wiki_id,movie_name,release,countries,genres,decade,year
23890098,Taxi Blues,1990,"['Russia', 'Soviet Union', 'France']","['Drama', 'World cinema']",1990,0
20663735,Narasimham,2000,['India'],"['Action', 'Musical', 'Drama', 'Bollywood']",2000,0
2231378,The Lemon Drop Kid,1951,['United States of America'],"['Screwball comedy', 'Comedy']",1950,1
595909,A Cry in the Dark,1988,"['New Zealand', 'Australia', 'United States of America']","['Crime Fiction', 'World cinema', 'Docudrama', 'Drama', 'Courtroom Drama']",1980,8
5272176,End Game,2006,"['Germany', 'United States of America', 'Canada']","['Action', 'Drama', 'Action/Adventure', 'Thriller']",2000,6
1952976,Dark Water,2005,['United States of America'],"['Drama', 'Thriller', 'Horror']",2000,5
24225279,Sing,1989,['United States of America'],"['Teen', 'Drama']",1980,9
2462689,Meet John Doe,1941,['United States of America'],"['Black-and-white', 'Comedy', 'Media Satire', 'Romance Film', 'Americana', 'Drama', 'Romantic comedy', 'Comedy-drama']",1940,1
15401493,Husband for Hire,2008,['United States of America'],['Comedy'],2000,8
18188932,Up and Down,2004,['Czech Republic'],"['Crime Fiction', 'Comedy', 'World cinema', 'Drama']",2000,4
2940516,Ghost In The Noonday Sun,1973,['United Kingdom'],"['Parody', 'Comedy']",1970,3
1335380,Exodus,1960,['United States of America'],"['Action', 'Film adaptation', 'Action/Adventure', 'War film', 'Drama', 'Period piece', 'Epic', 'Political drama']",1960,0
1480747,House Party 2,1991,['United States of America'],"['Coming of age', 'Comedy', 'Teen', 'Cult']",1990,1
24448645,Forest of the Damned 2,2008,[],['Horror'],2000,8
15072401,Charlie Chan's Secret,1936,['United States of America'],"['Crime Fiction', 'Mystery', 'Thriller', 'Comedy film', 'Horror']",1930,6
4018288,The Biggest Fan,2002,['United States of America'],['Drama'],2000,2
4596602,Ashes to Ashes,1999,['United Kingdom'],"['Action', 'Crime Fiction', 'Indie', 'Thriller', 'Romance Film', 'Martial Arts Film']",1990,9
15224586,Green Dragon,2001,['United States of America'],"['Period piece', 'Indie', 'Drama']",2000,1
15585766,The Rats of Tobruk,1944,['Australia'],"['War film', 'Drama']",1940,4
29326153,Class of '61,1993,['United States of America'],"['Action', 'Drama', 'Adventure']",1990,3
9252321,"Come Back, Africa",1960,"['United States of America', 'South Africa']","['Drama', 'Documentary']",1960,0
8388648,Nee Sneham,2002,['India'],['Drama'],2000,2
10644072,Bhagwan Dada,1986,['India'],[],1980,6
13455076,A Merry Mixup,1957,['United States of America'],"['Short Film', 'Black-and-white', 'Comedy']",1950,7
33269085,Kehtaa Hai Dil Baar Baar,2002,"['India', 'United States of America']","['Romance Film', 'Comedy film']",2000,2
2254491,Mr. & Mrs. '55,1955,['India'],"['Musical', 'Comedy', 'Bollywood', 'Romance Film']",1950,5
447194,Samson and Delilah,1949,['United States of America'],"['Action', 'Drama', 'History', 'Romance Film', 'Adventure']",1940,9
24165951,Getting Even,1986,['United States of America'],"['Action', 'Thriller', 'Romance Film', 'Adventure']",1980,6
18549958,"Love, Mary",1985,['United States of America'],"['Drama', 'Biopic [feature]']",1980,5
12978934,The Deep End of the Ocean,1999,['United States of America'],"['Film adaptation', 'Family Drama', 'Drama', 'Family Film']",1990,9
8471210,Pieces,1982,"['Spain', 'Puerto Rico', 'Italy', 'United States of America']","['Mystery', 'Slasher', 'Horror', 'B-movie']",1980,2
1925869,River of No Return,1954,['United States of America'],"['Action', 'Drama', 'Action/Adventure', 'Western']",1950,4
10799612,Amici miei,1975,['Italy'],"['Screwball comedy', 'Buddy film', 'Comedy', 'Drama']",1970,5
3150865,Yankee Doodle Daffy,1943,['United States of America'],"['Animation', 'Short Film', 'Comedy', 'Family Film']",1940,3
20591333,The Good Life,2007,"['Canada', 'United States of America']","['Indie', 'Drama']",2000,7
28238240,Mickey's Big Game Hunt,1928,['United States of America'],['Short Film'],1920,8
5414895,Red Cliff,2008,['China'],"['Action', 'Costume Adventure', 'Action/Adventure', 'World cinema', 'Chinese Movies', 'Drama', 'History', 'Historical Epic', 'Epic', 'War film']",2000,8
17124781,"The Good, the Bad, the Weird",2008,['South Korea'],"['Action', 'Costume Adventure', 'Action/Adventure', 'Comedy', 'World cinema', 'Adventure', 'Period piece', 'Western']",2000,8
5425205,Eastern Promises,2007,"['United Kingdom', 'United States of America', 'Canada']","['Crime Fiction', 'Mystery', 'Thriller', 'Crime Thriller', 'Drama']",2000,7
4356664,No Entry,2005,['India'],"['Comedy', 'Bollywood']",2000,5
19174305,Tahaan,2008,['India'],"['Drama', 'World cinema']",2000,8
33417831,Men In The City,2009,['Germany'],"['Comedy', 'Comedy film']",2000,9
2408359,Bikini Beach,1964,['United States of America'],"['Musical', 'Comedy', 'Teen', 'Musical comedy', 'Romance Film', 'Romantic comedy', 'Beach Film']",1960,4
1838882,The Storm Riders,1998,['Hong Kong'],"['Romantic fantasy', 'Fantasy Adventure', 'Action/Adventure', 'World cinema', 'Chinese Movies', 'Martial Arts Film', 'Adventure', 'Wuxia', 'Superhero movie', 'Fantasy']",1990,8
25755313,Against Her Will: An Incident in Baltimore,1992,['United States of America'],['Drama'],1990,2
10016997,Milk and Honey,1936,['United States of America'],"['Animation', 'Short Film', 'Comedy', 'Family Film']",1930,6
8153846,La Cité de la peur,1994,['France'],"['Black comedy', 'Satire', 'Comedy']",1990,4
24486071,Cheap Kisses,1924,['United States of America'],"['Silent film', 'Romance Film', 'Romantic drama']",1920,4
4466226,The Saddest Music in the World,2003,['Canada'],"['Musical', 'Musical Drama', 'Indie', 'Avant-garde', 'Comedy', 'Romance Film', 'Drama', 'Period piece', 'Experimental film', 'Fantasy']",2000,3
6167400,Twist,2003,['Canada'],"['LGBT', 'Gay', 'Indie', 'Drama']",2000,3
17711304,Rendezvous,1935,['United States of America'],"['Spy', 'Black-and-white']",1930,5
18392317,Mysterious Mose,1930,['United States of America'],['Short Film'],1930,0
15161056,Killjoy,2000,['United States of America'],"['Slasher', 'Teen', 'Horror', 'B-movie']",2000,0
21500407,You,2009,['United States of America'],"['Romantic drama', 'Family Drama', 'Romance Film', 'Melodrama', 'Drama']",2000,9
3459677,Shaadi No. 1,2005,['India'],"['Romantic drama', 'Comedy', 'World cinema', 'Romance Film', 'Romantic comedy', 'Drama']",2000,5
34420857,Kelviyum Naane Pathilum Naane,1982,['India'],['Musical'],1980,2
18369853,Soup or Sonic,1980,['United States of America'],"['Animation', 'Short Film', 'Comedy', 'Family Film']",1980,0
529276,Jaws: The Revenge,1987,['United States of America'],"['Action', 'Action/Adventure', 'Thriller', 'Horror', 'Natural horror films']",1980,7
24577134,The Healer,1935,['United States of America'],"['Romance Film', 'Romantic drama', 'Drama']",1930,5
455089,Givat Halfon Eina Ona,1976,['Israel'],"['Comedy', 'Cult']",1970,6
23266463,"Girl, Positive",2007,['United States of America'],"['Drama', 'Television movie']",2000,7
226664,About Schmidt,2002,['United States of America'],"['Drama', 'Indie', 'Comedy', 'Comedy of manners', 'Black comedy', 'Comedy-drama', 'Tragicomedy']",2000,2
25113407,"Wait Until Spring, Bandini",1989,"['Belgium', 'France', 'Italy', 'United States of America']","['Sports', 'Drama']",1980,9
27403920,Oil for the Lamps of China,1935,['United States of America'],"['Melodrama', 'Drama']",1930,5
2524925,The Land Before Time III: The Time of the Great Giving,1995,['United States of America'],"['Music', 'Animation', ""Children's"", 'Family-Oriented Adventure', ""Children's/Family"", 'Adventure', 'Family Film']",1990,5
657446,Liar Liar,1997,['United States of America'],"['Comedy', 'Domestic Comedy', 'Slapstick', 'Fantasy Comedy', 'Fantasy']",1990,7
1591973,"Hush… Hush, Sweet Charlotte",1964,['United States of America'],"['Psychological thriller', 'Black-and-white', 'Mystery', 'Psycho-biddy', 'Thriller', 'Horror', 'Crime Thriller']",1960,4
12383757,The Man from Monterey,1933,['United States of America'],"['Action', 'B-Western', 'Black-and-white', 'Action/Adventure', 'Western']",1930,3
4355919,Changes,1969,['United States of America'],['Drama'],1960,9
32163620,Gates of the Night,1946,['France'],"['Mystery', 'Romance Film', 'Drama', 'Fantasy']",1940,6
11685571,The Emperor Jones,1933,['United States of America'],"['Black-and-white', 'Pre-Code', 'Drama']",1930,3
17371197,Treed Murray,2001,['Canada'],"['Action', 'Psychological thriller', 'Action/Adventure', 'Thriller', 'Crime Thriller', 'Drama']",2000,1
1282593,The Incredibly True Adventure of Two Girls in Love,1995,['United States of America'],"['LGBT', 'Indie', 'Romantic drama', 'Comedy', 'Romance Film', 'Drama', 'Gay Themed', 'Gay', 'Coming of age', 'Gay Interest', 'Romantic comedy']",1990,5
7504323,More Pep,1936,['United States of America'],"['Animation', 'Short Film', 'Comedy', 'Family Film']",1930,6
7675415,Sundays and Cybelle,1962,['France'],"['Black-and-white', 'World cinema', 'War film', 'Drama']",1960,2
3109393,The Bloody Fists,2004,"['Hong Kong', 'Japan']","['Action', 'Japanese Movies', 'Action/Adventure', 'World cinema', 'Chinese Movies', 'Martial Arts Film']",2000,4
7580720,Rhythm,2000,['India'],"['Musical', 'Romance Film', 'Drama']",2000,0
457561,The Passion of Joan of Arc,1928,"['France', 'Denmark']","['Black-and-white', 'Biography', 'Indie', 'World cinema', 'Christian film', 'War film', 'Costume drama', 'Drama', 'Biopic [feature]', 'Silent film', 'Historical fiction', 'Epic', 'Hagiography', 'Political drama']",1920,8
32137084,Champion,2000,['India'],"['Action', 'Drama', 'Action/Adventure', 'Thriller', 'World cinema']",2000,0
4072739,Frozen with Fear,2001,['Canada'],"['Crime Fiction', 'Mystery', 'Thriller']",2000,1
8034072,Journey of a Woman,2007,['India'],"['Musical', 'Bollywood', 'World cinema', 'Drama']",2000,7
3470969,Day Watch,2006,['Russia'],"['Action', 'Thriller', 'World cinema', 'Supernatural', 'Science Fiction', 'Fantasy']",2000,6
4016437,Sophie's Choice,1982,"['United Kingdom', 'United States of America']","['Period piece', 'Romantic drama', 'Romance Film', 'Drama']",1980,2
17060199,Expired,2007,['United States of America'],"['Drama', 'Indie', 'Short Film', 'Comedy', 'Romance Film', 'Romantic comedy', 'Comedy-drama']",2000,7
7481126,Classmates,2006,['India'],"['Musical', 'Mystery', 'Comedy', 'Thriller', 'Romance Film', 'Drama']",2000,6
9031450,Spring Bears Love,2003,['South Korea'],"['Romance Film', 'Comedy']",2000,3
14582951,A Game for Vultures,1979,['United Kingdom'],"['War film', 'Drama', 'Political drama']",1970,9
4803289,Until Death,2007,"['Bulgaria', 'United Kingdom', 'Germany', 'United States of America']","['Action', 'Crime Fiction', 'Action/Adventure', 'Thriller']",2000,7
1788654,Novocaine,2001,['United States of America'],"['Neo-noir', 'Crime Fiction', 'Comedy', 'Thriller', 'Black comedy', 'Drama', 'Crime Comedy', 'Comedy-drama']",2000,1
25388139,Suryavamsam,1997,['India'],['Drama'],1990,7
21735071,The Understudy,2008,['United Kingdom'],['Black comedy'],2000,8
15912738,L: Change the World,2008,['Japan'],"['Japanese Movies', 'Action/Adventure', 'Thriller', 'World cinema', 'Fantasy']",2000,8
24589422,Maria’s Lovers,1984,['United States of America'],"['Romantic drama', 'Indie', 'Romance Film', 'Drama']",1980,4
4767342,Sa Pusod ng Dagat,1998,['Philippines'],"['Filipino Movies', 'World cinema', 'Filipino', 'Drama']",1990,8
28177482,My Brother's Keeper,1948,['United Kingdom'],"['Drama', 'Crime Fiction']",1940,8
3662683,American Dreamz,2006,['United States of America'],"['Political cinema', 'Political satire', 'Parody', 'Comedy', 'Media Satire']",2000,6
35068740,Chinnavar,1992,['India'],['Drama'],1990,2
9709159,The Policeman,1970,['Israel'],"['Comedy', 'Crime Comedy', 'World cinema', 'Drama']",1970,0
25094002,Rose by Any Other Name...,1997,['United States of America'],['Comedy'],1990,7
11624345,Bandhe Haath,1973,['India'],"['Romantic drama', 'Action/Adventure', 'Thriller', 'World cinema', 'Romance Film', 'Drama']",1970,3
5786261,Three Little Bops,1957,['United States of America'],['Musical'],1950,7
33837735,The Black Corsair,1976,['Italy'],"['Action', 'Adventure']",1970,6
21132951,Aparan,1988,['India'],"['Mystery', 'Thriller']",1980,8
18906519,The Assassin,1952,['United Kingdom'],"['Film adaptation', 'Detective', 'Thriller', 'Film noir', 'Crime Thriller', 'Drama']",1950,2
473286,Anything Else,2003,"['United Kingdom', 'France', 'United States of America']","['Romance Film', 'Romantic comedy', 'Comedy']",2000,3
11388102,Old Clothes,1925,['United States of America'],"['Black-and-white', 'Silent film', 'Comedy-drama', 'Drama']",1920,5
19757981,The Big Premiere,1940,['United States of America'],"['Black-and-white', 'Short Film', 'Comedy', 'Family Film']",1940,0
3644125,Each Dawn I Die,1939,['United States of America'],"['Prison', 'Black-and-white', 'Crime Fiction', 'Gangster Film', 'Prison film', 'Drama', 'Thriller']",1930,9
21450904,Bug Buster,1998,['United States of America'],"['Action', 'Parody', 'Comedy film', 'Horror', 'B-movie', 'Science Fiction']",1990,8
11823946,Twelfth Night: Or What You Will,1996,"['United Kingdom', 'Ireland', 'United States of America']","['Film adaptation', 'Comedy', 'Romance Film', 'Romantic comedy', 'Drama']",1990,6
6575053,Deepstar Six,1989,['United States of America'],"['Creature Film', 'Thriller', 'Horror', 'Sci-Fi Horror', 'Science Fiction', 'Natural horror films']",1980,9
21714981,Libido,1973,['Australia'],['Drama'],1970,3
11990695,Maneater,2007,['United States of America'],"['Action', 'Action/Adventure', 'Thriller', 'Horror', 'Television movie', 'Science Fiction', 'Natural horror films']",2000,7
3649186,Una mujer sin amor,1952,['Mexico'],"['Black-and-white', 'Art film', 'Romantic drama', 'World cinema', 'Romance Film', 'Melodrama', 'Drama']",1950,2
6935978,The Rounders,1965,['United States of America'],['Western'],1960,5
12092931,Say it in Russian,2007,"['United States of America', 'France']","['Crime Fiction', 'Romantic drama', 'Thriller', 'Romance Film', 'Drama']",2000,7
1596505,The Million Dollar Hotel,2000,"['United Kingdom', 'Germany', 'United States of America']","['Detective fiction', 'Mystery', 'Indie', 'Thriller', 'World cinema', 'Crime Thriller', 'Drama', 'Detective', 'Ensemble Film']",2000,0
25807103,The Secret Cinema,1968,['United States of America'],['Short Film'],1960,8
20903293,Maha Chor,1976,['India'],"['Action', 'Drama', 'Crime Fiction', 'Comedy']",1970,6
235406,Mother India,1957,['India'],"['Bollywood', 'World cinema', 'Melodrama', 'Epic', 'Drama']",1950,7
7718873,Mosquito Man,2005,['United States of America'],"['Creature Film', 'Monster movie', 'Horror', 'B-movie', 'Science Fiction', 'Natural horror films']",2000,5
142423,Il Postino,1994,"['France', 'Italy', 'Belgium']","['Period piece', 'Biography', 'Romantic drama', 'Comedy', 'World cinema', 'Romance Film', 'Drama']",1990,4
5107196,Final Stab,2001,['United States of America'],"['Slasher', 'Teen', 'Horror']",2000,1
30476388,Christmas in Paradise,2007,['United States of America'],"['Drama', 'Comedy film']",2000,7
30005855,Breath of Hate,2009,['United States of America'],"['Slasher', 'Horror', 'Romance Film', 'Drama', 'Cult']",2000,9
2209027,Betty Blue,1986,['France'],"['Romance Film', 'Drama']",1980,6
14746604,"Rip, Sew and Stitch",1953,['United States of America'],"['Short Film', 'Black-and-white', 'Comedy']",1950,3
8191245,Crimes at the Dark House,1940,['United Kingdom'],"['Black-and-white', 'Thriller', 'Crime Drama', 'Crime Thriller', 'Drama']",1940,0
20914710,Mighty Baby,2002,['Hong Kong'],['Chinese Movies'],2000,2
27369092,Zandy's Bride,1974,['United States of America'],"['Western', 'Romantic drama', 'Action/Adventure']",1970,4
24268011,Phir Kabhi,2009,['India'],"['Romance Film', 'Drama']",2000,9
4154028,Two Evil Eyes,1990,"['Italy', 'United States of America']","['Psychological thriller', 'Film adaptation', 'Thriller', 'Anthology', 'Drama', 'Horror', 'Supernatural', 'Cult']",1990,0
770277,Indochine,1992,['France'],"['Romantic drama', 'World cinema', 'Romance Film', 'Epic', 'War film', 'Drama']",1990,2
25588342,Hot Millions,1968,"['United Kingdom', 'United States of America']","['Comedy', 'Crime Comedy']",1960,8
22479768,Take A Hard Ride,1975,"['Italy', 'United States of America']","['Spaghetti Western', 'Blaxploitation', 'Western']",1970,5
6002183,Horton Hears a Who!,2008,['United States of America'],"['Animation', 'Comedy', 'Adventure', 'Family Film', 'Computer Animation']",2000,8
6540216,Always Outnumbered,1998,['United States of America'],"['Action', 'Crime Fiction', 'Drama']",1990,8
225473,Cinderella Liberty,1973,['United States of America'],"['Romance Film', 'Romantic drama', 'Drama']",1970,3
24073089,Folks!,1992,['United States of America'],"['Comedy', 'Black comedy', 'Domestic Comedy', 'Slapstick']",1990,2
23991052,Northern Lights,2009,"['Canada', 'United States of America']","['Film adaptation', 'Crime Fiction', 'Mystery', 'Romantic drama', 'Romance Film', 'Television movie', 'Drama']",2000,9
6084851,Le gendarme se marie,1968,['France'],['Comedy'],1960,8
1813912,Tell Them Willie Boy Is Here,1969,['United States of America'],"['Chase Movie', 'Western', 'Action/Adventure', 'Indian Western', 'Drama']",1960,9
23605990,Beck – Pensionat Pärlan,1998,"['Denmark', 'Norway', 'Sweden', 'Germany']","['Mystery', 'Crime Fiction']",1990,8
35030619,Carib Gold,1956,['United States of America'],['Drama'],1950,6
19332675,Othello,2001,"['United Kingdom', 'United States of America', 'Canada']","['Film adaptation', 'Television movie', 'Drama']",2000,1
19755481,Wait Until Dark,1967,['United States of America'],"['Psychological thriller', 'Suspense', 'Thriller', 'New Hollywood', 'Horror']",1960,7
5925279,Orphans Of The Storm,1921,['United States of America'],"['Period piece', 'Black-and-white', 'Drama', 'Indie', 'Short Film', 'Silent film', 'Melodrama']",1920,1
26393786,3 saisons,2009,['Canada'],['Drama'],2000,9
27997130,Demobbed,2000,['Russia'],['Comedy film'],2000,0
30622939,Dark and Stormy Night,2009,['United States of America'],"['Mystery', 'Parody', 'Indie', 'Comedy', 'Thriller']",2000,9
1373219,Darkness,2002,"['Spain', 'United States of America']","['Haunted House Film', 'Horror']",2000,2
2311219,Munich,2005,"['France', 'United States of America', 'Canada']","['Spy', 'Thriller', 'Docudrama', 'Drama', 'Period piece', 'Airplanes and airports', 'Sports', 'Political drama', 'Political thriller']",2000,5
26834911,Face the Evil,1997,['United States of America'],"['Action', 'Action Thrillers', 'Indie', 'Action/Adventure', 'Thriller']",1990,7
20120996,Friendship,2008,['Thailand'],"['Romance Film', 'Drama']",2000,8
13448042,The Victim,2006,['Thailand'],"['Psychological thriller', 'Thriller', 'Horror', 'World cinema']",2000,6
9916623,The Spell of the Circus,1931,['United States of America'],"['Action', 'Black-and-white', 'Adventure']",1930,1
20753929,The Notorious Elinor Lee,1940,['United States of America'],"['Early Black Cinema', 'Drama']",1940,0
6777222,"Rack, Shack, and Benny",1995,['United States of America'],"['Musical', 'Animation', 'Short Film', ""Children's""]",1990,5
26464187,Lucky Losers,1950,['United States of America'],"['Comedy', 'Crime Fiction']",1950,0
26182742,Thanks maa,2008,['India'],"['Drama', 'World cinema']",2000,8
5733324,Easy Money,1983,['United States of America'],"['Indie', 'Comedy']",1980,3
8262659,Abbott and Costello Meet the Keystone Kops,1955,['United States of America'],"['Black-and-white', 'Parody', 'Comedy', 'Family Film']",1950,5
6285350,Klamek ji bo Beko,1992,"['Armenia', 'Germany']",['Drama'],1990,2
4995581,Mildred Pierce,1945,['United States of America'],"['Family Drama', 'Mystery', 'Crime Drama', 'Romance Film', 'Film noir', 'Melodrama', 'Drama']",1940,5
20805584,Shifty,2009,['United Kingdom'],"['Crime Drama', 'Drama']",2000,9
2257358,Great Expectations,1946,['United Kingdom'],"['Period piece', 'Film adaptation', 'Romantic drama', 'Romance Film', 'Costume drama', 'Drama']",1940,6
11074454,Diaboliquement vôtre,1967,"['France', 'Germany', 'Italy']","['Psychological thriller', 'Crime Fiction', 'Thriller', 'Drama']",1960,7
12113134,Aasha,1957,['India'],['Comedy'],1950,7
5239234,Aces: Iron Eagle III,1992,"['United Kingdom', 'United States of America']","['Action', 'Crime Fiction', 'Action/Adventure', 'Thriller']",1990,2
18066729,Poppoya,1999,['Japan'],['Japanese Movies'],1990,9
6593182,Land of the Lost,2009,['United States of America'],"['Action', 'Monster', 'Action/Adventure', 'Comedy', 'Sci-Fi Adventure', 'Adventure', 'Parody', 'Science Fiction', 'Fantasy']",2000,9
3257958,The Santa Clause 3: The Escape Clause,2006,['United States of America'],"['Comedy', 'Holiday Film', 'Christmas movie', 'Fantasy Comedy', 'Family Film']",2000,6
4716139,Bharathi Kannamma,1997,['India'],"['Romantic drama', 'Tamil cinema', 'World cinema', 'Romance Film', 'Drama']",1990,7
22480532,Tigger and Pooh and A Musical Too,2009,['United States of America'],"['Musical', 'Animation', 'Educational', 'Family Film']",2000,9
9294,The Evil Dead,1981,['United States of America'],"['Indie', 'Horror', 'Haunted House Film', 'B-movie', 'Cult']",1980,1
32803232,Parc,2008,['France'],"['Drama', 'World cinema']",2000,8
3389457,Postmortem,1998,['United States of America'],"['Psychological thriller', 'Suspense', 'Mystery', 'Thriller', 'Crime Thriller']",1990,8
24840023,Rebellion,2009,['Hong Kong'],"['Action/Adventure', 'Thriller', 'World cinema', 'Crime Thriller', 'Chinese Movies']",2000,9
1330432,Mighty Aphrodite,1995,['United States of America'],"['Indie', 'Comedy', 'Romance Film', 'Romantic comedy', 'Sex comedy']",1990,5
518117,Mughal-e-Azam,1960,['India'],"['Musical', 'Bollywood', 'Romance Film', 'War film', 'Drama']",1960,0
14359457,"Jacob, the Liar",1975,"['Czechoslovakia', 'Germany', 'German Democratic Republic']","['Crime Fiction', 'Comedy', 'World cinema', 'Drama']",1970,5
6270685,Tiptoes,2003,"['France', 'United States of America']","['Drama', 'Indie', 'Romantic drama', 'Comedy', 'Romance Film', 'Romantic comedy']",2000,3
6369452,That Old Feeling,1997,['United States of America'],"['Comedy', 'Romance Film', 'Romantic comedy', 'Sex comedy']",1990,7
5283066,King of the Ants,2003,['United States of America'],"['Psychological thriller', 'Crime Fiction', 'Gangster Film', 'Thriller', 'Crime Thriller', 'Drama', 'Suspense', 'Horror']",2000,3
13259610,Shinsengumi,1969,['Japan'],"['Art film', 'Japanese Movies', 'Action/Adventure', 'World cinema', 'Drama']",1960,9
4199982,Suddenly Naked,2001,['Canada'],"['Romance Film', 'Romantic comedy', 'Comedy-drama', 'Drama']",2000,1
14570672,The Dawning,1988,"['Ireland', 'United Kingdom']","['Coming of age', 'Melodrama', 'Political drama', 'Drama']",1980,8
25098041,Protector,2009,[],['War film'],2000,9
12786966,The Woman on the Beach,1947,['United States of America'],"['Black-and-white', 'Film noir', 'Melodrama', 'Drama']",1940,7
3523090,Le Beau Serge,1958,['France'],"['Drama', 'World cinema']",1950,8
20887118,Battlestar Galactica: The Plan,2009,['United States of America'],"['Science Fiction', 'Sci-Fi Adventure']",2000,9
3723154,Storm Rider,1972,['Italy'],"['Action/Adventure', 'Western', 'World cinema', 'Spaghetti Western']",1970,2
2274938,Friday the 13th Part 2,1981,['United States of America'],"['Slasher', 'Teen', 'Horror', 'Cult']",1980,1
3147170,Noises Off...,1992,['United States of America'],"['Parody', 'Slapstick', 'Comedy']",1990,2
7529479,Virumbugiren,2002,['India'],['Romance Film'],2000,2
8665259,The Man Who Quit Smoking,1972,['Sweden'],['Comedy'],1970,2
31844153,Three Brave Men,1956,['United States of America'],"['Docudrama', 'Drama']",1950,6
9734319,Anantha Poongathe,1999,['India'],[],1990,9
10016740,Mela,2000,['India'],"['Action', 'Drama']",2000,0
22829,Orgy of the Dead,1965,['United States of America'],"['Sexploitation', 'Horror', 'B-movie', 'Zombie Film', 'Supernatural', 'Cult']",1960,5
9141521,Outpost,2008,"['United Kingdom', 'Scotland']","['Action', 'Drama', 'Slasher', 'Horror']",2000,8
12333653,An Eye for an Eye,1981,['United States of America'],"['Action', 'Crime Fiction', 'Indie', 'Thriller', 'Martial Arts Film', 'Adventure']",1980,1
11627124,Takkari,2007,['India'],['Romance Film'],2000,7
1307956,Stage Beauty,2004,"['United Kingdom', 'Germany', 'United States of America']","['LGBT', 'Romantic drama', 'Comedy', 'Romance Film', 'Drama', 'Period piece', 'Romantic comedy', 'Comedy-drama', 'Comedy of manners']",2000,4
6009073,Northern Lights,1997,"['Canada', 'United States of America']","['Television movie', 'Comedy-drama', 'Drama']",1990,7
3177319,A Chump at Oxford,1940,['United States of America'],"['Black-and-white', 'Buddy film', 'Satire', 'Comedy', 'Comedy of manners', 'Slapstick']",1940,0
22457596,American Pie Presents: The Book of Love,2009,"['Canada', 'United States of America']","['Coming of age', 'Comedy', 'Teen', 'Sex comedy']",2000,9
2906378,Le Magnifique,1973,['France'],"['Action', 'Parody', 'Action Comedy', 'Action/Adventure', 'Comedy', 'World cinema', 'Romantic comedy']",1970,3
1871096,Bad Boys,1983,['United States of America'],"['Crime Fiction', 'Coming of age', 'Thriller', 'Drama']",1980,3
17938594,La ragazza di via Condotti,1973,"['France', 'Spain', 'Italy']","['Crime', 'Thriller']",1970,3
797330,Strange Brew,1983,['Canada'],"['Indie', 'Satire', 'Comedy', 'Cult', 'Absurdism']",1980,3
34171890,The Dead Don't Die,1975,['United States of America'],"['Thriller', 'Horror']",1970,5
8094606,The Assault,1986,['Netherlands'],"['The Netherlands in World War II', 'Action Thrillers', 'Thriller', 'World cinema', 'War film', 'Drama']",1980,6
3098782,Strictly Business,1991,['United States of America'],"['Romance Film', 'Romantic comedy', 'Comedy']",1990,1
8418734,Killer Tomatoes Eat France,1991,['United States of America'],"['Parody', 'Comedy', 'Horror', 'B-movie', 'Science Fiction']",1990,1
7171361,Jacknife,1989,['United States of America'],['Drama'],1980,9
8956466,El Amateur,1999,['Argentina'],"['Drama', 'Indie', 'World cinema', 'Sports']",1990,9
7977406,Dirty Work,1933,['United States of America'],"['Short Film', 'Black-and-white', 'Comedy']",1930,3
16179846,Sadhanai,1986,['India'],['Drama'],1980,6
19203309,Ring of Spies,1964,['United Kingdom'],"['Docudrama', 'Spy']",1960,4
17063416,Dar alanda kısa paslaşmalar,2000,['Turkey'],['Drama'],2000,0
15052685,Charlie Chan in Paris,1935,['United States of America'],"['Crime Fiction', 'Mystery', 'Thriller', 'Comedy film', 'Drama']",1930,5
17991914,Pink Collar,2006,['United States of America'],['Comedy'],2000,6
21716330,Makante achan,2009,['India'],['Drama'],2000,9
3192223,Canary Row,1950,['United States of America'],"['Animation', 'Short Film', 'Comedy', 'Family Film']",1950,0
6838347,Retenez Moi...Ou Je Fais Un Malheur,1984,['France'],['Comedy'],1980,4
61494,Naughty Marietta,1935,['United States of America'],"['Musical', 'Black-and-white', 'Drama']",1930,5
203413,The Lizzie McGuire Movie,2003,['United States of America'],"['Music', 'Comedy', 'Teen', 'Romance Film', 'Romantic comedy', 'Adventure', 'Family Film']",2000,3
5981203,"I Love You, I Love You Not",1997,"['United Kingdom', 'France', 'Germany', 'United States of America']","['Teen', 'Romance Film', 'Romantic comedy', 'Drama']",1990,7
28822507,For the Love of Ada,1972,['United Kingdom'],['Comedy'],1970,2
8204853,Big Nothing,2006,"['Canada', 'United Kingdom']","['Action', 'Suspense', 'Crime Fiction', 'Action/Adventure', 'Comedy', 'Crime Comedy', 'Black comedy']",2000,6
4179195,Overnight,2004,['United States of America'],['Documentary'],2000,4
204774,Farewell My Concubine,1993,"['China', 'Hong Kong']","['Music', 'LGBT', 'Art film', 'World cinema', 'Romance Film', 'Chinese Movies', 'Drama']",1990,3
8423977,Apna Sapna Money Money,2006,['India'],"['Musical', 'Comedy', 'Bollywood', 'World cinema', 'Romance Film']",2000,6
6014959,Anari,1959,['India'],"['Bollywood', 'Drama']",1950,9
26283768,St. Benny the Dip,1951,['United States of America'],"['Religious Film', 'Comedy', 'Crime Comedy']",1950,1
4268056,I Am David,2003,['United States of America'],"['Period piece', 'Film adaptation', 'Family Drama', 'Childhood Drama', 'Escape Film', 'Drama', 'Family Film']",2000,3
15842654,His First Flame,1927,['United States of America'],"['Silent film', 'Black-and-white', 'Comedy']",1920,7
5719024,The War Wagon,1967,['United States of America'],"['Heist', 'Action/Adventure', 'Western', 'Caper story']",1960,7
25480074,Fine Things,1990,['United States of America'],"['Film adaptation', 'Romantic drama', 'Romance Film', 'Television movie', 'Drama']",1990,0
9916970,The Mouthpiece,1932,['United States of America'],"['Black-and-white', 'Crime Fiction', 'Crime Drama', 'Drama']",1930,2
265033,Space Jam,1996,['United States of America'],"['Animation', 'Comedy', ""Children's/Family"", 'Adventure', 'Sports', 'Alien Film', 'Science Fiction', 'Family Film', 'Fantasy']",1990,6
2155517,Wild Cactus,1993,['United States of America'],"['Thriller', 'Horror', 'Erotic thriller', 'Adult']",1990,3
34638152,Sivandha Mann,1969,['India'],[],1960,9
8764467,The In-Laws,2003,"['Germany', 'United States of America']","['Action', 'Action/Adventure', 'Comedy']",2000,3
17643352,Phir Teri Kahani Yaad Aayee,1993,['India'],"['Romance Film', 'Drama']",1990,3
6004920,Gharshana,2004,['India'],"['Action', 'Crime Fiction', 'Mystery', 'Romance Film', 'Tollywood', 'Drama']",2000,4
305909,Zoolander,2001,"['Germany', 'United States of America', 'Australia']","['Parody', 'Comedy', 'Comedy of Errors']",2000,1
1324717,The One Who My Heart Longs For,2004,['India'],"['Musical', 'Romantic drama', 'Comedy', 'Bollywood', 'World cinema', 'Romance Film', 'Drama']",2000,4
106352,Atlantic City,1980,"['France', 'United States of America', 'Canada']","['Musical', 'Crime Fiction', 'Romantic drama', 'New Hollywood', 'Romance Film', 'Drama']",1980,0
24228496,SpongeBob's Truth or Square,2009,['United States of America'],"['Comedy', 'Animation']",2000,9
11293276,Madurai Veeran,2007,['India'],"['Action', 'Romance Film']",2000,7
16673820,Gym Teacher: The Movie,2008,['United States of America'],"['Coming of age', 'Comedy', 'Television movie', ""Children's"", 'Family Film']",2000,8
5159732,Bas Itna Sa Khwaab Hai,2001,['India'],"['Romance Film', 'Bollywood']",2000,1
917524,I Am Curious (Yellow),1967,['Sweden'],"['Erotic Drama', 'Romantic drama', 'World cinema', 'Romance Film', 'Erotica', 'Drama']",1960,7
3182458,Tales of Manhattan,1942,['United States of America'],"['Black-and-white', 'Comedy of manners', 'Comedy-drama', 'Drama']",1940,2
14901197,Daisy Town,1972,['Belgium'],"['Animation', 'Western', 'Comedy']",1970,2
474750,Batman: Mystery of the Batwoman,2003,['United States of America'],"['Fantasy Adventure', 'Animated cartoon', 'Animation', 'Superhero', 'Action/Adventure', 'Short Film', 'Superhero movie', 'Family Film', 'Fantasy']",2000,3
32777283,Dust in the Sun,1958,[],['Drama'],1950,8
6002416,Parakh,1960,['India'],['Bollywood'],1960,0
3322205,Dil Hai Ke Manta Nahin,1991,['India'],"['Musical', 'Romantic drama', 'Bollywood', 'World cinema', 'Romance Film', 'Drama']",1990,1
9537791,Decoys 2: Alien Seduction,2007,['Canada'],"['Science Fiction', 'Comedy', 'Horror']",2000,7
23910715,The Admiral Was a Lady,1950,['United States of America'],"['Romance Film', 'Black-and-white', 'Comedy']",1950,0
45772,Rocky,1976,['United States of America'],"['Action', 'Boxing', 'New Hollywood', 'Romance Film', 'Sports', 'Drama']",1970,6
7537280,High Road to China,1983,"['Yugoslavia', 'United States of America']","['Romance Film', 'War film', 'Adventure', 'Drama']",1980,3
600008,Steel Magnolias,1989,['United States of America'],"['Family Drama', 'Medical fiction', 'Domestic Comedy', 'Drama', 'Family Film', 'Ensemble Film']",1980,9
15428140,La Vérité si je mens!,1997,['France'],"['Satire', 'Comedy film', 'Comedy of manners', 'Romantic comedy']",1990,7
7671792,Bring Me the Head of Charlie Brown,1986,['United States of America'],"['Action', 'Animation', 'Parody', 'Short Film', 'Comedy film']",1980,6
5983605,"No sos vos, soy yo",2004,['Argentina'],"['Romantic comedy', 'Comedy', 'Drama']",2000,4
7548602,The Robe,1953,['United States of America'],"['Period piece', 'Christian film', 'Sword and Sandal', 'Epic', 'Roadshow theatrical release', 'Costume drama', 'Drama']",1950,3
33614310,Rakkuyilin Ragasadassil,1986,[],['Drama'],1980,6
14935392,Next Day Air,2009,['United States of America'],"['Action', 'Crime Fiction', 'Comedy', 'Crime Comedy', 'Comedy of Errors']",2000,9
26561332,Merupu Daadi,1984,['India'],"['Action', 'Western', 'Drama']",1980,4
5672605,Su Excelencia,1966,['Mexico'],"['Political satire', 'Comedy', 'World cinema', 'Drama', 'Comedy of Errors']",1960,6
5657238,Maayavi,2005,['India'],"['Drama', 'Comedy']",2000,5
29549727,Qaidi,2002,['India'],['World cinema'],2000,2
3709021,"Follow Me, Boys!",1966,['United States of America'],"['Family Drama', 'Comedy', 'Childhood Drama', 'Drama', 'Family Film']",1960,6
4734122,Tzameti,2005,['France'],"['Psychological thriller', 'Thriller', 'World cinema', 'Crime Thriller']",2000,5
17193728,Dangerous Moonlight,1941,['United Kingdom'],"['Black-and-white', 'War film', 'Adventure', 'Drama']",1940,1
785488,The Singing Ringing Tree,1957,"['Germany', 'German Democratic Republic']",['World cinema'],1950,7
6215073,Appleseed,2005,"['Japan', 'United States of America']","['Action', 'Animation', 'Action/Adventure', 'Thriller', 'World cinema', 'Computer Animation', 'Japanese Movies', 'Anime', 'Science Fiction']",2000,5
21099183,The Good Witch's Garden,2009,['Canada'],"['Comedy', 'Romance Film', 'Television movie', 'Family Film', 'Fantasy']",2000,9
484102,Malèna,2000,"['Italy', 'United States of America']","['Drama', 'World cinema']",2000,0
4415958,Little Secrets,2001,['United States of America'],"['Family Drama', 'Indie', 'Comedy', 'Teen', 'Drama', 'Coming of age', 'Comedy-drama', 'Family Film']",2000,1
9307052,Bhool Bhulaiyaa,2007,['India'],"['Mystery', 'Comedy', 'Thriller', 'Horror']",2000,7
17489502,Newtonin 3-m Vidhi,2008,['India'],"['Action', 'Crime Fiction']",2000,8
101523,Jay and Silent Bob Strike Back,2001,['United States of America'],"['Stoner film', 'Buddy film', 'Comedy', 'Road movie']",2000,1
12152908,The Rocker,2008,['United States of America'],"['Comedy', 'Musical comedy']",2000,8
1697309,Odd Girl Out,2005,['United States of America'],"['Film adaptation', 'Teen', 'Television movie', 'Drama']",2000,5
10014126,Samson and Delilah,1984,"['United Kingdom', 'United States of America']","['Short Film', 'Christian film']",1980,4
25489908,Some Kind of a Nut,1970,['United States of America'],['Comedy'],1970,0
14840073,Kiss Kiss,2001,['United Kingdom'],"['Comedy', 'Thriller']",2000,1
10395114,Tonight Is Ours,1933,['United States of America'],"['Black-and-white', 'Comedy', 'Romance Film', 'Drama']",1930,3
6788669,A Big Hand for the Little Lady,1966,['United States of America'],"['Comedy Western', 'Action/Adventure', 'Western', 'Comedy']",1960,6
12494128,What Price Glory,1952,['United States of America'],"['Period piece', 'Romantic drama', 'Romance Film', 'Drama']",1950,2
9214302,Martín,1997,"['Argentina', 'Spain']","['LGBT', 'Indie', 'World cinema', 'Drama']",1990,7
1862086,Paheli,2005,['India'],"['Mystery', 'Fantasy Drama', 'Romantic drama', 'Thriller', 'World cinema', 'Romance Film', 'Drama', 'Supernatural']",2000,5
23057797,Adultery Diary: One More Time While I'm Still Wet,1996,['Japan'],"['Erotica', 'Japanese Movies', 'Pornographic movie']",1990,6
6902699,Pennies from Heaven,1981,['United States of America'],"['Musical', 'Period piece', 'Romantic drama', 'Romance Film', 'Drama']",1980,1
5965800,Centurians of Rome,1981,['United States of America'],"['Gay pornography', 'Pornographic movie']",1980,1
3410910,Night After Night,1932,['United States of America'],"['Black-and-white', 'Romantic drama', 'Pre-Code', 'Drama']",1930,2
8454631,China Moon,1994,['United States of America'],"['Psychological thriller', 'Neo-noir', 'Mystery', 'Thriller', 'Erotic thriller']",1990,4
35030681,Sidecar Racers,1975,"['United States of America', 'Australia']",['Drama'],1970,5
6551508,The Monster Maker,1944,['United States of America'],"['Creature Film', 'Black-and-white', 'Horror', 'Science Fiction']",1940,4
4707517,Page 3,2005,['India'],"['Art film', 'Bollywood', 'World cinema', 'Drama']",2000,5
21674541,La Florida,1993,['Canada'],"['Comedy', 'Comedy of Errors']",1990,3
2870583,Sun Alley,1999,['Germany'],"['Romance Film', 'Comedy']",1990,9
22541211,Manmadhan,2004,['India'],"['Musical', 'Bollywood', 'World cinema', 'Drama']",2000,4
8955193,Antigua vida mía,2001,['Argentina'],['Drama'],2000,1
19896950,April Showers,2009,['United States of America'],"['Crime Fiction', 'Indie', 'Drama']",2000,9
26340503,Naked Massacre,1976,"['Canada', 'France', 'West Germany', 'Italy']","['Thriller', 'Crime Fiction']",1970,6
4372744,The Voyager,1991,"['United Kingdom', 'France', 'Germany', 'Greece']","['Period piece', 'Crime Fiction', 'Romantic drama', 'World cinema', 'Romance Film', 'Drama']",1990,1
1261355,The King of Kings,1927,['United States of America'],"['Indie', 'Silent film', 'Christian film', 'Drama']",1920,7
12599417,Mrigayaa,1976,['India'],"['Period piece', 'Political drama', 'Drama']",1970,6
7192710,Manthri gari Viyyankudu,1983,['India'],"['Action', 'Drama', 'Comedy', 'Romance Film']",1980,3
24355979,Warlords of the 21st Century,1982,['New Zealand'],"['Indie', 'Science Fiction']",1980,2
1376896,Out Cold,2001,['United States of America'],"['Sports', 'Comedy']",2000,1
161450,The Man with the Golden Arm,1955,['United States of America'],"['Film adaptation', 'Black-and-white', 'Melodrama', 'Addiction Drama', 'Drama']",1950,5
31832848,Mama Loves Papa,1945,['United States of America'],['Comedy film'],1940,5
4370892,House,1986,['United States of America'],"['Comedy', 'Horror', 'Black comedy', 'Zombie Film']",1980,6
22834804,Never Say Never Mind: The Swedish Bikini Team,2001,['England'],"['Action', 'Comedy', 'Adventure']",2000,1
19282000,Wishbone's Dog Days of the West,1998,['United States of America'],"['Comedy', 'Adventure', ""Children's"", 'Family Film']",1990,8
1595987,The Pentagon Wars,1998,['United States of America'],"['War film', 'Comedy film']",1990,8
23899512,Fiffty Fiffty,1981,['India'],"['Action', 'Musical', 'Comedy']",1980,1
3036635,Lost & Found,1999,['United States of America'],"['Screwball comedy', 'Comedy', 'Romance Film', 'Romantic comedy']",1990,9
24898518,Chanakya,2005,['India'],"['Drama', 'World cinema']",2000,5
5549799,My Life,1993,['United States of America'],"['Melodrama', 'Family Drama', 'Drama']",1990,3
228355,The Naked Gun: From the Files of Police Squad!,1988,['United States of America'],"['Action', 'Crime Fiction', 'Screwball comedy', 'Parody', 'Comedy', 'Romance Film']",1980,8
8773488,Remote,1993,['United States of America'],['Comedy'],1990,3
645071,The Kingdom,1994,"['Denmark', 'Sweden', 'France', 'Germany']","['Surrealism', 'Mystery', 'Comedy', 'Horror', 'Black comedy', 'Drama', 'Fantasy']",1990,4
13005847,I Witness,2003,"['Germany', 'United States of America']","['Crime Fiction', 'Mystery', 'Thriller', 'Crime Thriller', 'Political drama', 'Drama', 'Political thriller']",2000,3
18520285,Miss Conception,2008,"['United Kingdom', 'Germany', 'United States of America']","['Indie', 'Comedy', 'Romance Film', 'Romantic comedy']",2000,8
1740764,Envy,2004,"['United States of America', 'Australia']","['Black comedy', 'Comedy', 'Cult']",2000,4
35586499,Nasibo,1993,['India'],[],1990,3
32496356,Dost,1989,['India'],"['Musical', 'Bollywood', 'World cinema', 'Drama']",1980,9
3790121,Unprecedented: The 2000 Presidential Election,2002,['United States of America'],"['Social issues', 'Law & Crime', 'Political cinema', 'History', 'Indie', 'Documentary']",2000,2
1266819,Aliens of the Deep,2005,['United States of America'],"['Education', 'Travel', 'Documentary']",2000,5
3615688,Bordertown,2006,"['United Kingdom', 'United States of America']","['Drama', 'Crime Fiction', 'Mystery', 'Indie', 'Thriller', 'Crime Thriller']",2000,6
33329567,Leghorn Swoggled,1951,[],"['Animation', 'Short Film', 'Comedy film', 'Family Film']",1950,1
3564596,She's On Duty,2005,['South Korea'],"['Romance Film', 'Crime Fiction', 'Comedy']",2000,5
25576998,This Time Around,2003,[],"['Romance Film', 'Comedy film']",2000,3
23945123,Little Miss Millions,1993,['United States of America'],['Comedy'],1990,3
12576808,Futurama: The Wild Green Yonder,2009,['United States of America'],"['Science Fiction', 'Comedy']",2000,9
3067907,Mapado,2005,['South Korea'],['Comedy'],2000,5
1906889,Threesome,1994,['United States of America'],"['LGBT', 'Comedy', 'Erotica', 'Romance Film', 'Romantic comedy', 'Drama']",1990,4
32426830,Paying the Piper,1949,[],"['Animation', 'Short Film', 'Comedy film', 'Family Film']",1940,9
9013693,A Big Bang Love: Juvenile,2006,['Japan'],"['LGBT', 'Japanese Movies', 'Thriller', 'World cinema']",2000,6
24320501,A Modern Hero,1934,['United States of America'],"['Black-and-white', 'Drama']",1930,4
22632836,The Eternal Empire,1994,['South Korea'],"['Mystery', 'Drama']",1990,4
20671625,By Hook or by Crook,2002,['United States of America'],"['LGBT', 'Buddy film', 'Romance Film', 'Drama']",2000,2
7463316,Thrashin',1986,['United States of America'],"['Action', 'Drama']",1980,6
7443928,Doing Time on Maple Drive,1992,['United States of America'],"['Drama', 'Television movie']",1990,2
24446273,Bandhana,1984,['India'],"['Musical', 'Romantic drama', 'Bollywood', 'World cinema', 'Romance Film', 'Drama']",1980,4
35978509,Curse of the Talisman,2001,['United States of America'],['Horror'],2000,1
26358395,Endangered Species,2002,[],"['Science Fiction', 'Thriller', 'Horror']",2000,2
20645464,Mil Mascaras Resurrection,2007,['United States of America'],"['Action', 'Horror', 'Adventure', 'Science Fiction']",2000,7
5894429,Closing the Ring,2007,"['United Kingdom', 'United States of America', 'Canada']","['Romantic drama', 'Romance Film', 'War film', 'Drama']",2000,7
19730179,Me and Dad's New Wife,1975,['United States of America'],"['Comedy', 'Drama', 'Adventure']",1970,5
26906212,Descendant,2003,['United States of America'],"['Thriller', 'Horror']",2000,3
1343628,Don't Move,2004,"['United Kingdom', 'Spain', 'Italy']","['Romantic drama', 'World cinema', 'Romance Film', 'Melodrama', 'Drama']",2000,4
6639909,Idhaya Thirudan,2005,['India'],['Romance Film'],2000,5
30627321,Gor,1987,['United States of America'],"['Film adaptation', 'Action/Adventure', 'Adventure', 'Drama', 'Fantasy']",1980,7
32643768,Man in Blues,2003,[],"['Drama', 'Comedy film']",2000,3
5846938,Super,2005,['India'],"['Romantic drama', 'World cinema', 'Romance Film', 'Drama']",2000,5
3138227,Poor Cow,1967,['United Kingdom'],"['Film adaptation', 'Romantic drama', 'Social problem film', 'Romance Film', 'Kitchen sink realism', 'Drama']",1960,7
5697632,Hurricane Streets,1998,['United States of America'],"['Crime Fiction', 'Coming of age', 'Indie', 'Teen', 'Drama']",1990,8
15508824,Cruel Winter Blues,2006,['South Korea'],"['Crime Fiction', 'Family Drama', 'Crime Thriller', 'Drama']",2000,6
2210286,Whistle Stop,1946,['United States of America'],"['Film noir', 'Romantic drama', 'Drama']",1940,6
27160764,Dubai,2001,['India'],"['Action', 'Crime Fiction', 'Thriller']",2000,1
8113966,The Wedding,1998,['United States of America'],['Drama'],1990,8
617769,Rasen,1998,['Japan'],"['Japanese Movies', 'Horror', 'World cinema', 'Supernatural']",1990,8
14445660,Epitaph,2007,['South Korea'],"['World cinema', 'Horror']",2000,7
2259030,Tarzan the Ape Man,1932,['United States of America'],"['Action', 'Black-and-white', 'Adventure', 'Pre-Code']",1930,2
2769852,S.F.W.,1994,['United States of America'],"['Crime Fiction', 'Black comedy', 'Media Satire', 'Comedy-drama', 'Drama']",1990,4
4400405,Union Pacific,1939,['United States of America'],"['Action', 'Epic Western', 'Western', 'Action/Adventure', 'Epic', 'Drama']",1930,9
8294126,Singapore Dreaming,2006,['Singapore'],"['Family Drama', 'Drama']",2000,6
3177439,Atoll K,1950,"['France', 'Italy']","['Comedy', 'Black-and-white']",1950,0
7906,Destry Rides Again,1939,['United States of America'],"['Black-and-white', 'Action/Adventure', 'Western', 'Comedy']",1930,9
11842746,Ladies They Talk About,1933,['United States of America'],"['Prison', 'Black-and-white', 'Crime Fiction', 'Crime Drama', 'Pre-Code', 'Drama', 'Women in prison films']",1930,3
8896753,Case 39,2009,"['Canada', 'United States of America']","['Suspense', 'Mystery', 'Thriller', 'Horror', 'Crime Thriller', 'Supernatural']",2000,9
11850569,Kirikou and the Wild Beasts,2005,['France'],"['Animation', 'World cinema', 'Family Film', 'Fantasy']",2000,5
5787450,Motives,2004,['United States of America'],"['Action', 'Mystery', 'Action/Adventure', 'Thriller', 'Crime Thriller', 'Drama']",2000,4
1461417,One-Way Ticket to Mombasa,2002,['Finland'],"['Drama', 'Comedy']",2000,2
14143644,The Secret Code,1942,['United States of America'],"['Spy', 'Black-and-white', 'Adventure']",1940,2
9495654,Parzania,2007,"['India', 'United States of America']","['Drama', 'Art film']",2000,7
5760640,Rendu,2006,['India'],"['Musical', 'Comedy', 'Bollywood', 'World cinema', 'Drama']",2000,6
5937788,Naa Alludu,2005,['India'],['Romance Film'],2000,5
32826498,The Yellow Rose of Texas,1944,['United States of America'],"['Action/Adventure', 'Western']",1940,4
30413149,Go Go 70s,2008,['South Korea'],"['Drama', 'World cinema']",2000,8
2344137,Armitage III,1994,['Japan'],"['Anime', 'Japanese Movies', 'Science Fiction']",1990,4
4971555,Dasavatharam,2007,['India'],"['Action/Adventure', 'Tamil cinema', 'World cinema', 'Disaster', 'Science Fiction']",2000,7
5120572,Savages,1972,['United States of America'],"['Indie', 'Parody', 'Comedy', 'Black comedy', 'Drama']",1970,2
26131380,Two O'Clock Courage,1945,['United States of America'],"['Mystery', 'Film noir']",1940,5
12414587,Camp Rock,2008,['United States of America'],"['Musical', 'Comedy', 'Teen', 'Romance Film', ""Children's/Family"", 'Family Film']",2000,8
10031038,Departamento compartido,1980,['Argentina'],['Comedy'],1980,0
16047605,The Story of Temple Drake,1933,['United States of America'],"['Black-and-white', 'Crime Fiction', 'Pre-Code', 'Drama']",1930,3
2116356,The House on 92nd Street,1945,['United States of America'],"['Spy', 'Black-and-white', 'Thriller', 'Film noir', 'Crime Thriller', 'Docudrama', 'Drama']",1940,5
15060240,Barbie Mariposa,2008,['United States of America'],"['Animation', 'Adventure', ""Children's"", 'Family Film', 'Computer Animation']",2000,8
4288473,Bicentennial Man,1999,"['Germany', 'United States of America']","['Film adaptation', 'Family Drama', 'Comedy', 'Romance Film', 'Drama', 'Tragedy', 'Domestic Comedy', 'Science Fiction', 'Family Film', 'Fantasy']",1990,9
21600231,Daffy Dilly,1948,['United States of America'],"['Animation', 'Short Film', 'Comedy', 'Family Film']",1940,8
1141596,Henry: Portrait Of A Serial Killer,1986,['United States of America'],"['Crime Fiction', 'Slasher', 'Thriller', 'Horror', 'Crime Drama', 'Drama', 'Cult']",1980,6
24972992,The Flying Scissors,2009,['United States of America'],"['Mockumentary', 'Indie', 'Comedy']",2000,9
28226679,Bowery to Bagdad,1955,['United States of America'],['Comedy film'],1950,5
171545,The Apostle,1997,['United States of America'],"['Indie', 'Christian film', 'Drama']",1990,7
14136794,Bombay To Bangkok,2008,['India'],"['Musical', 'Comedy', 'Bollywood', 'World cinema']",2000,8
23128400,Written By,2009,['Hong Kong'],"['Crime Fiction', 'Art film', 'Comedy', 'Thriller', 'World cinema', 'Chinese Movies', 'Drama', 'Science Fiction', 'Fantasy']",2000,9
3912910,Feast,2006,['United States of America'],"['Monster movie', 'Comedy', 'Horror', 'Cult']",2000,6
3681139,Necessary Roughness,1991,['United States of America'],"['Sports', 'Comedy']",1990,1
2762659,No Good Deed,2003,"['Germany', 'United States of America']","['Action', 'Drama', 'Crime Fiction', 'Indie', 'Action/Adventure', 'Thriller', 'Crime Thriller']",2000,3
451791,Aimée & Jaguar,1999,['Germany'],"['LGBT', 'Romantic drama', 'World cinema', 'Romance Film', 'Drama', 'Period piece', 'Gay Themed', 'Gay', 'Gay Interest']",1990,9
26364509,The Devil's Hand,1961,['United States of America'],"['Horror', 'B-movie']",1960,1
21388424,Brewster's Millions,1945,['United States of America'],['Black-and-white'],1940,5
445895,Escape to Witch Mountain,1995,['United States of America'],['Science Fiction'],1990,5
456959,Wishmaster,1997,['United States of America'],"['Creature Film', 'Indie', 'Horror', 'Black comedy', 'Supernatural', 'Fantasy']",1990,7
4140604,Amandla! A Revolution in Four Part Harmony,2002,"['United States of America', 'South Africa']","['Music', 'Historical fiction', 'Documentary']",2000,2
15127637,Stowaway,1936,['United States of America'],"['Musical', 'Black-and-white', 'Drama', 'Family Film']",1930,6
28148325,Mort & Phil. Mission: Save Earth,2008,['Spain'],"['Comedy', 'Family Film']",2000,8
24583533,Kallarali Hoovagi,2006,['India'],['Romance Film'],2000,6
8302915,Bleed,2002,['United States of America'],"['Slasher', 'B-movie', 'Horror']",2000,2
129246,The Last Emperor,1987,"['China', 'United Kingdom', 'France', 'Italy']","['Biography', 'Biographical film', 'Chinese Movies', 'Drama', 'Period piece', 'History', 'Epic', 'Political drama']",1980,7
859241,Landru,1963,"['France', 'Italy']","['Crime Fiction', 'Biographical film', 'Biopic [feature]', 'Crime Drama', 'Drama']",1960,3
22225850,Pop Rocks,2004,['United States of America'],"['Music', 'Comedy film']",2000,4
35281447,Jallikattu Kaalai,1994,['India'],['Drama'],1990,4
1226363,Beauty and the Beast,1946,['France'],"['Black-and-white', 'Art film', 'Romantic drama', 'World cinema', 'Romance Film', 'Drama', 'Fantasy']",1940,6
17957459,Trick Or Treats,1982,['United States of America'],"['Slasher', 'Horror']",1980,2
26226313,Ice Twisters,2009,"['Canada', 'United States of America']","['Television movie', 'Disaster', 'Science Fiction']",2000,9
23790789,Forbidden Nights,1990,['United States of America'],['Drama'],1990,0
26695384,Praja,2001,['India'],"['Action', 'Drama']",2000,1
2295200,A Ticket to Tomahawk,1950,['United States of America'],"['Western', 'Comedy']",1950,0
1475914,Flower & Garnet,2002,['Canada'],"['Indie', 'Comedy', 'Drama']",2000,2
9693961,Saturday the 14th,1981,['United States of America'],"['Creature Film', 'Parody', 'Horror Comedy', 'Comedy', 'Horror', 'Haunted House Film']",1980,1
29029252,Tansy,1921,['United Kingdom'],['Silent film'],1920,1
32874019,The Intruders,1969,[],"['Adventure', 'Family Film']",1960,9
11076103,Love and Suicide,2006,['United States of America'],"['Romantic drama', 'Indie', 'Romance Film', 'Drama']",2000,6
5416532,Dr. Akagi,1998,"['France', 'Japan']","['Japanese Movies', 'Comedy', 'World cinema', 'Comedy-drama', 'Medical fiction']",1990,8
1364238,If I Were King,1938,['United States of America'],"['Black-and-white', 'History', 'Costume drama', 'Adventure', 'Drama']",1930,8
4705518,The Phantom Tollbooth,1970,['United States of America'],"[""Children's Fantasy"", 'Animation', ""Children's/Family"", 'Adventure', 'Family Film', 'Fantasy']",1970,0
12757619,Scar,2007,['United States of America'],"['Crime Fiction', 'Slasher', 'Thriller', 'Horror', 'B-movie', 'Science Fiction']",2000,7
19208905,Mysterious Mr. Moto,1938,['United States of America'],"['Crime Fiction', 'Mystery', 'Thriller', 'Crime Thriller', 'Drama']",1930,8
7109992,Jack London,1943,['United States of America'],"['Action', 'Black-and-white', 'Indie', 'Biography', 'Action/Adventure', 'Biographical film', 'Adventure', 'Drama']",1940,3
512161,Herbie Goes to Monte Carlo,1977,['United States of America'],"['Comedy', 'Family-Oriented Adventure', ""Children's/Family"", 'Auto racing', 'Adventure', 'Drama', 'Family Film']",1970,7
11397477,Graduation Day,1981,['United States of America'],"['Slasher', 'Teen', 'Horror', 'B-movie']",1980,1
28887962,Chidambaram,1985,['India'],['Drama'],1980,5
18624278,The Dizzy Acrobat,1943,[],"['Animation', 'Short Film', 'Family Film']",1940,3
30559901,Pidakkozhi Koovunna Noottandu,1994,[],['Comedy film'],1990,4
13891325,Pellet,2000,['Spain'],"['Family Drama', 'Childhood Drama', 'World cinema', 'Drama']",2000,0
25754553,Crazy Fruit,1981,[],['Drama'],1980,1
29051421,Malsaram,2004,['India'],['Drama'],2000,4
1138873,Come and Get It,1936,['United States of America'],"['Action', 'Black-and-white', 'Drama', 'Romantic drama', 'Romance Film']",1930,6
21032415,Destry,1954,['United States of America'],"['Action/Adventure', 'Western']",1950,4
14242470,Secrets of a Superstud,1976,['United Kingdom'],['Comedy'],1970,6
6942838,Chakushin Ari 2,2005,['Japan'],"['Japanese Movies', 'Thriller', 'Horror', 'World cinema', 'Supernatural']",2000,5
16958405,Radio Inside,1994,['United States of America'],"['Coming of age', 'Romantic drama', 'Family Drama', 'Romance Film', 'Drama']",1990,4
633832,Dirty Pretty Things,2002,['United Kingdom'],"['Suspense', 'Crime Fiction', 'Mystery', 'Thriller', 'Crime Thriller', 'Drama']",2000,2
8249465,Hitler,1997,['India'],[],1990,7
2493307,Ghost in the Machine,1993,['United States of America'],"['Action', 'Thriller', 'Horror', 'Supernatural', 'Science Fiction']",1990,3
3384239,The Patriot,1998,['United States of America'],"['Action', 'Action/Adventure', 'Thriller']",1990,8
4358039,La séparation,1994,['France'],"['Marriage Drama', 'Drama', 'World cinema']",1990,4
1814089,The Cat from Outer Space,1978,['United States of America'],"['Comedy', 'Animal Picture', ""Children's/Family"", 'Science Fiction', 'Family Film']",1970,8
6847340,The Living Dead,1932,"['Weimar Republic', 'Germany']","['Black-and-white', 'Mystery', 'Indie', 'Horror', 'Silent film', 'Black comedy', 'Science Fiction']",1930,2
16345566,Evolusi KL Drift,2008,['Malaysia'],"['Action', 'Auto racing']",2000,8
21869908,Corpus Callosum,2007,['United States of America'],"['Drama', 'Comedy']",2000,7
3581636,A Night at the Golden Eagle,2002,['United States of America'],"['Crime Fiction', 'Indie', 'Drama']",2000,2
23925754,Big Animal,2000,['Poland'],"['Comedy', 'Drama', 'World cinema']",2000,0
3589259,Second Name,2002,['Spain'],"['Psychological thriller', 'Thriller', 'Horror']",2000,2
5579906,The Man from Colorado,1948,['United States of America'],"['Western', 'Action/Adventure', 'Drama']",1940,8
29393556,Jung,1996,['India'],['Drama'],1990,6
491757,Doom,2005,"['United Kingdom', 'Germany', 'Czech Republic', 'United States of America']","['Creature Film', 'Action', 'Action/Adventure', 'Horror', 'Adventure', 'Zombie Film', 'Science Fiction']",2000,5
350584,The Vanishing,1988,"['France', 'Netherlands']","['Psychological thriller', 'Thriller', 'World cinema', 'Crime Thriller']",1980,8
1592736,Peluca,2003,['United States of America'],['Short Film'],2000,3
25888701,"Foster Daddy, Tora!",1980,['Japan'],['Japanese Movies'],1980,0
1238102,Bad Lieutenant,1992,['United States of America'],"['Crime Fiction', 'Thriller', 'Crime Drama', 'Drama']",1990,2
133688,The Piano,1993,"['France', 'New Zealand', 'Australia']","['Period piece', 'Romantic drama', 'Romance Film', 'Drama', 'Feminist Film']",1990,3
9522001,Alice in Wonderland,2006,['India'],"['Romance Film', 'Drama']",2000,6
335298,Toy Story 2,1999,['United States of America'],"['Animation', 'Comedy', 'Family-Oriented Adventure', ""Children's/Family"", 'Adventure', ""Children's Fantasy"", 'Fantasy Comedy', 'Family Film', 'Fantasy']",1990,9
74868,The Last Picture Show,1971,['United States of America'],"['Film adaptation', 'Black-and-white', 'Americana', 'Drama', 'Period piece', 'Coming of age', 'New Hollywood', 'Slice of life story', 'Ensemble Film']",1970,1
13951439,MP3 - Mera Pehla Pehla Pyaar,2007,['India'],"['Musical', 'Romantic drama', 'Comedy', 'Teen', 'World cinema', 'Romance Film', 'Drama', 'Coming of age', 'Romantic comedy']",2000,7
4836072,My Fair Lady,1964,['United States of America'],"['Musical', 'Comedy', 'Romance Film', 'Roadshow theatrical release', 'Costume drama', 'Drama', 'Family Film']",1960,4
4575990,Manolete,2007,"['United Kingdom', 'Spain']","['Period piece', 'Romantic drama', 'Biography', 'World cinema', 'Romance Film', 'Drama']",2000,7
864614,Moscow Does Not Believe In Tears,1979,"['Russia', 'Soviet Union']","['Comedy', 'World cinema', 'Romance Film', 'Romantic comedy', 'Melodrama', 'Comedy-drama']",1970,9
3493076,Camelot,1967,['United States of America'],"['Musical', 'Romance Film', 'Roadshow theatrical release', 'Costume drama']",1960,7
77223,Dial M for Murder,1954,"['United Kingdom', 'United States of America']","['Psychological thriller', 'Mystery', 'Thriller', 'Crime Thriller']",1950,4
20580166,Thunder Birds,1942,['United States of America'],"['Romance Film', 'War film', 'Drama']",1940,2
26499171,A Boy Called Dad,2009,['United Kingdom'],"['Indie', 'Drama']",2000,9
4022937,Northfork,2003,['United States of America'],"['Period piece', 'Fairy tale', 'Americana', 'Drama', 'Fantasy']",2000,3
12279512,Susan Slept Here,1954,['United States of America'],"['Romance Film', 'Romantic comedy', 'Comedy']",1950,4
23805085,The Tie That Binds,1995,['United States of America'],"['Mystery', 'Thriller']",1990,5
7520304,Caresses,1997,['Spain'],"['LGBT', 'Romantic drama', 'Avant-garde', 'World cinema', 'Experimental film', 'Black comedy', 'Drama']",1990,7
4592959,All Quiet on the Western Front,1930,['United States of America'],"['Action', 'Film adaptation', 'Black-and-white', 'War film', 'Pre-Code', 'Drama']",1930,0
3008149,Far Out Man,1990,['United States of America'],"['Action', 'Screwball comedy', 'Indie', 'Action/Adventure', 'Stoner film', 'Comedy', 'Adventure', 'Road movie']",1990,0
18459346,Diljale,1996,['India'],"['Action', 'Romance Film', 'Drama']",1990,6
24128069,Chal Chalein,2009,['India'],"['Drama', 'World cinema']",2000,9
28871413,Saturday's Hero,1951,['United States of America'],['Drama'],1950,1
28882106,Thulabharam,1968,['India'],['Drama'],1960,8
15340311,And the Violins stopped playing,1988,"['Poland', 'United States of America']","['War film', 'Drama']",1980,8
18728031,The Fox and the Child,2007,['France'],"[""Children's Fantasy"", 'World cinema', ""Children's/Family"", 'Drama']",2000,7
9652303,Home Town Story,1951,['United States of America'],"['Black-and-white', 'Melodrama', 'Propaganda film', 'Drama']",1950,1
77598,Here Comes Mr. Jordan,1941,['United States of America'],"['Black-and-white', 'Screwball comedy', 'Heavenly Comedy', 'Comedy', 'Romance Film', 'Heaven-Can-Wait Fantasies', 'Romantic comedy', 'Sports', 'Fantasy']",1940,1
490800,Memories,1995,['Japan'],"['Action', 'Animation', 'World cinema', 'Adventure', 'Drama', 'Japanese Movies', 'Anime', 'Science Fiction', 'Fantasy']",1990,5
4345210,Learning to Lie,2003,['Germany'],"['Romance Film', 'Comedy-drama']",2000,3
7518798,The Madwoman of Chaillot,1969,['United States of America'],"['Satire', 'Drama']",1960,9
20773812,Munde U.K. De,2009,['India'],"['Musical', 'Romantic drama', 'Bollywood', 'Musical comedy', 'World cinema', 'Romance Film', 'Drama']",2000,9
4499062,Let Sleeping Corpses Lie,1974,['United Kingdom'],"['Indie', 'Science Fiction', 'Horror', 'Zombie Film', 'Cult']",1970,4
730575,Combat Academy,1986,['United States of America'],['Comedy'],1980,6
11488122,Mama Jack,2005,['South Africa'],['Comedy'],2000,5
4883547,Tango Charlie,2005,['India'],"['World cinema', 'War film', 'Adventure', 'Drama']",2000,5
3820085,My Little Pony: The Movie,1986,['United States of America'],"[""Children's Fantasy"", 'Animation', ""Children's/Family"", 'Fantasy']",1980,6
27445334,Mr. Vampire III,1987,['Hong Kong'],"['Chinese Movies', 'Comedy', 'Horror', 'World cinema']",1980,7
26549866,Heat Lightning,1934,['United States of America'],['Drama'],1930,4
11048780,A Stranger's Heart,2007,['United States of America'],"['Romantic drama', 'Inspirational Drama', 'Romance Film', 'Television movie', 'Drama']",2000,7
7153927,Puppet Master 5: The Final Chapter,1994,['United States of America'],['Horror'],1990,4
28252120,Down Twisted,1987,['United States of America'],"['Action', 'Crime Fiction', 'Drama']",1980,7
4246026,Dixiana,1930,['United States of America'],"['Musical', 'Comedy', 'Musical comedy']",1930,0
17146332,Devil's Island,1939,['United States of America'],"['Black-and-white', 'Drama', 'Thriller']",1930,9
583932,A View to a Kill,1985,"['United Kingdom', 'United States of America']","['Action', 'Spy', 'Action Thrillers', 'Action/Adventure', 'Thriller', 'Glamorized Spy Film']",1980,5
36322034,Doraemon: Nobita's the Night Before a Wedding,1999,['Japan'],['Short Film'],1990,9
3952475,Straight Talk,1992,['United States of America'],['Comedy'],1990,2
3136201,Lion of the Desert,1981,"['Libya', 'United States of America']","['Combat Films', 'Action/Adventure', 'Biographical film', 'Drama', 'Biopic [feature]', 'Historical Epic', 'Epic', 'Propaganda film', 'War film']",1980,1
3694594,Carry On Regardless,1961,['United Kingdom'],"['Parody', 'Comedy']",1960,1
4712667,Witchboard 2: The Devil's Doorway,1993,['United States of America'],"['Supernatural', 'Drama', 'Horror']",1990,3
506119,Out of Sight,1998,['United States of America'],"['Action', 'Film adaptation', 'Crime Fiction', 'Indie', 'Action/Adventure', 'Romantic drama', 'Comedy', 'Thriller', 'Romance Film', 'Crime Thriller', 'Drama', 'Heist', 'Romantic comedy']",1990,8
23195993,A Dangerous Woman,1993,['United States of America'],"['Film adaptation', 'Romantic drama', 'Romance Film', 'Drama']",1990,3
2711162,Nobody Lives Forever,1946,['United States of America'],"['Film noir', 'Crime Fiction', 'Drama']",1940,6
6317956,Iron Will,1994,['United States of America'],"['Family Drama', 'Adventure', ""Children's"", 'Drama', 'Family Film']",1990,4
6304083,Detectives on the Edge of a Nervous Breakdown,1993,['United Kingdom'],"['Short Film', 'Comedy film']",1990,3
8905156,King Solomon's Mines,1937,"['United Kingdom', 'England']","['Action', 'Musical', 'Black-and-white', 'Thriller', 'Romance Film', 'Adventure', 'Drama']",1930,7
5263902,Dark Command,1940,['United States of America'],"['Action/Adventure', 'Western']",1940,0
27117416,Deadly Impact,2007,['United States of America'],"['Crime Fiction', 'Thriller', 'Crime Thriller', 'Drama']",2000,7
31967555,Khwab,1980,[],"['Romance Film', 'Crime Fiction', 'Drama']",1980,0
70428,The Quiet Man,1952,['United States of America'],"['Comedy', 'Romance Film', 'Romantic comedy', 'Comedy-drama', 'Drama']",1950,2
10366326,God's Gift to Women,1931,['United States of America'],"['Musical', 'Comedy', 'Romance Film', 'Romantic comedy']",1930,1
32927927,Raising Jeffrey Dahmer,2006,['United States of America'],"['Crime Fiction', 'Biography', 'Drama']",2000,6
16334910,American Drug War: The Last White Hope,2007,['United States of America'],"['Social issues', 'Law & Crime', 'Political cinema', 'Crime Fiction', 'Documentary', 'Culture & Society']",2000,7
3498675,Gangaajal,2003,['India'],"['Drama', 'Bollywood', 'World cinema']",2000,3
15292916,Witchouse 2: Blood Coven,2000,['United States of America'],"['B-movie', 'Haunted House Film', 'Horror']",2000,0
66870,Annie Hall,1977,['United States of America'],"['Comedy', 'New Hollywood', 'Comedy of manners', 'Romance Film', 'Romantic comedy', 'Drama']",1970,7
2456550,Night Monster,1942,['United States of America'],"['Black-and-white', 'Mystery', 'Gothic Film', 'Thriller', 'Horror']",1940,2
32098611,Karishma Kudrat Ka,1985,['India'],"['Drama', 'World cinema']",1980,5
8636654,"I'm a Cyborg, But That's OK",2006,['South Korea'],"['Romance Film', 'Comedy', 'Drama']",2000,6
5875034,The Kingdom,2007,"['Germany', 'United States of America']","['Action', 'Drama', 'Action/Adventure', 'Thriller', 'War film']",2000,7
19685467,Football Romeo,1938,['United States of America'],"['Black-and-white', 'Short Film', 'Comedy', 'Family Film']",1930,8
2456030,I'll see you in my dreams,2003,['Portugal'],"['Zombie Film', 'Short Film', 'Horror']",2000,3
2684671,Nina's Tragedies,2003,['Israel'],"['Comedy', 'Drama', 'World cinema']",2000,3
9074501,The Piano Tuner of Earthquakes,2005,"['Spain', 'United Kingdom', 'France', 'Germany']","['Music', 'Animation', 'World cinema', 'Romance Film', 'Drama', 'Stop motion', 'Science Fiction', 'Fantasy']",2000,5
26716752,Maid-Droid,2008,['Japan'],"['Japanese Movies', 'Thriller', 'World cinema', 'Romance Film', 'Drama']",2000,8
11190234,Mumbai Meri Jaan,2008,['India'],"['Musical', 'Crime Fiction', 'World cinema', 'Drama']",2000,8
4685642,Beyond Witch Mountain,1982,['United States of America'],"['Science Fiction', 'Family Film', 'Fantasy']",1980,2
7174075,Betty in Blunderland,1934,['United States of America'],['Musical'],1930,4
168554,Runaway Train,1985,"['Israel', 'United States of America']","['Action', 'Crime Fiction', 'Action Thrillers', 'Action/Adventure', 'Thriller', 'Escape Film', 'Adventure', 'Drama']",1980,5
6217649,Refugee,2000,['India'],"['Musical', 'Romantic drama', 'Bollywood', 'World cinema', 'Romance Film', 'Drama']",2000,0
3759173,Fighter in the Wind,2004,['South Korea'],"['Action', 'Action/Adventure', 'World cinema', 'Martial Arts Film']",2000,4
4731904,Mad Love,1995,['United States of America'],"['Coming of age', 'Romantic drama', 'Teen', 'Romance Film', 'Drama']",1990,5
16744198,Food of Love,2002,"['Germany', 'Spain']","['Music', 'Drama']",2000,2
177735,Their Own Desire,1929,['United States of America'],"['Black-and-white', 'Romance Film', 'Melodrama', 'Drama']",1920,9
2156510,Don't Be a Menace to South Central While Drinking Your Juice in the Hood,1996,['United States of America'],"['Crime Fiction', 'Parody', 'Comedy']",1990,6
12212399,A Flintstones Christmas Carol,1994,['United States of America'],"[""Children's/Family"", 'Holiday Film', 'Comedy']",1990,4
21508247,Gulaal,2009,['India'],"['Crime Fiction', 'Thriller', 'World cinema', 'Drama']",2000,9
24158175,Billy Two Hats,1974,['United States of America'],['Western'],1970,4
24188674,Return to Peyton Place,1961,['United States of America'],['Drama'],1960,1
161915,I Never Sang for My Father,1970,['United States of America'],"['Family Drama', 'Drama']",1970,0
652432,Project A,1983,['Hong Kong'],"['Action', 'Action/Adventure', 'Comedy', 'World cinema', 'Chinese Movies', 'Martial Arts Film']",1980,3
5604985,Angora Love,1929,['United States of America'],"['Black-and-white', 'Indie', 'Short Film', 'Comedy', 'Slapstick', 'Animal Picture', 'Silent film']",1920,9
28838608,Einbrecher,1930,['Germany'],"['Musical', 'Comedy']",1930,0
32466495,Dumb-Hounded,1943,['United States of America'],['Short Film'],1940,3
3130659,Princess of Thieves,2001,['United States of America'],"['Family-Oriented Adventure', ""Children's/Family"", 'Costume drama', 'Drama']",2000,1
20329270,Mandela,1995,"['United States of America', 'South Africa']","['Political cinema', 'History', 'World cinema', 'Documentary']",1990,5
1597802,I'll Sleep When I'm Dead,2004,"['United Kingdom', 'United States of America']","['Crime Fiction', 'Gangster Film', 'Indie', 'Mystery', 'Thriller', 'Crime Thriller', 'Drama', 'Crime Drama']",2000,4
1405743,Fever Pitch,1985,['United States of America'],['Drama'],1980,5
4861305,Cria Cuervos,1975,['Spain'],"['Coming of age', 'Family Drama', 'Childhood Drama', 'World cinema', 'Drama']",1970,5
5720418,The Beast from Haunted Cave,1959,['United States of America'],"['Black-and-white', 'Crime Fiction', 'Thriller', 'Horror', 'Science Fiction']",1950,9
6426786,The Bride with White Hair,1993,['Hong Kong'],"['Romantic fantasy', 'Fantasy Adventure', 'Action/Adventure', 'World cinema', 'Chinese Movies', 'Martial Arts Film', 'Adventure', 'Sword and sorcery films', 'Wuxia', 'Fantasy']",1990,3
29616483,Mulligans,2008,[],"['Romance Film', 'Drama']",2000,8
1157158,Death to Smoochy,2002,"['United Kingdom', 'Germany', 'United States of America']","['Parody', 'Satire', 'Comedy', 'Black comedy']",2000,2
33940717,12,2003,['United States of America'],"['Musical', 'Indie', 'Comedy film']",2000,3
19025779,Dorothy Vernon of Haddon Hall,1924,['United States of America'],"['Silent film', 'Black-and-white', 'Parody']",1920,4
6212570,Citizen Toxie: The Toxic Avenger Part IV,2001,['United States of America'],"['Action', 'Satire', 'Comedy', 'Black comedy', 'Horror', 'Superhero movie', 'B-movie', 'Cult']",2000,1
9756837,The Earrings of Madame de...,1953,"['France', 'Italy']","['Black-and-white', 'Romantic drama', 'World cinema', 'Romance Film', 'Drama']",1950,3
9232950,Land of the Free,1998,['United States of America'],"['Action', 'Suspense', 'Action/Adventure', 'Thriller', 'Political drama', 'Drama', 'Political thriller']",1990,8
10660190,Ek Chalis Ki Last Local,2007,['India'],"['Action/Adventure', 'Comedy', 'World cinema']",2000,7
29881311,Wiggle Time,1998,[],['Short Film'],1990,8
20077388,I Can’t Think Straight,2008,"['United Kingdom', 'United States of America']","['Film adaptation', 'LGBT', 'Indie', 'Romantic drama', 'Romance Film', 'Drama', 'Gay Themed', 'Gay', 'Gay Interest', 'Feature film']",2000,8
1271694,Polyester,1981,['United States of America'],"['Indie', 'Parody', 'Satire', 'Comedy', 'Black comedy', 'Domestic Comedy', 'Cult']",1980,1
14261075,Chill Factor,1999,['United States of America'],"['Action', 'Action/Adventure', 'Comedy', 'Thriller']",1990,9
9916550,Battling with Buffalo Bill,1931,['United States of America'],"['Action', 'B-Western', 'Black-and-white', 'Action/Adventure', 'Western', 'Adventure']",1930,1
5264560,Blades of Glory,2007,['United States of America'],"['Sports', 'Parody', 'Comedy']",2000,7
22682411,Jahan Tum Le Chalo,1999,['India'],['Romance Film'],1990,9
23607760,Koodum Thedi,1985,['India'],"['Romance Film', 'Comedy-drama']",1980,5
3569886,Heaven's Prisoners,1996,['United States of America'],"['Psychological thriller', 'Film adaptation', 'Crime Fiction', 'Mystery', 'Thriller', 'Crime Thriller', 'Drama', 'Suspense', 'Slasher']",1990,6
3012123,Howling V: The Rebirth,1989,['United Kingdom'],"['Creature Film', 'Indie', 'Gothic Film', 'Horror']",1980,9
13643392,Rome Express,1932,['United Kingdom'],"['Black-and-white', 'Detective']",1930,2
1166518,The King is Alive,2000,"['Sweden', 'Denmark', 'United States of America']","['Dogme 95', 'Indie', 'World cinema', 'Drama', 'Ensemble Film']",2000,0
9644100,Snow White,1987,"['United Kingdom', 'United States of America']","['Musical', 'Family Film', 'Fantasy']",1980,7
4019049,No te engañes corazón,1936,['Mexico'],"['Black-and-white', 'Slapstick', 'Comedy']",1930,6
6975303,Mister Frost,1990,"['United Kingdom', 'France']","['Crime Fiction', 'Indie', 'Comedy', 'Thriller', 'Drama']",1990,0
479589,Uncle Nino,2003,['United States of America'],"['Family Drama', 'Comedy', 'Comedy-drama', 'Drama', 'Family Film']",2000,3
20692099,Pudhu Pudhu Arthangal,1989,['India'],['Drama'],1980,9
2367161,The Thomas Crown Affair,1999,['United States of America'],"['Crime Fiction', 'Romantic drama', 'Comedy', 'Remake', 'Romance Film', 'Crime Thriller', 'Drama', 'Heist']",1990,9
5924049,When a Killer Calls,2005,['United States of America'],"['Psychological thriller', 'Indie', 'Slasher', 'Teen', 'Horror', 'B-movie']",2000,5
22634826,Kamen Rider Decade: All Riders vs. Great Shocker,2009,['Japan'],"['Action', 'Japanese Movies']",2000,9
34196805,Life Returns,1935,['United States of America'],"['Crime Fiction', 'Science Fiction', 'Drama']",1930,5
18964317,C Kkompany,2008,['India'],"['Musical', 'Bollywood', 'World cinema']",2000,8
4448175,Kitchen Party,1997,['Canada'],"['Indie', 'Short Film', 'Comedy', 'Teen']",1990,7
15357779,13 Rue Madeleine,1947,['United States of America'],"['Action', 'Spy', 'Black-and-white', 'Thriller', 'War film']",1940,7
24949170,City Girl,1984,"['Canada', 'United States of America']",['Drama'],1980,4
3466113,Fort Apache,1948,['United States of America'],"['Black-and-white', 'Western', 'Action/Adventure', 'Cavalry Film', 'War film']",1940,8
10224734,Proud,2004,['United States of America'],['Drama'],2000,4
966552,Billy Jack,1971,['United States of America'],"['Action', 'Drama', 'Action/Adventure', 'Adventure', 'Martial Arts Film']",1970,1
5241676,Steel Dawn,1987,['United States of America'],"['Action', 'Indie', 'Action/Adventure', 'Adventure', 'Doomsday film', 'Disaster', 'Science Fiction']",1980,7
15639202,Bees in Paradise,1944,['United Kingdom'],"['Musical', 'Screwball comedy', 'Comedy', 'Musical comedy']",1940,4
1663320,Just My Luck,2006,['United States of America'],"['Romance Film', 'Comedy', 'Fantasy']",2000,6
1303197,Cinderella,1957,['United States of America'],"['Musical', 'Romantic drama', 'Romance Film', 'Television movie', 'Drama']",1950,7
4512681,Blackballed,2004,['United States of America'],"['Indie', 'Comedy', 'Sports', 'Slapstick']",2000,4
23975295,The Dark Hour,1936,['United States of America'],"['Crime Fiction', 'Mystery', 'Thriller', 'Comedy film', 'Horror', 'Crime Thriller', 'Drama']",1930,6
2467280,Carry On Nurse,1959,['United Kingdom'],"['Parody', 'Slapstick', 'Comedy']",1950,9
7090669,Kansas,1988,['United States of America'],"['Crime Fiction', 'Crime Thriller', 'Thriller']",1980,8
6435145,The Adventures of Sherlock Holmes,1939,['United States of America'],"['Film adaptation', 'Detective fiction', 'Black-and-white', 'Mystery', 'Thriller', 'Crime Thriller', 'Drama']",1930,9
2648856,Jane Eyre,1944,['United States of America'],"['Black-and-white', 'Romantic drama', 'Romance Film', 'Costume drama', 'Drama']",1940,4
2338993,Deuce Bigalow: European Gigolo,2005,['United States of America'],"['Gross out', 'Gross-out film', 'Comedy', 'Slapstick', 'Sex comedy']",2000,5
14640745,Of Cash and Hash,1955,['United States of America'],"['Short Film', 'Black-and-white', 'Comedy']",1950,5
31205051,Split Image,1982,"['Canada', 'United States of America']",['Drama'],1980,2
6937139,Hot Rod,2007,['United States of America'],"['Action', 'Action/Adventure', 'Comedy', 'Sports', 'Slapstick']",2000,7
622993,Of Mice and Men,1992,['United States of America'],"['Period piece', 'Film adaptation', 'Drama', 'Indie']",1990,2
699336,Nine Months,1995,['United States of America'],"['Comedy', 'Romance Film', 'Romantic comedy', 'Domestic Comedy']",1990,5
21634467,The Stoneman Murders,2009,['India'],"['Drama', 'Crime Fiction', 'Thriller']",2000,9
14143347,Terry and the Pirates,1940,['United States of America'],"['Adventure', 'Black-and-white']",1940,0
26600812,Duplicate,2009,['India'],"['Drama', 'Comedy']",2000,9
3229585,Replicant,2001,['United States of America'],"['Action', 'Action/Adventure', 'Science Fiction', 'Thriller']",2000,1
15462142,Papi Gudia,1996,['India'],"['Thriller', 'Horror']",1990,6
31156702,Thandavam,2002,['India'],"['Action', 'Drama']",2000,2
28386057,The Shadow Riders,1982,['United States of America'],"['Western', 'Television movie', 'Action/Adventure']",1980,2
5435938,Dance Hall Racket,1953,['United States of America'],['Crime Fiction'],1950,3
2206566,GoBots: Battle of the Rock Lords,1986,['United States of America'],"['Action', 'Adventure']",1980,6
14896191,Flower Island,2001,['South Korea'],"['Road movie', 'Drama', 'World cinema']",2000,1
180241,Sanjuro,1962,['Japan'],"['Black-and-white', 'Samurai cinema', 'Art film', 'Action/Adventure', 'Comedy', 'World cinema', 'Martial Arts Film', 'Adventure', 'Drama', 'Japanese Movies']",1960,2
2390554,The Last Day of Summer,1958,['Poland'],"['Romance Film', 'Black-and-white', 'Drama']",1950,8
1482950,Battle Cry,1955,['United States of America'],"['Action', 'Film adaptation', 'Romantic drama', 'Romance Film', 'War film', 'Drama']",1950,5
4092144,Riki-Oh: The Story of Ricky,1991,"['Hong Kong', 'Japan']","['Action', 'Prison', 'Crime Fiction', 'Action/Adventure', 'World cinema', 'Chinese Movies', 'Martial Arts Film', 'Japanese Movies']",1990,1
3019565,Khartoum,1966,"['United Kingdom', 'United States of America']","['British Empire Film', 'War film', 'Historical Epic', 'Historical fiction', 'Epic', 'Costume drama', 'Drama']",1960,6
8283136,Government Agents vs Phantom Legion,1951,['United States of America'],"['Action', 'Spy', 'Black-and-white', 'Adventure']",1950,1
545795,The Big Chill,1983,['United States of America'],"['Period piece', 'Comedy', 'Comedy of manners', 'Comedy-drama', 'Drama', 'Ensemble Film']",1980,3
22352229,O Stratis parastratise,1969,['Greece'],['Comedy'],1960,9
34927590,80 Minutes,2008,['Germany'],"['Action', 'Action/Adventure', 'Thriller', 'World cinema', 'Crime Thriller']",2000,8
8536802,Sniper 3,2004,['United States of America'],"['Action', 'Action Thrillers', 'Action/Adventure', 'Thriller']",2000,4
10331139,'Gator Bait,1974,['United States of America'],"['Action', 'Thriller', 'Drama']",1970,4
3334667,My Tender Comrade,1943,['United States of America'],"['Black-and-white', 'Drama']",1940,3
19497060,Cameriera bella presenza offresi...,1951,['Italy'],"['Comedy', 'Black-and-white']",1950,1
19310258,"Captain Carey, U.S.A.",1950,['United States of America'],"['Film adaptation', 'Thriller', 'War film', 'Drama']",1950,0
32204201,Welcome Stranger,1947,['United States of America'],['Comedy'],1940,7
6699130,Suburban Mayhem,2006,['Australia'],"['Drama', 'Indie', 'Comedy', 'Thriller', 'World cinema', 'Black comedy', 'Crime Thriller']",2000,6
15139794,Spring In My Hometown,1998,['South Korea'],"['War film', 'Drama']",1990,8
27665775,The Breaking of Bumbo,1970,[],['Comedy film'],1970,0
9266932,Def-Con 4,1985,['Canada'],"['Action/Adventure', 'Thriller', 'Disaster', 'Science Fiction']",1980,5
32380648,Make Haste to Live,1954,['United States of America'],"['Crime Fiction', 'Crime Thriller', 'Thriller']",1950,4
16648109,The Three Musketeers,1986,['Australia'],"['Animation', 'Adventure', 'Family Film']",1980,6
8940854,Animalada,2001,['Argentina'],"['Satire', 'Comedy', 'World cinema', 'Black comedy', 'Sex comedy']",2000,1
1001692,The Divorce of Lady X,1938,['United Kingdom'],"['Comedy', 'Romance Film', 'Romantic comedy', 'Comedy of Errors']",1930,8
12561001,Ben 10: Race Against Time,2007,['United States of America'],"['Action', 'Action/Adventure', 'Comedy', 'Family-Oriented Adventure', 'Superhero movie', 'Television movie', 'Doomsday film', 'Science Fiction', 'Family Film', 'Fantasy']",2000,7
20658736,Rishi,2001,['India'],"['Drama', 'World cinema']",2000,1
289755,Shiri,1999,['South Korea'],"['Action', 'Spy', 'Crime Fiction', 'Action Thrillers', 'Mystery', 'Action/Adventure', 'Buddy film', 'Thriller', 'World cinema', 'Romance Film', 'Drama', 'Political thriller']",1990,9
448814,The Little Mermaid II: Return to the Sea,2000,"['United States of America', 'Canada', 'Australia']","['Music', 'Animation', 'Animated Musical', ""Children's/Family"", ""Children's"", 'Fairy tale', ""Children's Fantasy"", 'Family Film']",2000,0
3253340,The Green Slime,1968,"['Japan', 'United States of America']","['Japanese Movies', 'Science Fiction', 'Horror', 'Sci-Fi Horror', 'Adventure']",1960,8
10071292,Along Came a Spider,2001,['United States of America'],"['Psychological thriller', 'Suspense', 'Film adaptation', 'Crime Fiction', 'Mystery', 'Thriller', 'Crime Thriller']",2000,1
10479762,City of Hope,1991,['United States of America'],"['Indie', 'Social problem film', 'Political drama', 'Drama', 'Ensemble Film']",1990,1
14399659,Midnight Eagle,2007,['Japan'],"['Action', 'Japanese Movies', 'Action Thrillers', 'Action/Adventure', 'Thriller', 'World cinema', 'Drama']",2000,7
12835554,Darling,2007,"['United Kingdom', 'India']","['Musical', 'Bollywood', 'Horror', 'World cinema', 'Drama']",2000,7
5562511,Thagapansamy,2006,['India'],[],2000,6
5725237,Broken Trail,2006,"['Canada', 'United States of America']","['Western', 'Revisionist Western', 'Epic Western']",2000,6
4451435,From Hell,2001,"['Czech Republic', 'United States of America']","['Film adaptation', 'Crime Fiction', 'Mystery', 'Biographical film', 'Thriller', 'Crime Thriller', 'Costume Horror', 'Costume drama', 'Drama', 'Period piece', 'Slasher', 'Horror']",2000,1
169202,Russian Ark,2002,"['Russia', 'Germany', 'United States of America']","['Essay Film', 'History', 'Mystery', 'Avant-garde', 'Experimental film', 'Drama', 'Fantasy']",2000,2
2377695,The Emperor Waltz,1948,['United States of America'],"['Musical', 'Comedy', 'Musical comedy']",1940,8
3837132,Back-Room Boy,1942,['United Kingdom'],"['Spy', 'Mystery', 'Comedy']",1940,2
11288620,Righteous Kill,2008,['United States of America'],"['Action', 'Psychological thriller', 'Crime Fiction', 'Mystery', 'Thriller', 'Crime Thriller', 'Drama']",2000,8
26064019,Troublesome Night 19,2003,['Hong Kong'],"['Comedy horror', 'Chinese Movies', 'Thriller', 'Horror']",2000,3
14359104,The Maids of Wilko,1979,['Poland'],"['Drama', 'World cinema']",1970,9
7351154,G.I. Joe: Spy Troops,2003,['United States of America'],['Animation'],2000,3
2112205,The Captive Heart,1946,['United Kingdom'],"['War film', 'Drama']",1940,6
2617386,The Land Before Time IV: Journey Through the Mists,1996,['United States of America'],"['Animation', 'Adventure', 'Family Film']",1990,6
16066384,Sparrow,2008,"['China', 'Hong Kong']","['Action', 'Chinese Movies']",2000,8
3237559,The Texas Chainsaw Massacre: The Beginning,2006,['United States of America'],"['Slasher', 'Teen', 'Horror', 'Road-Horror', 'Cult']",2000,6
41528,Forrest Gump,1994,['United States of America'],"['Coming of age', 'Romantic drama', 'Comedy film', 'Romance Film', 'War film', 'Drama']",1990,4
16029506,Necrosis,2009,['United States of America'],"['Psychological thriller', 'Indie', 'Horror']",2000,9
19817505,By Hook or by Crook,1980,['Hong Kong'],"['LGBT', 'Chinese Movies', 'Martial Arts Film']",1980,0
6233638,A Simple Plan,1998,"['Japan', 'United Kingdom', 'France', 'Germany', 'United States of America']","['Suspense', 'Crime Fiction', 'Japanese Movies', 'Thriller', 'Crime Drama', 'Crime Thriller', 'Drama']",1990,8
5454380,The Thrill of It All,1963,['United States of America'],"['Screwball comedy', 'Comedy', 'Romance Film', 'Romantic comedy']",1960,3
9789564,Kalabha Kadhalan,2006,['India'],"['Drama', 'World cinema']",2000,6
19502933,Roxy Hunter and the Myth of the Mermaid,2008,[],"['Adventure', 'Family Film']",2000,8
20571157,The Shooting Of Dan McGoo,1945,['United States of America'],['Short Film'],1940,5
25345231,The Last Trimester,2006,"['Canada', 'United States of America']","['Drama', 'Crime Fiction', 'Thriller']",2000,6
27197943,Allos gia to ekatommyrio,1964,['Greece'],['Comedy film'],1960,4
18000201,Hotel Haywire,1937,['United States of America'],"['Romance Film', 'Black-and-white', 'Comedy']",1930,7
34307355,Amaran,1992,['India'],[],1990,2
13639421,Breakthrough,1979,['West Germany'],"['War film', 'Drama']",1970,9
9573648,Machakaaran,2007,['India'],['Action'],2000,7
1012964,Blood Circus,1985,['United States of America'],['Science Fiction'],1980,5
6499360,Pasivadi Pranam,1987,['India'],"['Musical', 'Bollywood', 'World cinema', 'Drama']",1980,7
8004497,Rhythm and Weep,1946,['United States of America'],"['Black-and-white', 'Short Film', 'Comedy', 'Slapstick']",1940,6
4343515,Bloody Birthday,1981,['United States of America'],"['Psychological thriller', 'Crime Fiction', 'Slasher', 'Horror', 'B-movie']",1980,1
10640523,Phool Bane Angaray,1991,['India'],"['Bollywood', 'Thriller', 'World cinema', 'Drama']",1990,1
1336117,Beyond Re-Animator,2003,"['Spain', 'United States of America']","['Prison', 'Comedy', 'Horror Comedy', 'Horror', 'Zombie Film', 'Science Fiction', 'Cult']",2000,3
13361675,The Women,2008,['United States of America'],"['Comedy', 'Romance Film', 'Romantic comedy', 'Drama']",2000,8
18862965,Badhaai Ho Badhaai,2002,['India'],"['Comedy', 'World cinema']",2000,2
4537597,Timequest,2002,['United States of America'],['Science Fiction'],2000,2
8141252,Sharky's Machine,1981,['United States of America'],"['Action', 'Gangster Film', 'Action Thrillers', 'Action/Adventure', 'Thriller', 'Crime Thriller', 'Drama', 'Suspense']",1980,1
6768398,Chennai Kadhal,2006,['India'],"['Musical', 'Romantic drama', 'Bollywood', 'World cinema', 'Romance Film', 'Drama']",2000,6
23617312,Killjoy 2: Deliverance from Evil,2002,['United States of America'],"['Slasher', 'Horror']",2000,2
8355881,Jagadam,2007,['India'],"['Musical', 'Crime Fiction', 'Gangster Film', 'Bollywood', 'World cinema', 'Drama']",2000,7
11604193,Forsaking All Others,1934,['United States of America'],"['Black-and-white', 'Comedy', 'Romance Film', 'Drama']",1930,4
24551073,Funny About Love,1990,['United States of America'],"['Romantic drama', 'Comedy', 'Romance Film', 'Romantic comedy', 'Drama']",1990,0
23681959,Ignition,2002,"['Canada', 'United Kingdom']","['Action', 'Drama', 'Indie', 'Action/Adventure', 'Thriller', 'Science Fiction', 'Political thriller']",2000,2
7209996,Manjunatha,2001,['India'],"['Musical', 'Historical fiction', 'Drama', 'Family Film']",2000,1
6057074,Mister Buddwing,1966,['United States of America'],"['Black-and-white', 'Mystery', 'Drama']",1960,6
2645157,HellBent,2004,['United States of America'],"['LGBT', 'Slasher', 'Horror']",2000,4
17243817,Homecoming,2009,['United States of America'],"['Psychological thriller', 'Suspense', 'Drama', 'Indie', 'Thriller', 'Horror', 'Teen']",2000,9
7052375,Green Mansions,1959,['United States of America'],"['Action', 'Drama', 'Romance Film', 'Adventure']",1950,9
34246375,Odd Squad,1981,['Italy'],"['War film', 'Comedy film']",1980,1
31427508,Golanthara Vartha,1993,[],"['Thriller', 'Family Film']",1990,3
1056023,Another 48 Hrs.,1990,['United States of America'],"['Action', 'Crime Fiction', 'Action Comedy', 'Action/Adventure', 'Buddy film', 'Comedy', 'Buddy cop']",1990,0
4471231,In Search of Love,1929,"['Korea', 'South Korea']","['Action', 'Black-and-white', 'Indie', 'Silent film']",1920,9
3523466,Purely Belter,2000,['United Kingdom'],['Comedy-drama'],2000,0
1482557,Inchon,1981,"['United States of America', 'South Korea']","['Historical fiction', 'War film', 'Drama']",1980,1
31291851,The Man with Two Faces,1934,['United States of America'],"['Drama', 'Crime Fiction']",1930,4
29468540,Yaar Gaddar,1994,['India'],"['Action', 'Thriller']",1990,4
19700296,Les Espions,1957,"['France', 'Germany', 'Italy']","['Psychological thriller', 'Spy', 'Thriller', 'Drama']",1950,7
10190365,Tere Mere Sapne,1996,['India'],"['Romantic drama', 'Comedy', 'World cinema', 'Romance Film', 'Romantic comedy', 'Drama']",1990,6
26967746,Fuzz Bucket,1986,['United States of America'],"['Comedy', 'Family Film', 'Adventure']",1980,6
29585621,Wiggle Time,1993,['Australia'],['Short Film'],1990,3
2430019,Tokyo Joe,1949,['United States of America'],"['Action', 'Crime Fiction', 'Romantic drama', 'Thriller', 'Romance Film', 'Crime Thriller', 'Drama', 'Crime Drama', 'War film']",1940,9
14560623,La Baie des Anges,1963,['France'],"['Art film', 'World cinema', 'Romance Film', 'Drama']",1960,3
2788063,Bolero,1984,['United States of America'],"['Romance Film', 'Indie', 'Drama']",1980,4
34354688,Some,2004,['South Korea'],"['Action', 'Crime Fiction', 'Mystery']",2000,4
9463843,La Vallée,1972,['France'],"['Art film', 'Erotic Drama', 'World cinema', 'Adventure', 'Drama']",1970,2
18991745,Smith,1939,['United Kingdom'],"['Short Film', 'Drama']",1930,9
25092646,Big Shots,1987,['United States of America'],"['Action', 'Comedy']",1980,7
8974884,The She Beast,1966,"['United Kingdom', 'Italy']","['Supernatural', 'B-movie', 'Horror']",1960,6
21426405,A Kiss From Mary Pickford,1927,['Soviet Union'],"['Silent film', 'Black-and-white', 'Comedy']",1920,7
3272326,Painted Fire,2002,['South Korea'],"['Biography', 'Drama', 'World cinema']",2000,2
26166944,The Challenge,1970,['United States of America'],"['War film', 'Drama']",1970,0
11524153,Pandemic,2007,['United States of America'],"['Action/Adventure', 'Thriller', 'Disaster', 'Science Fiction']",2000,7
1345561,Algiers,1938,['United States of America'],"['Black-and-white', 'Gangster Film', 'Romantic drama', 'Romance Film', 'Drama']",1930,8
10628527,Once in a Lifetime,2000,['Sweden'],"['Music', 'Drama', 'Comedy']",2000,0
6079205,Gamma Squad,2004,['United States of America'],"['Indie', 'Short Film', 'War film']",2000,4
12625574,Lady from Louisiana,1941,['United States of America'],"['Black-and-white', 'Comedy', 'Crime Drama', 'Natural disaster', 'Disaster', 'Drama']",1940,1
12364636,Quicksand,2001,"['United Kingdom', 'France', 'Germany']","['Action', 'Psychological thriller', 'Action/Adventure', 'Thriller', 'Crime Thriller']",2000,1
2964301,Together,2003,"['China', 'South Korea']","['Musical', 'World cinema', 'Chinese Movies', 'Drama']",2000,3
33108388,Himmatwala,1983,[],"['Action', 'Drama', 'Comedy film', 'Family Film']",1980,3
13996230,Jada,2008,['United States of America'],"['Indie', 'Inspirational Drama', 'Drama']",2000,8
11161265,Games,1967,['United States of America'],"['Psychological thriller', 'Crime Fiction', 'Thriller', 'Crime Thriller', 'Drama']",1960,7
7460481,Felix the Cat: The Movie,1988,"['Germany', 'Hungary', 'United States of America']","['Musical', 'Animation', 'Science Fiction', 'Family Film', 'Fantasy']",1980,8
12039019,Hold Your Man,1933,['United States of America'],"['Black-and-white', 'Pre-Code', 'Drama']",1930,3
6504302,Brothers,2004,"['Denmark', 'Sweden', 'United Kingdom', 'Norway']","['Art film', 'World cinema', 'War film', 'Drama']",2000,4
476640,Celtic Pride,1996,['United States of America'],"['Sports', 'Slapstick', 'Comedy']",1990,6
54030,Vanilla Sky,2001,"['Spain', 'United States of America']","['Psychological thriller', 'Mystery', 'Thriller', 'Romance Film', 'Science Fiction']",2000,1
33984024,When We Were Young,1989,['United States of America'],['Drama'],1980,9
165990,Rumble in the Bronx,1995,"['Canada', 'Hong Kong']","['Action', 'Crime Fiction', 'Action/Adventure', 'Comedy', 'Thriller', 'World cinema', 'Chinese Movies', 'Martial Arts Film', 'Action Comedy']",1990,5
6978600,Androcles and the Lion,1953,['United States of America'],"['Costume drama', 'Comedy']",1950,3
6494145,Animal Farm,1954,['United Kingdom'],"['Film adaptation', 'Animation', 'Comedy', 'Drama', 'Political cinema', 'Dystopia', 'Parody', 'Political drama']",1950,4
23150143,For the Love of Nancy,1994,['United States of America'],['Drama'],1990,4
14814612,Naruto: Shippūden the Movie 2,2008,['Japan'],"['Action', 'Animation', 'Japanese Movies', 'Anime']",2000,8
26322280,Maampazhakkaalam,2004,['India'],['Comedy'],2000,4
26748825,Memoirs of Modern Love: Curious Age,1967,['Japan'],"['Japanese Movies', 'Pinku eiga']",1960,7
18994794,Crossing,2008,['South Korea'],"['Political drama', 'Drama', 'World cinema']",2000,8
19398524,For Pete's Sake!,1934,['United States of America'],"['Black-and-white', 'Short Film', 'Comedy', 'Drama']",1930,4
5628492,Q&A,1990,['United States of America'],"['Action', 'Suspense', 'Drama', 'Crime Fiction', 'Indie']",1990,0
1417388,The Brothers,2001,['United States of America'],"['Romantic drama', 'Comedy', 'Romance Film', 'Romantic comedy', 'Drama']",2000,1
25947431,The Avenger,1962,"['France', 'Yugoslavia', 'Italy']","['Adventure', 'Fantasy']",1960,2
29271392,Where's Sally?,1936,['United Kingdom'],['Comedy film'],1930,6
12710627,Le amiche,1955,['Italy'],"['Black-and-white', 'World cinema', 'Romance Film', 'Melodrama', 'Drama', 'Ensemble Film']",1950,5
1662573,The Game of Their Lives,2005,['United States of America'],"['Film adaptation', 'Sports', 'Drama']",2000,5
23118238,Come Live with Me,1941,['United States of America'],"['Romance Film', 'Romantic comedy', 'Comedy']",1940,1
11624498,Jaka Sembung,1981,['Indonesia'],"['Action', 'Action/Adventure', 'Thriller', 'World cinema', 'Adventure', 'Fantasy']",1980,1
11120431,Action in the North Atlantic,1943,['United States of America'],"['Action', 'Combat Films', 'Black-and-white', 'Action/Adventure', 'War film', 'Drama']",1940,3
2259688,Maniac Cop 2,1990,['United States of America'],"['Action', 'Indie', 'Slasher', 'Thriller', 'Horror', 'Crime Thriller']",1990,0
12674456,Valdez Is Coming,1971,['United States of America'],"['Western', 'Revisionist Western', 'Action/Adventure']",1970,1
10133100,College Road Trip,2008,['United States of America'],"['Comedy', 'Teen', ""Children's"", 'Drama', 'Coming of age', 'Domestic Comedy', 'Road movie', 'Family Film']",2000,8
2270205,Viridiana,1961,"['Mexico', 'Spain']","['Art film', 'Satire', 'Comedy', 'World cinema', 'Black comedy', 'Comedy-drama', 'Drama']",1960,1
17874058,"Un Autre homme,Une Autre chance",1977,['France'],['Western'],1970,7
13464912,The Shameless Old Lady,1965,['France'],['Drama'],1960,5
3645256,The Locket,1946,['United States of America'],"['Film noir', 'Black-and-white']",1940,6
3499631,Old Shatterhand,1964,"['Germany', 'Yugoslavia', 'West Germany']","['Indian Western', 'Western']",1960,4
2435076,Birth of the Beatles,1979,['United States of America'],"['Music', 'Biography', 'Drama']",1970,9
4343361,Lookin' to Get Out,1982,['United States of America'],['Comedy'],1980,2
23746718,Citizen Jane,2009,['United States of America'],"['Action', 'Crime Fiction', 'Mystery', 'Indie', 'Action/Adventure', 'Biographical film', 'Thriller', 'Crime Thriller']",2000,9
25256753,The Railway Children,2000,['United Kingdom'],['Family Film'],2000,0
15938122,Solomon Kane,2009,"['United Kingdom', 'France', 'Czech Republic']","['Action/Adventure', 'World cinema', 'Adventure', 'Superhero movie', 'Fantasy']",2000,9
14355911,Sivagangai seemai,1959,['India'],[],1950,9
67427,The Glimmer Man,1996,['United States of America'],"['Psychological thriller', 'Action', 'Crime Fiction', 'Action Thrillers', 'Action/Adventure', 'Thriller', 'Martial Arts Film']",1990,6
770239,Mr. & Mrs. Bridge,1990,"['United Kingdom', 'United States of America']","['Period piece', 'Romantic drama', 'Romance Film', 'Drama']",1990,0
29901445,Alancheri Thamprakkal,1995,[],['Drama'],1990,5
6645089,Family Guy Presents: Stewie Griffin: The Untold Story,2005,['United States of America'],"['Animation', 'Science Fiction', 'Comedy']",2000,5
18683083,Honeymoon Academy,1990,['United States of America'],"['Action', 'Spy', 'Comedy', 'Comedy-drama', 'Drama']",1990,0
30351286,Springtime in the Rockies,1941,['United States of America'],['Western'],1940,1
4295195,Knocked Up,2007,['United States of America'],"['Stoner film', 'Comedy', 'Romance Film', 'Romantic comedy', 'Drama', 'Sex comedy']",2000,7
8737659,Speed Racer,2008,"['Germany', 'United States of America', 'Australia']","['Adventure Comedy', 'Action', 'Chase Movie', 'Family Film', 'Sports', 'Adventure']",2000,8
24845777,Start Cheering,1938,['United States of America'],"['Musical', 'Romantic comedy', 'Comedy']",1930,8
9985510,Dikari,2006,['Russia'],['Comedy'],2000,6
4105119,Comrade X,1940,['United States of America'],"['Spy', 'Black-and-white', 'Comedy', 'Comedy of manners', 'Romantic comedy', 'Comedy-drama', 'Drama']",1940,0
14900984,The City,1998,['United States of America'],"['Black-and-white', 'Drama', 'Indie', 'World cinema']",1990,8
11944726,Most Wanted,1997,['United States of America'],"['Action', 'Action/Adventure', 'Thriller']",1990,7
1682805,The Family Stone,2005,['United States of America'],"['LGBT', 'Comedy', 'Comedy of manners', 'Romance Film', 'Holiday Film', 'Christmas movie', 'Drama', 'Domestic Comedy', 'Romantic comedy', 'Comedy-drama']",2000,5
26913455,The Hidden Power of the Dragon Sabre,1984,['Hong Kong'],"['Wuxia', 'Chinese Movies']",1980,4
17006384,Cracked Nuts,1931,['United States of America'],"['Comedy', 'Black-and-white']",1930,1
2251194,The Rainmaker,1956,['United States of America'],"['Romance Film', 'Romantic comedy', 'Comedy']",1950,6
15397453,A Pleasant Journey,1923,['United States of America'],"['Black-and-white', 'Indie', 'Short Film', 'Comedy', 'Silent film', 'Family Film']",1920,3
7906493,Babysitter Wanted,2008,['United States of America'],"['Slasher', 'Teen', 'Horror']",2000,8
2162986,The Pursuit of Happyness,2006,['United States of America'],"['Inspirational Drama', 'Family Drama', 'Biographical film', 'Drama']",2000,6
4865852,"Double, Double, Toil and Trouble",1993,['United States of America'],"['Comedy', 'Adventure', 'Family Film', 'Fantasy']",1990,3
463396,In the Company of Men,1997,"['Canada', 'United States of America']","['Black comedy', 'Indie', 'Drama']",1990,7
4795478,Felicity: An American Girl Adventure,2005,['United States of America'],"['Family Drama', 'Family-Oriented Adventure', ""Children's/Family"", 'Adventure', 'Drama', 'Period piece', 'Animal Picture', 'Television movie', 'Family Film']",2000,5
565879,The Incredibles,2004,['United States of America'],"['Action', 'Animation', 'Superhero', 'Action/Adventure', 'Comedy', 'Family-Oriented Adventure', ""Children's/Family"", 'Adventure', 'Computer Animation', 'Superhero movie', 'Family Film']",2000,4
2614244,Sangharsh,1999,['India'],"['Bollywood', 'Thriller']",1990,9
5902339,Dingaka,1965,['South Africa'],"['Action', 'Drama']",1960,5
15899017,Dealers,1989,['United Kingdom'],"['Indie', 'Drama']",1980,9
2941342,Flesh Gordon Meets the Cosmic Cheerleaders,1989,[],"['Parody', 'Comedy', 'Adventure', 'Science Fiction', 'Sex comedy']",1980,9
19344803,Noah's Arc: Jumping the Broom,2008,['United States of America'],"['LGBT', 'Romance Film', 'Drama', 'Gay Themed', 'Gay', 'Gay Interest', 'Comedy-drama', 'Road movie']",2000,8
17776753,Spirit of the Forest,2008,['Spain'],"['Fairy tale', 'Animation', 'Comedy', ""Children's/Family"", 'Family Film']",2000,8
4032727,Molly,1999,['United States of America'],"['Romantic comedy', 'Comedy-drama', 'Drama']",1990,9
4892253,Forever Love,1998,['United States of America'],"['Family Drama', 'Television movie', 'Drama', 'Medical fiction']",1990,8
34749036,"Listen, Let's Make Love",1969,['Italy'],"['Parody', 'Comedy', 'World cinema', 'Romance Film', 'Romantic comedy', 'Drama']",1960,9
34988305,Sphodanam,1981,['India'],['Family Film'],1980,1
3978160,Gene-X,2006,['Australia'],"['Romance Film', 'Thriller']",2000,6
4851414,Villain,2002,['India'],"['Action', 'Drama', 'Thriller', 'Romance Film']",2000,2
29641798,You Can't See 'round Corners,1969,[],['Drama'],1960,9
28116404,Eating Out 3: All You Can Eat,2009,['United States of America'],"['Gay Themed', 'LGBT', 'Screwball comedy', 'Comedy', 'Romance Film']",2000,9
7451098,Cellar Dweller,1988,['United States of America'],"['Horror', 'Fantasy']",1980,8
2731727,Vulgar,2000,['United States of America'],"['Drama', 'Crime Fiction', 'Indie', 'Comedy', 'Thriller', 'Black comedy', 'Comedy-drama']",2000,0
4069274,When Will I Be Loved,2004,['United States of America'],"['Erotic Drama', 'Romantic drama', 'Indie', 'Erotic thriller', 'Romance Film', 'Erotica', 'Drama']",2000,4
5626726,The Bohemian Girl,1936,['United States of America'],"['Black-and-white', 'Operetta', 'Satire', 'Comedy', 'Comedy-drama', 'Slapstick']",1930,6
1389153,"Dude, Where's My Car?",2000,['United States of America'],"['Mystery', 'Stoner film', 'Buddy film', 'Comedy', 'Teen', 'Slapstick', 'Absurdism', 'Science Fiction']",2000,0
18762081,Guy X,2005,"['United Kingdom', 'Canada', 'Iceland']","['Indie', 'Comedy', 'Black comedy', 'War film']",2000,5
2080306,Drop Zone,1994,['United States of America'],"['Suspense', 'Action', 'Action Thrillers', 'Chase Movie', 'Action/Adventure', 'Thriller']",1990,4
12283356,Reckless,1984,['United States of America'],['Drama'],1980,4
8982202,Marriage on the Rocks,1965,['United States of America'],"['Romance Film', 'Romantic comedy', 'Comedy']",1960,5
25180915,Lies & Illusions,2009,['United States of America'],"['Action', 'Action/Adventure', 'Thriller']",2000,9
16291021,Paar Magale Paar,1963,['India'],['Drama'],1960,3
401782,The Calcium Kid,2004,['United Kingdom'],"['Boxing', 'Mockumentary', 'Parody', 'Comedy', 'Sports']",2000,4
26990345,Johnny Cool,1963,['United States of America'],"['Film adaptation', 'Gangster Film', 'Thriller', 'Crime Thriller', 'Drama']",1960,3
9974375,The Promise,1979,['United States of America'],['Drama'],1970,9
34037650,Calzonzin Inspector,1973,['Mexico'],"['Comedy', 'Comedy film', 'World cinema', 'Fantasy']",1970,3
8357964,Terkel in Trouble,2004,"['United Kingdom', 'Denmark']","['Animation', 'Comedy', 'Black comedy', 'Computer Animation']",2000,4
18884961,The Long Arm,1956,['United Kingdom'],"['Crime Fiction', 'Mystery', 'Drama']",1950,6
957322,The Scorpion King,2002,"['Germany', 'United States of America', 'Belgium']","['Action', 'Fantasy Adventure', 'Thriller', 'Romance Film', 'Adventure', 'Fantasy']",2000,2
22989233,Mukhamukham,1984,['India'],['Drama'],1980,4
25086167,Anandam,2001,['India'],['Romance Film'],2000,1
1058504,Lacombe Lucien,1974,"['France', 'Germany', 'West Germany', 'Italy']","['Coming of age', 'World cinema', 'Romance Film', 'War film', 'Drama']",1970,4
26792591,Eliza Fraser,1976,['Australia'],"['Comedy', 'Drama', 'Adventure']",1970,6
4391702,Dragon Lord,1982,['Hong Kong'],"['Action', 'Martial Arts Film', 'Action Comedy', 'Action/Adventure', 'Comedy', 'World cinema', 'Chinese Movies']",1980,2
6135427,Man-Thing,2005,"['United States of America', 'Australia']","['Action', 'Superhero', 'Creature Film', 'Monster movie', 'Horror', 'Superhero movie', 'B-movie', 'Science Fiction']",2000,5
3341217,Christmas Child,2003,['United States of America'],"['Inspirational Drama', 'Christian film', 'Holiday Film', 'Christmas movie', 'Drama']",2000,3
694559,Time Masters,1982,"['Switzerland', 'Hungary', 'United Kingdom', 'France', 'Germany', 'West Germany']","['Animation', 'World cinema', 'Adventure', 'Science Fiction', 'Family Film']",1980,2
21871596,Ujala,1959,['India'],"['Action', 'Crime Fiction', 'Drama']",1950,9
1576720,Saboteur,1942,['United States of America'],"['Action', 'Spy', 'Black-and-white', 'Mystery', 'Action/Adventure', 'Thriller', 'Romance Film', 'Crime Thriller', 'Suspense', 'Chase Movie']",1940,2
4531990,Boy Eats Girl,2005,"['Ireland', 'United Kingdom']","['Creature Film', 'Indie', 'Horror Comedy', 'Teen', 'Horror', 'Comedy', 'Zombie Film']",2000,5
28995186,El Dorado,1963,['Israel'],['Drama'],1960,3
3933604,Buck Privates,1941,['United States of America'],"['Comedy', 'Black-and-white']",1940,1
23947773,Balalaika,1939,['United States of America'],"['Musical', 'Romance Film']",1930,9
19063274,Doctors' Wives,1971,['United States of America'],['Drama'],1970,1
6969487,Marlowe,1969,['United States of America'],"['Detective fiction', 'Mystery', 'Detective']",1960,9
21753290,The Journey of Jared Price,2000,['United States of America'],"['Gay Themed', 'LGBT', 'Drama', 'Coming of age', 'Indie', 'Romantic drama', 'Romance Film']",2000,0
666923,The Lost World: Jurassic Park,1997,['United States of America'],"['Action', 'Film adaptation', 'Thriller', 'Adventure', 'Science Fiction']",1990,7
22574837,The Nickel Ride,1974,['United States of America'],"['Crime Drama', 'Crime Fiction']",1970,4
2393998,Street Fighter Alpha,2000,['Japan'],"['Action', 'Fantasy Adventure', 'Animation', 'Japanese Movies', 'Anime', 'Martial Arts Film']",2000,0
5490152,Un cœur en hiver,1992,['France'],"['Romantic drama', 'World cinema', 'Romance Film', 'Drama']",1990,2
7450532,Chronic Bachelor,2003,['India'],"['Drama', 'Comedy']",2000,3
21250632,To Bina Bhala Lagena,2008,['India'],"['Action', 'Musical', 'Drama']",2000,8
30245847,Carnival,1946,['United Kingdom'],['Romance Film'],1940,6
9087548,Rogue Male,1976,['United Kingdom'],"['Action Thrillers', 'Thriller', 'Escape Film', 'Political thriller']",1970,6
31658770,Melba,1953,['United Kingdom'],"['Musical', 'Drama', 'Biopic [feature]']",1950,3
22407076,Taipei Story,1985,['Taiwan'],"['Romantic drama', 'Drama']",1980,5
27193276,Dog in Boots,1981,['Soviet Union'],"['Musical', 'Animation', 'Parody', 'Short Film']",1980,1
73471,Flash Gordon,1936,['United States of America'],"['Action', 'Black-and-white', 'Adventure', 'Movie serial', 'Superhero movie', 'Science Fiction']",1930,6
15945871,The Dorm That Dripped Blood,1982,['United States of America'],"['Mystery', 'Horror']",1980,2
550486,MirrorMask,2005,"['United Kingdom', 'United States of America']","['Fantasy Adventure', 'Family Drama', 'Adventure', 'Science Fiction', 'Drama', 'Family Film', 'Fantasy']",2000,5
25499697,Spanish Movie,2009,['Spain'],['Parody'],2000,9
31239767,Devil Dogs of the Air,1935,['United States of America'],"['Action', 'Drama', 'War film']",1930,5
171618,Pollock,2001,['United States of America'],"['Indie', 'Biography', 'Romantic drama', 'Biographical film', 'Romance Film', 'Drama', 'Period piece', 'Marriage Drama', 'Biopic [feature]']",2000,1
12061267,Grizzly II: The Predator,1987,['United States of America'],"['Thriller', 'Horror']",1980,7
26039454,Troublesome Night 12,2001,['Hong Kong'],"['Chinese Movies', 'Comedy', 'Horror']",2000,1
10543866,In the Shadow of the Moon,2007,"['United Kingdom', 'United States of America']","['History', 'Indie', 'Biography', 'Documentary']",2000,7
6156372,Tony Rome,1967,['United States of America'],"['Detective fiction', 'Mystery', 'Thriller', 'Detective', 'Crime Thriller']",1960,7
27727249,Aspiring Home Tutor: Soiled Pure Whiteness,2004,['Japan'],['Japanese Movies'],2000,4
12897402,Jurm,1990,['India'],"['Musical', 'Crime Fiction', 'Bollywood', 'Romance Film']",1990,0
531816,Eight Crazy Nights,2002,['United States of America'],"['Musical', 'Animation', 'Comedy', 'Christmas movie']",2000,2
21510686,The Locusts,1997,['United States of America'],"['Period piece', 'Romantic drama', 'Indie', 'Romance Film', 'Drama']",1990,7
8484755,Open Season,2006,['United States of America'],"['Computer Animation', 'Animation', ""Children's"", 'Buddy film', 'Comedy', 'Adventure', 'Family Film']",2000,6
1668866,Dark Passage,1947,['United States of America'],"['Crime Fiction', 'Romantic drama', 'Thriller', 'Film noir', 'Crime Thriller', 'Drama']",1940,7
15699428,Wombling Free,1977,['United Kingdom'],"['Fantasy Adventure', ""Children's Fantasy"", ""Children's/Family"", 'Fantasy']",1970,7
20425100,Night and Day,2008,['South Korea'],"['Drama', 'World cinema']",2000,8
18400321,Bomber's Moon,1943,['United States of America'],"['Prison escape', 'War film', 'Adventure', 'Drama']",1940,3
1737543,Last Days,2005,['United States of America'],"['Music', 'Musical', 'LGBT', 'Drama', 'Biography', 'Indie', 'Biographical film']",2000,5
25730129,Liberty Kid,2007,['United States of America'],"['Indie', 'Drama']",2000,7
6142808,The Grudge 3,2009,"['Japan', 'United States of America']","['Japanese Movies', 'Thriller', 'Horror', 'Supernatural']",2000,9
17864265,Itsy Bitsy Spider,1992,['United States of America'],"['Short Film', 'Comedy']",1990,2
23395917,Dennis the Menace: Dinosaur Hunter,1987,['United States of America'],"['Comedy', 'Family Film']",1980,7
2617036,Tai-Pan,1986,['United States of America'],"['Period piece', 'Film adaptation', 'Drama', 'Indie', 'Action/Adventure', 'Adventure', 'Historical Epic']",1980,6
806082,Boys on the Side,1995,"['United States of America', 'France']","['LGBT', 'Buddy film', 'Comedy', 'Comedy-drama', 'Road movie', 'Drama', 'Feminist Film']",1990,5
32172995,Mickey's Big Broadcast,1933,[],['Short Film'],1930,3
18685527,Scooby-Doo and the Goblin King,2008,['United States of America'],"['Animation', 'Comedy', 'Thriller', 'Family Film', 'Fantasy']",2000,8
2384000,Sindhu Bhairavi,1985,['India'],['Drama'],1980,5
11376173,Amar,1954,['India'],"['Musical', 'Romance Film']",1950,4
28611693,Thema syneidiseos,1973,['Greece'],"['Thriller', 'Drama']",1970,3
12311917,The Fifth Horseman is Fear,1964,['Czech Republic'],"['Black-and-white', 'Indie', 'World cinema', 'Drama', 'Tragedy']",1960,4
13572405,Ten Little Indians,1989,['United Kingdom'],"['Mystery', 'Thriller']",1980,9
7029576,Four Eyed Monsters,2005,['United States of America'],"['Drama', 'Indie', 'Romantic drama', 'Romance Film', 'Romantic comedy', 'Domestic Comedy', 'Comedy-drama']",2000,5
228496,Lies,1999,['South Korea'],"['Romantic drama', 'World cinema', 'Romance Film', 'Erotica', 'Drama']",1990,9
6763625,Yeh Dillagi,1994,['India'],"['Musical', 'Romantic drama', 'Bollywood', 'World cinema', 'Romance Film', 'Drama']",1990,4
739286,The Village,2004,['United States of America'],"['Mystery', 'Thriller', 'Drama', 'Fantasy']",2000,4
11142730,Sanam Teri Kasam,1982,['India'],"['Romantic drama', 'World cinema', 'Romance Film', 'Drama']",1980,2
170936,Harvey,1950,['United States of America'],"['Black-and-white', 'Screwball comedy', 'Comedy', 'Fantasy']",1950,0
6461832,Betrayed,1954,['United States of America'],"['War film', 'Drama']",1950,4
35484229,Paandi Nattu Thangam,1989,['India'],['Drama'],1980,9
17848676,An American Carol,2008,['United States of America'],"['Political cinema', 'Indie', 'Parody', 'Satire', 'Comedy', 'Holiday Film']",2000,8
2752473,Malevolence,2004,['United States of America'],"['Crime Fiction', 'Mystery', 'Slasher', 'Thriller', 'Horror', 'B-movie']",2000,4
2528153,Kabhi Haan Kabhi Naa,1993,['India'],"['Musical', 'Bollywood']",1990,3
12406248,Hum Ek Hain,2004,['Pakistan'],['Drama'],2000,4
33636196,Pal Pal Dil Ke Ssaat,2009,[],['Romantic comedy'],2000,9
11823583,Tough enough,2006,['Germany'],"['Drama', 'Crime Fiction']",2000,6
4255260,C.H.U.D II: Bud the C.H.U.D.,1988,['United States of America'],"['Comedy', 'Horror', 'Zombie Film', 'Supernatural', 'Natural horror films']",1980,8
2488992,Kung Fu Mahjong,2005,['Hong Kong'],"['Action', 'Martial Arts Film', 'Action Comedy', 'Action/Adventure', 'Comedy', 'World cinema', 'Chinese Movies']",2000,5
23014684,Blissful Genuine Sex: Penetration!,1995,['Japan'],"['Erotica', 'Japanese Movies', 'Pornographic movie']",1990,5
1222564,Girl 6,1996,['United States of America'],"['Indie', 'Comedy', 'Comedy-drama', 'Workplace Comedy']",1990,6
12404324,Checking Out,1989,"['United Kingdom', 'United States of America']","['Indie', 'Comedy']",1980,9
9280571,The Mystery of the Marie Celeste,1935,['United Kingdom'],"['Black-and-white', 'Mystery', 'Thriller', 'Horror', 'Crime Thriller', 'Drama']",1930,5
2738256,The Pathfinder,1987,['Norway'],"['Action', 'Drama', 'Adventure']",1980,7
2360213,The Sound of Fury,1950,['United States of America'],"['Film adaptation', 'Heist', 'Crime Fiction', 'Film noir', 'Drama']",1950,0
930379,Casino Royale,2006,"['United Kingdom', 'Germany', 'Czech Republic', 'Bahamas', 'United States of America']","['Action', 'Crime Fiction', 'Action/Adventure', 'Thriller', 'Parkour in popular culture', 'Adventure', 'Drama', 'Reboot']",2000,6
18410093,Serious Charge,1959,['United Kingdom'],"['Musical', 'Drama']",1950,9
13527082,Jack Says,2008,['United Kingdom'],"['Drama', 'Mystery', 'Indie', 'Thriller', 'Film noir', 'Crime Thriller']",2000,8
29550132,Aisa Pyaar Kahan,1986,['India'],['Drama'],1980,6
1287132,The Big Snooze,1946,['United States of America'],['Comedy'],1940,6
19189562,Neverwas,2005,"['Canada', 'United States of America']","['Psychological thriller', 'Thriller', 'Drama', 'Fantasy']",2000,5
29541354,Gautam Govinda,2002,['India'],['Action'],2000,2
11993,Son of Godzilla,1967,['Japan'],"['Monster', 'World cinema', 'Creature Film', 'Japanese Movies', 'Horror', 'Science Fiction', 'Cult', 'Fantasy']",1960,7
9682483,The Offence,1972,"['United Kingdom', 'United States of America']","['Crime Fiction', 'Crime Thriller', 'Drama']",1970,2
176545,The Seventh Seal,1957,['Sweden'],"['Black-and-white', 'Art film', 'World cinema', 'Costume drama', 'Drama', 'Period piece', 'Existentialism', 'Fantasy']",1950,7
18614296,How to Be a Serial Killer,2008,['United States of America'],"['Crime Fiction', 'Indie', 'Slasher', 'Horror Comedy', 'Comedy', 'Black comedy']",2000,8
249876,Bend It Like Beckham,2002,"['United Kingdom', 'Germany', 'United States of America']","['Indie', 'Comedy', 'Teen', 'Romance Film', 'Drama', 'Coming of age', 'Domestic Comedy', 'Comedy-drama', 'Sports']",2000,2
317828,O Lucky Man!,1973,['United Kingdom'],"['Musical', 'Surrealism', 'Parody', 'Satire', 'Comedy', 'Black comedy', 'Comedy-drama']",1970,3
24213087,"Parole, Inc.",1948,['United States of America'],"['Crime Fiction', 'Thriller', 'Film noir', 'Crime Thriller', 'Drama']",1940,8
1904097,The Exterminator,1980,['United States of America'],"['Action', 'Adventure']",1980,0
9129800,Who's That Girl?,1987,['United States of America'],"['Musical', 'Comedy', 'Thriller', 'Romance Film', 'Romantic comedy']",1980,7
6914656,The Young Lieutenant,2005,['France'],"['Crime Fiction', 'Drama', 'World cinema']",2000,5
18900457,An Ounce of Pink,1965,[],"['Short Film', 'Animation']",1960,5
4224754,Thevar Magan,1992,['India'],['Drama'],1990,2
3733842,Seconds,1966,['United States of America'],"['Psychological thriller', 'Suspense', 'Thriller', 'Science Fiction']",1960,6
4521454,Songs from the Second Floor,2000,"['Norway', 'Sweden', 'Denmark']","['Surrealism', 'Comedy', 'World cinema', 'Black comedy', 'Comedy-drama', 'Drama']",2000,0
6185940,"Torrente 2, Misión en Marbella",2001,['Spain'],"['Action', 'Action/Adventure', 'Comedy', 'World cinema']",2000,1
11893755,Into the Wild,2007,['United States of America'],"['Film adaptation', 'Biography', 'Docudrama', 'Adventure', 'Drama']",2000,7
9811512,Pantry Panic,1941,[],"['Animation', 'Short Film', 'Comedy', 'Family Film']",1940,1
2452691,Chaos,2005,['United States of America'],"['Slasher', 'Teen', 'Horror', 'B-movie']",2000,5
1842419,Karla,2006,['United States of America'],"['Psychological thriller', 'Crime Fiction', 'Biographical film', 'Thriller', 'Crime Thriller', 'Drama']",2000,6
8029508,Only The Brave,2005,['United States of America'],"['Action', 'Drama', 'Action/Adventure', 'War film']",2000,5
26830040,Oru Abhibhashakante Case Diary,1995,['India'],"['Mystery', 'Thriller']",1990,5
14988233,Gable and Lombard,1976,['United States of America'],"['Biography', 'Romantic drama', 'Biographical film', 'Biopic [feature]', 'Romance Film', 'Drama']",1970,6
21007646,The Plex,2008,['Australia'],['Comedy'],2000,8
2396904,The Jazz Singer,1980,['United States of America'],"['Musical', 'Indie', 'Remake', 'Drama']",1980,0
2386382,The Care Bears in the Land Without Feelings,1983,['Canada'],"['Musical', 'Animation', 'Short Film', 'Fantasy']",1980,3
20225362,Thirumal Perumai,1968,['India'],['Fantasy'],1960,8
350908,Kind Hearts and Coronets,1949,['United Kingdom'],"['Ealing Comedies', 'Black-and-white', 'Crime Fiction', 'Comedy', 'Crime Comedy', 'Black comedy']",1940,9
5735742,Latin Dragon,2004,['United States of America'],"['Action', 'Crime Fiction', 'Action Thrillers', 'Action/Adventure', 'Thriller', 'Martial Arts Film']",2000,4
725468,Murder by Death,1976,['United States of America'],"['Detective fiction', 'Mystery', 'Comedy', 'Thriller', 'Whodunit', 'Crime Thriller', 'Parody', 'Detective', 'Ensemble Film']",1970,6
14746837,Gypped in the Penthouse,1955,['United States of America'],"['Short Film', 'Black-and-white', 'Comedy']",1950,5
24173081,Bush Mama,1979,['United States of America'],['Drama'],1970,9
1822878,Stealing Beauty,1996,"['United Kingdom', 'France', 'Italy']","['Coming of age', 'Romantic drama', 'World cinema', 'Romance Film', 'Drama']",1990,6
697113,Big Trouble in Little China,1986,['United States of America'],"['Action', 'Comedy', 'Romance Film', 'Martial Arts Film', 'Adventure', 'Action Comedy', 'Fantasy Comedy', 'Fantasy']",1980,6
14615908,Stone Age Romeos,1955,['United States of America'],"['Short Film', 'Black-and-white', 'Comedy']",1950,5
3554438,In the Heat of the Sun,1994,"['Hong Kong', 'Taiwan', 'China']","['Drama', 'Biopic [feature]', 'Chinese Movies']",1990,4
10776142,Aankhon Aankhon Mein,1972,['India'],"['Drama', 'Bollywood', 'World cinema']",1970,2
6525562,Dense,2004,['United States of America'],"['Short Film', 'Avant-garde', 'Experimental film', 'Drama']",2000,4
21739675,Katha,1983,['India'],"['Romantic drama', 'Bollywood', 'World cinema', 'Romance Film', 'Drama']",1980,3
17356798,The Haunting in Connecticut,2009,"['Canada', 'United States of America']","['Psychological thriller', 'Thriller', 'Horror', 'Supernatural', 'Drama', 'Haunted House Film']",2000,9
1430396,Corpse Bride,2005,"['United Kingdom', 'United States of America']","['Musical', 'Animation', 'Comedy', 'Black comedy', 'Costume drama', 'Romantic comedy', 'Stop motion', 'Fantasy']",2000,5
12213607,Dick Tracy Meets Gruesome,1947,['United States of America'],"['Action', 'Black-and-white', 'Mystery', 'Superhero', 'Detective', 'Thriller', 'Superhero movie']",1940,7
9382582,Parachute Battalion,1941,['United States of America'],"['Romantic drama', 'War film']",1940,1
5227373,Rebecca of Sunnybrook Farm,1938,['United States of America'],"['Musical', 'Black-and-white', 'Family Drama', 'Drama', 'Family Film']",1930,8
92566,Picnic,1955,['United States of America'],['Drama'],1950,5
1139962,O,2001,['United States of America'],"['Film adaptation', 'Romantic drama', 'Teen', 'Romance Film', 'Sports', 'Drama']",2000,1
31157100,Jubilee,2008,['India'],"['Thriller', 'Family Film']",2000,8
17177170,Lal Darja,1997,['India'],['Drama'],1990,7
2390369,The Cassandra Crossing,1976,"['United Kingdom', 'Germany', 'West Germany', 'Italy']","['Action', 'Action Thrillers', 'Action/Adventure', 'Thriller', 'World cinema', 'Disaster', 'Adventure', 'Drama', 'Suspense']",1970,6
30498632,Among Giants,1998,['United Kingdom'],"['Romantic drama', 'Comedy', 'Romance Film', 'Romantic comedy', 'Comedy-drama']",1990,8
2606345,American Pie Presents: Band Camp,2005,['United States of America'],"['Comedy', 'Teen', 'Sex comedy']",2000,5
9574727,Triumph of the Spirit,1989,['United States of America'],"['Boxing', 'Biography', 'Biographical film', 'Docudrama', 'Drama', 'Period piece', 'Sports', 'War film']",1980,9
31795187,Sol Goode,2001,['United States of America'],"['Comedy', 'Romance Film', 'Romantic comedy', 'Ensemble Film']",2000,1
12097185,Phoenix,1998,['United States of America'],"['Crime Fiction', 'Thriller', 'Crime Thriller', 'Drama']",1990,8
3615041,Charlie Wilson's War,2007,"['Germany', 'United States of America']","['Spy', 'Film adaptation', 'Biography', 'Comedy', 'Biographical film', 'Docudrama', 'Drama', 'History', 'Political drama']",2000,7
950245,Angus,1995,"['United Kingdom', 'France', 'Germany', 'United States of America']","['Coming of age', 'Buddy film', 'Comedy', 'Teen', 'Romantic comedy', 'Romance Film', 'Drama']",1990,5
598868,Mad Max Beyond Thunderdome,1985,"['New Zealand', 'Australia', 'United States of America']","['Action', 'Indie', 'World cinema', 'Apocalyptic and post-apocalyptic fiction', 'Doomsday film', 'Science Fiction']",1980,5
25899488,Varnam,1989,['India'],"['Romance Film', 'Comedy', 'Drama']",1980,9
6312980,Brewster's Millions,1985,['United States of America'],"['Screwball comedy', 'Comedy']",1980,5
20554131,Gardens of the Night,2008,"['United Kingdom', 'United States of America']",['Drama'],2000,8
23939272,Million Dollar Legs,1932,['United States of America'],['Black-and-white'],1930,2
3748405,Murder Ahoy!,1964,['United Kingdom'],"['Film adaptation', 'Crime Fiction', 'Mystery', 'Comedy', 'Thriller']",1960,4
23315758,"Femme Fatale, Jang Hee-bin",1968,['South Korea'],['Drama'],1960,8
2442231,Wonderwall,1968,['United Kingdom'],"['Romantic drama', 'Romance Film', 'Drama', 'Cult']",1960,8
9235373,Behind the Mask: The Rise of Leslie Vernon,2006,['United States of America'],"['Slasher', 'Horror Comedy', 'Horror', 'Comedy', 'Media Satire', 'Mockumentary', 'Cult']",2000,6
153372,Iron Eagle,1986,"['Israel', 'United States of America', 'Canada']","['Action', 'Action Thrillers', 'Action/Adventure', 'Thriller', 'Adventure']",1980,6
29081296,That Certain Thing,1928,['United States of America'],"['Romance Film', 'Romantic comedy', 'Comedy-drama']",1920,8
12562570,5ive Days to Midnight,2004,"['Canada', 'United States of America']","['Science Fiction', 'Thriller']",2000,4
14072881,Boys' Reformatory,1939,['United States of America'],"['Black-and-white', 'Crime Fiction', 'Teen', 'Crime Drama', 'Juvenile Delinquency Film', 'Drama']",1930,9
232325,Swathi Kiranam,1992,['India'],"['Musical', 'Drama', 'Family Film']",1990,2
19744174,Captain Spanky's Show Boat,1939,['United States of America'],"['Black-and-white', 'Short Film', 'Comedy', 'Family Film']",1930,9
4036425,Bombay Boys,1998,['India'],['LGBT'],1990,8
5631382,"Lust, Caution",2007,"['Hong Kong', 'China', 'Taiwan', 'United States of America']","['Spy', 'Art film', 'Erotic Drama', 'Thriller', 'World cinema', 'Romance Film', 'Chinese Movies', 'Drama', 'Period piece', 'Erotic thriller', 'Erotica', 'War film']",2000,7
14710585,Tanya's Island,1980,"['Canada', 'United States of America']","['Fantasy Adventure', 'Romantic drama', 'Action/Adventure', 'Romance Film', 'Adventure', 'Drama', 'Softcore Porn', 'Sexploitation', 'Fantasy']",1980,0
7659023,Why I Wore Lipstick To My Mastectomy,2006,['United States of America'],"['Film adaptation', 'Biography', 'Television movie', 'Comedy-drama', 'Drama']",2000,6
26369842,Ricky Rapper,2008,['Finland'],[],2000,8
11529249,December Bride,1991,"['Ireland', 'United Kingdom']","['Period piece', 'Film adaptation', 'Drama', 'Indie', 'Romantic drama', 'Romance Film']",1990,1
9355314,Deception,2008,['United States of America'],"['Action', 'Psychological thriller', 'Suspense', 'Thriller', 'Erotic thriller', 'Crime Thriller']",2000,8
4317586,Muthu,1995,['India'],"['Musical', 'Bollywood', 'World cinema', 'Musical comedy', 'Drama']",1990,5
28436992,Poison Pen,1939,['United Kingdom'],['Drama'],1930,9
24583717,Love Exposure,2008,['Japan'],"['Action', 'Drama', 'Comedy', 'Romance Film']",2000,8
23824827,Zonad,2009,"['Ireland', 'United Kingdom']","['Parody', 'Indie', 'Comedy', 'Slapstick', 'Science Fiction']",2000,9
170858,The Hudsucker Proxy,1994,"['United Kingdom', 'Germany', 'United States of America']","['Period piece', 'Screwball comedy', 'Comedy', 'Workplace Comedy', 'Drama', 'Fantasy']",1990,4
35790654,Pulan Visaranai,1990,['India'],[],1990,0
6457380,The Harpy,2007,['United States of America'],"['Television movie', 'Science Fiction', 'Adventure']",2000,7
20086938,Death Bell,2008,['South Korea'],"['Thriller', 'Horror']",2000,8
20904181,Palkon Ki Chhaon Mein,1977,['India'],"['Drama', 'Family Film']",1970,7
8835205,Comfort and Joy,2003,['United States of America'],"['Romantic drama', 'Comedy', 'Romance Film', 'Romantic comedy', 'Drama', 'Fantasy']",2000,3
5721992,Prophecy,1979,['United States of America'],"['Science Fiction', 'Natural horror films', 'Horror']",1970,9
1354062,BMX Bandits,1983,"['New Zealand', 'Australia']","['Action', 'Crime Fiction', 'Comedy', 'Family-Oriented Adventure', 'Adventure', 'Drama', 'Chase Movie', 'Family Film']",1980,3
2041686,Hardware Wars,1977,['United States of America'],"['Action', 'Indie', 'Satire', 'Comedy', 'Adventure', 'Parody', 'Short Film', 'Science Fiction']",1970,7
7305684,Under Suspicion,1981,['France'],"['Psychological thriller', 'Crime Fiction', 'Thriller', 'Remake', 'Drama']",1980,1
29879308,The Message,2009,['China'],"['Crime Fiction', 'Thriller', 'World cinema', 'Historical fiction', 'Chinese Movies', 'Drama']",2000,9
2951878,Two Small Bodies,1993,['Germany'],"['Drama', 'Crime Fiction', 'Thriller']",1990,3
8430743,Aquanoids,2003,['United States of America'],"['Science Fiction', 'Natural horror films', 'Horror']",2000,3
22593770,Fortunes of Captain Blood,1950,['United States of America'],"['Action', 'Action/Adventure', 'Adventure', 'Swashbuckler films']",1950,0
12376020,Superdad,1973,['United States of America'],"['Comedy', 'Family Film']",1970,3
1354757,The Pledge,2001,['United States of America'],"['Mystery', 'Crime Fiction', 'Thriller', 'Crime Thriller', 'Drama']",2000,1
1934977,Night and the City,1950,"['United Kingdom', 'United States of America']","['Film adaptation', 'Crime Fiction', 'Thriller', 'Film noir', 'Sports', 'Drama']",1950,0
10956510,Saugandh,1991,['India'],"['Action', 'Family Film']",1990,1
8094113,Pop Goes the Easel,1935,['United States of America'],"['Short Film', 'Black-and-white', 'Comedy']",1930,5
29830825,Pati Patni Aur Tawaif,1990,['India'],"['Musical', 'Bollywood', 'World cinema', 'Drama']",1990,0
20072112,Kill Switch,2008,['United States of America'],"['Action', 'Action Thrillers', 'Action/Adventure', 'Thriller']",2000,8
25732854,Decalogue VIII,1988,['Poland'],['Drama'],1980,8
20181941,Black,2005,['India'],"['Musical', 'Bollywood', 'World cinema', 'Drama', 'Family Film']",2000,5
2071781,The Gumball Rally,1976,['United States of America'],"['Action', 'Action/Adventure', 'Comedy', 'Auto racing', 'Sports', 'Chase Movie', 'Road movie', 'Ensemble Film']",1970,6
11052725,Vel,2007,['India'],"['Action', 'Romance Film']",2000,7
7645983,Saigon Eclipse,2007,['Vietnam'],"['Romantic drama', 'Thriller', 'World cinema', 'Romance Film', 'Drama']",2000,7
32069698,Diana of the Crossways,1922,['United Kingdom'],"['Silent film', 'Drama']",1920,2
2126621,Les Misérables,1934,['France'],"['Black-and-white', 'Drama', 'World cinema']",1930,4
9199438,Part Time Pal,1947,['United States of America'],"['Animation', 'Short Film', 'Family Film']",1940,7
924123,Blink,1994,['United States of America'],"['Psychological thriller', 'Crime Fiction', 'Mystery', 'Slasher', 'Thriller', 'Crime Thriller']",1990,4
12320671,Minutemen,2008,['United States of America'],"[""Children's"", 'Comedy', 'Adventure', 'Teen', 'Sci-Fi Adventure', 'Science Fiction']",2000,8
18623459,To Duck or Not To Duck,1943,['United States of America'],"['Animation', 'Short Film', 'Family Film']",1940,3
5855792,Munna,2007,['India'],['Action'],2000,7
20178550,Moranak Meada,2004,['Cambodia'],"['Romance Film', 'Drama', 'Fantasy']",2000,4
12292280,Mr. Nobody,2009,"['Canada', 'Belgium', 'France', 'Germany']","['Romance Film', 'Science Fiction', 'Drama', 'Fantasy']",2000,9
14350910,June Bride,1948,['United States of America'],"['Black-and-white', 'Comedy', 'Romance Film', 'Romantic comedy']",1940,8
21855963,Pulijanmam,2006,['India'],"['Drama', 'Art film']",2000,6
490623,Kiki's Delivery Service,1989,['Japan'],"['Animation', 'World cinema', 'Family-Oriented Adventure', ""Children's/Family"", ""Children's"", 'Adventure', ""Children's Fantasy"", 'Japanese Movies', 'Coming of age', 'Anime', 'Family Film', 'Fantasy']",1980,9
4964205,Lupin the Third: The Legend of the Gold of Babylon,1985,['Japan'],"['Animation', 'Japanese Movies', 'Anime']",1980,5
6012766,Aaye Din Bahar Ke,1966,['India'],"['Musical', 'Romance Film']",1960,6
1693905,St. Ives,1998,"['United Kingdom', 'France', 'Germany', 'Ireland']","['Romance Film', 'Drama']",1990,8
19078391,Oliver Twist,1933,['United States of America'],['Drama'],1930,3
10801856,Killer Constable,1981,['Hong Kong'],"['Action', 'Chinese Movies', 'Martial Arts Film', 'Drama']",1980,1
6128662,Vampires: The Turning,2005,['United States of America'],"['Creature Film', 'Action/Adventure', 'Horror', 'Martial Arts Film']",2000,5
29143402,Tender Loving Care,1997,['United States of America'],"['Psychological thriller', 'Thriller']",1990,7
19437477,Tumi Kar,2008,['India'],['Drama'],2000,8
2780906,Everything's Gone Green,2007,['Canada'],"['Coming of age', 'Indie', 'Comedy', 'Black comedy']",2000,7
28671081,Kids in America,2005,['United States of America'],"['Indie', 'Comedy', 'Teen', 'Comedy-drama', 'Drama']",2000,5
23805173,I Saw What You Did,1988,['United States of America'],"['Drama', 'Thriller', 'Horror']",1980,8
22884121,Mister Moses,1965,['United States of America'],"['Adventure', 'Drama']",1960,5
3263044,The Body Snatcher,1946,['United States of America'],"['Psychological thriller', 'Black-and-white', 'Gothic Film', 'Thriller', 'Horror']",1940,6
1506586,Body and Soul,1947,['United States of America'],"['Boxing', 'Black-and-white', 'Film noir', 'Sports', 'Drama']",1940,7
22839891,Hotel Reserve,1944,['United Kingdom'],"['Action', 'Spy', 'Mystery', 'Thriller', 'War film']",1940,4
3262696,Beowulf & Grendel,2005,"['United Kingdom', 'Canada', 'Iceland']","['Action', 'Film adaptation', 'Action/Adventure', 'World cinema', 'Adventure', 'Drama', 'Period piece', 'Mythological Fantasy', 'Fantasy']",2000,5
24611507,I'll Take Sweden,1965,['United States of America'],"['Musical', 'Comedy', 'Romance Film', 'Romantic comedy']",1960,5
13505565,El Viento,2005,['Argentina'],"['Romance Film', 'Drama']",2000,5
28197101,For Those in Peril,1944,['United Kingdom'],"['War film', 'Drama']",1940,4
61070,I Am a Fugitive from a Chain Gang,1932,['United States of America'],"['Prison', 'Black-and-white', 'Crime Fiction', 'Film noir', 'Pre-Code', 'Drama']",1930,2
2792491,Anna In Kungfuland,2003,['Hong Kong'],"['Romantic drama', 'Action/Adventure', 'Comedy', 'World cinema', 'Romance Film', 'Chinese Movies', 'Martial Arts Film', 'Drama', 'Romantic comedy', 'Sports']",2000,3
20833962,The Cheaters,1930,['Australia'],"['Silent film', 'Crime Fiction', 'Drama']",1930,0
11787589,Santhosha Subramani,2008,['India'],['Musical'],2000,8
1371113,Being Julia,2004,"['Canada', 'United Kingdom', 'Hungary', 'United States of America']","['Film adaptation', 'LGBT', 'Romantic drama', 'Comedy', 'Romance Film', 'Drama', 'Period piece', 'Romantic comedy', 'Comedy-drama']",2000,4
24028252,Heartbeat,1993,['United States of America'],"['Film adaptation', 'Romantic drama', 'Romance Film', 'Television movie', 'Drama']",1990,3
7159773,Jessica,2004,['Australia'],"['Drama', 'Television movie']",2000,4
6443785,The Crew,2000,['United States of America'],"['Action', 'Crime Fiction', 'Action/Adventure', 'Comedy']",2000,0
30221797,Kanave Kalaiyadhe,1999,[],['Romance Film'],1990,9
9378717,The Spy Who Came in from the Cold,1965,['United Kingdom'],"['Spy', 'Film adaptation', 'Thriller']",1960,5
33624347,Meri Biwi Ka Jawaab Nahin,2004,[],"['Action', 'Comedy film']",2000,4
5106720,Candyman: Farewell to the Flesh,1995,['United States of America'],"['Cult', 'Slasher', 'Horror']",1990,5
1226289,Bless the Child,2000,"['Germany', 'United States of America']","['Mystery', 'Thriller', 'Horror', 'Supernatural']",2000,0
26016582,Tora-san's Island Encounter,1985,['Japan'],['Japanese Movies'],1980,5
5640549,Scoop,1987,['United Kingdom'],[],1980,7
4164407,Meet Me in Miami,2006,['New Zealand'],"['Romantic comedy', 'Comedy', 'Family Film']",2000,6
26628405,Sergeant Ryker,1968,['United States of America'],"['Drama', 'War film', 'Biopic [feature]']",1960,8
11119134,Ara Soyza,1978,['Sri Lanka'],['Comedy'],1970,8
5649185,The Breed,2001,['United States of America'],['Horror'],2000,1
13902330,The Ambassador,1984,['United States of America'],['Thriller'],1980,4
32656988,Lovers and Luggers,1937,[],"['Adventure', 'Comedy film']",1930,7
22100120,"Novia, Esposa y Amante",1980,['Mexico'],['Drama'],1980,0
31229264,The Long Days of Summer,1980,['United States of America'],['Drama'],1980,0
14508657,Desa Nisa,1972,['Sri Lanka'],['Drama'],1970,2
12253961,Maanasa Sarovara,1982,['India'],"['Romance Film', 'Drama']",1980,2
10405882,Ankhiyon Ke Jharokhon Se,1978,['India'],"['Romantic drama', 'Bollywood', 'World cinema', 'Romance Film', 'Drama']",1970,8
25169565,Mommy,1995,['United States of America'],['Thriller'],1990,5
5079650,Bean,1997,"['United Kingdom', 'United States of America']","['Screwball comedy', 'Slapstick', 'Comedy', 'Family Film']",1990,7
25802262,Or Iravu,1951,['India'],['Drama'],1950,1
255858,Johnny English,2003,"['United Kingdom', 'France', 'United States of America']","['Action', 'Spy', 'Action/Adventure', 'Comedy', 'Thriller', 'Adventure', 'Comedy of Errors', 'Parody', 'Family Film']",2000,3
4888072,The Magic of Lassie,1978,['United States of America'],"[""Children's/Family"", 'Adventure', 'Drama', 'Family Film']",1970,8
5843229,The Wheeler Dealers,1963,['United States of America'],"['Comedy', 'Satire', 'Romance Film', 'Romantic comedy']",1960,3
20523067,Mystery Team,2009,['United States of America'],"['Detective fiction', 'Crime Fiction', 'Mystery', 'Indie', 'Comedy', 'Thriller', 'Detective']",2000,9
12252309,The Snake King's Child,2001,"['Cambodia', 'Thailand']","['Romance Film', 'Fantasy', 'Horror']",2000,1
7489932,Betty Boop and Grampy,1935,['United States of America'],"['Animation', 'Short Film', 'Comedy', 'Family Film']",1930,5
1954198,The Gay Sisters,1942,['United States of America'],['Drama'],1940,2
13163993,Un borghese piccolo piccolo,1977,['Italy'],['Drama'],1970,7
2138170,Colors,1988,['United States of America'],"['Action', 'Crime Fiction', 'Indie', 'Buddy film', 'Drama']",1980,8
26726510,The Rebel Set,1959,['United States of America'],"['Drama', 'Crime Fiction']",1950,9
5304218,Pudhupettai,2006,['India'],['Gangster Film'],2000,6
23260995,Hell on Frisco Bay,1955,['United States of America'],"['Detective fiction', 'Crime Fiction', 'Mystery', 'Detective', 'Drama']",1950,5
1015932,Hammer Boy,2004,['South Korea'],"['Action', 'Animation', 'Anime', 'Science Fiction']",2000,4
16185034,The Two-Headed Spy,1958,['United Kingdom'],"['Action', 'Spy', 'Mystery', 'Thriller', 'Docudrama', 'Drama', 'Historical fiction', 'War film']",1950,8
8827343,"OSS 117: Cairo, Nest of Spies",2006,['France'],"['Spy', 'Action/Adventure', 'Comedy', 'Thriller', 'World cinema']",2000,6
365070,Ginger Snaps,2000,"['Canada', 'United States of America']","['Cult', 'Teen', 'Horror']",2000,0
3946028,Nosferatu in Venice,1988,['Italy'],['Horror'],1980,8
11573895,Alien from L.A.,1988,"['United States of America', 'South Africa']","['Action/Adventure', 'Comedy', 'Teen', 'Adventure', 'Sci-Fi Adventure', 'Science Fiction']",1980,8
24709102,Ajami,2009,"['Israel', 'Germany']","['Drama', 'World cinema']",2000,9
11143111,Arangetram,1973,['India'],['Drama'],1970,3
9251956,Sunny Side Up,1929,['United States of America'],"['Musical', 'Black-and-white', 'Comedy', 'Romance Film', 'Pre-Code']",1920,9
16189151,The Joyless Street,1925,['Germany'],"['Drama', 'Ensemble Film']",1920,5
3112136,The TV Set,2006,['United States of America'],"['Indie', 'Comedy', 'Media Satire', 'Comedy-drama', 'Drama']",2000,6
8326319,The Boneyard,1991,['United States of America'],"['Zombie Film', 'History', 'Horror']",1990,1
24292756,Eyes of a Stranger,1981,['United States of America'],"['Psychological thriller', 'Mystery', 'Slasher', 'Thriller', 'Horror', 'Crime Thriller']",1980,1
13264461,Ulysses,1954,"['Italy', 'United States of America']","['Film adaptation', 'Action/Adventure', 'World cinema', 'Epic', 'Adventure', 'Drama']",1950,4
9223398,A Lion Is in the Streets,1953,['United States of America'],"['Political drama', 'Satire', 'Drama']",1950,3
1374349,To Live,1994,['Hong Kong'],"['Romantic drama', 'Family Drama', 'World cinema', 'Romance Film', 'Chinese Movies', 'Political drama', 'Drama']",1990,4
25193351,The Hoodlum Soldier,1965,['Japan'],['Japanese Movies'],1960,5
9470913,The Wedding,1972,['Poland'],['Drama'],1970,2
3920193,No Country for Old Men,2007,['United States of America'],"['Suspense', 'Film adaptation', 'Crime Fiction', 'Gangster Film', 'Thriller', 'Crime Thriller', 'Drama']",2000,7
19582424,There Was a Crooked Man,1960,['United Kingdom'],['Comedy'],1960,0
4287489,Frankenstein and the Monster from Hell,1974,['United Kingdom'],"['Creature Film', 'Monster', 'Horror', 'Costume Horror']",1970,4
11958595,Two Bits,1995,['United States of America'],"['Period piece', 'Coming of age', 'Family Drama', 'Drama']",1990,5
1512550,Bayside Shakedown 2,2003,['Japan'],"['Action', 'Crime Fiction', 'Japanese Movies', 'Parody', 'Comedy']",2000,3
4627909,Le Coup de grâce,1976,"['Socialist Federal Republic of Yugoslavia', 'France', 'Germany', 'West Germany']","['Black-and-white', 'Romantic drama', 'World cinema', 'Romance Film', 'War film', 'Drama']",1970,6
9957049,The War Between Men and Women,1972,['United States of America'],"['Romantic comedy', 'Comedy-drama', 'Comedy']",1970,2
161496,A Hatful of Rain,1957,['United States of America'],"['Melodrama', 'Addiction Drama', 'Drama']",1950,7
19369265,Team Batista no Eikō,2008,['Japan'],"['Mystery', 'Japanese Movies', 'Comedy', 'Drama']",2000,8
28687847,County Kilburn,2000,['United Kingdom'],['Comedy'],2000,0
25683949,Kauravar,1992,['India'],['Action'],1990,2
25964342,Legion,1998,[],"['Action', 'Science Fiction', 'Horror']",1990,8
14414193,Crossroads,1942,['United States of America'],"['Black-and-white', 'Mystery', 'Film noir', 'Drama']",1940,2
9576424,Sidekick,2005,['Canada'],"['Action', 'Superhero', 'Indie', 'Action/Adventure', 'Comedy', 'Superhero movie', 'Workplace Comedy', 'Fantasy']",2000,5
1393318,The Heart Desires,2001,['India'],"['Musical', 'Romantic drama', 'Comedy', 'Bollywood', 'World cinema', 'Romance Film', 'Drama', 'Comedy-drama']",2000,1
15441884,The American Ruling Class,2005,['United States of America'],"['Social issues', 'Political cinema', 'Documentary', 'Culture & Society']",2000,5
12777147,Harlem on the Prairie,1937,['United States of America'],"['Musical', 'Western', 'Singing cowboy']",1930,7
19765039,Adam's Wall,2008,['Canada'],"['Romantic drama', 'Drama']",2000,8
26231473,Ride Clear of Diablo,1954,['United States of America'],['Western'],1950,4
7286899,Perumazhakkalam,2006,['India'],"['Art film', 'Drama', 'World cinema']",2000,6
26357439,Farsighted for Two Diopters,1976,['Bulgaria'],['Comedy'],1970,6
9800451,Fires on the Plain,1959,['Japan'],"['Black-and-white', 'Japanese Movies', 'World cinema', 'War film', 'Drama']",1950,9
12171112,Speedy Gonzales - noin 7 veljeksen poika,1970,['Finland'],['Comedy'],1970,0
1123274,Shock,1946,['United States of America'],"['Psychological thriller', 'Black-and-white', 'Crime Fiction', 'Thriller', 'Film noir', 'Crime Thriller', 'Drama']",1940,6
21057974,Pirates of Treasure Island,2006,['United States of America'],"['Action', 'Indie', 'Action/Adventure', 'Comedy', 'Thriller', 'Swashbuckler films', 'Adventure', 'Drama', 'Comedy-drama']",2000,6
32696212,The Phantom Ship,1936,[],"['Animation', 'Short Film', 'Comedy film']",1930,6
6844255,Dallas 362,2003,['United States of America'],"['Crime Fiction', 'Buddy film', 'Drama']",2000,3
20332030,It's a Date,1940,['United States of America'],"['Musical', 'Black-and-white', 'Comedy', 'Romance Film']",1940,0
29473806,Letter of Introduction,1938,['United States of America'],['Drama'],1930,8
27300461,O katergaris,1971,['Greece'],['Comedy'],1970,1
768808,The Frighteners,1996,"['New Zealand', 'United States of America']","['Comedy', 'Horror Comedy', 'Horror', 'Black comedy', 'Supernatural', 'Cult', 'Fantasy']",1990,6
29768643,Drop Squad,1994,['United States of America'],['Drama'],1990,4
19652797,Nayagan,2008,['India'],"['Crime Fiction', 'Thriller']",2000,8
10603161,Que la fête commence,1975,['France'],"['Period piece', 'Romantic drama', 'World cinema', 'Romance Film', 'Political drama', 'Drama']",1970,5
5122793,Baiju Bawra,1952,['India'],"['Musical', 'Bollywood', 'World cinema']",1950,2
129410,Mississippi Burning,1988,['United States of America'],"['Detective fiction', 'Crime Fiction', 'Mystery', 'Detective', 'Political drama', 'Drama', 'Political thriller']",1980,8
462452,The Lost Prince,2003,"['United Kingdom', 'United States of America']","['Period piece', 'Biography', 'Drama']",2000,3
3018980,Thoovanathumbikal,1987,['India'],"['Musical', 'Drama', 'Fantasy']",1980,7
18855425,Riot,1997,['United States of America'],"['Crime Fiction', 'Television movie', 'Political drama', 'Drama']",1990,7
14509186,Figures in a Landscape,1970,['United Kingdom'],"['Drama', 'Chase Movie', 'Thriller']",1970,0
15652607,It's a Bikini World,1967,['United States of America'],"['Musical', 'Comedy', 'Beach Film', 'Cult']",1960,7
6672248,The Masseur,2005,['Philippines'],"['Filipino Movies', 'LGBT', 'Romantic drama', 'World cinema', 'Romance Film', 'Erotica', 'Drama']",2000,5
26442677,Master Minds,1949,['United States of America'],"['Horror', 'Comedy', 'Horror Comedy']",1940,9
3663936,D'Artagnan and Three Musketeers,1978,['Soviet Union'],['Musical'],1970,8
19828661,Radio Bugs,1944,['United States of America'],"['Black-and-white', 'Short Film', 'Comedy', 'Family Film']",1940,4
15495512,Suhaag,1994,['India'],"['Action/Adventure', 'World cinema']",1990,4
6680289,Aviation Vacation,1941,['United States of America'],"['Airplanes and airports', 'Black-and-white', 'Short Film', 'Comedy']",1940,1
19775805,The Sheltering Sky,1990,"['United Kingdom', 'Italy']","['Film adaptation', 'Romantic drama', 'Romance Film', 'Drama']",1990,0
4242930,Satomi Hakkenden,1983,['Japan'],"['Samurai cinema', 'Japanese Movies', 'Action/Adventure', 'World cinema', 'Martial Arts Film']",1980,3
3231227,Moonrise,1948,['United States of America'],"['Film noir', 'Melodrama', 'Drama']",1940,8
2111318,I Walked with a Zombie,1943,['United States of America'],"['Black-and-white', 'Horror', 'Zombie Film', 'Supernatural']",1940,3
7952414,Magnificent Butcher,1979,['Hong Kong'],"['Action', 'Action/Adventure', 'Comedy', 'World cinema', 'Chinese Movies', 'Martial Arts Film']",1970,9
11660374,The Pyx,1973,['Canada'],"['Film adaptation', 'Crime Fiction', 'Thriller', 'Crime Thriller', 'Drama', 'Suspense', 'Horror', 'Supernatural']",1970,3
2099075,I Dream Too Much,1935,['United States of America'],"['Romantic comedy', 'Black-and-white', 'Drama']",1930,5
1181107,Life as a House,2001,['United States of America'],"['Family Drama', 'Romance Film', 'Drama', 'Medical fiction']",2000,1
11337163,Sasural,1960,['India'],"['Musical', 'Romantic drama', 'Bollywood', 'World cinema', 'Romance Film', 'Drama']",1960,0
12688359,The Red Kebaya,2006,['Malaysia'],['Drama'],2000,6
390693,Born in Flames,1983,['United States of America'],"['LGBT', 'Dystopia', 'Comedy', 'Science Fiction', 'Drama', 'Feminist Film']",1980,3
32901780,Pay or Die,1960,['United States of America'],['Crime Fiction'],1960,0
171540,The People vs. Larry Flynt,1996,['United States of America'],"['Period piece', 'Biography', 'Biographical film', 'Biopic [feature]', 'Comedy-drama', 'Drama', 'Courtroom Drama']",1990,6
9231192,Panthaya Kozhi,2007,['India'],[],2000,7
12778413,Race to Mars,2008,[],[],2000,8
12255107,Coeur fidèle,1923,['France'],"['Black-and-white', 'Drama', 'Indie', 'Silent film']",1920,3
3825963,Dreamgirls,2006,['United States of America'],"['Music', 'Period piece', 'Musical', 'Musical Drama', 'Roadshow theatrical release', 'Drama']",2000,6
34044456,Ice Age,2002,['United States of America'],"['Computer Animation', 'Animation', 'Comedy', 'Adventure', 'Family Film', 'Fantasy']",2000,2
24590973,Moby Presents: Alien Sex Party,2003,['United States of America'],"['Musical', 'Indie', 'Comedy']",2000,3
5457190,A Man Vanishes,1967,['Japan'],"['Surrealism', 'Mystery', 'Japanese Movies', 'Mockumentary', 'Drama']",1960,7
2786477,Troll 2,1990,"['Italy', 'United States of America']","['Monster movie', 'Horror']",1990,0
11545267,Megiddo: The Omega Code 2,2001,['United States of America'],"['Action', 'Mystery', 'Indie', 'Action/Adventure', 'Thriller', 'Christian film', 'Supernatural', 'Science Fiction']",2000,1
1623960,Brokeback Mountain,2005,['United States of America'],"['LGBT', 'Romantic drama', 'Romance Film', 'Drama', 'Gay Themed', 'Gay', 'Western', 'Gay Interest']",2000,5
2524297,Island of Terror,1966,['United Kingdom'],"['Creature Film', 'Horror', 'Science Fiction', 'Natural horror films']",1960,6
12594210,The Assassination of Trotsky,1972,"['United Kingdom', 'France', 'Italy']","['Biographical film', 'Thriller', 'Biopic [feature]', 'Historical fiction', 'Political drama', 'Drama']",1970,2
2448004,The Day the Clown Cried,1972,['United States of America'],['Drama'],1970,2
5179763,Namak Halaal,1982,['India'],"['Comedy', 'Bollywood']",1980,2
685981,Loaded Weapon 1,1993,['United States of America'],"['Action', 'Parody', 'Indie', 'Action/Adventure', 'Buddy film', 'Comedy']",1990,3
9617369,Journey to the Center of the Earth,2008,['United States of America'],"['Action/Adventure', 'Comedy', 'Thriller', 'Adventure', 'Science Fiction', 'Family Film']",2000,8
3906643,The Corpse Vanishes,1942,['United States of America'],"['Black-and-white', 'Thriller', 'Horror', 'Sci-Fi Horror', 'Science Fiction']",1940,2
10017886,My Pal Gus,1952,['United States of America'],"['Comedy', 'Domestic Comedy', 'Comedy-drama', 'Drama']",1950,2
673472,The Lost Boys,1987,['United States of America'],"['Coming of age', 'Comedy', 'Teen', 'Horror', 'Cult']",1980,7
7063839,Angel in my Pocket,1969,['United States of America'],['Comedy'],1960,9
8681206,"It's Trad, Dad!",1962,['United Kingdom'],"['Musical', 'Black-and-white', 'Comedy', 'Musical comedy']",1960,2
6563355,Amityville: A New Generation,1993,['United States of America'],"['Haunted House Film', 'Horror']",1990,3
9337317,Fighting Caravans,1931,['United States of America'],"['Action', 'Black-and-white', 'Romantic drama', 'Action/Adventure', 'Romance Film', 'Adventure', 'B-Western', 'Western']",1930,1
5003768,Driving Miss Wealthy / Juet sai ho bun,2004,"['China', 'Hong Kong']","['Romantic drama', 'Comedy', 'World cinema', 'Romance Film', 'Romantic comedy', 'Chinese Movies', 'Drama']",2000,4
4692894,Marupakkam,1990,['India'],['Drama'],1990,0
23842374,Blood Beach,1981,['United States of America'],"['Creature Film', 'Horror']",1980,1
6571638,The Ghost Walks,1934,['United States of America'],"['Psychological thriller', 'Black-and-white', 'Mystery', 'Thriller', 'Whodunit']",1930,4
13631232,The Vagabond King,1956,['United States of America'],"['Musical', 'Romance Film']",1950,6
19111900,Connected,2008,"['China', 'Hong Kong']","['Action', 'Action Thrillers', 'Action/Adventure', 'Thriller', 'World cinema', 'Crime Thriller', 'Chinese Movies']",2000,8
12005853,The Lucky Ones,2008,['United States of America'],"['Drama', 'Indie', 'Comedy', 'Comedy-drama']",2000,8
33443303,Sweet 15,1990,[],"['Family Drama', 'Melodrama', 'Television movie', 'Family Film', 'Drama']",1990,0
10615096,Rajkumar,1964,['India'],"['Musical', 'Comedy', 'Romance Film', 'Drama']",1960,4
18070985,Thieves and Liars,2006,['Puerto Rico'],"['Family Drama', 'World cinema', 'Social problem film', 'Drama', 'Ensemble Film']",2000,6
2761219,The Prophecy II,1998,['United States of America'],"['Thriller', 'Cult', 'Horror']",1990,8
6021280,Scream Blacula Scream,1973,['United States of America'],"['Blaxploitation', 'Action/Adventure', 'Horror', 'Cult']",1970,3
4340003,Down to Earth,1947,['United States of America'],"['Musical', 'Parody', 'Comedy', 'Romance Film', 'Romantic comedy', 'Religious Film', 'Fantasy']",1940,7
5472338,The Clown Murders,1976,['Canada'],"['Slasher', 'Thriller', 'Horror', 'Crime Thriller']",1970,6
7585416,Route 666,2001,"['Canada', 'United States of America']","['Creature Film', 'Zombie Film', 'Horror']",2000,1
28258355,The Boy Who Had Everything,1985,['Australia'],['Drama'],1980,5
22281870,Strangled Eggs,1961,['United States of America'],"['Animation', 'Short Film', 'Comedy', 'Family Film']",1960,1
12496033,Balram vs. Taradas,2006,['India'],"['Action', 'Crime Fiction', 'Thriller', 'World cinema']",2000,6
16771910,The Bridge,1959,"['Germany', 'West Germany']","['War film', 'Drama']",1950,9
25400157,The Dark Avenger,1955,['United States of America'],['War film'],1950,5
8153108,Holi,1985,['India'],"['Art film', 'Comedy', 'Drama']",1980,5
9124584,Maw`ed Ma` al-Sa`adah,1954,['Egypt'],"['Romance Film', 'Drama']",1950,4
2338179,T-Men,1947,['United States of America'],"['Detective fiction', 'Crime Fiction', 'Black-and-white', 'Gangster Film', 'Thriller', 'Film noir', 'Crime Thriller', 'Drama', 'Detective']",1940,7
7735007,Any Wednesday,1966,['United States of America'],"['Screwball comedy', 'Comedy', 'Comedy of manners', 'Romance Film', 'Romantic comedy', 'Comedy-drama', 'Drama']",1960,6
18166884,Deface,2007,['United States of America'],"['Short Film', 'Drama']",2000,7
12877538,The Clown at Midnight,1999,['Canada'],"['Thriller', 'Horror']",1990,9
2913859,The Fast and the Furious: Tokyo Drift,2006,"['Germany', 'United States of America']","['Action', 'Crime Fiction', 'Action Thrillers', 'Action/Adventure', 'Thriller', 'Crime Thriller', 'Auto racing', 'Drama', 'Sports']",2000,6
7856493,Mimic 3: Sentinel,2003,['United States of America'],"['Creature Film', 'Thriller', 'Horror', 'Science Fiction', 'Natural horror films']",2000,3
29605174,"U, Bomsi & Me",2005,[],['Comedy film'],2000,5
12573497,Nothing But the Truth,1941,['United States of America'],"['Comedy', 'Black-and-white']",1940,1
20193934,Hudugaata,2007,['India'],['Comedy'],2000,7
455013,The Boys in the Band,1970,['United States of America'],"['Gay Themed', 'LGBT', 'Gay', 'Gay Interest', 'Drama']",1970,0
35082998,Viswanathan Ramamoorthy,2001,['India'],[],2000,1
5541680,Race to Space,2002,"['Germany', 'United States of America']","['Period piece', 'Family Drama', 'Childhood Drama', 'Animal Picture', 'Drama', 'Family Film']",2000,2
11438787,Celia,1989,['Australia'],"['Indie', 'Drama', 'Horror']",1980,9
18951054,Apocalypse Now,1979,['United States of America'],"['Adventure', 'Drama', 'Anti-war', 'Anti-war film', 'Existentialism', 'Jungle Film', 'New Hollywood', 'War film']",1970,9
7085931,The Scorpion King 2: Rise of a Warrior,2008,"['Germany', 'South Africa', 'United States of America']","['Action', 'Fantasy Adventure', 'Action/Adventure', 'Thriller', 'Swashbuckler films', 'Adventure']",2000,8
1132138,It's a Very Merry Muppet Christmas Movie,2002,['United States of America'],"[""Children's Fantasy"", 'Heavenly Comedy', 'Comedy', ""Children's/Family"", 'Holiday Film']",2000,2
6012592,Anpadh,1962,['India'],"['Romantic drama', 'World cinema', 'Romance Film', 'Drama']",1960,2
25686865,Lady by Choice,1934,['United States of America'],['Comedy-drama'],1930,4
23671700,Uncle's Paradise,2006,['Japan'],"['Japanese Movies', 'Horror', 'Pornographic movie', 'Erotica']",2000,6
31508751,Dragonfly,1976,['United States of America'],['Romantic drama'],1970,6
25874731,Talk of the Town Tora-san,1978,['Japan'],['Japanese Movies'],1970,8
13761516,Nasrani,2007,['India'],"['Drama', 'Comedy']",2000,7
742453,Titan A.E.,2000,['United States of America'],"['Action', 'Animation', 'Adventure', 'Science Fiction', 'Family Film']",2000,0
1183043,Kagemusha,1980,['Japan'],"['Samurai cinema', 'Art film', 'Action/Adventure', 'World cinema', 'Drama', 'History', 'Japanese Movies', 'Historical Epic', 'Epic', 'War film']",1980,0
24205497,Donald Duck and the Gorilla,1944,['United States of America'],"['Animation', 'Short Film', 'Comedy', 'Family Film']",1940,4
19786863,Pkah Thgall Meas,1975,['Cambodia'],['Drama'],1970,5
8846610,Men in White,1934,['United States of America'],"['Black-and-white', 'Pre-Code', 'Drama']",1930,4
5315392,A Summer's Tale,1996,['France'],"['Art film', 'Romantic drama', 'Comedy', 'World cinema', 'Romance Film', 'Drama']",1990,6
22336327,Mercy Streets,2000,['United States of America'],"['Action', 'Crime Fiction', 'Drama']",2000,0
4011202,Tenebrae,1982,['Italy'],"['Giallo', 'Mystery', 'Thriller', 'Horror']",1980,2
5199340,Hadh Kar Di Aapne,2000,['India'],"['Romantic comedy', 'Bollywood']",2000,0
1508176,Babes in Toyland,1961,['United States of America'],"['Musical', 'Stop motion', 'Drama', 'Family Film', 'Fantasy']",1960,1
5746032,9mm Sunrise,2006,['United States of America'],['Action'],2000,6
6283620,Save The Last Dance for Me,2004,[],[],2000,4
10248470,X-Rated: The TV They Tried to Ban,2005,['United Kingdom'],['Documentary'],2000,5
26506906,"Dick Deadeye, or Duty Done",1975,['United Kingdom'],"['Musical', 'Animation']",1970,5
6667989,Tormented,1960,['United States of America'],"['Black-and-white', 'Indie', 'Horror', 'B-movie']",1960,0
20765579,Crime in Connecticut: The Story of Alex Kelly,1999,"['Canada', 'United States of America']",['Drama'],1990,9
803864,Sitcom,1998,['France'],"['LGBT', 'Comedy', 'World cinema', 'Black comedy', 'Domestic Comedy', 'Comedy-drama']",1990,8
20225590,Solstorm,2007,['Sweden'],"['Drama', 'Mystery', 'Thriller']",2000,7
28249206,The Young Lovers,1954,['United Kingdom'],"['Action', 'Spy', 'Drama', 'Romantic drama', 'Romance Film']",1950,4
4770345,Get on the Bus,1996,['United States of America'],"['Indie', 'Road movie', 'Political drama', 'Drama', 'Ensemble Film']",1990,6
20208154,Manik,2005,['India'],['Drama'],2000,5
19362000,You're Telling Me!,1934,['United States of America'],"['Black-and-white', 'Slapstick', 'Comedy']",1930,4
1394726,A Guy Thing,2003,['United States of America'],"['Comedy', 'Romance Film', 'Romantic comedy', 'Comedy of Errors']",2000,3
6329365,2:37,2006,"['New Zealand', 'Australia']","['Indie', 'Drama', 'World cinema']",2000,6
21157144,The Christmas Tree,1996,['United States of America'],['Drama'],1990,6
7672134,Iluzija,2004,['Republic of Macedonia'],"['Coming of age', 'Drama', 'World cinema']",2000,4
3105893,L'Enfant,2005,"['France', 'Belgium']","['Crime Fiction', 'Art film', 'World cinema', 'Social problem film', 'Romance Film', 'Drama']",2000,5
1064537,Santa Sangre,1989,"['Mexico', 'Italy']","['Surrealism', 'Psychological thriller', 'Avant-garde', 'World cinema', 'Horror', 'Experimental film', 'Cult', 'Fantasy']",1980,9
19286375,Vaanmathi,1996,['India'],"['Drama', 'World cinema']",1990,6
14202294,Don't Give Up the Sheep,1953,['United States of America'],"['Animation', 'Short Film', 'Comedy film', 'Family Film']",1950,3
1301789,M,1951,['United States of America'],"['Psychological thriller', 'Film noir', 'Remake']",1950,1
24680056,Manito,2003,['United States of America'],"['Drama', 'Crime Fiction', 'Coming of age', 'Indie', 'Family Drama', 'Family Film']",2000,3
9167153,Mandy,1952,['United Kingdom'],['Drama'],1950,2
1662366,The Long Night,1947,['United States of America'],"['Black-and-white', 'Thriller', 'Film noir', 'Drama']",1940,7
6742643,Artists and Models,1955,['United States of America'],['Comedy'],1950,5
10811095,The Italian,2005,['Russia'],"['Art film', 'Drama', 'World cinema']",2000,5
9967714,El Último tren,2002,"['Argentina', 'Spain', 'Uruguay']","['Action', 'Indie', 'Action/Adventure', 'Comedy', 'World cinema', 'Adventure', 'Drama']",2000,2
4792606,Sione's Wedding,2006,['New Zealand'],"['Comedy', 'World cinema', 'Romance Film', 'Romantic comedy']",2000,6
1617607,Electra Glide in Blue,1973,['United States of America'],"['Action', 'Drama', 'Crime Fiction', 'Action/Adventure']",1970,3
234827,Ridicule,1996,['France'],"['Romantic drama', 'Comedy', 'World cinema', 'Romance Film', 'Drama', 'Period piece', 'Romantic comedy', 'Comedy of manners']",1990,6
6328860,Fatwa,2006,['United States of America'],"['Drama', 'Thriller', 'Political thriller']",2000,6
4143552,Blood of the Vampire,1958,['United Kingdom'],['Horror'],1950,8
17709042,Party Wire,1935,['United States of America'],"['Black-and-white', 'Comedy of manners', 'Comedy-drama', 'Drama', 'Comedy of Errors']",1930,5
29497481,Kizhakkunarum Pakshi,1991,['India'],['Musical'],1990,1
1865556,Zenon: Z3,2004,['United States of America'],"['Science Fiction', ""Children's"", 'Comedy']",2000,4
18892860,Lucky Lady,1975,['United States of America'],"['Drama', 'Comedy']",1970,5
11174624,City Streets,1931,['United States of America'],"['Black-and-white', 'Crime Fiction', 'Film noir', 'Drama']",1930,1
28306726,Timbuktu,1959,['United States of America'],"['Action', 'Drama', 'Action/Adventure', 'Adventure']",1950,9
19046062,Alias Nick Beal,1949,['United States of America'],"['Black-and-white', 'Drama', 'Fantasy']",1940,9
14617763,Dr. Dolittle: Tail To The Chief,2008,"['Canada', 'United States of America']","['Comedy', 'Animal Picture', ""Children's/Family"", 'Fantasy Comedy', 'Family Film']",2000,8
172005,Sadie Thompson,1928,['United States of America'],"['Film adaptation', 'Black-and-white', 'Drama', 'Indie', 'Romantic drama', 'Silent film', 'Romance Film']",1920,8
1093364,I Confess,1953,['United States of America'],"['Psychological thriller', 'Crime Fiction', 'Thriller', 'Film noir', 'Drama']",1950,3
3842309,K-PAX,2001,"['Germany', 'United States of America']","['Mystery', 'Science Fiction', 'Drama']",2000,1
1988341,Hairshirt,1998,['United States of America'],"['Romance Film', 'Romantic comedy', 'Comedy']",1990,8
17004086,Week-End in Havana,1941,['United States of America'],['Musical'],1940,1
19998760,Sangee,2003,['India'],['Romance Film'],2000,3
14498349,Fashions of 1934,1934,['United States of America'],"['Musical', 'Black-and-white', 'Musical Drama', 'Comedy', 'Musical comedy', 'Romance Film', 'Pre-Code', 'Romantic comedy', 'Comedy-drama']",1930,4
26137623,Going All the Way,1997,['United States of America'],"['Period piece', 'Film adaptation', 'Drama', 'Indie', 'Romantic drama', 'Comedy', 'Romance Film']",1990,7
35658593,Orphans,1998,['United Kingdom'],"['Black comedy', 'Drama']",1990,8
1377960,Silmido,2003,['South Korea'],"['Action/Adventure', 'World cinema', 'War film', 'Political drama', 'Drama']",2000,3
4856981,A Simple Twist of Fate,1994,['United States of America'],"['Family Drama', 'Melodrama', 'Drama', 'Family Film']",1990,4
5206156,The Bonfire of the Vanities,1990,['United States of America'],"['Comedy', 'Satire', 'Black comedy', 'Drama']",1990,0
367085,Atlantis: The Lost Empire,2001,['United States of America'],"['Fantasy Adventure', 'Animation', 'Adventure', ""Children's/Family"", 'Science Fiction', 'Family Film']",2000,1
17437799,Iron Cross,2009,['United Kingdom'],"['Psychological thriller', 'Detective fiction', 'Thriller', 'Detective', 'Drama']",2000,9
1006993,Simply Irresistible,1999,"['Germany', 'United States of America']","['Comedy', 'Romance Film', 'Romantic comedy', 'Drama', 'Fantasy']",1990,9
3748765,Legal Eagles,1986,['United States of America'],"['Crime Fiction', 'Mystery', 'Comedy', 'Thriller', 'Romance Film', 'Courtroom Drama', 'Courtroom Comedy', 'Comedy Thriller', 'Romantic comedy', 'Legal drama']",1980,6
733910,Another Stakeout,1993,['United States of America'],"['Action', 'Action Comedy', 'Action/Adventure', 'Comedy', 'Comedy-drama']",1990,3
5109578,Witches of the Caribbean,2005,['United States of America'],"['Supernatural', 'B-movie', 'Horror']",2000,5
28222214,While I Live,1947,['United Kingdom'],"['Thriller', 'Drama']",1940,7
3828751,Houseboat Horror,1989,"['New Zealand', 'Australia']","['Monster movie', 'Slasher', 'Horror', 'B-movie']",1980,9
4650872,Disorganized Crime,1989,['United States of America'],"['Action', 'Crime Fiction', 'Gangster Film', 'Indie', 'Action/Adventure', 'Comedy', 'Thriller', 'Comedy of Errors', 'Parody']",1980,9
447074,The Wages of Fear,1953,"['France', 'Italy']","['Action', 'Psychological thriller', 'Thriller', 'World cinema', 'Film noir', 'Adventure', 'Drama', 'Suspense', 'Existentialism']",1950,3
3504129,Wheels on Meals,1984,['Hong Kong'],"['Adventure Comedy', 'Action', 'Martial Arts Film', 'Action Comedy', 'Comedy', 'Chinese Movies']",1980,4
13635649,Jaanam Samjha Karo,1999,['India'],"['Musical', 'Romantic drama', 'Bollywood', 'World cinema', 'Romance Film', 'Drama']",1990,9
5806720,The Quiet Earth,1985,"['New Zealand', 'Australia']","['Mystery', 'Indie', 'Thriller', 'World cinema', 'Apocalyptic and post-apocalyptic fiction', 'Disaster', 'Drama', 'Existentialism', 'Doomsday film', 'Science Fiction']",1980,5
21356182,Buried Alive,2007,[],"['Supernatural', 'Horror']",2000,7
492769,Kohtalon kirja,2003,['Finland'],['Horror'],2000,3
30815040,Against the Law,1997,[],"['Action', 'Crime Fiction', 'Action/Adventure', 'Western', 'Thriller', 'Drama']",1990,7
6724491,The Last Time I Saw Paris,1954,['United States of America'],"['Romantic drama', 'Romance Film', 'Melodrama', 'Drama']",1950,4
4139688,Terminal Velocity,1994,"['Canada', 'United States of America']","['Action', 'Spy', 'Action Thrillers', 'Action/Adventure', 'Thriller']",1990,4
23015747,The Matriarch,2007,['Finland'],"['Drama', 'Comedy film']",2000,7
12680019,…All the Marbles,1981,['United States of America'],"['Comedy-drama', 'Comedy', 'Drama']",1980,1
522735,Queen Emeraldas,1998,['Japan'],"['Animation', 'Japanese Movies', 'World cinema', 'Anime', 'Science Fiction', 'Fantasy']",1990,8
12913133,Mountain Family Robinson,1979,['United States of America'],"['Adventure', ""Children's"", 'Drama', 'Family Film']",1970,9
17274959,Riders to the Stars,1954,['United States of America'],"['Science Fiction', 'Adventure']",1950,4
2263255,Return of the Living Dead Part II,1988,['United States of America'],"['Parody', 'Satire', 'Comedy', 'Horror', 'Teen', 'Horror Comedy', 'Zombie Film']",1980,8
5844491,The Lady and the Monster,1944,['United States of America'],"['Science Fiction', 'Sci-Fi Horror', 'Horror']",1940,4
28302512,Fighting Trouble,1956,['United States of America'],"['Action', 'Adventure', 'Comedy film']",1950,6
3811830,You Made Me Crazy,2006,['India'],"['Musical', 'Romantic drama', 'Bollywood', 'World cinema', 'Romance Film', 'Drama']",2000,6
27758186,Find the Lady,1956,['United Kingdom'],['Comedy'],1950,6
4031328,Demon Under Glass,2002,['United States of America'],"['Horror', 'B-movie']",2000,2
142430,Fargo,1996,"['United Kingdom', 'United States of America']","['Neo-noir', 'Drama', 'Crime Fiction', 'Indie', 'Comedy', 'Thriller', 'Black comedy']",1990,6
5664795,The Hound of the Baskervilles,1939,['United States of America'],"['Film adaptation', 'Black-and-white', 'Mystery', 'Thriller', 'Crime Thriller', 'Drama']",1930,9
8260808,Napoléon,1955,"['France', 'Italy']",['Drama'],1950,5
2475248,Take This Job and Shove It,1981,['United States of America'],"['Workplace Comedy', 'Indie', 'Comedy', 'Romance Film', 'Romantic comedy', 'Comedy-drama']",1980,1
576341,The Matthew Shepard Story,2002,"['Canada', 'United States of America']","['Biopic [feature]', 'Docudrama', 'Drama', 'Courtroom Drama']",2000,2
7601466,Sukob,2006,['Philippines'],"['Filipino Movies', 'Horror', 'World cinema', 'Drama']",2000,6
2952395,Dangerous Beauty,1998,['United States of America'],"['Film adaptation', 'Romantic drama', 'Biographical film', 'Romance Film', 'Costume drama', 'Drama', 'Feminist Film', 'Period piece', 'Biopic [feature]']",1990,8
16874805,I Do,1921,['United States of America'],"['Silent film', 'Black-and-white', 'Short Film']",1920,1
223902,Klute,1971,['United States of America'],"['Detective fiction', 'Mystery', 'Thriller', 'Detective', 'New Hollywood', 'Crime Thriller', 'Drama']",1970,1
6061609,Dilli Ka Thug,1958,['India'],"['Black-and-white', 'Comedy', 'World cinema']",1950,8
27541690,Villa Amalia,2009,"['Switzerland', 'France']","['Feminist Film', 'World cinema', 'Drama', 'Slice of life story']",2000,9
29137992,While Parents Sleep,1935,['United Kingdom'],['Comedy film'],1930,5
1606173,Noel,2004,['United States of America'],"['Romantic drama', 'Romance Film', 'Christmas movie', 'Drama']",2000,4
12149364,The Borrowers,1997,"['United Kingdom', 'United States of America']","['Indie', 'Comedy', 'Family Film', 'Fantasy']",1990,7
3544709,Firstborn,1984,['United States of America'],"['Psychological thriller', 'Drama', 'Thriller']",1980,4
28796355,Gonks Go Beat,1965,['United Kingdom'],"['Musical', 'Comedy']",1960,5
36035782,Twists of Terror,1997,['Canada'],"['Thriller', 'Horror']",1990,7
31377787,Going Home,1971,[],['Drama'],1970,1
3060756,Babel,2006,"['France', 'Mexico', 'United States of America']","['Indie', 'Political drama', 'Drama']",2000,6
35708430,Wan Pipel,1976,['Netherlands'],['Drama'],1970,6
142426,Sense and Sensibility,1995,"['United Kingdom', 'United States of America']","['Period piece', 'Film adaptation', 'Romantic drama', 'Romance Film', 'Costume drama', 'Drama']",1990,5
2833429,Manjil Virinja Pookkal,1980,['India'],"['Musical', 'Romance Film', 'Drama']",1980,0
18571859,Hachiko: A Dog's Story,2009,"['United Kingdom', 'United States of America']","['Family Drama', 'Drama', 'Family Film']",2000,9
2169886,Executive Action,1973,['United States of America'],"['Action', 'Crime Fiction', 'Action/Adventure', 'Political drama', 'Drama', 'Political thriller']",1970,3
33382234,Fireman Save My Child,1954,['United States of America'],['Comedy film'],1950,4
5537826,Kamen Rider the First,2005,['Japan'],"['Action', 'Animation', 'Action/Adventure', 'Thriller', 'World cinema', 'Japanese Movies', 'Anime', 'Science Fiction']",2000,5
3546329,Alias Jesse James,1959,['United States of America'],"['Comedy Western', 'Screwball comedy', 'Action/Adventure', 'Western', 'Comedy']",1950,9
6691211,The Silent Enemy,1958,['United Kingdom'],"['Action', 'Biographical film', 'Historical fiction', 'War film']",1950,8
2239713,Johann Mouse,1953,['United States of America'],"['Adventure Comedy', 'Comedy']",1950,3
19174558,Flame in the Streets,1961,['United Kingdom'],['Drama'],1960,1
7245752,Ninja Over the Great Wall,1979,['Hong Kong'],"['Action/Adventure', 'World cinema', 'Chinese Movies', 'Martial Arts Film']",1970,9
1918678,Dead Reckoning,1947,['United States of America'],"['Black-and-white', 'Crime Fiction', 'Mystery', 'Thriller', 'Film noir', 'Crime Thriller', 'Drama', 'Suspense']",1940,7
7782424,Angel Rodriguez,2005,['United States of America'],"['Television movie', 'Indie', 'Drama']",2000,5
6667912,The Wild Life,1984,['United States of America'],"['Buddy film', 'Comedy', 'Teen', 'Drama', 'Ensemble Film']",1980,4
4392928,Death of a Dynasty,2005,['United States of America'],"['LGBT', 'Parody', 'Indie', 'Comedy', 'Biopic [feature]', 'Hip hop movies']",2000,5
5565346,Madeleine,1950,['United Kingdom'],"['Period piece', 'Crime Fiction', 'Docudrama', 'Drama', 'Courtroom Drama']",1950,0
23299075,A Tender Heart,1967,['South Korea'],['Drama'],1960,7
16751513,The Secret Life of Bees,2008,['United States of America'],"['Period piece', 'Film adaptation', 'Coming of age', 'Drama']",2000,8
2947481,Invincible,2001,"['United Kingdom', 'Germany', 'Ireland', 'United States of America']","['Period piece', 'Drama', 'Indie', 'Biography', 'World cinema', 'Political drama', 'War film']",2000,1
20868226,The Fox with Nine Tails,1994,['South Korea'],"[""Children's Fantasy"", ""Children's/Family"", 'Anime', 'Fantasy']",1990,4
7230206,The Proud and Profane,1956,['United States of America'],"['Period piece', 'Black-and-white', 'Romantic drama', 'Romance Film', 'Epic', 'War film', 'Drama']",1950,6
10631093,Trancers 6,2002,['United States of America'],"['Action', 'Action Thrillers', 'Action/Adventure', 'Science Fiction', 'Thriller']",2000,2
18998102,Un comisar acuză,1973,['Romania'],"['War film', 'Drama', 'Political thriller']",1970,3
22877662,Gallopin' Gals,1940,['United States of America'],"['Animation', 'Short Film', 'Comedy', 'Family Film']",1940,0
267848,Scarface,1983,['United States of America'],"['Action', 'Crime Fiction', 'Gangster Film', 'Action/Adventure', 'Thriller', 'Crime Thriller', 'Drama']",1980,3
24265023,Possessed,2009,['South Korea'],"['World cinema', 'Horror']",2000,9
13275998,Seeing the World,1927,['United States of America'],"['Black-and-white', 'Indie', 'Short Film', 'Comedy', 'Silent film', 'Family Film']",1920,7
22965595,Black Field,2009,['Canada'],"['History', 'Drama']",2000,9
661723,Change of Habit,1969,['United States of America'],"['Musical', 'Romantic drama', 'Musical Drama', 'Romance Film', 'Drama']",1960,9
53085,Toy Story,1995,['United States of America'],"['Animation', 'Comedy', 'Buddy film', 'Family-Oriented Adventure', ""Children's/Family"", 'Adventure', 'Computer Animation', ""Children's Fantasy"", 'Fantasy Comedy', 'Family Film', 'Fantasy']",1990,5
31692847,Minnunnathellam Ponnalla,1957,[],[],1950,7
28282337,Si Buta Lawan Jaka Sembung,1983,['Indonesia'],['Action'],1980,3
23257072,A Man Called Blade,1977,['Italy'],"['Action', 'Action/Adventure', 'Western', 'World cinema', 'Spaghetti Western']",1970,7
23715097,Minnaram,1994,['India'],"['Musical', 'Comedy', 'Bollywood', 'Drama']",1990,4
7291111,Venom,1982,['United Kingdom'],"['Horror', 'B-movie']",1980,2
4251465,Fido,2006,"['Canada', 'United States of America']","['Comedy', 'Horror Comedy', 'Romance Film', 'Zombie Film', 'Drama', 'Period piece', 'Parody', 'Horror']",2000,6
35764883,Iskandar,2003,['Malaysia'],"['Action', 'Romance Film']",2000,3
9883850,A Holiday Romance,1999,['United States of America'],"['Romantic drama', 'Comedy', 'Romance Film', 'Television movie', 'Drama']",1990,9
1044875,Back to School,1986,['United States of America'],['Comedy'],1980,6
23278047,Jaago,2004,['India'],"['Action/Adventure', 'Drama', 'World cinema']",2000,4
25951555,Paithrukam,1993,['India'],"['Drama', 'Family Film']",1990,3
15731192,L'homme est une femme comme les autres,1998,['France'],"['LGBT', 'Comedy', 'Romance Film', 'Romantic comedy']",1990,8
26244289,Snow White and the Three Stooges,1961,['United States of America'],"['Musical', 'Fairy tale', 'Comedy', ""Children's/Family"", 'Slapstick', 'Family Film', 'Fantasy']",1960,1
19522572,Pom Pom,1984,['Hong Kong'],"['Action', 'Chinese Movies', 'Comedy']",1980,4
7927833,Keane,2004,['United States of America'],"['Indie', 'Drama']",2000,4
19554764,Born Romantic,2000,['United Kingdom'],"['Indie', 'Comedy', 'Romance Film', 'Romantic comedy']",2000,0
24460880,The Beauty Prize,1924,['United States of America'],['Silent film'],1920,4
20066135,Lust for Gold,1949,['United States of America'],"['Western', 'Crime Fiction']",1940,9
17752353,L'ultima orgia del III Reich,1977,['Italy'],"['Sexploitation', 'Thriller', 'Horror', 'War film']",1970,7
19278375,Happy Anniversary and Goodbye,1974,['United States of America'],['Comedy film'],1970,4
4325320,Chaos,2001,['France'],"['Crime Fiction', 'Satire', 'Comedy', 'World cinema', 'Drama']",2000,1
24581122,Willie & Phil,1980,['United States of America'],"['Romance Film', 'Comedy', 'Drama']",1980,0
11922721,Phantoms,1998,['United States of America'],"['Film adaptation', 'Thriller', 'Horror', 'Science Fiction', 'Drama']",1990,8
13329416,Just Buried,2007,['Canada'],"['Indie', 'Comedy', 'Black comedy', 'Drama']",2000,7
11576690,Skylark,1993,['United States of America'],"['Drama', 'Comedy']",1990,3
22488519,Antarnaad,1991,['India'],['Art film'],1990,1
5992871,Curly Sue,1991,['United States of America'],"['Family Drama', 'Comedy', 'Melodrama', 'Drama', 'Family Film']",1990,1
29616495,Oridathoru Phayalwan,1981,['India'],['Drama'],1980,1
15078267,Vaishali,1988,['India'],"['Musical', 'Bollywood', 'World cinema', 'Drama']",1980,8
14609636,Three Pests in a Mess,1945,['United States of America'],"['Short Film', 'Black-and-white', 'Comedy']",1940,5
24407246,Barefoot Gen 2,1986,['Japan'],"['Action', 'Animation', 'Japanese Movies', 'Anime', 'War film', 'Drama']",1980,6
10131195,Going! Going! Gosh!,1952,['United States of America'],['Animated cartoon'],1950,2
7078738,The Swimmer,1968,['United States of America'],"['Film adaptation', 'Romantic drama', 'Romance Film', 'Drama', 'Tragedy']",1960,8
2001717,The Cutter,2005,['United States of America'],"['Action', 'Action Thrillers', 'Action/Adventure', 'Thriller', 'Martial Arts Film']",2000,5
20370033,Love Story,2008,['India'],"['Romance Film', 'Drama']",2000,8
9523372,Shukriya: Till Death Do Us Apart,2004,['India'],"['Romantic drama', 'World cinema', 'Romance Film', 'Drama']",2000,4
1115624,L'Amour fou,1969,['France'],['Drama'],1960,9
26292267,Carry On Pickpocket,1982,['Hong Kong'],"['Action', 'Action Comedy', 'Action/Adventure', 'Comedy', 'Crime Comedy', 'World cinema', 'Chinese Movies']",1980,2
3091175,Heavy Metal 2000,2000,"['Germany', 'United States of America', 'Canada']","['Action', 'Animation', 'Adventure', 'Science Fiction', 'Cult', 'Fantasy']",2000,0
9015881,Change of Heart,1934,['United States of America'],"['Romance Film', 'Black-and-white']",1930,4
1043108,I ♥ Huckabees,2004,"['Germany', 'United States of America']","['Surrealism', 'Drama', 'Indie', 'Comedy', 'Black comedy', 'Cult']",2000,4
5012787,Air Bud: Golden Receiver,1998,"['Canada', 'United States of America']","['Sports', 'Comedy', 'Animal Picture', ""Children's/Family"", ""Children's"", 'Family Film']",1990,8
2022113,The Sea Wolves,1980,['United Kingdom'],"['Action', 'Action/Adventure', 'Thriller', 'Adventure', 'War film', 'Drama']",1980,0
1072075,Scooby-Doo,2002,"['United States of America', 'Australia']","['Fantasy Adventure', 'Mystery', 'Comedy', 'Family-Oriented Adventure', ""Children's/Family"", 'Live action', 'Adventure', 'Fantasy Comedy', 'Family Film']",2000,2
1610321,White Zombie,1932,['United States of America'],"['Creature Film', 'Black-and-white', 'Indie', 'Horror', 'Zombie Film']",1930,2
9524916,In Old Santa Fe,1934,['United States of America'],"['Western', 'Black-and-white']",1930,4
3928484,Red Light,1949,['United States of America'],"['Film noir', 'Crime Fiction']",1940,9
3030263,Live Wire,1992,['United States of America'],"['Action', 'Drama', 'Action/Adventure', 'Thriller']",1990,2
23555063,Amreeka,2009,"['Kuwait', 'United States of America', 'Canada']","['Indie', 'Drama']",2000,9
5003508,The Syrian Bride,2004,"['Israel', 'France', 'Germany']","['Family Drama', 'Comedy', 'World cinema', 'Political drama', 'Drama']",2000,4
25194189,Uptown New York,1932,['United States of America'],"['Romance Film', 'Romantic drama', 'Drama']",1930,2
20825583,Showdown,1973,['United States of America'],"['Action', 'Drama', 'Crime Fiction', 'Action/Adventure', 'Western']",1970,3
2103388,Nora,2000,"['United Kingdom', 'Germany', 'Ireland', 'Italy']","['Indie', 'Drama']",2000,0
20580938,Talentime,2009,['Malaysia'],['Drama'],2000,9
22868781,Panneer Pushpangal,1981,['India'],['Romance Film'],1980,1
22285976,Devil's Angels,1967,['United States of America'],"['Action', 'Drama', 'Crime Fiction', 'Indie', 'Action/Adventure', 'Outlaw biker film']",1960,7
14168925,Total Corruption,1993,['United States of America'],"['Crime Fiction', 'Pornographic movie', 'Gay pornography', 'Drama']",1990,3
18940531,The Legion of the Condemned,1928,['United States of America'],['Silent film'],1920,8
13843818,Flavors,2004,['United States of America'],"['Comedy-drama', 'Comedy', 'Ensemble Film']",2000,4
6307083,The Fixer,1968,"['United Kingdom', 'United States of America']",['Biographical film'],1960,8
2251266,Ocean's Eleven,2001,['United States of America'],"['Action', 'Heist', 'Crime Fiction', 'Action/Adventure', 'Comedy', 'Thriller', 'Remake']",2000,1
8979709,Applause,1929,['United States of America'],"['Musical', 'Black-and-white', 'Pre-Code', 'Drama']",1920,9
30480836,Baby,2008,['United States of America'],"['Crime Fiction', 'Indie', 'Drama']",2000,8
1362383,Odd Couple,1979,['Hong Kong'],"['Chinese Movies', 'Martial Arts Film']",1970,9
8673987,Yeshwant,1997,['India'],"['Action', 'Crime Fiction', 'Drama']",1990,7
2296633,Waydowntown,2000,['Canada'],"['Indie', 'Comedy', 'Black comedy', 'Workplace Comedy']",2000,0
11977088,Chandni Chowk to China,2009,['India'],"['Musical', 'Comedy', 'Bollywood', 'World cinema', 'Martial Arts Film']",2000,9
5787216,And Starring Pancho Villa as Himself,2003,['United States of America'],"['Costume Adventure', 'Action/Adventure', 'Biographical film', 'Adventure', 'Drama', 'Western', 'Biopic [feature]', 'Television movie', 'Historical fiction', 'War film']",2000,3
7048192,Gaby,1956,['United States of America'],"['War film', 'Drama']",1950,6
3850349,House of Strangers,1949,['United States of America'],"['Black-and-white', 'Family Drama', 'Film noir', 'Drama']",1940,9
28204476,The Bowery Boys Meet the Monsters,1954,['United States of America'],"['Science Fiction', 'Comedy film', 'Horror']",1950,4
3783270,Jiang Hu,2004,"['China', 'Hong Kong']","['Action/Adventure', 'Thriller', 'World cinema', 'Chinese Movies']",2000,4
97734,Lilies of the Field,1963,['United States of America'],"['Drama', 'Comedy']",1960,3
26200434,Over the Hill,1992,"['New Zealand', 'Australia']","['Film adaptation', 'Drama', 'Romantic drama', 'Indie', 'World cinema', 'Romance Film']",1990,2
30878636,Sarvam Sakthimayam,1986,[],['Romance Film'],1980,6
954883,A Saintly Switch,1999,['United States of America'],"['Comedy', 'Domestic Comedy', 'Television movie', 'Family Film', 'Fantasy Comedy']",1990,9
3732855,Heartbeeps,1981,['United States of America'],"['Comedy', 'Romance Film', 'Romantic comedy', 'Science Fiction', 'Family Film']",1980,1
10398910,Four Frightened People,1934,['United States of America'],"['Black-and-white', 'Action/Adventure', 'Comedy', 'Thriller', 'Disaster', 'Adventure']",1930,4
5191439,One Missed Call,2008,"['Germany', 'United States of America', 'Japan']","['Psychological thriller', 'Mystery', 'Japanese Movies', 'Thriller', 'Horror', 'Supernatural']",2000,8
1859592,Pola X,1999,"['Switzerland', 'Japan', 'France', 'Germany']","['Art film', 'Japanese Movies', 'Romantic drama', 'World cinema', 'Romance Film', 'Drama']",1990,9
194664,The Flintstones,1994,['United States of America'],"['Crime Fiction', 'Comedy', 'Family-Oriented Adventure', ""Children's/Family"", 'Family Film', 'Fantasy']",1990,4
2302751,Camp,2003,['United States of America'],"['Musical', 'LGBT', 'Indie', 'Comedy', 'Drama']",2000,3
1707352,Baabul,2006,['India'],"['Musical', 'Bollywood', 'World cinema', 'Drama']",2000,6
21626526,Woh Chokri,1994,['India'],['Art film'],1990,4
19106328,Beyond the Curtain,1960,['United Kingdom'],"['Action', 'Adventure']",1960,0
843289,Babylon 5: The Gathering,1993,['United States of America'],"['Mystery', 'Adventure', 'Television movie', 'Whodunit', 'Science Fiction', 'Drama']",1990,3
11104355,Piccolo mondo antico,1941,['Italy'],['Drama'],1940,1
3903941,God Is Great and I'm Not,2001,['France'],"['Romantic drama', 'Comedy', 'World cinema', 'Romance Film', 'Drama', 'Romantic comedy', 'Religious Film', 'Comedy of manners']",2000,1
3237184,My Gun Is Quick,1957,['United States of America'],"['Film adaptation', 'Detective fiction', 'Crime Fiction', 'Mystery', 'Thriller', 'Crime Thriller', 'Drama', 'Detective']",1950,7
23795261,Puthiya Mukham,2009,['India'],['Action'],2000,9
19820692,The Little Mermaid,1968,['Soviet Union'],"['Animation', 'Short Film', 'Family Film']",1960,8
1316128,CB4,1993,['United States of America'],"['Parody', 'Comedy', 'Mockumentary', 'Hip hop movies']",1990,3
709490,Anchorman: The Legend of Ron Burgundy,2004,['United States of America'],"['Parody', 'Comedy', 'Media Satire', 'Romance Film', 'Workplace Comedy', 'Cult']",2000,4
24862569,The Snow Queen,1995,['United Kingdom'],"['Animation', 'Adventure', 'Family Film']",1990,5
18578336,Four Minutes,2006,['Germany'],"['LGBT', 'Drama', 'World cinema']",2000,6
5623405,Joseph,1995,"['Germany', 'United States of America', 'Italy']","['Christian film', 'Television movie', 'Epic', 'Costume drama', 'Adventure', 'Drama']",1990,5
23419800,The Blue Light,1932,"['Weimar Republic', 'Germany']","['Black-and-white', 'World cinema', 'Drama', 'Fantasy']",1930,2
18235376,Daffy Rents,1966,['United States of America'],"['Animation', 'Short Film', 'Family Film']",1960,6
26387200,Last of the Living,2008,"['New Zealand', 'Australia']","['Comedy', 'World cinema', 'Horror', 'Black comedy', 'Zombie Film', 'Cult']",2000,8
5106854,The Frightening,2002,['United States of America'],"['Psychological thriller', 'Slasher', 'Teen', 'Horror', 'B-movie']",2000,2
7397742,Calmi Couri Appassionati,2001,['Japan'],['Japanese Movies'],2000,1
4107637,Children of the Living Dead,2001,['United States of America'],"['Indie', 'Horror Comedy', 'Teen', 'Horror', 'Zombie Film']",2000,1
166186,Victim,1961,['United Kingdom'],"['LGBT', 'Crime Fiction', 'Drama']",1960,1
6030897,Une hirondelle a fait le printemps,2001,['France'],"['Comedy', 'Drama', 'World cinema']",2000,1
19250571,Fling,2008,['United States of America'],"['Romantic drama', 'Indie', 'Romance Film', 'Drama']",2000,8
4744688,Frankenstein: The True Story,1973,['United Kingdom'],"['Period piece', 'Monster', 'Horror', 'Television movie', 'Costume Horror', 'Sci-Fi Horror', 'Science Fiction']",1970,3
6809403,Unnai Ninaithu,2002,['India'],"['Romantic drama', 'World cinema', 'Romance Film', 'Drama']",2000,2
28069565,Daadagiri,1997,['India'],"['Action', 'Drama', 'Crime Fiction', 'Comedy film']",1990,7
289253,Grease 2,1982,['United States of America'],"['Musical', 'Comedy', 'Teen', 'Romance Film', 'Romantic comedy', 'Drama']",1980,2
22645043,Siberia,1998,['Netherlands'],"['Crime Fiction', 'Comedy', 'World cinema', 'Black comedy', 'Romance Film', 'Drama']",1990,8
5090323,Johny Mera Naam,1970,['India'],"['Action', 'Musical', 'Drama', 'Thriller', 'Family Film']",1970,0
24328926,Under the Boardwalk,1989,['United States of America'],"['Romance Film', 'Romantic drama', 'Drama']",1980,9
28427287,Hollywood,2002,['India'],['Science Fiction'],2000,2
873469,Harold & Kumar Go to White Castle,2004,"['Germany', 'United States of America', 'Canada']","['Stoner film', 'Buddy film', 'Comedy', 'Adventure', 'Slapstick', 'Cult']",2000,4
983731,Long Time Dead,2002,"['United Kingdom', 'France']","['Slasher', 'Teen', 'Horror', 'Supernatural']",2000,2
1046769,Speed 2: Cruise Control,1997,['United States of America'],"['Action', 'Action Thrillers', 'Action/Adventure', 'Thriller', 'Romance Film', 'Disaster']",1990,7
31939369,Yamanam,1992,[],['Drama'],1990,2
254274,The Ninth Configuration,1980,['United States of America'],"['Psychological thriller', 'Supernatural', 'Indie', 'Gothic Film', 'Comedy', 'Black comedy', 'Drama', 'Horror', 'Political drama']",1980,0
3200178,Splitting Heirs,1993,"['United Kingdom', 'United States of America']","['Indie', 'Comedy', 'Black comedy', 'Comedy of Errors']",1990,3
5690313,Avvaiyyar,1953,['India'],[],1950,3
22162922,I Wanted Wings,1941,['United States of America'],"['Romance Film', 'Black-and-white', 'Drama']",1940,1
16355097,Achamundu Achamundu,2009,"['India', 'United States of America']","['Thriller', 'Drama']",2000,9
1039561,Heavy Weights,1995,['United States of America'],"['Slapstick', 'Comedy', 'Comedy-drama', 'Family Film']",1990,5
3098399,Isle of Flowers,1989,['Brazil'],"['Short Film', 'Documentary']",1980,9
21984392,It's Never Too Late,1953,['Italy'],"['Comedy', 'Black-and-white']",1950,3
9375612,Blind Fury,1990,['United States of America'],"['Action', 'Action Thrillers', 'Action/Adventure', 'Comedy', 'Thriller', 'Martial Arts Film', 'Adventure']",1990,0
32811226,Within the Whirlwind,2009,[],"['Drama', 'World cinema']",2000,9
15732863,The Terrornauts,1967,['United Kingdom'],['Science Fiction'],1960,7
179044,The Jerk,1979,['United States of America'],"['Music', 'Screwball comedy', 'Comedy', 'Slapstick', 'Absurdism']",1970,9
5257171,Class of '44,1973,['United States of America'],"['Period piece', 'Coming of age', 'Romance Film', 'Comedy-drama', 'Drama']",1970,3
21776870,The Skywalk Is Gone,2002,"['Taiwan', 'France']","['Short Film', 'Comedy', 'Drama']",2000,2
14194356,At Ground Zero,1994,['United States of America'],"['Crime Fiction', 'Comedy', 'Adventure', 'Drama']",1990,4
14529906,Nishchaiy,1992,['India'],"['Action', 'Crime Fiction', 'Drama']",1990,2
9448041,El Fondo del Mar,2003,['Argentina'],"['Drama', 'Indie', 'Comedy', 'Thriller', 'World cinema', 'Black comedy']",2000,3
10619329,Zameer,1975,['India'],"['Action', 'Musical', 'Thriller', 'Bollywood', 'World cinema', 'Drama', 'Family Film']",1970,5
16113015,Stella Dallas,1937,['United States of America'],"['Black-and-white', 'Drama']",1930,7
20060327,Dear Mr. Wonderful,1982,"['Germany', 'United States of America', 'West Germany']","['Crime Fiction', 'Comedy', 'World cinema', 'Drama']",1980,2
32109227,The Last Message,1975,[],['Comedy film'],1970,5
1840775,White Oleander,2002,['United States of America'],"['Film adaptation', 'Coming of age', 'Melodrama', 'Drama']",2000,2
24165826,Arena,1953,['United States of America'],"['Sports', 'Western', 'Drama']",1950,3
4290703,The Gamers,2002,['United States of America'],"['Indie', 'Short Film', 'Comedy', 'Adventure', 'Fantasy']",2000,2
1419848,Lost in America,1985,['United States of America'],"['Parody', 'Satire', 'Comedy', 'Comedy of manners', 'Black comedy', 'Road movie']",1980,5
5179684,Khud-daar,1982,['India'],"['Action', 'Drama', 'Family Film']",1980,2
11682101,Space Chimps,2008,['United States of America'],"['Computer Animation', 'Animation', 'Comedy', 'Animal Picture', ""Children's/Family"", 'Adventure', 'Family Film']",2000,8
1835620,Something's Got to Give,1962,['United States of America'],['Short Film'],1960,2
27515609,Monday or Tuesday,1966,"['Yugoslavia', 'Socialist Federal Republic of Yugoslavia']",['Drama'],1960,6
4494486,El ministro y yo,1975,['Mexico'],"['Comedy', 'Comedy-drama']",1970,5
4596922,A Short Film About John Bolton,2003,['United Kingdom'],"['Biography', 'Indie', 'Comedy', 'Documentary', 'Black comedy', 'Mockumentary', 'Short Film', 'Graphic & Applied Arts']",2000,3
15172134,A Good Man in Africa,1994,"['United States of America', 'South Africa']","['Film adaptation', 'Comedy', 'Political drama', 'Drama']",1990,4
18023592,Innathe Chintha Vishayam,2008,['India'],"['Musical', 'Bollywood', 'World cinema', 'Drama']",2000,8
5424460,Stanley and Livingstone,1939,['United States of America'],"['British Empire Film', 'Biopic [feature]', 'Adventure', 'Drama']",1930,9
24645237,One 4 All,1999,['France'],"['Romance Film', 'Comedy']",1990,9
3055220,And the Angels Sing,1944,['United States of America'],"['Musical', 'Black-and-white', 'Comedy']",1940,4
6298192,Song of Russia,1944,['United States of America'],"['War film', 'Propaganda film', 'Drama']",1940,4
1609051,Afghan Breakdown,1991,"['Soviet Union', 'Italy']",['War film'],1990,1
25903505,Chalo America,1999,['India'],['Comedy'],1990,9
1588096,Dream On!,1981,['United States of America'],['Drama'],1980,1
406704,Chinese Box,1997,"['France', 'Japan', 'United States of America']","['Drama', 'Indie', 'Japanese Movies', 'Romantic drama', 'Romance Film', 'Melodrama', 'Political drama']",1990,7
12674076,Avanim,2004,"['Israel', 'France', 'United States of America']","['Indie', 'Drama', 'World cinema']",2000,4
31976274,Blood and Lace,1971,['United States of America'],['Horror'],1970,1
3082124,Light Sleeper,1992,['United States of America'],"['Crime Fiction', 'Crime Drama', 'Addiction Drama', 'Drama']",1990,2
1333732,Brave,1994,['United Kingdom'],"['Musical', 'Indie', 'Thriller', 'Experimental film']",1990,4
23675899,The Secret Rapture,1993,['United Kingdom'],"['Family Drama', 'Thriller', 'Romance Film', 'Drama']",1990,3
534751,Bad Taste,1987,"['New Zealand', 'Australia']","['Comedy', 'Horror Comedy', 'World cinema', 'Black comedy', 'Splatter film', 'Horror', 'B-movie', 'Alien Film', 'Science Fiction', 'Cult']",1980,7
11020749,A Witch's Tangled Hare,1959,['United States of America'],['Animation'],1950,9
6487068,"Clear Cut: The Story of Philomath, Oregon",2006,['United States of America'],"['Social issues', 'Indie', 'Documentary', 'Political drama', 'Culture & Society']",2000,6
13895355,For Your Height Only,1981,['Philippines'],"['Action', 'Filipino Movies', 'Spy', 'Parody', 'Comedy', 'Martial Arts Film']",1980,1
187636,Mogambo,1953,['United States of America'],"['Romance Film', 'Adventure', 'Drama']",1950,3
1336108,Bride of Re-Animator,1990,['United States of America'],"['Comedy', 'Horror Comedy', 'Horror', 'Zombie Film', 'Sci-Fi Horror', 'Science Fiction', 'Cult']",1990,0
1924820,The Seinfeld Chronicles,1989,['United States of America'],"['Short Film', 'Comedy']",1980,9
22578500,Prince Yeonsan,1961,['South Korea'],"['Historical drama', 'History']",1960,1
36567002,Tip on a dead jockey,1957,['United States of America'],"['Drama', 'Crime Fiction']",1950,7
2799874,Keeping Mum,2005,['United Kingdom'],"['Black comedy', 'Comedy']",2000,5
31199884,Indian,2001,[],"['Action', 'Drama', 'Crime Fiction', 'Thriller']",2000,1
2807368,Horror Express,1973,['United Kingdom'],"['Science Fiction', 'Horror', 'B-movie', 'Alien Film', 'Cult']",1970,3
142463,Life Is Beautiful,1997,['Italy'],"['Comedy film', 'Romance Film', 'War film', 'Drama']",1990,7
25990620,Tora-san Goes Religious?,1983,['Japan'],['Japanese Movies'],1980,3
3738820,Mother of Mine,2005,"['Finland', 'Sweden']","['Drama', 'World cinema']",2000,5
19024755,Achilles and the Tortoise,2008,['Japan'],"['Japanese Movies', 'Drama', 'World cinema']",2000,8
20924409,Madam Oh,1965,['South Korea'],['Drama'],1960,5
5566931,Three Ages,1923,['United States of America'],"['Black-and-white', 'Indie', 'Comedy', 'Drama', 'Parody', 'Silent film', 'Romantic comedy', 'Epic', 'Fantasy']",1920,3
30464659,Burma Rani,1945,[],['Action'],1940,5
14700543,Bhootayyana Maga Ayyu,1974,['India'],['Drama'],1970,4
10555625,Victoria No. 203,1972,['India'],"['Bollywood', 'World cinema']",1970,2
34992166,The Journalist,1979,['Australia'],['Comedy film'],1970,9
5216472,Claire's Knee,1971,['France'],"['Art film', 'Romantic drama', 'Comedy of manners', 'World cinema', 'Romance Film', 'Comedy-drama', 'Drama']",1970,1
8031432,The Curious Case of Benjamin Button,2008,['United States of America'],"['Film adaptation', 'Mystery', 'Romantic drama', 'Fantasy Drama', 'Romance Film', 'Drama', 'Period piece', 'Fantasy']",2000,8
2150615,Teenage Mutant Ninja Turtles II: The Secret of the Ooze,1991,"['Hong Kong', 'Japan', 'United States of America']","['Action', 'Superhero', 'Indie', 'Action/Adventure', 'Comedy', 'Chinese Movies', 'Martial Arts Film', 'Japanese Movies', 'Action Comedy', 'Superhero movie', 'Family Film']",1990,1
21103667,The Rainbow Thief,1990,['United Kingdom'],"['Drama', 'Fantasy']",1990,0
35114850,Flowers from Another World,1999,['Spain'],"['Romantic drama', 'Comedy film', 'World cinema', 'Romance Film', 'Romantic comedy', 'Drama']",1990,9
11192670,Al's Lads,2001,['United Kingdom'],"['Period piece', 'Crime Fiction', 'Gangster Film', 'Indie', 'Drama']",2000,1
6251539,The Canterville Ghost,1944,['United States of America'],"['Black-and-white', 'Costume drama', 'Comedy']",1940,4
8355871,The Adventures of Tom Thumb and Thumbelina,2002,['United States of America'],"[""Children's Fantasy"", 'Animation', 'Animated Musical', ""Children's/Family"", 'Adventure', 'Family Film']",2000,2
24720604,Boni,2009,['India'],"['Action', 'Comedy', 'Romance Film', 'Adventure']",2000,9
5276632,Pauline at the Beach,1983,['France'],"['Comedy', 'World cinema']",1980,3
4046725,Nowhere to Run,1993,['United States of America'],"['Action', 'Action/Adventure', 'Thriller']",1990,3
13899957,Conquest,1983,"['Spain', 'Mexico', 'Italy']","['Action/Adventure', 'World cinema', 'Adventure', 'Horror', 'Sword and sorcery', 'Supernatural', 'Science Fiction', 'Fantasy']",1980,3
262465,Mad Max 2: The Road Warrior,1981,['Australia'],"['Action', 'LGBT', 'Indie', 'Thriller', 'World cinema', 'Apocalyptic and post-apocalyptic fiction', 'Adventure', 'Dystopia', 'Road movie', 'Science Fiction']",1980,1
6057960,Sri Ramadasu,2006,['India'],"['Drama', 'World cinema']",2000,6
5261530,Carter’s Army,1970,['United States of America'],"['Suspense', 'Action/Adventure', 'War film']",1970,0
16439424,Funny Man,1994,['United Kingdom'],"['Slasher', 'Horror Comedy', 'Horror']",1990,4
17929573,Wish Upon a Star,1996,['United States of America'],"[""Children's Fantasy"", 'Coming of age', 'Comedy', 'Teen', ""Children's/Family"", 'Fantasy Comedy', 'Family Film']",1990,6
6245744,On Broadway,2007,['United States of America'],"['Drama', 'Family Drama', 'Indie', 'Romantic drama', 'Romance Film', 'Family Film']",2000,7
31485693,Nagaravadhu,2001,[],"['Action', 'Drama', 'Crime Fiction', 'Bollywood']",2000,1
1131961,Dead End,2003,"['France', 'United States of America']","['Mystery', 'Comedy', 'Thriller', 'Horror', 'Road-Horror', 'Supernatural']",2000,3
27914668,Twin Sitters,1994,['United States of America'],"['Slapstick', 'Comedy', 'Thriller', 'Family Film']",1990,4
32020596,High Rolling in a Hot Corvette,1977,[],"['Action', 'Crime Fiction', 'Action/Adventure', 'Buddy film', 'Comedy', 'World cinema', 'Action Comedy', 'Comedy film', 'Road movie']",1970,7
11126051,Kuntilanak,2006,['Indonesia'],['Horror'],2000,6
13701844,Micro-Phonies,1945,['United States of America'],"['Black-and-white', 'Short Film', 'Comedy', 'Slapstick']",1940,5
423372,Wild Things,1998,['United States of America'],"['Neo-noir', 'LGBT', 'Crime Fiction', 'Mystery', 'Thriller', 'Crime Thriller', 'Suspense', 'Erotic thriller']",1990,8
22610435,Prince Daewon,1968,['South Korea'],"['Historical drama', 'Drama']",1960,8
12230323,Wild Child,2008,"['United Kingdom', 'France', 'United States of America']","['Comedy', 'Teen', 'Romance Film', 'Drama']",2000,8
9541497,In Bruges,2008,"['Belgium', 'United Kingdom', 'Ireland', 'United States of America']","['Action', 'Crime Fiction', 'Action/Adventure', 'Comedy', 'Thriller', 'Buddy film', 'Black comedy', 'Crime Thriller', 'Drama', 'Crime Drama', 'Comedy-drama']",2000,8
1889426,Kiss Kiss Bang Bang,2005,['United States of America'],"['Action', 'Neo-noir', 'LGBT', 'Crime Fiction', 'Mystery', 'Action/Adventure', 'Comedy', 'Thriller', 'Film noir', 'Black comedy', 'Crime Thriller', 'Parody', 'Detective']",2000,5
878974,Kronos,1957,['United States of America'],"['Black-and-white', 'Monster', 'Alien invasion', 'Alien Film', 'Science Fiction', 'Cult']",1950,7
15538307,Murder on a Honeymoon,1935,['United States of America'],"['Black-and-white', 'Detective fiction', 'Mystery', 'Comedy', 'Detective', 'Whodunit']",1930,5
26429769,Warhead,1977,['United States of America'],"['Action', 'War film', 'Adventure']",1970,7
18123554,New York Town,1941,['United States of America'],['Comedy'],1940,1
22759895,Bama Vijayam,1967,['India'],"['Comedy', 'World cinema']",1960,7
909577,Love and Anarchy,1973,['Italy'],"['Political satire', 'World cinema', 'Comedy-drama', 'Tragicomedy', 'Political drama', 'Drama']",1970,3
2831557,Xtro,1983,"['United Kingdom', 'United States of America']","['Creature Film', 'Science Fiction', 'Horror', 'Alien Film', 'Sci-Fi Horror']",1980,3
330,Actrius,1996,['Spain'],"['Comedy-drama', 'Drama']",1990,6
17980259,Strictly Dishonorable,1951,['United States of America'],"['Comedy', 'Black-and-white']",1950,1
8863891,When the Wind Blows,1986,['United Kingdom'],"['Drama', 'Doomsday film', 'War film']",1980,6
7077690,Narendra Makan Jayakanthan Vaka,2001,['India'],"['Drama', 'Comedy', 'Bollywood']",2000,1
26057620,5 Branded Women,1960,"['Italy', 'United States of America']","['War film', 'Drama']",1960,0
9980905,College,2008,['United States of America'],['Comedy'],2000,8
168498,Starman,1984,['United States of America'],"['Romantic fantasy', 'Romantic drama', 'Romance Film', 'Road movie', 'Science Fiction', 'Drama', 'Fantasy']",1980,4
6196826,Treasure Island,1950,"['United Kingdom', 'United States of America']","['Costume drama', 'Adventure', 'Drama', 'Family Film']",1950,0
11463357,The Secret Ways,1961,['United States of America'],"['Action', 'Spy', 'Black-and-white', 'Adventure', 'Drama']",1960,1
7169030,Children of Divorce,1927,['United States of America'],"['Silent film', 'Black-and-white', 'Indie']",1920,7
3222136,Alvin and the Chipmunks Meet Frankenstein,1999,['United States of America'],"['Animation', 'Family Film', 'Horror']",1990,9
2772657,Daddy-O,1958,['United States of America'],"['Action', 'Black-and-white', 'Drama', 'Crime Fiction', 'Adventure']",1950,8
3761238,The Bedroom Window,1987,['United States of America'],"['Psychological thriller', 'Suspense', 'Mystery', 'Thriller', 'Erotic thriller', 'Crime Thriller']",1980,7
11378430,The Mouse on the Moon,1963,['United Kingdom'],"['Film adaptation', 'Political cinema', 'Parody', 'Comedy', ""Children's/Family"", 'Drama', 'Family Film']",1960,3
6935276,The Sheepman,1958,['United States of America'],"['Western', 'Comedy']",1950,8
2150352,Bobby,1973,['India'],"['Musical', 'Romantic drama', 'Bollywood', 'World cinema', 'Romance Film', 'Drama']",1970,3
6013531,The Old Man of the Mountain,1933,['United States of America'],"['Musical', 'Black-and-white', 'Short Film']",1930,3
34398592,Asuravithu,1968,[],['Action'],1960,8
27875557,Fascination,1979,['France'],"['World cinema', 'Horror']",1970,9
1326068,Fiza,2000,['India'],"['Drama', 'Bollywood', 'World cinema']",2000,0
142456,Good Will Hunting,1997,['United States of America'],"['Coming of age', 'Romantic drama', 'Indie', 'Romance Film', 'Drama']",1990,7
1311098,Short Circuit 2,1988,['United States of America'],"['Action', 'Crime Fiction', 'Action/Adventure', 'Comedy', 'Science Fiction', 'Family Film']",1980,8
1980268,The Girls of Pleasure Island,1953,['United States of America'],"['Romantic drama', 'Comedy', 'Romance Film', 'Romantic comedy', 'Drama']",1950,3
25451763,Dhairyavanthudu,1986,['India'],['Drama'],1980,6
30885658,Moran of the Lady Letty,1922,[],['Silent film'],1920,2
24837554,Thrill of a Romance,1945,['United States of America'],"['Musical', 'Comedy', 'Romance Film', 'Romantic comedy']",1940,5
9424571,Bidaya wa nihaya,1960,['Egypt'],['Drama'],1960,0
20259200,Killer Bees,1974,['United States of America'],"['Horror', 'Science Fiction']",1970,4
32269433,Main Tera Dushman,1989,[],"['Action', 'Crime Fiction', 'Thriller', 'Adventure']",1980,9
2414288,Now You See It...,2005,['United States of America'],"['Comedy', ""Children's/Family"", 'Drama', 'Fantasy']",2000,5
3569822,A Beautiful Mind,2001,['United States of America'],"['Psychological thriller', 'Biography', 'Romantic drama', 'Biographical film', 'Romance Film', 'Drama', 'Period piece', 'Marriage Drama', 'Biopic [feature]']",2000,1
30984089,Nowhere to Hide,1987,"['Canada', 'United States of America']","['Action', 'Thriller']",1980,7
2797638,Holiday in the Sun,2001,['United States of America'],"['Comedy', 'Teen', ""Children's/Family"", 'Adventure', 'Family Film']",2000,1
1364187,The Westerner,1940,['United States of America'],"['Western', 'Black-and-white', 'Action/Adventure']",1940,0
2806249,Homo Erectus,2006,['United States of America'],['Comedy'],2000,6
2566991,Hey Ram,2000,['India'],"['Bollywood', 'World cinema', 'Historical fiction', 'Drama']",2000,0
29850091,Numbri Aadmi,1991,['India'],"['Action', 'Crime Fiction', 'Drama']",1990,1
407293,The Fast and the Furious,1955,['United States of America'],"['Action', 'Crime Fiction', 'Mystery', 'Action/Adventure', 'Detective', 'Drama']",1950,5
28347040,Born Lucky,1933,['United Kingdom'],['Musical'],1930,3
2588741,Outrageous!,1977,['Canada'],"['LGBT', 'Comedy', 'Cult']",1970,7
5520359,Good Times,1967,['United States of America'],"['Musical', 'Comedy', 'Fantasy']",1960,7
2223585,Earth,1998,"['Canada', 'India']","['Crime Fiction', 'Art film', 'Romantic drama', 'Bollywood', 'World cinema', 'Political drama', 'Romance Film', 'Drama', 'Period piece', 'War film']",1990,8
36356804,Nadie oyó gritar,1973,['Spain'],['Horror'],1970,3
35365357,"I'm Taraneh, 15",2002,['Iran'],['Drama'],2000,2
5819565,The Great Garrick,1937,['United States of America'],"['Black-and-white', 'Comedy', 'Romance Film', 'Romantic comedy']",1930,7
469932,Robin and the Seven Hoods,1964,['United States of America'],"['Action', 'Musical', 'Crime Fiction', 'Gangster Film', 'Comedy', 'Musical comedy', 'Heist', 'Crime Comedy']",1960,4
31234125,The Seven Red Berets,1969,[],"['Action', 'Drama']",1960,9
16258940,Aaja Nachle,2007,['India'],"['Musical', 'Romantic drama', 'Musical Drama', 'Bollywood', 'World cinema', 'Romance Film', 'Drama']",2000,7
12638350,Luxury Car,2006,"['China', 'France']","['Crime Fiction', 'World cinema', 'Chinese Movies', 'Drama']",2000,6
29503032,Cattle King,1963,['United States of America'],['Western'],1960,3
22146286,The Abduction Club,2002,"['United Kingdom', 'France', 'Germany', 'Ireland']","['Romance Film', 'Romantic comedy', 'Comedy-drama', 'Drama']",2000,2
68108,All That Heaven Allows,1955,['United States of America'],"['Romantic drama', 'Romance Film', 'Melodrama', 'Drama']",1950,5
24740489,Dying to Belong,1997,['United States of America'],"['Suspense', 'Mystery', 'Thriller', 'Drama']",1990,7
313885,Boys' Night Out,1962,['United States of America'],"['Comedy', 'Satire', 'Romance Film', 'Romantic comedy']",1960,2
18788912,Whatever Works,2009,"['United States of America', 'France']","['Indie', 'Comedy', 'Comedy of manners', 'Romance Film', 'Romantic comedy']",2000,9
30872068,Tea Over Rice,1952,['Japan'],"['Japanese Movies', 'Drama']",1950,2
24531271,Steel Frontier,1995,['United States of America'],"['Action', 'Action/Adventure', 'Hybrid Western', 'Western', 'Science Fiction']",1990,5
9667585,King,2002,['India'],['Drama'],2000,2
19758454,The New Pupil,1940,['United States of America'],"['Black-and-white', 'Short Film', 'Comedy', 'Family Film']",1940,0
5502313,The Tale of the Fox,1937,['France'],"['Black-and-white', 'Animation', 'Stop motion']",1930,7
10640380,Panakkaran,1990,['India'],['Drama'],1990,0
1439597,Doug's 1st Movie,1999,['United States of America'],"['Animation', 'Comedy', 'Teen', ""Children's/Family"", ""Children's""]",1990,9
25757227,Edge of Eternity,1959,['United States of America'],"['Action Thrillers', 'Western', 'Adventure']",1950,9
8569317,Righting Wrongs,1986,['Hong Kong'],"['Action', 'Chinese Movies', 'Martial Arts Film']",1980,6
244752,Waking Life,2001,['United States of America'],"['Animation', 'Mystery', 'Avant-garde', 'Experimental film', 'Fantasy', 'Drama', 'Ensemble Film']",2000,1
689969,Election,1999,['United States of America'],"['Political cinema', 'Drama', 'Indie', 'Satire', 'Comedy', 'Black comedy']",1990,9
17181831,Delightful Forest,1972,['Hong Kong'],"['Action', 'Action/Adventure', 'World cinema', 'Chinese Movies', 'Martial Arts Film']",1970,2
2332890,Les Patterson Saves the World,1987,['Australia'],['Comedy'],1980,7
26704454,My Old Dutch,1934,['United Kingdom'],['Drama'],1930,4
22456352,Chetniks! The Fighting Guerrillas,1943,['United States of America'],['War film'],1940,3
10239839,Knife Edge,2009,['United Kingdom'],"['Suspense', 'Psychological thriller', 'Mystery', 'Thriller', 'Horror', 'Crime Thriller', 'Supernatural']",2000,9
22116336,Cheriyachante Kroorakrithyangal,1979,['India'],['Crime Fiction'],1970,9
11057357,Dhanwan,1993,['India'],['Romance Film'],1990,3
19837950,Fortunat,1960,"['France', 'Italy']","['War film', 'Comedy']",1960,0
10591973,Ekhrajiha,2007,['Iran'],['War film'],2000,7
34453923,Kochi Rajavu,2005,['India'],"['Action', 'Crime Fiction', 'Comedy', 'Comedy film']",2000,5
16794046,The Greeks Had a Word for Them,1932,['United States of America'],"['Black-and-white', 'Pre-Code', 'Comedy']",1930,2
2058214,My Baby's Daddy,2004,['United States of America'],"['Domestic Comedy', 'Comedy']",2000,4
1312526,My Father the Hero,1991,['France'],"['Drama', 'Comedy']",1990,1
1633134,Shadowlands,1993,['United Kingdom'],"['Period piece', 'Romantic drama', 'Biography', 'Romance Film', 'Drama']",1990,3
10095763,Great Balls of Fire!,1989,['United States of America'],"['Period piece', 'Biography', 'Comedy', 'Biopic [feature]', 'Biographical film', 'Docudrama', 'Drama']",1980,9
11026652,Pazhassi Raja,2009,['India'],['Historical fiction'],2000,9
28238282,Mickey's Northwest Mounted,1929,['United States of America'],['Short Film'],1920,9
20117565,Indian Summer,1993,"['Canada', 'United States of America']","['Indie', 'Comedy', 'Drama']",1990,3
18600186,Wild Geese Calling,1941,['United States of America'],"['Historical fiction', 'Adventure', 'Drama']",1940,1
1353671,Chalte Chalte,2003,['India'],"['Musical', 'Romantic drama', 'Bollywood', 'World cinema', 'Romance Film', 'Drama']",2000,3
10644435,Pojkarna på Storholmen,1932,['Sweden'],"['Comedy', 'Black-and-white']",1930,2
3703666,The Invisible,2007,"['Canada', 'United States of America']","['Psychological thriller', 'Thriller', 'Teen', 'Crime Thriller', 'Supernatural', 'Drama', 'Fantasy']",2000,7
2122948,The Life and Death of Peter Sellers,2004,"['United Kingdom', 'United States of America']","['Biography', 'Comedy', 'Biopic [feature]', 'Biographical film', 'Comedy-drama', 'Drama']",2000,4
24961905,Project Shadowchaser,1992,['United States of America'],"['Action', 'Science Fiction']",1990,2
2571348,Last Holiday,2006,['United States of America'],"['Comedy', 'Romance Film', 'Romantic comedy', 'Adventure', 'Drama']",2000,6
695700,25th Hour,2002,['United States of America'],"['Crime Drama', 'Crime Fiction', 'Drama']",2000,2
28324750,Duel of Hearts,1991,['United Kingdom'],"['Mystery', 'Thriller', 'Romance Film', 'Drama']",1990,1
3843778,Happy Ero Christmas,2003,['South Korea'],"['Romance Film', 'Comedy', 'Comedy film']",2000,3
4947802,Keeper of the Flame,1942,['United States of America'],"['Black-and-white', 'Mystery', 'Thriller', 'Film noir', 'Drama']",1940,2
9687588,Basti,2003,['India'],"['Action', 'Drama', 'Crime Fiction', 'Action/Adventure', 'World cinema']",2000,3
1618008,Dark Water,2002,['Japan'],"['Japanese Movies', 'Thriller', 'Horror', 'World cinema']",2000,2
17610036,Bombs Over Burma,1943,['United States of America'],"['Action', 'Black-and-white', 'Action/Adventure', 'Adventure', 'Propaganda film', 'War film', 'Drama']",1940,3
5468241,The Plainsman,1936,['United States of America'],"['Black-and-white', 'Western', 'Biographical film', 'Action/Adventure']",1930,6
5290892,Bloody Mama,1970,['United States of America'],"['Action', 'Crime Fiction', 'Gangster Film', 'Indie', 'Family Drama', 'Action/Adventure', 'Drama', 'Period piece', 'Crime Drama']",1970,0
3539355,The Empress Dowager,1975,['Hong Kong'],['Chinese Movies'],1970,5
4333681,A Bucket of Blood,1959,['United States of America'],"['Satire', 'Comedy film', 'Horror', 'Black comedy', 'B-movie']",1950,9
6878478,Driftwood,2006,['United States of America'],"['Indie', 'Thriller', 'Horror', 'Crime Thriller', 'Supernatural']",2000,6
4791383,Princess Daisy,1983,['United States of America'],"['Melodrama', 'Drama']",1980,3
8229935,Diamonds,1999,"['Germany', 'United States of America']","['Sports', 'Drama']",1990,9
18264961,Assault and Peppered,1965,['United States of America'],"['Short Film', 'Family Film']",1960,5
4133151,Sleepaway Camp 2,1988,['United States of America'],"['Comedy horror', 'Indie', 'Slasher', 'Teen', 'Horror']",1980,8
236497,Knighty Knight Bugs,1958,['United States of America'],"['Animation', 'Short Film', 'Comedy']",1950,8
16812698,Colleen,1936,['United States of America'],"['Musical', 'Black-and-white']",1930,6
15007742,Victory,2008,['India'],"['Musical', 'Bollywood', 'World cinema', 'Drama']",2000,8
3605117,Aradhana,1969,['India'],"['Musical', 'Bollywood', 'World cinema', 'Drama']",1960,9
5865997,Le fantôme de la liberté,1974,"['France', 'Italy']","['Surrealism', 'Art film', 'Comedy', 'World cinema', 'Drama']",1970,4
29586711,High Barbaree,1947,['United States of America'],"['Action', 'Drama']",1940,7
221858,Ashes of Time,1994,"['Hong Kong', 'Taiwan', 'China']","['Period piece', 'Costume Adventure', 'Wuxia', 'Chinese Movies', 'Martial Arts Film', 'Adventure']",1990,4
17996335,What's Your Raashee?,2009,['India'],"['Musical', 'Romantic drama', 'Comedy', 'Bollywood', 'World cinema', 'Romance Film', 'Drama', 'Romantic comedy']",2000,9
18472209,The Dove,1968,['United States of America'],"['Parody', 'Short Film', 'Comedy']",1960,8
32038442,Unnaruge Naan Irundhal,2000,['India'],['Comedy film'],2000,0
21012980,Exo oi kleftes,1961,['Greece'],['Comedy'],1960,1
1646358,Godzilla vs. Megaguirus,2000,['Japan'],"['Creature Film', 'Action', 'Japanese Movies', 'Monster', 'World cinema', 'Science Fiction', 'Cult']",2000,0
17014422,"Exit the Dragon, Enter the Tiger",1976,"['Hong Kong', 'Taiwan']","['Action', 'Crime Fiction', 'Drama']",1970,6
5113496,Sachaa Jhutha,1970,['India'],"['Action', 'Musical', 'Crime Fiction', 'Action/Adventure', 'Comedy', 'Bollywood', 'World cinema']",1970,0
8591538,Abu Zayd al-Hilali,1947,['Egypt'],[],1940,7
3332816,Kasoor,2001,['India'],"['Suspense', 'Thriller', 'Bollywood']",2000,1
20204625,Grampy's Indoor Outing,1936,[],"['Animation', 'Short Film', 'Comedy']",1930,6
1341089,Swades,2004,['India'],"['Musical', 'Musical Drama', 'Drama']",2000,4
11141613,Tops with Pops,1957,[],"[""Children's/Family""]",1950,7
6807441,Catch the black sunshine,1972,['United States of America'],"['Action', 'Indie', 'Drama']",1970,2
6954778,Raja Vikramarka,1990,['India'],"['Action', 'Comedy', 'Family Film']",1990,0
8763366,Jekyll and Hyde... Together Again,1982,['United States of America'],"['Parody', 'Comedy']",1980,2
1918683,Return of the Killer Tomatoes,1988,['United States of America'],"['Parody', 'Horror', 'Adventure', 'Science Fiction']",1980,8
17922555,Tri Sestry,1994,"['Russia', 'Germany']",['Drama'],1990,4
12355679,Sabrina Goes to Rome,1998,['United States of America'],"['Comedy', 'Teen', 'Comedy-drama', 'Fantasy']",1990,8
6708252,Kong Island,1968,['Italy'],"['Horror', 'Science Fiction']",1960,8
33842844,Raw Deal,1977,['Australia'],['Western'],1970,7
16198418,Dirt Merchant,1999,['United States of America'],"['Drama', 'Mystery', 'Indie', 'Comedy Thriller', 'Thriller', 'Comedy', 'Crime Thriller']",1990,9
4110734,Henry Fool,1997,['United States of America'],"['Indie', 'Comedy', 'Black comedy', 'Romance Film', 'Drama', 'Domestic Comedy', 'Melodrama', 'Comedy-drama']",1990,7
26067636,Jungle Boy,1998,"['India', 'United States of America']","['Adventure', 'Family Film', 'Fantasy']",1990,8
25081004,One Spy Too Many,1966,['United States of America'],"['Action', 'Spy', 'Adventure']",1960,6
265891,The Great Race,1965,['United States of America'],"['Action', 'Adventure Comedy', 'Musical', 'Costume Adventure', 'Comedy', 'Romance Film', 'Slapstick', 'Adventure', 'Parody', 'Sports', 'Family Film', 'Ensemble Film']",1960,5
6577108,The Seven-Ups,1973,['United States of America'],"['Action', 'Detective fiction', 'Crime Fiction', 'Mystery', 'Action/Adventure', 'Thriller', 'Crime Thriller', 'Detective']",1970,3
10197031,Murugaa,2007,['India'],['Romance Film'],2000,7
5736981,I Got the Hook Up,1998,['United States of America'],"['Action', 'Crime Fiction', 'Action/Adventure', 'Comedy']",1990,8
10202862,Secret Agent X-9,1945,['United States of America'],"['Action', 'Spy', 'Black-and-white', 'Adventure']",1940,5
6465014,Three Fugitives,1989,['United States of America'],"['Action', 'Chase Movie', 'Action/Adventure', 'Slapstick', 'Comedy', 'Comedy of Errors']",1980,9
617066,Hooper,1978,['United States of America'],"['Action', 'Action Comedy', 'Action/Adventure', 'Comedy']",1970,8
10640685,Mappillai,1989,['India'],"['Romantic drama', 'World cinema', 'Romance Film', 'Drama']",1980,9
1792785,Fire Birds,1990,['United States of America'],"['Action', 'Crime Fiction', 'Action/Adventure', 'War film']",1990,0
6198415,Metropolis,2001,['Japan'],"['Dystopia', 'Japanese Movies', 'Animation', 'Anime', 'Science Fiction']",2000,1
1260100,Student Bodies,1981,['United States of America'],"['Parody', 'Slasher', 'Horror Comedy', 'Comedy', 'Horror', 'Black comedy']",1980,1
4711636,The Last Flight of Noah's Ark,1980,['United States of America'],"['Animal Picture', 'Family-Oriented Adventure', ""Children's/Family"", 'Adventure']",1980,0
29676959,Love by Request,1983,['Soviet Union'],['Comedy'],1980,3
4857566,Krippendorf's Tribe,1998,['United States of America'],"['Film adaptation', 'Screwball comedy', 'Comedy', 'Family Film', 'Comedy of Errors']",1990,8
143952,Alphaville,1965,"['France', 'Italy']","['Black-and-white', 'Crime Fiction', 'Art film', 'World cinema', 'Drama', 'Dystopia', 'Future noir', 'Science Fiction']",1960,5
9538292,Hindustan Ki Kasam,1973,['India'],['War film'],1970,3
13636848,School of the Holy Beast,1974,['Japan'],"['Japanese Movies', 'Sexploitation', 'World cinema', 'Horror', 'Pinku eiga', 'Erotica', 'Drama']",1970,4
7246171,La Monja,2005,"['United Kingdom', 'Spain']","['Thriller', 'Horror']",2000,5
19911954,Novel Romance,2005,['United States of America'],"['Indie', 'Comedy', 'Romance Film', 'Romantic comedy']",2000,5
850497,Tarzan and the Leopard Woman,1946,['United States of America'],"['Adventure', 'Jungle Film']",1940,6
23812920,Night in the City,1933,['China'],"['Black-and-white', 'Silent film', 'Chinese Movies', 'Drama']",1930,3
74904,Little Miss Marker,1934,['United States of America'],"['Black-and-white', 'Comedy', 'Adventure', 'Drama', 'Family Film']",1930,4
22100782,Shobaraj,1986,[],"['Action', 'Drama', 'Bollywood']",1980,6
28616678,The Scarlet Clue,1945,['United States of America'],"['Mystery', 'Crime Fiction', 'Thriller', 'Comedy', 'Media Satire', 'Crime Thriller', 'Whodunit']",1940,5
10995365,The Leather Boys,1964,"['United Kingdom', 'England']","['Gay Themed', 'LGBT', 'Biker Film', 'Gay', 'Gay Interest', 'Kitchen sink realism', 'Drama']",1960,4
10165473,Tiempo de Revancha,1981,['Argentina'],"['Drama', 'Crime Fiction']",1980,1
6772207,Miguel/Michelle,1998,['Philippines'],"['Filipino Movies', 'LGBT', 'Family Drama', 'Drama']",1990,8
27181651,Esther,1999,"['Germany', 'United States of America', 'Italy']","['Period piece', 'Crime Fiction', 'Romantic drama', 'Biography', 'Romance Film', 'Epic', 'Drama']",1990,9
4167411,Night at the Museum,2006,"['United Kingdom', 'United States of America']","['Adventure Comedy', 'Fantasy Adventure', 'Action', 'Comedy', 'Family Film', 'Adventure', 'Fantasy']",2000,6
672737,Kitchen Stories,2003,"['Sweden', 'Norway']","['Satire', 'Comedy', 'Comedy of manners', 'World cinema', 'Comedy-drama', 'Drama']",2000,3
24017181,Acceptance,2009,['United States of America'],"['Television movie', 'Comedy', 'Family Film']",2000,9
3259855,Deeply,2000,"['Canada', 'United States of America']","['Suspense', 'Period piece', 'Mystery', 'Thriller', 'Romance Film', 'Supernatural', 'Drama']",2000,0
27326736,Varnapakittu,1997,[],"['Action', 'Romance Film', 'Drama']",1990,7
19691404,Mariyadhai,2009,['India'],['Drama'],2000,9
14739838,"Listen, Judge",1952,['United States of America'],"['Short Film', 'Black-and-white', 'Comedy']",1950,2
25500563,The Beast,1981,"['France', 'Italy']",['Drama'],1980,1
5973389,McHale's Navy,1997,['United States of America'],"['Action', 'Action/Adventure', 'Comedy']",1990,7
3244123,Cover Up,1949,['United States of America'],['Film noir'],1940,9
1519082,The Pacifier,2005,"['Canada', 'United States of America']","['Action', 'Action Comedy', 'Comedy', 'Thriller', 'Drama', 'Family Film']",2000,5
28520054,Love for Rent,2005,[],"['Romance Film', 'Comedy film']",2000,5
1225570,The Affairs of Annabel,1938,['United States of America'],"['Black-and-white', 'Parody', 'Satire', 'Comedy', 'Slapstick']",1930,8
3181607,Seizure,1974,"['Canada', 'United States of America']","['Monster movie', 'Surrealism', 'Psychological thriller', 'Slasher', 'Satire', 'Horror']",1970,4
1231856,For Love of the Game,1999,['United States of America'],"['Romantic drama', 'Romance Film', 'Sports', 'Drama']",1990,9
18780551,Payment Deferred,1932,['United States of America'],"['Black-and-white', 'Crime Fiction', 'Crime Drama', 'Drama']",1930,2
1002717,Foul Play,1978,['United States of America'],"['Action', 'Mystery', 'Action/Adventure', 'Comedy', 'Thriller', 'Romance Film', 'Comedy film', 'Albino bias', 'Romantic comedy']",1970,8
26163035,World Traveler,2002,"['Canada', 'United States of America']","['Indie', 'Drama']",2000,2
15205682,Journey for Margaret,1942,['United States of America'],"['Black-and-white', 'War film', 'Drama']",1940,2
24520560,Trancers 5: Sudden Deth,1994,['United States of America'],"['Action', 'Time travel', 'Action/Adventure', 'Science Fiction', 'Thriller']",1990,4
216072,Home Alone,1990,['United States of America'],"['Crime Fiction', 'Christmas movie', 'Slapstick', 'Comedy', 'Adventure', ""Children's"", 'Family Film']",1990,0
990663,Death of a Gunfighter,1969,['United States of America'],"['Western', 'Revisionist Western', 'Action/Adventure']",1960,9
168929,Billy Elliot,2000,"['United Kingdom', 'France', 'England']","['LGBT', 'Indie', 'Family Drama', 'Comedy', 'Childhood Drama', 'Drama', 'Period piece', 'Coming of age', 'Dance', 'Comedy-drama']",2000,0
4362550,Nuts,1987,['United States of America'],"['Musical', 'Crime Fiction', 'Drama', 'Courtroom Drama']",1980,7
3198799,Bugs Bunny Rides Again,1948,['United States of America'],['Short Film'],1940,8
22997248,Paarai,2001,['India'],"['Romantic drama', 'World cinema', 'Romance Film', 'Drama']",2000,1
4211962,Life with Mikey,1993,['United States of America'],"['Comedy', 'Family Film']",1990,3
31977939,Flames of the Islands,1956,['United States of America'],"['Romance Film', 'Romantic drama', 'Drama']",1950,6
11039028,Eagle's Claw,1983,['Hong Kong'],"['Action', 'Chinese Movies', 'Action/Adventure', 'World cinema', 'Sports', 'Martial Arts Film']",1980,3
6942306,Laughter in Paradise,1951,['United Kingdom'],['Comedy'],1950,1
32581343,Conversations with My Gardener,2007,['France'],"['Drama', 'Comedy']",2000,7
2293008,Blue Moon,2002,['Austria'],"['Comedy', 'Romance Film', 'Romantic comedy', 'Adventure', 'Drama']",2000,2
6720101,Crash of Moons,1954,['United States of America'],"['Black-and-white', 'Indie', 'Adventure', 'Science Fiction']",1950,4
23291125,Two Thousand Women,1944,['United Kingdom'],"['War film', 'Drama']",1940,4
2475974,"What's Up, Doc?",1950,['United States of America'],"['Music', 'Animation', 'Short Film', 'Comedy film', 'Family Film']",1950,0
26524122,Accident,1985,['India'],['Drama'],1980,5
787273,True Colors,1991,['United States of America'],"['Drama', 'Political drama']",1990,1
6722354,The Secret of My Success,1965,['United Kingdom'],['Black comedy'],1960,5
5822642,"Splash, Too",1988,['United States of America'],"['Comedy', 'Romantic comedy', 'Fantasy Comedy', 'Fantasy']",1980,8
5964231,Mickey's Mellerdrammer,1933,['United States of America'],"['Black-and-white', 'Animation', 'Short Film', 'Family Film']",1930,3
1709435,Life-Size,2000,['United States of America'],"[""Children's Fantasy"", 'Comedy', ""Children's/Family"", ""Children's"", 'Family Film', 'Fantasy']",2000,0
3226895,Aquamania,1961,[],['Short Film'],1960,1
24582601,Pulival Kalyanam,2003,['India'],['Comedy'],2000,3
2275930,TerrorVision,1986,['United States of America'],"['Indie', 'Comedy', 'Thriller', 'Horror', 'Science Fiction', 'Cult']",1980,6
1866289,Dr. Terror's House of Horrors,1965,['United Kingdom'],"['Horror Comedy', 'Horror', 'B-movie', 'Natural horror films']",1960,5
18917513,Ten Seconds to Hell,1959,"['United Kingdom', 'Germany', 'West Germany', 'United States of America']","['Action', 'Combat Films', 'Mystery', 'Romance Film', 'War film', 'Drama']",1950,9
17851597,The Nine Ages of Nakedness,1969,['United Kingdom'],"['Parody', 'Comedy']",1960,9
2184393,The Satan Bug,1965,['United States of America'],"['Action', 'Spy', 'Action Thrillers', 'Chase Movie', 'Science Fiction']",1960,5
14992861,Snow Buddies,2008,['United States of America'],"['Comedy', 'Animal Picture', ""Children's/Family"", ""Children's"", 'Family Film']",2000,8
5898351,La Cérémonie,1996,"['France', 'Germany']","['Thriller', 'World cinema', 'Crime Drama', 'Crime Thriller', 'Drama']",1990,6
18766380,"Third Finger, Left Hand",1940,['United States of America'],"['Comedy', 'Black-and-white']",1940,0
10651171,Tako se kalio čelik,1988,['Yugoslavia'],[],1980,8
1870643,Alexander the Great,1956,"['Spain', 'United States of America']","['Biography', 'Biographical film', 'War film', 'Sword and Sandal', 'Epic', 'Costume drama', 'Drama']",1950,6
10117636,Mukhsin,2007,['Malaysia'],"['Comedy', 'Childhood Drama', 'World cinema', 'Romance Film', 'Comedy-drama', 'Drama', 'Family Film']",2000,7
10695156,Words and Music,1929,['United States of America'],"['Musical', 'Black-and-white', 'Comedy']",1920,9
6945281,The Prime Minister,1941,['United Kingdom'],"['Black-and-white', 'Biographical film', 'Biopic [feature]', 'Drama']",1940,1
1549991,Slums of Beverly Hills,1998,['United States of America'],"['Indie', 'Comedy', 'Black comedy', 'Drama', 'Period piece', 'Coming of age', 'Domestic Comedy', 'Comedy-drama']",1990,8
26037408,Troublesome Night 9,2001,['Hong Kong'],"['Chinese Movies', 'Mystery', 'Comedy', 'Horror', 'Drama']",2000,1
5429460,The Postman Always Rings Twice,1981,"['West Germany', 'United States of America']","['Film adaptation', 'Neo-noir', 'Crime Fiction', 'Mystery', 'Thriller', 'Film noir', 'Crime Thriller', 'Drama', 'Period piece', 'Suspense', 'Erotic thriller']",1980,1
105394,Girlfriend From Hell,1989,['United States of America'],"['Fantasy', 'Comedy', 'Horror']",1980,9
9122163,Sing You Sinners,1938,['United States of America'],"['Musical', 'Black-and-white', 'Comedy', 'Romance Film']",1930,8
22486844,Life During Wartime,2009,['United States of America'],"['Drama', 'Indie', 'Comedy', 'Black comedy', 'Comedy-drama', 'Ensemble Film']",2000,9
678080,Blood Feast,1963,['United States of America'],"['Slasher', 'Splatter film', 'Horror', 'B-movie', 'Supernatural', 'Cult']",1960,3
5224,Citizen Kane,1941,['United States of America'],"['Period piece', 'Film à clef', 'Black-and-white', 'Mystery', 'Epic', 'Political drama', 'Drama']",1940,1
14414565,Confession,1937,['United States of America'],"['Black-and-white', 'Drama']",1930,7
15310776,La Habanera,1937,['Germany'],"['Black-and-white', 'Romantic drama', 'World cinema', 'Romance Film', 'Drama']",1930,7
10521327,U2 3D,2008,['United States of America'],"['Music', 'Concert film', 'Documentary']",2000,8
16036739,Sila Nerangalil,2008,['India'],['Drama'],2000,8
5569839,"Larceny, Inc.",1942,['United States of America'],"['Black-and-white', 'Crime Fiction', 'Heist', 'Comedy']",1940,2
2750980,Heavens Fall,2006,['United States of America'],"['Period piece', 'Drama', 'Crime Fiction', 'Indie', 'Docudrama', 'Courtroom Drama']",2000,6
7994800,Bug Me Not!,2005,['Hong Kong'],"['Romantic drama', 'Comedy', 'World cinema', 'Romance Film', 'Chinese Movies', 'Drama', 'Romantic comedy', 'Fantasy']",2000,5
24464878,Megafault,2009,['United States of America'],"['Disaster', 'Action/Adventure', 'Science Fiction']",2000,9
27904525,The Secret Society - Boss,2003,['Hong Kong'],['Chinese Movies'],2000,3
11840982,Never Been Thawed,2005,['United States of America'],"['Indie', 'Parody', 'Satire', 'Comedy', 'Mockumentary']",2000,5
19664197,Beloved Enemy,1936,['United States of America'],"['Black-and-white', 'War film', 'Drama']",1930,6
7584180,Saaz,1998,['India'],['Drama'],1990,8
10735637,Freakshow,2007,['United States of America'],"['Psychological thriller', 'Suspense', 'Indie', 'Horror']",2000,7
28492772,Aalkkoottathil Thaniye,1984,['India'],['Drama'],1980,4
14823527,Chintakayala Ravi,2008,['India'],"['Musical', 'Comedy', 'Bollywood', 'World cinema', 'Romance Film', 'Romantic comedy', 'Drama']",2000,8
1344253,Flubber,1997,['United States of America'],"['Slapstick', 'Comedy', 'Science Fiction', 'Fantasy Comedy', 'Family Film', 'Fantasy']",1990,7
5840102,Pyar To Hona Hi Tha,1998,['India'],"['Romantic drama', 'Comedy', 'Bollywood', 'World cinema', 'Romance Film', 'Romantic comedy', 'Drama']",1990,8
2037975,Harry and the Hendersons,1987,['United States of America'],"['Buddy film', 'Comedy', 'Animal Picture', 'Family-Oriented Adventure', ""Children's/Family"", 'Family Film', 'Fantasy']",1980,7
17593898,Honeysuckle Rose,1980,['United States of America'],"['Musical', 'Romance Film', 'Drama']",1980,0
16054694,Outing Riley,2004,['United States of America'],"['Gay Themed', 'LGBT', 'Gay', 'Indie', 'Gay Interest', 'Comedy', 'Romance Film']",2000,4
6631386,In This Our Life,1942,['United States of America'],"['Black-and-white', 'Family Drama', 'Romantic drama', 'Romance Film', 'Melodrama', 'Drama']",1940,2
13298228,Plane Daffy,1944,['United States of America'],['Propaganda film'],1940,4
1699911,"Turn Left, Turn Right",2003,"['Hong Kong', 'Singapore']","['Chinese Movies', 'Romance Film']",2000,3
25160272,Hands of a Stranger,1962,['United States of America'],['Horror'],1960,2
24397723,Jolly Roger: Massacre at Cutter's Cove,2005,[],"['Action/Adventure', 'Slasher', 'Horror', 'B-movie', 'Swashbuckler films']",2000,5
338849,The Last Starfighter,1984,['United States of America'],"['Action/Adventure', 'Adventure', 'Science Fiction', 'Family Film']",1980,4
1094719,The Grudge,2004,"['Japan', 'United States of America']","['Mystery', 'Japanese Movies', 'Thriller', 'Horror', 'Supernatural', 'Haunted House Film']",2000,4
34346480,Jaal,1967,['India'],"['Action', 'Drama', 'Crime Fiction', 'Mystery', 'Thriller']",1960,7
26241300,The Adventuress,1950,['Mexico'],"['Drama', 'World cinema']",1950,0
16777096,Steve + Sky,2004,['Belgium'],"['Romantic drama', 'World cinema', 'Romance Film', 'Drama']",2000,4
1122412,The Coca-Cola Kid,1985,"['New Zealand', 'Australia']","['Parody', 'Comedy', 'World cinema', 'Romantic comedy', 'Drama']",1980,5
19259663,The Way We Live Now,1970,['United States of America'],['Drama'],1970,0
14401906,Le Serpent,2006,['France'],['Thriller'],2000,6
5283093,From Beyond,1986,['United States of America'],"['Monster movie', 'Film adaptation', 'Horror Comedy', 'Horror', 'Science Fiction', 'Drama', 'Cult']",1980,6
6986799,The Grinch Grinches the Cat in the Hat,1982,['United States of America'],['Animation'],1980,2
17776062,Dirty Laundry,2007,['United States of America'],"['Gay Themed', 'LGBT', 'Indie', 'Drama', 'Comedy', 'Comedy-drama']",2000,7
16908874,You're a Sweetheart,1937,['United States of America'],"['Musical', 'Black-and-white', 'Comedy']",1930,7
7210856,Betty Boop's Museum,1932,['United States of America'],['Black-and-white'],1930,2
924857,Losing Isaiah,1995,['United States of America'],"['Courtroom Drama', 'Family Drama', 'Drama']",1990,5
8195278,Renegades,1989,['United States of America'],"['Action', 'Crime Fiction', 'Action/Adventure', 'Buddy film', 'Thriller', 'Drama']",1980,9
243204,Caligula,1979,"['Italy', 'United States of America']","['LGBT', 'Historical drama', 'Biographical film', 'Erotica', 'Romance Film', 'Costume drama', 'Drama', 'Period piece', 'Sexploitation', 'Biopic [feature]', 'Historical Epic', 'Epic', 'Historical fiction', 'Political drama', 'Adult']",1970,9
6804178,Beasties,1989,['United States of America'],"['Comedy', 'Horror', 'Science Fiction', 'Fantasy']",1980,9
7804238,Showboy,2002,['United States of America'],"['Indie', 'Comedy', 'Mockumentary', 'Drama']",2000,2
10103122,Cursed,2004,['Japan'],"['Japanese Movies', 'Supernatural', 'Horror']",2000,4
2748709,Brick,2006,['United States of America'],"['Neo-noir', 'Detective fiction', 'Crime Fiction', 'Mystery', 'Indie', 'Teen', 'Thriller', 'Film noir', 'Crime Thriller', 'Drama', 'Detective']",2000,6
1713779,Son of Kong,1933,['United States of America'],"['Creature Film', 'Monster movie', 'Action', 'Action/Adventure', 'Comedy', 'Stop motion']",1930,3
20872882,Gabby's Diner,1961,[],"['Animation', 'Short Film', 'Family Film']",1960,1
32583135,All The Vermeers In New York,1990,['United States of America'],"['Drama', 'Indie', 'Romantic drama', 'Comedy', 'Romance Film', 'Romantic comedy']",1990,0
26551541,Triple Trouble,1950,['United States of America'],"['Action', 'Crime Fiction', 'Comedy']",1950,0
5388717,I'm Not There,2007,"['Germany', 'United States of America']","['Musical', 'Drama', 'Indie', 'Biographical film', 'Biopic [feature]', 'Musical Drama', 'Political drama']",2000,7
2724049,The Woman in Red,1984,['United States of America'],"['Romance Film', 'Romantic comedy', 'Comedy']",1980,4
13911356,João da Mata,1923,['Brazil'],"['Silent film', 'Drama']",1920,3
18620128,The Henpecked Duck,1941,[],"['Animation', 'Short Film', 'Family Film']",1940,1
7738646,Ai-Fak,2004,['Thailand'],['Drama'],2000,4
10972714,Brighton Rock,1947,['United Kingdom'],"['Black-and-white', 'Crime Fiction', 'Film noir', 'Crime Drama']",1940,7
24491249,Mistrial,1996,['United States of America'],"['Action', 'Psychological thriller', 'Drama', 'Thriller', 'Television movie']",1990,6
21256010,Hit List,1989,['United States of America'],"['Action', 'Thriller']",1980,9
23751392,Ee Pattanathil Bhootham,2009,['India'],['Fantasy'],2000,9
12157553,Blood of Ghastly Horror,1972,['United States of America'],"['Horror', 'B-movie', 'Zombie Film', 'Sci-Fi Horror', 'Science Fiction']",1970,2
4334307,Abbott and Costello Meet Captain Kidd,1952,['United States of America'],"['Comedy', 'Slapstick', 'Adventure', 'Family Film']",1950,2
9457226,Monster on the Campus,1958,['United States of America'],"['Creature Film', 'Monster movie', 'Horror', 'Science Fiction', 'Natural horror films']",1950,8
669691,Pather Panchali,1955,['India'],"['Film à clef', 'Art film', 'Coming of age', 'Family Drama', 'World cinema', 'Drama']",1950,5
19521134,My Mother is a Belly Dancer,2006,['Hong Kong'],['Chinese Movies'],2000,6
6199357,"Kiss Me, Guido",1997,['United States of America'],"['Gay Themed', 'LGBT', 'Gay', 'Indie', 'Gay Interest', 'Comedy']",1990,7
433062,Broken,1992,['United States of America'],['Short Film'],1990,2
34661304,I.C. Kill,1999,['Hong Kong'],['Horror'],1990,9
25084392,Beyond the Pole,2009,['United Kingdom'],"['Indie', 'Parody', 'Comedy', 'Nature', 'Mockumentary']",2000,9
1529108,Deterrence,1999,"['France', 'United States of America']","['Action', 'Mystery', 'Action/Adventure', 'Thriller', 'Drama', 'Political thriller']",1990,9
1051659,Rollerball,2002,['United States of America'],"['Action', 'Sports', 'Science Fiction']",2000,2
16951571,Touch And Go,1986,['United States of America'],"['Comedy', 'Romance Film', 'Sports', 'Drama']",1980,6
10996357,The Neighbour No. 13,2005,"['Argentina', 'Japan']","['Psychological thriller', 'Japanese Movies', 'Thriller', 'Horror', 'World cinema']",2000,5
28506139,Déjà Vu,1997,['United States of America'],"['Romantic drama', 'Indie', 'Romance Film', 'Drama']",1990,7
20682167,Go for Broke,2002,['United States of America'],['Comedy'],2000,2
13995078,Street Girl,1929,['United States of America'],"['Musical', 'Black-and-white', 'Comedy', 'Drama']",1920,9
563861,Dog Soldiers,2002,"['Luxembourg', 'United Kingdom', 'Scotland', 'United States of America']","['Action', 'Creature Film', 'Horror']",2000,2
1238341,Trail of the Pink Panther,1982,"['United Kingdom', 'United States of America']","['Parody', 'Slapstick', 'Comedy']",1980,2
7296021,Farewell to Harry,2002,['United States of America'],"['Period piece', 'Indie', 'Americana', 'Drama']",2000,2
5577180,A Hole in the Head,1959,['United States of America'],"['Musical', 'Comedy', 'Domestic Comedy', 'Romantic comedy']",1950,9
22110321,Design for Living,1933,['United States of America'],"['Black-and-white', 'Comedy', 'Romance Film', 'Pre-Code']",1930,3
4186543,Boom,2003,['India'],"['Crime Fiction', 'Mystery', 'Action/Adventure', 'World cinema', 'Drama']",2000,3
2546890,A World Apart,1988,"['United Kingdom', 'Zimbabwe', 'United States of America']","['Indie', 'Docudrama', 'Political drama', 'Drama']",1980,8
19708435,"Goke, Body Snatcher from Hell",1968,['Japan'],"['Horror', 'Science Fiction']",1960,8
1679183,The Cutting Edge,1992,['United States of America'],"['Romantic drama', 'Comedy', 'Romantic comedy', 'Romance Film', 'Comedy-drama', 'Sports', 'Drama']",1990,2
13368316,Unfolding Florence: The Many Lives of Florence Broadhurst,2006,['Australia'],"['Drama', 'Indie', 'World cinema', 'Documentary']",2000,6
3447112,The Off Season,2004,['United States of America'],"['Thriller', 'Haunted House Film', 'Horror']",2000,4
586740,Sleeper,1973,['United States of America'],"['Dystopia', 'Parody', 'Indie', 'Satire', 'Comedy', 'Slapstick', 'Science Fiction']",1970,3
1369204,Juarez,1939,['United States of America'],"['Black-and-white', 'Biographical film', 'Biopic [feature]', 'Historical fiction', 'Costume drama']",1930,9
905964,Open Water,2003,['United States of America'],"['Suspense', 'Drama', 'Indie', 'Thriller', 'Horror', 'Disaster', 'Natural horror films']",2000,3
21835208,Zombieland,2009,['United States of America'],"['Action', 'Comedy horror', 'Comedy', 'Horror Comedy', 'Black comedy', 'Zombie Film', 'Apocalyptic and post-apocalyptic fiction', 'Adventure', 'Horror', 'Road movie', 'Doomsday film']",2000,9
11039415,He Has Nothing But Kung Fu,1977,['Hong Kong'],"['Action', 'Action Thrillers', 'Chinese Movies', 'Martial Arts Film']",1970,7
5016294,Breezy,1973,['United States of America'],"['Romance Film', 'Romantic drama', 'Drama']",1970,3
29214531,The Patient Vanishes,1941,['United Kingdom'],"['Detective fiction', 'Crime Fiction', 'Mystery', 'Detective']",1940,1
68099,Kiss Me Deadly,1955,['United States of America'],"['Film adaptation', 'Crime Fiction', 'Mystery', 'Thriller', 'Film noir', 'Crime Thriller', 'Cult', 'Drama', 'Suspense', 'Detective']",1950,5
25412052,Joy House,1964,['France'],"['Psychological thriller', 'Crime Fiction', 'Thriller', 'World cinema', 'Crime Thriller', 'Drama']",1960,4
12289802,Dennis the Menace Strikes Again,1998,['United States of America'],"['Comedy', ""Children's/Family"", 'Slapstick', 'Family Film']",1990,8
496839,Chance,2002,['United States of America'],"['Drama', 'Comedy']",2000,2
3497579,The Barkleys of Broadway,1949,['United States of America'],"['Musical', 'Comedy', 'Musical comedy', 'Romance Film', 'Romantic comedy']",1940,9
14778926,Cyborg 2087,1966,['United States of America'],['Science Fiction'],1960,6
11014002,Lily in Love,1984,"['Hungary', 'United States of America']","['Romance Film', 'Comedy', 'Drama']",1980,4
20684980,Wild And Woolfy,1945,['United States of America'],['Short Film'],1940,5
16306760,Smuggler's Cove,1948,['United States of America'],"['Comedy film', 'Crime Fiction']",1940,8
11885257,The Sky is Falling,2000,"['Italy', 'United States of America']","['Drama', 'World cinema']",2000,0
6954825,Iddaru Mitrulu,1999,['India'],"['Drama', 'World cinema']",1990,9
34521922,The Last Rose of Summer,1920,['United Kingdom'],"['Silent film', 'Romance Film']",1920,0
20467212,The Devil's Game,2008,['South Korea'],"['Thriller', 'Drama']",2000,8
6420269,H.E. Double Hockey Sticks,1999,"['Canada', 'United States of America']",['Comedy'],1990,9
3915448,Sarkar Raj,2008,['India'],"['Musical', 'Drama', 'Crime Fiction', 'Indie', 'Thriller', 'Bollywood', 'World cinema']",2000,8
19841894,Afterwards,2008,"['France', 'Germany', 'Canada']","['Psychological thriller', 'Mystery', 'Thriller', 'World cinema', 'Supernatural']",2000,8
20161868,The Legend of the Evil Lake,2003,['South Korea'],"['Action', 'Drama', 'Horror', 'Romance Film', 'Fantasy']",2000,3
18627782,What's Cookin'?,1942,['United States of America'],"['Musical', 'Black-and-white']",1940,2
7370905,Waxwork II: Lost in Time,1992,['United States of America'],"['Horror Comedy', 'Comedy', 'Horror', 'Zombie Film', 'Cult']",1990,2
28034213,Fotonovela,2007,['Spain'],"['Comedy', 'World cinema']",2000,7
4394986,Egghead Rides Again,1937,['United States of America'],['Short Film'],1930,7
15082106,Krantiveer,1994,['India'],['Bollywood'],1990,4
21406077,Kathantara,2007,['India'],['Drama'],2000,7
1237394,Anne of Green Gables,1985,"['United States of America', 'Canada', 'West Germany']","['Television movie', 'Costume drama', 'Drama']",1980,5
20786998,Unfinished Sky,2007,['Australia'],['Drama'],2000,7
10299365,Paris,1929,['United States of America'],['Black-and-white'],1920,9
19425193,Foxhole in Cairo,1960,['United Kingdom'],"['Action', 'Spy', 'Historical fiction', 'Docudrama', 'War film', 'Drama']",1960,0
15070373,Bambaru Avith,1978,['Sri Lanka'],['Drama'],1970,8
874208,Ravenous,1999,"['Mexico', 'United Kingdom', 'Czech Republic', 'United States of America']","['Comedy', 'Thriller', 'Black comedy', 'Adventure', 'Period piece', 'Western', 'Slasher', 'Horror', 'War film']",1990,9
452017,Boogie Nights,1997,['United States of America'],"['Period piece', 'LGBT', 'Indie', 'Drama', 'Comedy', 'Comedy-drama', 'Ensemble Film']",1990,7
5291587,Firestarter 2: Rekindled,2002,['United States of America'],"['Science Fiction', 'Thriller', 'Horror', 'Sci-Fi Horror']",2000,2
11103867,Dragon Head,2003,['Japan'],"['Action', 'Japanese Movies', 'Horror', 'World cinema', 'Anime', 'Disaster', 'Science Fiction']",2000,3
19940419,Spectacular!,2009,"['Canada', 'United States of America']","['Musical', 'Comedy', 'Teen']",2000,9
18975648,Duniya Na Mane,1937,['India'],"['Black-and-white', 'Art film']",1930,7
11222156,Step Up 2: The Streets,2008,['United States of America'],"['Musical', 'Romantic drama', 'Dance', 'Romance Film', 'Drama']",2000,8
74375,Hoosiers,1986,['United States of America'],"['Sports', 'Family Drama', 'Teen', 'Docudrama', 'Drama', 'Family Film']",1980,6
11001009,La Bandera,1935,['France'],"['Black-and-white', 'Romantic drama', 'World cinema', 'Adventure', 'Drama']",1930,5
30873996,Toy Soldiers,1991,['United States of America'],"['Action', 'Drama', 'Action/Adventure', 'Thriller']",1990,1
25837169,Jokyo,1960,['Japan'],['Japanese Movies'],1960,0
7656319,Kurbaan,1991,['India'],['Family Film'],1990,1
26283042,House of the Living Dead,1976,['South Africa'],"['Mystery', 'Science Fiction', 'Horror']",1970,6
8220284,"A Man, a Woman, and a Bank",1979,['Canada'],"['Action', 'Crime Fiction', 'Action/Adventure', 'Comedy', 'Romance Film', 'Heist', 'Caper story', 'Crime Comedy', 'Romantic comedy']",1970,9
26927011,Married in Hollywood,1929,['United States of America'],['Musical'],1920,9
5880191,Auto,2007,['India'],"['Action', 'Comedy', 'Tamil cinema', 'Drama']",2000,7
33239589,Wajood,1998,['India'],"['Musical', 'Bollywood', 'World cinema']",1990,8
1587667,Catch and Release,2006,['United States of America'],"['Indie', 'Romantic drama', 'Comedy', 'Romance Film', 'Tragicomedy', 'Drama', 'Romantic comedy', 'Comedy-drama']",2000,6
3556179,A Slight Case of Murder,1938,['United States of America'],"['Comedy', 'Black-and-white']",1930,8
9211365,Raghu Romeo,2003,['India'],"['Romantic drama', 'Comedy', 'World cinema', 'Romance Film', 'Romantic comedy', 'Drama']",2000,3
1789118,Pay Day,1922,['United States of America'],"['Black-and-white', 'Indie', 'Short Film', 'Comedy', 'Silent film']",1920,2
26007945,The Crash,1932,['United States of America'],['Drama'],1930,2
3182015,Flawless,1999,['United States of America'],"['LGBT', 'Indie', 'Comedy', 'Drama']",1990,9
5700611,Ao no Honou,2003,['Japan'],['Japanese Movies'],2000,3
27420736,Cash on Demand,1961,['United Kingdom'],"['Drama', 'Crime Fiction', 'Thriller']",1960,1
423371,The Super Dimension Fortress Macross: Do You Remember Love?,1984,['Japan'],"['Animation', 'Japanese Movies', 'Romance Film', 'Anime', 'Science Fiction']",1980,4
4302862,The Even Stevens Movie,2003,['United States of America'],"['Comedy', 'Family-Oriented Adventure', 'Adventure', 'Family Film']",2000,3
2255118,The Driller Killer,1979,['United States of America'],"['Cult', 'Slasher', 'Horror']",1970,9
10523484,Vidhaata,1982,['India'],"['Drama', 'Bollywood', 'World cinema']",1980,2
27563361,Montana Territory,1953,['United States of America'],['Western'],1950,3
11303780,Chandamama,2007,['India'],"['Musical', 'Comedy', 'Bollywood', 'World cinema', 'Romance Film']",2000,7
29445957,"Candide, or the Optimist of the Twentieth Century",1960,[],"['Musical', 'Parody', 'Satire', 'Comedy', 'Comedy film', 'Drama']",1960,0
11496314,Vitus,2006,['Switzerland'],"['Family Drama', 'Drama', 'World cinema']",2000,6
26292933,"Guns, Girls, and Gangsters",1959,['United States of America'],"['Drama', 'Crime Fiction']",1950,9
2813020,The Red Shoes,2005,['South Korea'],"['Horror', 'Supernatural', 'World cinema']",2000,5
14355980,Under the Sun,1998,['Sweden'],"['Romantic drama', 'World cinema', 'Romance Film', 'Drama']",1990,8
11703733,Spaced Out Bunny,1980,['United States of America'],"['Short Film', 'Comedy', 'Family Film']",1980,0
1598996,Almost Heroes,1998,['United States of America'],"['Adventure Comedy', 'Western', 'Comedy', 'Adventure']",1990,8
2987324,Go West,1940,['United States of America'],"['Musical', 'Black-and-white', 'Western', 'Comedy']",1940,0
7518689,The Hot Air Salesman,1937,['United States of America'],"['Short Film', 'Animation']",1930,7
9338127,Scenes of a Sexual Nature,2006,['United Kingdom'],"['LGBT', 'Romantic drama', 'Comedy', 'Romance Film', 'Romantic comedy', 'Drama', 'Ensemble Film']",2000,6
4981484,The Star Chamber,1983,['United States of America'],"['Action', 'Suspense', 'Crime Fiction', 'Action/Adventure', 'Thriller', 'Drama', 'Courtroom Drama']",1980,3
13061224,Poveri ma belli,1957,['Italy'],"['Black-and-white', 'Comedy', 'Romance Film', 'Romantic comedy', 'Drama']",1950,7
1439062,Merlin's Shop of Mystical Wonders,1996,['United States of America'],"['Fantasy Adventure', 'Fantasy', 'Horror']",1990,6
1841530,Bachelor Party,1984,['United States of America'],"['Romance Film', 'Comedy', 'Sex comedy']",1980,4
3435387,Trenchcoat,1983,['United States of America'],"['Action', 'Spy', 'Crime Fiction', 'Mystery', 'Comedy']",1980,3
31063840,My Son Is Guilty,1939,['United States of America'],"['Action', 'Crime Fiction', 'Adventure']",1930,9
32336472,Muhammad bin Tughluq,1971,[],"['Satire', 'Comedy film']",1970,1
25080146,St. Ives,1976,['United States of America'],"['Action', 'Action/Adventure', 'Thriller', 'Crime Thriller']",1970,6
20467374,Until They Sail,1957,['United States of America'],"['Crime Fiction', 'Romantic drama', 'Romance Film', 'Drama']",1950,7
6730730,Vanakkam Thalaiva,2005,['India'],[],2000,5
26492850,Attack on the Iron Coast,1968,"['United Kingdom', 'United States of America']","['Action', 'Drama', 'War film']",1960,8
1700544,Two of a Kind,1983,['United States of America'],"['Comedy', 'Romance Film', 'Romantic comedy', 'Fantasy']",1980,3
8727155,Darwaaza Bandh Rakho,2006,['India'],"['Comedy', 'World cinema']",2000,6
11498750,Waris Jari Hantu,2007,['Malaysia'],['Fantasy'],2000,7
11450884,The Surrogate,1995,['United States of America'],['Drama'],1990,5
6005212,Malliswari,2004,['India'],['Romance Film'],2000,4
23463285,Gen-X Cops,1999,['Hong Kong'],"['Action', 'Martial Arts Film', 'Action Comedy', 'Action/Adventure', 'Comedy', 'World cinema', 'Chinese Movies']",1990,9
2632667,The Steel Claw,1961,['United States of America'],"['Action', 'Action/Adventure', 'War film']",1960,1
12555629,Hickey & Boggs,1972,['United States of America'],"['Crime Fiction', 'Mystery', 'Thriller', 'Crime Thriller']",1970,2
5990251,At War With The Army,1950,['United States of America'],"['Slapstick', 'Comedy']",1950,0
2820985,The Way Ahead,1944,['United Kingdom'],"['War film', 'Propaganda film', 'Drama']",1940,4
1972947,Super-Rabbit,1943,['United States of America'],"['Animation', 'Short Film', 'Comedy', 'Family Film']",1940,3
5010137,Dutch,1991,['United States of America'],"['Road movie', 'Comedy', 'Drama']",1990,1
7870782,Parinayam,1994,['India'],"['Historical fiction', 'Drama']",1990,4
24577679,Turning Point,2009,['Hong Kong'],"['Action', 'Crime Fiction', 'Action/Adventure', 'Thriller', 'World cinema', 'Crime Thriller', 'Chinese Movies', 'Drama']",2000,9
5555266,Kapurush,1965,['India'],"['Art film', 'Romantic drama', 'World cinema', 'Romance Film', 'Drama']",1960,5
2268987,Nadodikattu,1987,['India'],"['Satire', 'Bollywood', 'Comedy film']",1980,7
15963629,The Man Who Owed a Death,1955,['Argentina'],['Black-and-white'],1950,5
19778347,Red Lion,1969,['Japan'],"['Japanese Movies', 'Action/Adventure', 'World cinema']",1960,9
3694303,Carry On Constable,1960,['United Kingdom'],"['Parody', 'Slapstick', 'Comedy']",1960,0
9442754,Star Spangled Rhythm,1942,['United States of America'],"['Musical', 'Black-and-white', 'Comedy', 'Musical comedy']",1940,2
3507235,Swallowtail Butterfly,1996,['Japan'],['Japanese Movies'],1990,6
24070825,Summer Rain,2006,"['United Kingdom', 'Spain']","['Romance Film', 'Drama', 'World cinema']",2000,6
143834,The Boys from Brazil,1978,"['United Kingdom', 'United States of America']","['Suspense', 'Film adaptation', 'Political thriller', 'Thriller', 'Science Fiction', 'Drama']",1970,8
2709566,Carnival Story,1954,"['West Germany', 'United States of America']","['Romantic drama', 'Romance Film', 'Melodrama', 'Drama']",1950,4
24573767,Love's Blindness,1926,[],"['Silent film', 'Romance Film', 'Drama']",1920,6
1280968,In My Father's Den,2004,"['United Kingdom', 'New Zealand', 'Australia']","['Film adaptation', 'Crime Fiction', 'Mystery', 'Family Drama', 'Thriller', 'World cinema', 'Drama']",2000,4
1799456,Stark Raving Mad,2002,['United States of America'],"['Action', 'Heist', 'Crime Fiction', 'Action/Adventure', 'Comedy', 'Black comedy']",2000,2
408849,Big Fat Liar,2002,"['Germany', 'United States of America']","['Slapstick', 'Comedy', ""Children's/Family"", 'Adventure', 'Family Film']",2000,2
1869084,The Miracle Maker,2000,"['Russia', 'United Kingdom']","['Costume drama', 'Stop motion']",2000,0
5085028,Rough Cut,1980,['United States of America'],"['Heist', 'Crime Fiction', 'Comedy', 'Romantic comedy']",1980,0
17808534,Ski for Two,1944,['United States of America'],['Animation'],1940,4
33425667,Sinhasan,1979,['India'],"['Musical', 'Crime Fiction', 'Bollywood', 'World cinema', 'Political drama', 'Drama']",1970,9
17035291,Kaash,1987,['India'],['Bollywood'],1980,7
5848042,Lakshmi,2006,['India'],['Action'],2000,6
939750,Pushing Hands,1992,['Taiwan'],"['Family Drama', 'Comedy', 'Domestic Comedy', 'Comedy-drama', 'Drama']",1990,2
31612089,Aadum Koothu,2005,[],['Drama'],2000,5
1075228,Oliver's Story,1978,['United States of America'],"['Romance Film', 'Romantic drama', 'Drama']",1970,8
33555077,Pyase Panchi,1961,[],['Comedy film'],1960,1
1009041,Fight Club,1999,"['Germany', 'United States of America']","['Action', 'Psychological thriller', 'Action/Adventure', 'Satire', 'Thriller', 'Black comedy', 'Drama', 'Airplanes and airports', 'Existentialism', 'Cult']",1990,9
11464636,Buying the Cow,2002,['United States of America'],"['Comedy', 'Romance Film', 'Romantic comedy', 'Sex comedy']",2000,2
29550893,Meri Adalat,2001,['India'],['Action'],2000,1
29887498,Parthan Kanda Paralokam,2008,[],"['Drama', 'Comedy film']",2000,8
1801472,The Hand of Fear,1976,[],['Science Fiction'],1970,6
652534,The Medallion,2003,"['United Kingdom', 'Hong Kong', 'United States of America']","['Action', 'Fantasy Adventure', 'Action/Adventure', 'Comedy', 'Thriller', 'Buddy film', 'Chinese Movies', 'Martial Arts Film', 'Adventure', 'Action Comedy', 'Fantasy']",2000,3
3084955,City Slickers II: The Legend of Curly's Gold,1994,['United States of America'],"['Adventure Comedy', 'Action', 'Action/Adventure', 'Western', 'Comedy', 'Road movie']",1990,4
12990278,The Damned,1963,['United Kingdom'],"['Black-and-white', 'Science Fiction', 'Horror']",1960,3
2163703,I'll Be Home for Christmas,1998,['United States of America'],['Christmas movie'],1990,8
6560739,Aankhen,1993,['India'],['Bollywood'],1990,3
18874821,Little Lili,2003,"['Canada', 'France']","['Drama', 'World cinema']",2000,3
3653398,Ten Thousand Bedrooms,1957,['United States of America'],"['Musical', 'Comedy', 'Musical comedy', 'Romantic comedy']",1950,7
4628762,Marilyn Hotchkiss' Ballroom Dancing and Charm School,2005,['United States of America'],"['Musical', 'Drama', 'Indie', 'Comedy', 'Romance Film', 'Romantic comedy']",2000,5
8067478,It's a Boy Girl Thing,2006,"['Canada', 'United Kingdom']","['Comedy', 'Teen', 'Romance Film', 'Romantic comedy']",2000,6
20906127,Let It Rain,2008,['France'],"['Comedy', 'Drama', 'World cinema']",2000,8
1571564,The Narrow Margin,1952,['United States of America'],"['Psychological thriller', 'Black-and-white', 'Crime Fiction', 'Mystery', 'Thriller', 'Film noir', 'Crime Thriller', 'Drama', 'Suspense']",1950,2
2509885,Critters 4,1991,['United States of America'],"['Creature Film', 'Horror Comedy', 'Horror', 'Black comedy', 'Sci-Fi Horror', 'Science Fiction']",1990,1
25872272,Death Train,2006,['Germany'],"['Action', 'Action/Adventure', 'Thriller', 'World cinema', 'Adventure']",2000,6
30511712,Embraceable You,1948,['United States of America'],"['Thriller', 'Drama']",1940,8
13671006,Granpa,1989,['United Kingdom'],"['Animation', 'Short Film', 'Dance', ""Children's/Family"", ""Children's"", 'Family Film']",1980,9
883437,Shallow Grave,1994,"['Kingdom of Great Britain', 'United Kingdom', 'Scotland']","['Psychological thriller', 'Suspense', 'Crime Fiction', 'Indie', 'Thriller', 'Black comedy', 'Crime Thriller']",1990,4
1971322,Elmer's Pet Rabbit,1941,['United States of America'],"['Family Film', ""Children's/Family""]",1940,1
13632712,An Ordinary Miracle,1978,['Soviet Union'],"['Musical', 'Comedy', 'Romance Film', 'Fantasy']",1970,8
4853633,Sethu,1999,['India'],"['Romantic drama', 'World cinema', 'Romance Film', 'Drama']",1990,9
22881544,Boy Goes To Heaven,2005,['South Korea'],['Romance Film'],2000,5
6703617,The Forbidden Kingdom,2008,"['Hong Kong', 'China', 'United States of America']","['Action', 'Fantasy Adventure', 'Action/Adventure', 'Romance Film', 'Chinese Movies', 'Martial Arts Film', 'Adventure', 'Period piece', 'Wuxia', 'Fantasy']",2000,8
8595532,The Purple Heart,1944,['United States of America'],"['Action', 'Drama', 'Action/Adventure', 'Western', 'War film']",1940,4
570221,Godzilla vs. Mechagodzilla,1974,['Japan'],"['Japanese Movies', 'Action/Adventure', 'Monster', 'World cinema', 'Science Fiction', 'Cult', 'Fantasy']",1970,4
3306716,Tremors 3: Back to Perfection,2001,['United States of America'],"['Action', 'Comedy horror', 'Action/Adventure', 'Comedy', 'Horror Comedy', 'Creature Film', 'Horror', 'Science Fiction']",2000,1
28402972,The Good Bad Egg,1947,['United States of America'],['Short Film'],1940,7
9994307,The Tall Blond Man with One Black Shoe,1972,['France'],"['Comedy', 'Comedy of Errors']",1970,2
18908698,Boys in Brown,1949,['United Kingdom'],"['Black-and-white', 'Social problem film', 'Juvenile Delinquency Film', 'Drama']",1940,9
23913058,The Dirty Dozen: The Next Mission,1985,['United States of America'],"['Action', 'War film']",1980,5
8437284,Cash,2007,['India'],"['Action', 'Musical', 'Thriller', 'Bollywood', 'World cinema', 'Crime Thriller']",2000,7
19872306,Mahulbanir Sereng,2004,['India'],"['Musical', 'Bollywood', 'World cinema', 'Drama']",2000,4
3253210,Music From Another Room,1998,['United States of America'],"['Indie', 'Comedy', 'Romance Film', 'Romantic comedy']",1990,8
254152,Once Upon a Time,1986,['Japan'],"['Animation', 'World cinema', 'Drama', 'Japanese Movies', 'Anime', 'Steampunk', 'Science Fiction', 'Fantasy']",1980,6
19663841,In the Cool of the Day,1963,['United States of America'],"['Romance Film', 'Drama']",1960,3
6011641,Sherrybaby,2006,['United States of America'],"['Indie', 'Drama']",2000,6
2517905,The Fairly OddParents: Abra-Catastrophe!,2003,['United States of America'],"['Animation', 'Comedy', 'Family Film', 'Fantasy']",2000,3
27425045,Kalyanaraman,2002,['India'],"['Romantic comedy', 'Bollywood']",2000,2
2022788,Bionicle 3: Web of Shadows,2005,['United States of America'],"['Computer Animation', 'Animation', 'Adventure', 'Fantasy', 'Science Fiction', 'Family Film']",2000,5
4391376,The Ghost in the Invisible Bikini,1966,['United States of America'],"['Heavenly Comedy', 'Comedy', 'Beach Film', 'Fantasy']",1960,6
23688847,Beck – I Guds namn,2007,[],"['Mystery', 'Crime Fiction']",2000,7
32253591,Nayee Padosan,2003,['India'],"['Musical', 'Romantic drama', 'Comedy', 'Bollywood', 'World cinema', 'Romance Film', 'Drama', 'Romantic comedy']",2000,3
24065067,S/Y Joy,1989,['Sweden'],['Drama'],1980,9
31322893,Berlin – Ecke Schönhauser…,1957,"['Germany', 'German Democratic Republic']","['Crime Fiction', 'Art film', 'World cinema', 'Romance Film', 'Drama']",1950,7
23907596,Teen Devian,1965,['India'],"['Romantic drama', 'World cinema', 'Romance Film', 'Drama']",1960,5
5879984,Thirumalai,2003,['India'],"['Romantic drama', 'World cinema', 'Romance Film', 'Drama']",2000,3
2806974,The Isle,2000,['South Korea'],"['Drama', 'Thriller', 'World cinema']",2000,0
3737477,Don't Lose Your Head,1966,['United Kingdom'],"['Adventure Comedy', 'Parody', 'Comedy']",1960,6
1955275,"Dragon Fist Explosion!! If Gokū Can't Do It, Who Will?",1995,['Japan'],['Japanese Movies'],1990,5
5811284,Bala,2002,['India'],"['Action/Adventure', 'Tamil cinema', 'World cinema', 'Drama']",2000,2
255194,High Society,1956,['United States of America'],"['Musical', 'Comedy', 'Romance Film', 'Romantic comedy']",1950,6
18901219,Ahista Ahista,1981,['India'],"['Musical', 'Romance Film']",1980,1
7079205,A Dog Year,2009,['United States of America'],"['Comedy', 'Animal Picture', 'Comedy-drama', 'Drama']",2000,9
9764956,Fantômas se déchaîne,1965,"['France', 'Italy']","['Crime Fiction', 'Parody', 'Comedy Thriller', 'Thriller', 'Comedy', 'Master Criminal Films', 'Adventure']",1960,5
24043885,Arthur and the Vengeance of Maltazard,2009,"['United States of America', 'France']","['Animation', 'Adventure', 'Family Film', 'Fantasy']",2000,9
1873637,Carve Her Name with Pride,1958,['United Kingdom'],"['Spy', 'Film adaptation', 'Thriller', 'War film', 'Drama']",1950,8
16354971,Engal Aasan,2009,['India'],"['Action', 'Drama']",2000,9
11964824,Abhi,2008,['India'],"['Drama', 'Comedy']",2000,8
3610422,'Neath the Arizona Skies,1934,['United States of America'],"['Action', 'B-Western', 'Black-and-white', 'Action/Adventure', 'Western']",1930,4
5109880,The Iron Ladies,2000,"['Taiwan', 'Thailand']","['LGBT', 'Comedy', 'World cinema', 'Gay Themed', 'Gay', 'Gay Interest', 'Sports', 'Sex comedy']",2000,0
18104083,Blue,2009,['India'],"['Action', 'Bollywood', 'World cinema', 'Drama']",2000,9
226562,Tin Cup,1996,['United States of America'],"['Comedy', 'Romantic comedy', 'Romance Film', 'Sports', 'Drama']",1990,6
10945117,The Salon,2007,['United States of America'],"['Indie', 'Comedy', 'Workplace Comedy', 'Drama']",2000,7
11451733,Raza,1942,['Spain'],"['Black-and-white', 'War film', 'Biographical film']",1940,2
34717305,The Stranger Wore a Gun,1953,['United States of America'],['Western'],1950,3
4616225,Monrak Transistor,2001,['Thailand'],"['Musical', 'Crime Fiction', 'Romantic comedy', 'Drama']",2000,1
24204216,Eyes Beyond Seeing,1995,"['Canada', 'United States of America']",['Drama'],1990,5
21604407,Aduri,2008,['United States of America'],"['Action', 'Thriller', 'Drama']",2000,8
8175804,Sharpe's Eagle,1993,['United Kingdom'],"['Period piece', 'Costume Adventure', 'Historical fiction', 'Adventure']",1990,3
6678894,Milan,1995,['Philippines'],"['Filipino Movies', 'Romantic drama', 'World cinema', 'Romance Film', 'Drama']",1990,5
2317900,The Great Raid,2005,"['United States of America', 'Australia']","['Action', 'Drama', 'War film']",2000,5
29267198,Mr. Satan,1938,['United Kingdom'],['Crime Fiction'],1930,8
14284023,Santa Baby,2006,['United States of America'],"['Comedy', ""Children's/Family"", 'Holiday Film', 'Christmas movie', 'Family Film']",2000,6
451817,Taxi,2004,"['United States of America', 'France']","['Action', 'Heist', 'Crime Fiction', 'Action/Adventure', 'Comedy', 'Thriller']",2000,4
9208103,Condemned to Live,1935,['United States of America'],"['Black-and-white', 'Mystery', 'Thriller', 'Horror']",1930,5
12696049,Baby Mama,2008,['United States of America'],"['Romance Film', 'Comedy']",2000,8
26640372,Heritage of the Desert,1932,['United States of America'],"['Action', 'Romance Film', 'Western']",1930,2
1595142,Return to Never Land,2002,"['Canada', 'Australia', 'France', 'United States of America']","['Fantasy Adventure', 'Animation', ""Children's/Family"", ""Children's"", 'Family Film', 'Fantasy']",2000,2
14892910,The Maiden Heist,2009,['United States of America'],"['Heist', 'Crime Fiction', 'Comedy', 'Crime Comedy']",2000,9
34183631,Young Pioneers' Christmas,1976,[],"['Western', 'Drama']",1970,6
2267722,It Should Happen to You,1954,['United States of America'],"['Comedy', 'Satire', 'Romance Film', 'Romantic comedy']",1950,4
28336238,Priya Amar Priya,2008,[],"['Action', 'Romantic comedy']",2000,8
5488755,Extreme Days,2001,['United States of America'],"['Action', 'Action/Adventure', 'Teen', 'Christian film', 'Comedy-drama', 'Road movie', 'Sports']",2000,1
4409932,Namkeen,1982,['India'],"['Drama', 'Family Film']",1980,2
10396322,Young Man of Manhattan,1930,['United States of America'],"['Romance Film', 'Black-and-white', 'Comedy']",1930,0
3504034,The Mummy's Ghost,1944,['United States of America'],"['Creature Film', 'Archaeology', 'Horror']",1940,4
31398398,Orikkal Oridathu,1985,[],"['Romance Film', 'Drama']",1980,5
7917619,The Mackintosh Man,1973,"['United Kingdom', 'United States of America']","['Action', 'Spy', 'Action Thrillers', 'Action/Adventure', 'Thriller', 'Crime Thriller']",1970,3
28645418,Phantom of Death,1988,['Italy'],"['Mystery', 'Thriller', 'Horror']",1980,8
35722562,Casa de Mujeres,1966,['Mexico'],['Drama'],1960,6
16942427,Izzatdaar,1990,['India'],"['Action', 'Crime Fiction', 'Drama']",1990,0
22050847,An Empress and the Warriors,2008,"['China', 'Hong Kong']","['Action', 'Action/Adventure', 'World cinema', 'Romance Film', 'Chinese Movies', 'Martial Arts Film', 'Drama', 'Wuxia', 'War film']",2000,8
23721339,House of the Wolfman,2009,['United States of America'],"['Monster movie', 'Black-and-white', 'Monster', 'Horror', 'Cult']",2000,9
4890837,Reno 911!: Miami,2007,['United States of America'],"['Gross out', 'Crime Fiction', 'Gross-out film', 'Parody', 'Comedy', 'Slapstick']",2000,7
28999821,Ulladakkam,1991,['India'],"['Musical', 'Comedy']",1990,1
18002503,Kalippattam,1993,['India'],['Drama'],1990,3
12508219,Hearts in Dixie,1929,['United States of America'],"['Musical', 'Black-and-white', 'Drama']",1920,9
5649709,Gulliver's Travels,1939,['United States of America'],"['Musical', 'Animation', 'Adventure', 'Drama', 'Family Film']",1930,9
32095743,You for Me,1952,['United States of America'],"['Romance Film', 'Comedy']",1950,2
6901519,Don't Look in the Basement,1973,['United States of America'],['Horror'],1970,3
3643455,Cleopatra Jones and the Casino of Gold,1975,"['Hong Kong', 'United States of America']","['Action', 'Blaxploitation', 'Chinese Movies']",1970,5
8205806,Snake in the Monkey's Shadow,1980,['Hong Kong'],"['Action', 'Drama', 'Chinese Movies', 'Martial Arts Film']",1980,0
1365502,Teacher's Pet,1958,['United States of America'],"['Black-and-white', 'Comedy', 'Romance Film', 'Romantic comedy']",1950,8
11585359,Piñata,2005,['Australia'],"['Computer Animation', 'Short Film', 'Comedy']",2000,5
28009800,The Boys Club,1997,['Canada'],"['Suspense', 'Crime Fiction', 'Coming of age', 'Thriller', 'Teen', 'Crime Thriller', 'Drama']",1990,7
28900693,Onnaman,2001,['India'],"['Romance Film', 'Drama']",2000,1
6490523,A Force of One,1979,['United States of America'],"['Action', 'Crime Fiction', 'Action Thrillers', 'Indie', 'Action/Adventure', 'Thriller', 'Martial Arts Film', 'Drama']",1970,9
32819057,The Hayseeds,1933,[],"['Musical', 'Comedy film']",1930,3
26188329,Return of the Texan,1952,['United States of America'],['Western'],1950,2
13084474,Torpedo Run,1958,['United States of America'],"['Action', 'Combat Films', 'Drama', 'Melodrama']",1950,8
6602875,La Habitación Azul,2002,['Mexico'],['Drama'],2000,2
11141345,The Seven Minutes,1971,['United States of America'],"['Drama', 'Erotica']",1970,1
7769076,California Suite,1978,['United States of America'],"['Screwball comedy', 'Romantic drama', 'Comedy', 'Romance Film', 'Romantic comedy', 'Drama']",1970,8
2894499,The Strange One,1957,['United States of America'],['Drama'],1950,7
24678269,Sharada,1957,['India'],"['Musical', 'Romantic drama', 'Bollywood', 'World cinema', 'Romance Film', 'Drama', 'Slice of life story']",1950,7
28472340,Spook Chasers,1957,['United States of America'],"['Crime Fiction', 'Mystery', 'Comedy film', 'Horror']",1950,7
26207410,New Delhi Times,1986,['India'],['Drama'],1980,6
22663463,Young Widow,1946,['United States of America'],"['Melodrama', 'Drama']",1940,6
14608863,Scene of the Crime,1996,['United States of America'],"['Mystery', 'Indie', 'Thriller', 'Drama']",1990,6
4213154,The White Countess,2005,"['China', 'United Kingdom', 'Germany', 'United States of America']","['Period piece', 'Romantic drama', 'Romance Film', 'Chinese Movies', 'Drama']",2000,5
1692374,Cooley High,1975,['United States of America'],"['Comedy film', 'Romance Film', 'Comedy-drama', 'Drama']",1970,5
6027277,Shy People,1987,['United States of America'],"['Family Drama', 'Drama']",1980,7
32726414,Killer Instinct,1991,['United States of America'],"['Thriller', 'Crime Fiction']",1990,1
5373279,Gorp,1980,['United States of America'],"['Indie', 'Comedy']",1980,0
5980263,The Wonderful World of the Brothers Grimm,1962,['United States of America'],"['Musical', 'Biographical film', 'Stop motion', 'Adventure', 'Drama', 'Family Film', 'Fantasy']",1960,2
24098337,"Three – Love, Lies and Betrayal",2009,[],"['Drama', 'Mystery', 'Thriller']",2000,9
6858770,Sigappu Rojakkal,1978,['India'],"['Action', 'Bollywood', 'Horror']",1970,8
30013158,They Shall Have Music,1939,['United States of America'],"['Music', 'Drama', 'Family Film']",1930,9
4340789,The Dying Gaul,2005,['United States of America'],"['LGBT', 'Drama', 'Indie']",2000,5
3198813,Bunny Hugged,1951,['United States of America'],"['Animation', 'Short Film', 'Family Film']",1950,1
20579738,Ghar Ghar Ki Kahani,1970,['India'],"['Musical', 'Bollywood', 'World cinema', 'Drama']",1970,0
10550235,Maya Kannadi,2007,['India'],['Drama'],2000,7
1514063,Nude on the Moon,1961,['United States of America'],"['Sexploitation', 'Parody', 'Comedy', 'Science Fiction']",1960,1
10099627,Up the Front,1972,['United Kingdom'],"['Slapstick', 'Comedy film']",1970,2
27264955,Five Fingers,2005,['India'],"['Romance Film', 'Drama']",2000,5
12114243,Ober Da Bakod,1994,[],[],1990,4
13853693,Happiness,2007,['South Korea'],"['Romance Film', 'Drama']",2000,7
27289546,Beauty and the Barge,1937,['United Kingdom'],['Comedy'],1930,7
28091468,Flame in the Heather,1935,['United Kingdom'],['Drama'],1930,5
7034456,2001 Maniacs,2005,['United States of America'],"['Slasher', 'Comedy', 'Horror Comedy', 'Remake', 'Horror', 'Cult']",2000,5
25702392,Daylight Robbery,2008,['United Kingdom'],"['Thriller', 'Crime Thriller']",2000,8
2609817,Leatherface: Texas Chainsaw Massacre III,1990,['United States of America'],"['Slasher', 'Horror', 'Road-Horror', 'Cult']",1990,0
935892,Blue Hawaii,1961,['United States of America'],"['Musical', 'Comedy', 'Romance Film', 'Romantic comedy']",1960,1
179064,Human Nature,2001,"['United States of America', 'France']","['Indie', 'Comedy', 'Satire', 'Comedy of manners', 'Romance Film', 'Black comedy', 'Parody', 'Romantic comedy', 'Comedy-drama', 'Fantasy Comedy', 'Cult']",2000,1
724258,Mission: Impossible,1996,['United States of America'],"['Action', 'Spy', 'Action/Adventure', 'Thriller']",1990,6
877013,Tintin and the Blue Oranges,1964,"['France', 'Spain']","['Comedy', 'Adventure', 'Science Fiction', 'Family Film']",1960,4
9990262,200 Pounds Beauty,2006,['South Korea'],"['Romance Film', 'Comedy']",2000,6
21209475,British Agent,1934,['United States of America'],"['Spy', 'Romantic drama', 'War film', 'Drama']",1930,4
26426637,Kattalai,1993,[],"['Romance Film', 'Drama']",1990,3
2035320,Le Fate Ignoranti,2001,"['France', 'Italy']","['LGBT', 'Drama', 'World cinema']",2000,1
28496275,Pandu Pandoru Rajakumari,1992,['India'],"['Drama', 'Comedy']",1990,2
22937275,Ghost of Chibusa Enoki,1958,['Japan'],"['Black-and-white', 'Japanese Movies', 'Horror']",1950,8
17735988,Bottoms Up,2006,['United States of America'],"['Romantic comedy', 'Comedy']",2000,6
11704927,Chakra,1981,['India'],"['Art film', 'Bollywood', 'World cinema', 'Drama']",1980,1
3951250,Motor Mania,1950,[],"['Animation', 'Short Film', 'Family Film']",1950,0
914479,Antoine and Colette,1962,['France'],"['Short Film', 'Black-and-white']",1960,2
1206401,Jay Jay,2003,['India'],"['Romantic drama', 'Comedy', 'World cinema', 'Tamil cinema', 'Romance Film', 'Drama', 'Short Film', 'Romantic comedy']",2000,3
20518653,Kingsajz,1989,['Poland'],"['Comedy', 'World cinema', 'Drama', 'Fantasy']",1980,9
27872916,A Taste of Evil,1971,['United States of America'],"['Thriller', 'Horror']",1970,1
12247465,Death Bed: The Bed That Eats,1977,['United States of America'],"['Supernatural', 'Horror']",1970,7
5248234,Finder's Fee,2001,['United States of America'],"['Psychological thriller', 'Suspense', 'Indie', 'Thriller', 'Drama']",2000,1
1765701,Girl Happy,1965,['United States of America'],"['Musical', 'Comedy', 'Musical comedy', 'Romance Film', 'Romantic comedy', 'Beach Film']",1960,5
12005731,Sporting Blood,1931,['United States of America'],"['Black-and-white', 'Drama']",1930,1
890407,Husbands and Wives,1992,['United States of America'],"['Drama', 'Screwball comedy', 'Indie', 'Satire', 'Comedy', 'Romance Film', 'Romantic comedy']",1990,2
18541737,The Bothersome Man,2006,"['Norway', 'Iceland']","['Comedy', 'Thriller', 'World cinema', 'Supernatural', 'Drama', 'Fantasy']",2000,6
26693031,Sound of Boot,2008,['India'],"['Action', 'Psychological thriller', 'Crime Fiction', 'Mystery', 'Thriller']",2000,8
484876,The War Room,1993,['United States of America'],"['Political cinema', 'Documentary', 'History']",1990,3
15290813,The Dark Tower,1943,['United Kingdom'],"['Black-and-white', 'Drama']",1940,3
1421256,Who Is Harry Kellerman and Why Is He Saying Those Terrible Things About Me?,1971,['United States of America'],"['Comedy', 'Drama', 'Fantasy']",1970,1
21661747,The Dust of Time,2009,"['Russia', 'France', 'Germany', 'Greece', 'Italy']","['Art film', 'Drama', 'World cinema']",2000,9
4159282,Spotswood,1992,"['New Zealand', 'Australia']","['Crime Fiction', 'Indie', 'Comedy', 'World cinema', 'Drama']",1990,2
31046582,Love and Action in Chicago,1999,['United States of America'],"['Action', 'Action/Adventure', 'Comedy', 'Black comedy', 'Romance Film', 'Comedy Thriller', 'Romantic comedy', 'Comedy-drama']",1990,9
1844221,El Topo,1970,['Mexico'],"['Surrealism', 'Indie', 'Action/Adventure', 'Avant-garde', 'Hybrid Western', 'World cinema', 'Acid western', 'Drama', 'Western', 'Existentialism', 'Experimental film', 'Cult']",1970,0
4544208,Health,1980,['United States of America'],['Comedy'],1980,0
12030606,El Dorado,1988,"['France', 'Spain', 'Italy']",['Drama'],1980,8
16902655,Bereft,2004,['United States of America'],"['Drama', 'Romantic drama', 'Indie', 'Comedy', 'Television movie']",2000,4
18537547,Maria Mariana,1996,['Malaysia'],"['Action', 'Romance Film', 'Drama']",1990,6
2828905,Alice in Wonderland,1999,"['United Kingdom', 'Germany', 'United States of America']","['Comedy', 'Television movie', 'Costume drama', 'Adventure', 'Family Film', 'Fantasy']",1990,9
19042274,The Love Test,1935,['United Kingdom'],"['Romance Film', 'Comedy']",1930,5
6900622,Madame Bovary,1949,['United States of America'],"['Film adaptation', 'Black-and-white', 'Romantic drama', 'Romance Film', 'Costume drama', 'Drama']",1940,9
20969093,Reality Horror Night,2009,['United States of America'],"['Comedy', 'Horror']",2000,9
2513894,Analyze That,2002,['United States of America'],"['Gangster Film', 'Buddy film', 'Comedy', 'Crime Comedy']",2000,2
18607185,Smash Cut,2009,['Canada'],"['Slasher', 'Horror Comedy', 'Horror', 'B-movie']",2000,9
4401133,Smiley Face,2007,"['Germany', 'United States of America']","['Stoner film', 'Indie', 'Comedy', 'Comedy of Errors', 'Adventure', 'Cult', 'Fantasy']",2000,7
5153086,Hell Below,1933,['United States of America'],"['Action', 'Black-and-white', 'Romance Film', 'War film', 'Adventure', 'Drama']",1930,3
28236253,Mickey the Detective,1928,['United States of America'],['Short Film'],1920,8
11674085,My Wife is a Gangster 3,2006,"['China', 'South Korea']","['Action', 'Drama', 'Gangster Film', 'Comedy', 'Chinese Movies']",2000,6
27097,Star Trek: First Contact,1996,['United States of America'],"['Action', 'Time travel', 'Thriller', 'Adventure', 'Science Fiction']",1990,6
25020314,Pot Luck,1936,['United Kingdom'],"['Comedy film', 'Crime Fiction']",1930,6
2018425,Major Barbara,1941,['United Kingdom'],"['Black-and-white', 'Satire', 'Comedy']",1940,1
13314552,Love at First Sight,1977,"['Soviet Union', 'Georgia']","['Romance Film', 'Drama']",1970,7
2622711,Downtime,1995,['United Kingdom'],['Science Fiction'],1990,5
14952490,Plan,2004,['India'],"['Musical', 'Thriller', 'World cinema']",2000,4
22528630,First Family,1980,['United States of America'],['Comedy'],1980,0
6862788,Bang,1995,['United States of America'],"['Crime Fiction', 'Indie', 'Drama']",1990,5
7237206,Roja Kootam,2002,['India'],"['Musical', 'Romantic drama', 'World cinema', 'Romance Film', 'Drama']",2000,2
12193119,Hirttämättömät,1971,['Finland'],['Comedy'],1970,1
2675949,Without Warning!,1952,['United States of America'],"['Film noir', 'Black-and-white', 'Thriller']",1950,2
26798950,The Art of Losing,2004,"['Colombia', 'Spain']","['Crime Thriller', 'Thriller', 'World cinema']",2000,4
16730206,I.T.A.L.Y.,2008,['Philippines'],"['Filipino Movies', 'Romantic drama', 'World cinema', 'Romance Film', 'Romantic comedy', 'Drama']",2000,8
12622802,Radioactive Dreams,1985,['United States of America'],"['Comedy horror', 'Apocalyptic and post-apocalyptic fiction', 'Science Fiction', 'Fantasy']",1980,5
32048853,Swing Shift Maisie,1943,['United States of America'],"['Historical fiction', 'War effort', 'Comedy']",1940,3
14337425,The Invitation,1973,"['Switzerland', 'France']","['Psychological thriller', 'Comedy', 'Thriller']",1970,3
182164,Grave of the Fireflies,1988,['Japan'],"['Animation', 'Japanese Movies', 'Anime', 'War film', ""Children's"", 'Drama']",1980,8
15293843,When I Turned Nine,2004,['South Korea'],['Drama'],2000,4
1172681,Riding the Bullet,2004,"['Germany', 'United States of America', 'Canada']","['Psychological thriller', 'Film adaptation', 'Horror', 'Road movie']",2000,4
1333447,Roosters,1993,['United States of America'],"['Sports', 'Indie', 'Drama']",1990,3
5923051,International Velvet,1978,['United States of America'],"['Horse racing', 'Coming of age', 'Family Drama', 'Animal Picture', ""Children's/Family"", 'Drama', 'Family Film']",1970,8
5649004,Rufus Jones for President,1933,['United States of America'],"['Musical', 'Black-and-white', 'Short Film', 'Comedy']",1930,3
10835293,The Adventures of Captain Zoom in Outer Space,1995,['United States of America'],['Science Fiction'],1990,5
4578695,Psycho,1998,['United States of America'],"['Psychological thriller', 'Mystery', 'Slasher', 'Thriller', 'Horror']",1990,8
164502,The Adventures of Baron Munchausen,1988,"['United Kingdom', 'United States of America']","['Action', 'Fantasy Adventure', 'Costume Adventure', 'Action/Adventure', 'Comedy', 'Costume drama', 'Adventure', 'Drama', 'Steampunk', 'Fantasy Comedy', 'Family Film', 'Fantasy']",1980,8
12918018,Japan,2008,['United States of America'],"['Action', 'Crime Fiction', 'Drama']",2000,8
8559494,Brooklyn Rules,2006,['United States of America'],"['Period piece', 'Crime Fiction', 'Gangster Film', 'Coming of age', 'Comedy-drama', 'Drama']",2000,6
1031157,City Hall,1996,['United States of America'],"['Political drama', 'Drama', 'Courtroom Drama']",1990,6
2903798,The Bodyguard,2004,['Thailand'],"['Action', 'Crime Fiction', 'Action/Adventure', 'Comedy', 'Thriller', 'World cinema', 'Martial Arts Film']",2000,4
12392195,The Photograph,2007,"['Indonesia', 'Switzerland', 'Sweden', 'France', 'Netherlands']","['Drama', 'World cinema']",2000,7
29305837,The Root of All Evil,1947,['United Kingdom'],['Drama'],1940,7
10947631,Elsa Fraulein SS,1977,['France'],"['Erotic thriller', 'Thriller', 'World cinema']",1970,7
26287729,Captain Scarlett,1953,['United States of America'],['Adventure'],1950,3
8743877,Cohen and Tate,1989,['United States of America'],"['Action', 'Crime Fiction', 'Thriller']",1980,9
15187505,Chronicle of a Death Foretold,1987,"['Colombia', 'France', 'Italy']",['Drama'],1980,7
14386636,Technotise Edit & I,2009,['Serbia'],"['Computer Animation', 'Animation', 'Thriller', 'World cinema', 'Anime', 'Fantasy', 'Science Fiction']",2000,9
2679044,The Reckless Moment,1949,['United States of America'],"['Film noir', 'Crime Drama', 'Melodrama', 'Drama']",1940,9
2595680,"Scotland, Pa.",2001,['United States of America'],"['Crime Fiction', 'Parody', 'Indie', 'Comedy', 'Black comedy']",2000,1
26048721,Troublesome Night 15,2002,['Hong Kong'],"['Chinese Movies', 'Horror']",2000,2
25263118,She-Wolves of the Wasteland,1987,['United States of America'],['Fantasy'],1980,7
21245534,The Decline,1961,['Greece'],['Drama'],1960,1
26013008,Butterflies,1993,['India'],"['Romance Film', 'Comedy film']",1990,3
6644383,Dixie Chicks: Shut Up and Sing,2006,['United States of America'],"['Music', 'Political cinema', 'Rockumentary', 'Indie', 'Biography', 'Documentary']",2000,6
1971532,Once Upon a Time in China III,1993,"['China', 'Hong Kong']","['Action', 'Action/Adventure', 'World cinema', 'Chinese Movies', 'Martial Arts Film']",1990,3
2147563,A Prairie Home Companion,2006,['United States of America'],"['Music', 'Musical', 'Comedy', 'Americana', 'Drama', 'Ensemble Film']",2000,6
26138411,Prey,2007,"['United States of America', 'South Africa']","['Action', 'Action/Adventure', 'Thriller', 'Horror']",2000,7
8671750,Wild Rebels,1967,['United States of America'],"['Drama', 'Crime Fiction']",1960,7
2149218,Swept Away,1974,['Italy'],"['Romantic drama', 'Comedy', 'World cinema', 'Romance Film', 'Adventure', 'Drama', 'Political cinema', 'Romantic comedy', 'Political drama']",1970,4
18222110,Chat Room,2002,['United States of America'],"['Indie', 'Comedy', 'Romance Film', 'Romantic comedy']",2000,2
8530244,The Art of War 2,2008,['United States of America'],"['Action', 'Action/Adventure', 'Thriller']",2000,8
23033300,Piranthaen Valarnthaen,1986,['India'],['Family Film'],1980,6
2400405,Crashout,1955,['United States of America'],"['Crime Fiction', 'Film noir', 'Crime Thriller', 'Escape Film']",1950,5
15372410,Baby Take a Bow,1934,['United States of America'],"['Musical', 'Black-and-white', 'Family Drama', 'Drama', 'Family Film']",1930,4
5192888,Knock on Any Door,1949,['United States of America'],"['Film noir', 'Black-and-white', 'Drama']",1940,9
11375668,Anokha Milan,1972,['India'],['Drama'],1970,2
2811955,Surf's Up,2007,['United States of America'],"['Sports', 'Computer Animation', 'Animation', 'Comedy', 'Mockumentary', 'Adventure', 'Family Film']",2000,7
4578720,Mudhoney,1965,['United States of America'],"['Sexploitation', 'Drama']",1960,5
7156984,Killing Words,2003,['Spain'],"['Psychological thriller', 'Crime Fiction', 'Thriller', 'World cinema', 'Crime Thriller', 'Drama']",2000,3
10466696,Caramel,2007,"['France', 'Lebanon']","['LGBT', 'Romantic drama', 'Comedy', 'World cinema', 'Romance Film', 'Drama', 'Romantic comedy', 'Slice of life story', 'Ensemble Film']",2000,7
7280629,Werewolf Woman,1976,['Italy'],"['World cinema', 'Horror']",1970,6
73441,E.T. the Extra-Terrestrial,1982,['United States of America'],"['Family Drama', ""Children's/Family"", 'Sci-Fi Adventure', ""Children's"", 'Adventure', 'Drama', ""Children's Fantasy"", 'Science Fiction', 'Family Film', 'Fantasy']",1980,2
1168522,Mimic,1997,['United States of America'],"['Thriller', 'Horror', 'Science Fiction', 'Natural horror films']",1990,7
5676692,Iron Man,2008,['United States of America'],"['Action', 'Action/Adventure', 'Thriller', 'Superhero movie', 'War film', 'Science Fiction']",2000,8
10791868,Aayiram Jenmangal,1978,['India'],['Horror'],1970,8
2436901,Factotum,2005,"['Norway', 'France', 'United States of America']","['Film adaptation', 'Indie', 'Biography', 'Comedy', 'Black comedy', 'Romance Film', 'Tragicomedy', 'Drama', 'Comedy-drama']",2000,5
8378772,The World of Abbott and Costello,1965,['United States of America'],"['Black-and-white', 'Comedy', 'Film', 'Family Film']",1960,5
23295876,Roseanna McCoy,1949,['United States of America'],"['Romance Film', 'Drama']",1940,9
1469695,Boogeyman,2005,"['Germany', 'United States of America', 'New Zealand']","['Mystery', 'Thriller', 'Horror', 'Teen', 'Supernatural', 'Drama']",2000,5
13149,Galaxy Quest,1999,['United States of America'],"['Action', 'Comedy', 'Adventure', 'Science Fiction']",1990,9
24236292,Fascination: Portrait of a Lady,1977,['Japan'],"['Erotica', 'Japanese Movies', 'Pornographic movie']",1970,7
5349196,Arul,2004,['India'],"['Musical', 'Tamil cinema', 'World cinema', 'Drama']",2000,4
25470407,Christmas Town,2008,['Canada'],"['Holiday Film', 'Fantasy']",2000,8
5383633,Suds,1920,['United States of America'],"['Black-and-white', 'Drama', 'Indie', 'Romantic drama', 'Comedy', 'Silent film', 'Romance Film']",1920,0
14316363,Knutzy Knights,1954,['United States of America'],"['Short Film', 'Black-and-white', 'Comedy']",1950,4
1722535,Barfly,1987,['United States of America'],"['Indie', 'Romantic drama', 'Biographical film', 'Black comedy', 'Romance Film', 'Drama']",1980,7
381543,Last of the Dogmen,1995,['United States of America'],"['Mystery', 'Indie', 'Action/Adventure', 'Western', 'Thriller', 'Adventure', 'Crime Thriller']",1990,5
5226874,Flicka,2006,"['United Kingdom', 'United States of America']","['Film adaptation', 'Family Drama', ""Children's/Family"", 'Adventure', 'Drama', 'Coming of age', 'Animal Picture', 'Family Film']",2000,6
20546667,Smilin' Through,1932,['United States of America'],['Black-and-white'],1930,2
9067740,Porky's Spring Planting,1938,['United States of America'],"['Animation', 'Short Film', 'Comedy', 'Family Film']",1930,8
8701507,Love Crimes,1992,"['United Kingdom', 'United States of America']","['Erotic thriller', 'Thriller']",1990,2
8481623,"Afrodita, el Jardín de Los Perfumes",1998,"['Argentina', 'Mali']",['Drama'],1990,8
18497485,Doraemon: The New Record of Nobita: Spaceblazer,2009,['Japan'],"['Anime', 'Adventure']",2000,9
3697918,Chemmeen,1965,['India'],"['Romantic drama', 'Drama']",1960,5
3451706,About Love,2005,"['Taiwan', 'China', 'Japan']","['Romance Film', 'Japanese Movies', 'Chinese Movies']",2000,5
10141649,Yeh Teraa Ghar Yeh Meraa Ghar,2001,['India'],"['Romantic drama', 'Comedy', 'World cinema', 'Romance Film', 'Romantic comedy', 'Drama']",2000,1
5210535,Thiruttu Payale,2006,['India'],"['Musical', 'Bollywood', 'World cinema', 'Drama']",2000,6
33333101,MGR Nagaril,1991,[],['Drama'],1990,1
2094965,Glory Daze,1996,['United States of America'],"['Coming of age', 'Indie', 'Comedy', 'Comedy-drama', 'Ensemble Film']",1990,6
10746524,Remp-It,2006,['Malaysia'],['Action'],2000,6
29501024,Newman's Law,1974,['United States of America'],"['Action', 'Thriller']",1970,4
5313,"Crouching Tiger, Hidden Dragon",2000,"['Hong Kong', 'China', 'Taiwan', 'United States of America']","['Action', 'Romance Film', 'Chinese Movies', 'Martial Arts Film', 'Adventure', 'Drama', 'Period piece', 'Fantasy']",2000,0
20426846,The King of the Mountain,2007,['Spain'],"['Action', 'Action/Adventure', 'Thriller', 'World cinema', 'Crime Thriller']",2000,7
20582277,Mortelle randonnée,1983,['France'],"['Action', 'Psychological thriller', 'Crime Fiction', 'Mystery', 'Action/Adventure', 'Thriller', 'World cinema', 'Crime Thriller', 'Drama', 'Suspense']",1980,3
9642489,Buenos Aires Vice Versa,1996,"['Argentina', 'Netherlands']","['Indie', 'Comedy', 'Melodrama', 'Drama']",1990,6
19985850,Thoranai,2009,['India'],"['Action', 'Humour']",2000,9
2020181,Elmer's Candid Camera,1940,['United States of America'],"['Short Film', 'Comedy']",1940,0
13976657,Dick Tracy,1945,['United States of America'],"['Film noir', 'Detective']",1940,5
906380,The Emperor's Shadow,1996,"['China', 'Hong Kong']","['World cinema', 'Historical Epic', 'Epic', 'Chinese Movies', 'Drama']",1990,6
453907,Big Night,1996,['United States of America'],"['Period piece', 'Drama', 'Indie', 'Family Drama', 'Comedy', 'Comedy-drama', 'Ensemble Film']",1990,6
9110442,Darkness in Tallinn,1993,"['Finland', 'Estonia', 'United States of America']","['Satire', 'Thriller', 'World cinema']",1990,3
24064711,Flight,1929,['United States of America'],['Action/Adventure'],1920,9
2773890,The Guilty,1947,['United States of America'],"['Film noir', 'Black-and-white']",1940,7
13210849,Alvarez Kelly,1966,['United States of America'],"['Action/Adventure', 'Western', 'Cavalry Film', 'War film', 'Costume drama']",1960,6
19412716,Doctor in Distress,1970,['United Kingdom'],"['Romantic comedy', 'Comedy']",1970,0
2991187,Untamed Heart,1993,['United States of America'],"['Romantic drama', 'Comedy', 'Romance Film', 'Romantic comedy', 'Drama', 'Medical fiction']",1990,3
5534117,Karma,1986,['India'],"['Action/Adventure', 'World cinema']",1980,6
21768047,Keroro Gunso the Super Movie 3: Keroro vs. Keroro Great Sky Duel,2008,['Japan'],['Japanese Movies'],2000,8
32751781,Bush Christmas,1947,"['United Kingdom', 'Australia']","['Adventure', 'Drama', 'Family Film']",1940,7
29012443,The First Born,1928,['United Kingdom'],"['Silent film', 'Black-and-white', 'Drama']",1920,8
27226283,Man-Proof,1938,['United States of America'],['Romantic comedy'],1930,8
28372778,Seize the Day,1986,['United States of America'],"['Indie', 'Drama']",1980,6
23117383,THINGS,1989,['Canada'],['Horror'],1980,9
25512090,Rain Fall,2009,['Japan'],"['Action', 'Action Thrillers', 'Action/Adventure', 'Thriller', 'World cinema', 'Crime Thriller', 'Japanese Movies', 'Political thriller']",2000,9
32161053,Gold Mine in the Sky,1938,['United States of America'],"['Musical', 'Western', 'Action/Adventure']",1930,8
1306686,Tamango,1957,"['France', 'Italy']","['History', 'Adventure', 'Drama']",1950,7
5867940,Home of the Brave,2006,"['Morocco', 'United States of America']","['War film', 'Drama']",2000,6
3917873,Chitty Chitty Bang Bang,1968,['United Kingdom'],"['Musical', 'Comedy', 'Family-Oriented Adventure', 'Family Film', 'Fantasy']",1960,8
15903940,The Bride with White Hair 2,1993,['Hong Kong'],"['Action/Adventure', 'World cinema', 'Chinese Movies', 'Martial Arts Film', 'Adventure', 'Sword and sorcery films', 'Wuxia', 'Fantasy']",1990,3
9604242,Rondo,1966,"['Yugoslavia', 'Croatia']",['Drama'],1960,6
5082374,The Day They Robbed the Bank of England,1960,['United Kingdom'],"['Crime Fiction', 'Mystery', 'Caper story']",1960,0
16167585,Sundhara Travels,2002,['India'],['Comedy'],2000,2
1170663,The Adventures of Rocky and Bullwinkle,2000,"['Germany', 'United States of America']","['Adventure Comedy', 'Fantasy Adventure', 'Buddy film', 'Comedy', ""Children's/Family"", 'Family Film', 'Adventure']",2000,0
26183040,Istanbul Beneath My Wings,1996,['Turkey'],"['Romance Film', 'Adventure', 'Drama']",1990,6
11691107,Bristol Boys,2005,['United States of America'],"['Crime Drama', 'Crime Fiction', 'Drama']",2000,5
28214227,Mickey in School,1928,['United States of America'],['Short Film'],1920,8
232301,Swathi Muthyam,1985,['India'],"['Drama', 'Family Film']",1980,5
36467334,The Major Lied 'Til Dawn,1938,['United States of America'],"['Animation', 'Short Film', 'Family Film']",1930,8
5449985,Gentlemen Marry Brunettes,1955,['United States of America'],"['Musical', 'Film adaptation', 'Comedy', 'Musical comedy', 'Drama']",1950,5
19069841,It All Goes to Show,1969,['United Kingdom'],['Short Film'],1960,9
9989811,Get Crazy,1983,['United States of America'],"['Musical', 'Indie', 'Parody', 'Comedy']",1980,3
17294536,It Might Get Loud,2008,['United States of America'],"['Music', 'Rockumentary', 'Biography', 'Documentary', 'Instrumental Music']",2000,8
31480409,Love Comes Lately,2007,"['Germany', 'United States of America', 'Austria']","['Film adaptation', 'Indie', 'Romantic drama', 'Comedy', 'World cinema', 'Romance Film', 'Drama', 'Romantic comedy', 'Fantasy']",2000,7
737797,1969,1988,['United States of America'],"['Anti-war', 'Period piece', 'Drama', 'Coming of age', 'Indie', 'Anti-war film', 'Political drama']",1980,8
842974,Our Man Flint,1966,['United States of America'],"['Action', 'Spy', 'Action/Adventure', 'Comedy', 'Thriller', 'Glamorized Spy Film', 'Parody', 'Science Fiction']",1960,6
2743891,License to Drive,1988,['United States of America'],"['Buddy film', 'Comedy', 'Teen']",1980,8
33832193,Il diavolo nel cervello,1972,['Italy'],['Psychological thriller'],1970,2
8545243,La Religieuse,1966,['France'],"['Period piece', 'Drama']",1960,6
7182247,Swarabhishekam,2004,['India'],['Music'],2000,4
2649791,The Air Up There,1994,['United States of America'],"['Comedy', 'Adventure']",1990,4
1356647,Homeboy,1988,['United States of America'],"['Boxing', 'Sports', 'Drama']",1980,8
143890,SpaceCamp,1986,['United States of America'],"['Coming of age', 'Action/Adventure', 'Adventure', 'Family-Oriented Adventure', 'Science Fiction', 'Family Film']",1980,6
31912450,My Nanny's Secret,2009,['Canada'],"['Crime Fiction', 'Mystery', 'Thriller']",2000,9
11796273,Suryavanshi,1992,['India'],"['Horror', 'Fantasy']",1990,2
28113191,The Divided Heart,1954,['United Kingdom'],"['Docudrama', 'Drama']",1950,4
13166707,They Wait,2007,['Canada'],"['Horror', 'Science Fiction']",2000,7
1525408,The Legend of Bagger Vance,2000,['United States of America'],"['Film adaptation', 'Comedy', 'Romance Film', 'Americana', 'Drama', 'Period piece', 'Sports', 'Fantasy']",2000,0
28086514,Frozen Kiss,2009,[],['Drama'],2000,9
1664079,The Allnighter,1987,['United States of America'],"['Coming of age', 'Comedy', 'Teen', 'Romantic comedy', 'Romance Film', 'Sex comedy']",1980,7
26494139,Millennium Stars,2000,['India'],['Drama'],2000,0
12568590,Mein Ek Din Laut Kay Aaoon Ga,2007,['Pakistan'],"['Action', 'Drama', 'Thriller', 'Family Film']",2000,7
1880039,The Harder They Fall,1956,['United States of America'],"['Film à clef', 'Black-and-white', 'Crime Fiction', 'Thriller', 'Film noir', 'Drama', 'Crime Drama', 'Sports']",1950,6
30603831,The Beggar,1983,[],"['Action', 'Crime Fiction', 'Comedy film']",1980,3
11142038,Blessed,2004,"['United Kingdom', 'United States of America']","['Supernatural', 'Horror']",2000,4
2043990,Spy Hard,1996,['United States of America'],"['Action', 'Spy', 'Crime Fiction', 'Parody', 'Action/Adventure', 'Comedy']",1990,6
11561029,Diary of a Shinjuku Thief,1969,['Japan'],"['Erotic Drama', 'Japanese Movies', 'Comedy', 'Drama']",1960,9
24416479,Beastmaster 2: Through the Portal of Time,1991,['United States of America'],"['Action', 'Sword and sorcery', 'Adventure', 'Science Fiction', 'Fantasy']",1990,1
18304705,El Chanfle,1979,['Mexico'],"['Comedy film', 'Drama', 'Family Film', 'Fantasy']",1970,9
30108283,Bhairav,2001,[],['Action'],2000,1
10724184,Casanova 70,1965,['Italy'],"['Romantic drama', 'Comedy', 'World cinema', 'Romance Film', 'Romantic comedy', 'Drama', 'Sex comedy']",1960,5
28218992,Secret Service of the Imperial Court,1984,['Hong Kong'],"['Action', 'Wuxia', 'Chinese Movies', 'Martial Arts Film', 'Adventure']",1980,4
18168131,Love! Valour! Compassion!,1997,['United States of America'],"['Gay Themed', 'LGBT', 'Drama', 'Indie', 'Comedy', 'Romance Film']",1990,7
34230483,Satan's Brew,1976,['Germany'],"['LGBT', 'Satire', 'World cinema', 'Black comedy', 'Drama', 'Gay Themed', 'Gay', 'Gay Interest', 'Comedy film', 'Comedy-drama']",1970,6
15236532,Lost Angel,1943,['United States of America'],"['Black-and-white', 'Drama']",1940,3
21013036,Captain Pirate,1952,['United States of America'],"['Action', 'Drama', 'Action/Adventure', 'Adventure', 'Swashbuckler films']",1950,2
1710716,The End,1978,['United States of America'],"['Black comedy', 'Comedy']",1970,8
5690130,Demonicus,2001,['United States of America'],"['Fantasy Adventure', 'Fantasy', 'Horror', 'Sword and sorcery', 'B-movie', 'Supernatural', 'Sword and sorcery films']",2000,1
2509859,Critters 2: The Main Course,1988,['United States of America'],"['Creature Film', 'Horror Comedy', 'Horror', 'Black comedy', 'Alien Film', 'Sci-Fi Horror', 'Science Fiction']",1980,8
2680994,"Silent Night, Deadly Night Part 2",1987,['United States of America'],"['Slasher', 'Comedy', 'Thriller', 'Horror', 'Drama']",1980,7
5569766,Gardens of Stone,1987,['United States of America'],"['Anti-war', 'Film adaptation', 'Anti-war film', 'War film', 'Drama']",1980,7
909664,Little Odessa,1994,['United States of America'],"['Crime Fiction', 'Coming of age', 'Gangster Film', 'Crime Drama', 'Drama']",1990,4
25808230,St. Elmo,1923,['United States of America'],"['Silent film', 'Drama']",1920,3
1881878,Nick of Time,1995,['United States of America'],"['Psychological thriller', 'Suspense', 'Crime Fiction', 'Short Film', 'Thriller', 'Crime Thriller', 'Drama']",1990,5
6030578,Obsession: Radical Islam's War Against the West,2007,['United States of America'],"['Law & Crime', 'Political cinema', 'History', 'Indie', 'Documentary', 'Culture & Society']",2000,7
11379985,Thirst,1949,['Sweden'],"['Black-and-white', 'Romantic drama', 'World cinema', 'Romance Film', 'Drama']",1940,9
6402018,Blood of a Champion,2006,['United States of America'],"['Crime Fiction', 'Sports', 'Drama']",2000,6
4715195,Easter Yeggs,1947,['United States of America'],"['Short Film', 'Family Film']",1940,7
7514063,P2,2007,['United States of America'],"['Psychological thriller', 'Slasher', 'Thriller', 'Horror']",2000,7
31707381,The Way to the Gold,1957,['United States of America'],"['Adventure', 'Drama']",1950,7
13785006,Little Marines,1991,['United States of America'],"['Action', 'Family-Oriented Adventure', ""Children's/Family"", 'Adventure', 'Family Film']",1990,1
27922055,The Mother of Invention,2009,[],['Mockumentary'],2000,9
3938164,At the Earth's Core,1976,"['United Kingdom', 'United States of America']","['Fantasy Adventure', 'Adventure', 'Science Fiction', 'Cult', 'Fantasy']",1970,6
9031535,Becoming Royston,2007,['Singapore'],['Drama'],2000,7
28106326,Creature,1998,['United States of America'],"['Science Fiction', 'Thriller', 'Horror']",1990,8
6455210,The Inspector Wears Skirts,1988,"['China', 'Hong Kong']","['Action', 'Martial Arts Film', 'Action Comedy', 'Action/Adventure', 'Comedy', 'World cinema', 'Chinese Movies']",1980,8
5993535,Over-Exposed,1956,['United States of America'],"['Black-and-white', 'Melodrama', 'Drama']",1950,6
587807,The Nutty Professor,1963,['United States of America'],"['Comedy', 'Romance Film', 'Romantic comedy', 'Slapstick', 'Science Fiction']",1960,3
17546919,Champions of Faith,2008,[],"['Sports', 'Biography', 'Documentary']",2000,8
22343600,Sons of Matthew,1949,['Australia'],['Drama'],1940,9
10774494,Apna Desh,1972,['India'],"['Romantic drama', 'World cinema', 'Romance Film', 'Drama']",1970,2
236691,Cabaret,1972,['United States of America'],"['Musical', 'Film adaptation', 'LGBT', 'New Hollywood', 'Drama']",1970,2
3303351,House of Dracula,1945,['United States of America'],"['Creature Film', 'Horror']",1940,5
5938554,Crossing,2007,['Canada'],"['Crime Fiction', 'Indie', 'Romance Film', 'Drama']",2000,7
27366970,The First 9½ Weeks,1998,['United States of America'],"['Thriller', 'Drama']",1990,8
22852522,The Loneliest Runner,1976,['United States of America'],"['Sports', 'Drama']",1970,6
26526609,Unfinished Business,1985,['Australia'],['Comedy'],1980,5
751100,Coneccion Caribe,1984,"['Argentina', 'Puerto Rico']",[],1980,4
7806783,I See You,2006,['India'],"['Romantic drama', 'World cinema', 'Romance Film', 'Drama']",2000,6
3569608,The Long Gray Line,1955,['United States of America'],"['Comedy', 'Biographical film', 'Biopic [feature]', 'Sports', 'Drama']",1950,5
30207145,Agni Varsha,2002,['India'],"['Drama', 'World cinema']",2000,2
24551035,Helen's Babies,1924,[],"['Silent film', 'Comedy']",1920,4
33447468,Hisaab Khoon Ka,1989,[],['Action'],1980,9
27074087,Mull,1988,['Australia'],['Drama'],1980,8
36057872,Kannukku Kannaga,2000,['India'],['Drama'],2000,0
21751211,The Lady Takes a Flyer,1958,['United States of America'],"['Romance Film', 'Drama']",1950,8
2717905,The Benchwarmers,2006,['United States of America'],"['Slapstick', 'Comedy', 'Sports', 'Adventure', 'Family Film']",2000,6
75261,National Lampoon's Animal House,1978,['United States of America'],"['Sex comedy', 'Gross out', 'Gross-out film', 'Comedy', 'Romance Film', 'Absurdism']",1970,8
4765785,Duck Soup,1927,['United States of America'],"['Black-and-white', 'Indie', 'Short Film', 'Comedy', 'Silent film']",1920,7
1345168,Liberty Heights,1999,['United States of America'],"['Music', 'Family Drama', 'Comedy', 'Romance Film', 'Americana', 'Drama', 'Period piece', 'Coming of age', 'Ensemble Film']",1990,9
19022589,A Get2Gether,2005,['United States of America'],"['Indie', 'Comedy']",2000,5
3926180,Franklin and the Green Knight,2000,['Canada'],"['Animation', ""Children's"", 'Family Film']",2000,0
3816197,Kidco,1984,['United States of America'],['Comedy'],1980,4
19271338,Takkar,2008,['India'],"['Action', 'Romance Film', 'Drama']",2000,8
1891886,V for Vendetta,2006,"['United Kingdom', 'Germany', 'United States of America']","['Action', 'Film adaptation', 'LGBT', 'Action/Adventure', 'Thriller', 'Drama', 'Dystopia', 'Future noir', 'Superhero movie', 'Science Fiction', 'Political thriller']",2000,6
21427980,Gifted Hands: The Ben Carson Story,2009,['United States of America'],"['Television movie', 'Inspirational Drama', 'Drama']",2000,9
1252259,Godzilla Against Mechagodzilla,2002,['Japan'],"['Creature Film', 'Action', 'Japanese Movies', 'Monster', 'World cinema', 'Science Fiction', 'Cult']",2000,2
13282759,The Night My Number Came Up,1955,['United Kingdom'],"['Combat Films', 'Drama', 'Thriller']",1950,5
1629120,The Prisoner of Second Avenue,1975,['United States of America'],"['Black comedy', 'Comedy']",1970,5
10299117,No No Nanette,1930,['United States of America'],"['Musical', 'Comedy']",1930,0
2634852,Lawyer Lawyer,1997,['Hong Kong'],"['Period piece', 'Comedy', 'World cinema', 'Chinese Movies', 'Drama']",1990,7
1819931,The Odd Angry Shot,1979,['Australia'],"['War film', 'Comedy', 'Drama']",1970,9
2089001,Lady Beware,1987,['United States of America'],"['Psychological thriller', 'Indie', 'Thriller', 'Erotica']",1980,7
7533751,One Night Stand,1984,"['Canada', 'Australia']",['Drama'],1980,4
24381557,Gambling City,1975,['Italy'],"['Action', 'Crime Fiction', 'Action/Adventure', 'Thriller', 'World cinema', 'Crime Thriller', 'Drama']",1970,5
2642113,Time of Favor,2000,['Israel'],"['Thriller', 'World cinema', 'Political drama', 'Drama', 'Political thriller']",2000,0
28199182,Tread Softly Stranger,1958,['United Kingdom'],"['Drama', 'Crime Fiction']",1950,8
23275083,A Ghost Story of Joseon Dynasty,1970,['South Korea'],['Horror'],1970,0
14107960,El Paso Wrecking Corp.,1977,['United States of America'],"['Gay Themed', 'Gay', 'Gay Interest', 'Pornographic movie', 'Gay pornography', 'Adult']",1970,7
10700014,Hawas,1974,['India'],"['Romance Film', 'Drama', 'Family Film']",1970,4
1354975,Changing Lanes,2002,['United States of America'],"['Psychological thriller', 'Suspense', 'Thriller', 'Melodrama', 'Drama']",2000,2
30873812,The Sons of the Great Bear,1966,"['Germany', 'German Democratic Republic']","['Action/Adventure', 'Western', 'World cinema', 'Drama']",1960,6
7533357,Freaky Friday,1976,['United States of America'],"['Comedy', 'Drama', 'Family Film', 'Fantasy']",1970,6
9122363,College Humor,1933,['United States of America'],"['Musical', 'Black-and-white', 'Comedy']",1930,3
8484720,Sleeping Pills,2003,[],['Drama'],2000,3
20829476,Alien Raiders,2008,['United States of America'],"['Science Fiction', 'Thriller', 'Horror']",2000,8
33045817,The Crime of Dr. Crespi,1935,[],"['Crime Fiction', 'Mystery', 'Horror']",1930,5
5269245,"The World, the Flesh and the Devil",1959,['United States of America'],"['Doomsday film', 'Disaster', 'Science Fiction']",1950,9
5549932,Internal Affairs,1990,['United States of America'],"['Suspense', 'Crime Fiction', 'Thriller', 'Crime Thriller', 'Drama']",1990,0
24735116,Hold-Up,1985,"['Canada', 'France']","['Comedy film', 'Crime Fiction']",1980,5
21595912,Still Waiting...,2009,['United States of America'],"['Workplace Comedy', 'Indie', 'Comedy']",2000,9
2005119,Sabah,2005,['Canada'],"['Drama', 'Indie', 'Romantic drama', 'Comedy', 'Romance Film', 'Romantic comedy']",2000,5
7638932,Promise Me This,2007,"['Serbia', 'France']","['Art film', 'Comedy', 'World cinema', 'Drama']",2000,7
7725710,Hyde and Hare,1955,[],"['Animation', 'Short Film', 'Comedy film', 'Family Film']",1950,5
21141526,Otan leipei i gata,1962,['Greece'],['Comedy'],1960,2
1343352,Ben Hur,2003,['United States of America'],"['Animated cartoon', 'Animation', 'Christian film', 'Epic', 'Adventure', 'Drama', 'Family Film']",2000,3
5911735,Tovarich,1937,['United States of America'],"['Comedy', 'Black-and-white']",1930,7
25914703,Poovinnu Puthiya Poonthennal,1986,['India'],"['Action', 'Crime Fiction', 'Thriller', 'Bollywood', 'Family Film']",1980,6
11522949,Oh Schuks... I'm Gatvol,2004,['South Africa'],['Comedy'],2000,4
3447166,Little Shop of Horrors,1986,['United States of America'],"['Musical', 'Parody', 'Comedy', 'Horror', 'Black comedy', 'Romance Film', 'Science Fiction']",1980,6
15055389,Charlie Chan in Egypt,1935,['United States of America'],"['Detective fiction', 'Black-and-white', 'Mystery', 'Thriller', 'Detective', 'Horror', 'Crime Thriller']",1930,5
2853229,Thiruda Thiruda,1993,['India'],"['Action', 'Drama', 'Crime Fiction', 'Comedy']",1990,3
34404625,Bhaaga Pirivinai,1959,['India'],[],1950,9
11502520,Fox and His Friends,1975,"['Germany', 'West Germany']","['LGBT', 'Crime Fiction', 'Romance Film', 'Drama']",1970,5
2550894,Undiscovered,2005,"['Germany', 'United States of America']","['Indie', 'Comedy', 'Romance Film', 'Romantic comedy', 'Drama']",2000,5
23477628,Danger – Love at Work,1937,['United States of America'],['Screwball comedy'],1930,7
26615635,Awara Baap,1985,['India'],"['Romance Film', 'Drama']",1980,5
8244890,King Cobra,1999,['United States of America'],"['Science Fiction', 'Natural horror films', 'Horror']",1990,9
28827468,Hero of Rome,1964,['Italy'],"['Action', 'Action/Adventure', 'World cinema', 'Adventure', 'Drama', 'Fantasy']",1960,4
8668124,Count Dracula,1977,['United Kingdom'],"['Television movie', 'Horror']",1970,7
18684054,Love and Honor,2006,['Japan'],"['Art film', 'Japanese Movies', 'Romantic drama', 'World cinema', 'Romance Film', 'Drama']",2000,6
5326183,Belle's Magical World,1998,['United States of America'],"['Fairy tale', ""Children's Fantasy"", 'Animation', ""Children's"", ""Children's/Family"", 'Adventure', 'Family Film']",1990,8
10444367,Cheers for Miss Bishop,1941,['United States of America'],"['Romantic drama', 'Drama']",1940,1
18071506,Commandos,1968,['Italy'],"['Action/Adventure', 'Western', 'World cinema', 'War film', 'Drama']",1960,8
1334877,Minbo,1992,['Japan'],"['Comedy', 'Japanese Movies']",1990,2
30811665,India: Kingdom of the Tiger,2002,['Canada'],"['Travel', 'Documentary']",2000,2
5962955,Maelström,2000,['Canada'],"['Crime Fiction', 'Indie', 'Drama']",2000,0
12877496,The Sea Gypsies,1978,['United States of America'],"['Adventure', 'Family-Oriented Adventure', ""Children's"", 'Drama', 'Family Film']",1970,8
241052,The Man Who Wasn't There,2001,['United States of America'],"['Period piece', 'Crime Fiction', 'Comedy', 'Drama']",2000,1
877743,Footloose,1984,['United States of America'],"['Musical', 'Coming of age', 'Teen', 'Dance', 'Romance Film', 'Drama', 'Family Film']",1980,4
8602643,The Phantom of the Opera,1998,"['Hungary', 'Italy']","['Slasher', 'Horror']",1990,8
18793770,Crisis,1950,['United States of America'],"['Black-and-white', 'Drama']",1950,0
11729093,Geeta Mera Naam,1974,['India'],"['Action', 'Thriller']",1970,4
19592108,Some Girls,1988,['United States of America'],"['Comedy', 'Black comedy', 'Romantic comedy', 'Romance Film']",1980,8
1961652,East of Hope Street,1998,['United States of America'],"['Coming of age', 'Drama']",1990,8
5396202,The Great Gabbo,1929,['United States of America'],"['Musical', 'Romance Film', 'Melodrama', 'Drama']",1920,9
26132673,Single Room Furnished,1968,['United States of America'],['Drama'],1960,8
17651907,Tekken,2009,"['Japan', 'United States of America']","['Action', 'Crime Fiction', 'Action/Adventure', 'Thriller', 'Martial Arts Film', 'Adventure', 'Drama', 'Japanese Movies', 'Science Fiction', 'Fantasy']",2000,9
4746656,Vedham Pudhithu,1987,['India'],['Drama'],1980,7
8235561,Taffin,1988,"['Ireland', 'United Kingdom']","['Action', 'Suspense', 'Action Thrillers', 'Action/Adventure', 'Thriller', 'World cinema', 'Drama']",1980,8
13871052,The Cowboy and the Lady,1938,['United States of America'],"['Black-and-white', 'Screwball comedy', 'Western', 'Comedy', 'Romance Film', 'Romantic comedy']",1930,8
17079759,Tales from the Crapper,2004,['United States of America'],"['Gross out', 'Gross-out film', 'Horror Comedy', 'Comedy', 'Sexploitation', 'Parody', 'Splatter film', 'Horror', 'Cult']",2000,4
15453009,A Devilish Murder,1965,['South Korea'],"['Thriller', 'Horror']",1960,5
8829625,Rocket Man,1997,['United States of America'],"['Comedy', 'Slapstick', 'Science Fiction', 'Family Film']",1990,7
12776314,Shanghai Dreams,2005,['China'],"['Coming of age', 'Family Drama', 'Chinese Movies', 'Drama']",2000,5
32655333,The Squatter's Daughter,1933,[],['Drama'],1930,3
23194543,"Raging Sun, Raging Sky",2009,['Mexico'],"['LGBT', 'Drama', 'World cinema']",2000,9
11649391,The Anonymous Venetian,1970,['Italy'],['Drama'],1970,0
6859404,The Hunters,1958,['United States of America'],"['Action', 'Film adaptation', 'Romantic drama', 'Romance Film', 'Adventure', 'Drama', 'Period piece', 'War film']",1950,8
9917330,This Man Must Die,1969,"['France', 'Italy']","['Psychological thriller', 'Crime Fiction', 'Thriller', 'World cinema', 'Drama']",1960,9
28872129,A Separate Peace,1972,['United States of America'],['Drama'],1970,2
22156971,Grace,2009,"['Canada', 'United States of America']","['Psychological thriller', 'Thriller', 'Horror', 'Drama']",2000,9
14206642,Woolen Under Where,1963,[],"['Animation', 'Short Film', 'Comedy film', 'Family Film']",1960,3
9231540,Northern Pursuit,1943,['United States of America'],"['Action', 'Spy', 'Northern', 'War film', 'Drama']",1940,3
10943915,States of Grace,2005,['United States of America'],['Drama'],2000,5
9619859,The Prize Pest,1951,['United States of America'],"['Animated cartoon', 'Comedy', 'Family Film']",1950,1
19845179,Fame,2009,['United States of America'],"['Musical', 'Comedy', 'Remake', 'Dance', 'Romance Film', 'Drama', 'Family Film']",2000,9
9656385,Lamb,1986,['United Kingdom'],['Drama'],1980,6
4832313,Happily Ever After,1993,['United States of America'],"['Family Film', 'Animation']",1990,3
2400444,Six Pack,1982,['United States of America'],"['Action', 'Comedy', 'Comedy-drama', 'Sports', 'Adventure', 'Drama', 'Family Film']",1980,2
9170457,The Lost Moment,1947,['United States of America'],"['Film adaptation', 'Romantic drama', 'Romance Film', 'Docudrama', 'Drama']",1940,7
31684531,Route 30,2008,[],"['Indie', 'Comedy']",2000,8
1282851,Hell's Angels,1930,['United States of America'],"['Airplanes and airports', 'Combat Films', 'Action', 'War film', 'Pre-Code', 'Drama']",1930,0
35485635,Thangaikku Oru Thalattu,1990,['India'],['Drama'],1990,0
28799135,Hammerhead,1968,['United Kingdom'],['Thriller'],1960,8
145608,The Face Behind the Mask,1941,['United States of America'],"['Black-and-white', 'Drama']",1940,1
35056026,Love From Paris,1957,['West Germany'],"['Romance Film', 'Drama']",1950,7
103088,Dead Men Don't Wear Plaid,1982,['United States of America'],"['Action', 'Black-and-white', 'Detective fiction', 'Action/Adventure', 'Comedy', 'Film noir', 'Parody', 'Detective']",1980,2
286828,Lady and the Tramp,1955,['United States of America'],"['Musical', 'Animation', 'Animated Musical', 'Romance Film', ""Children's/Family"", 'Drama', 'Family Film']",1950,5
23937475,Fiction,2006,['Spain'],['Drama'],2000,6
27499456,Jaded,1996,['United States of America'],['Drama'],1990,6
21038272,Oru Vidukadhai Oru Thodarkadhai,1979,['India'],['Romance Film'],1970,9
28733517,A Town Like Alice,1956,['United Kingdom'],"['Film adaptation', 'Romantic drama', 'Romance Film', 'War film', 'Drama']",1950,6
1086550,Deep Blue Sea,1999,"['United States of America', 'Australia']","['Action', 'Action/Adventure', 'Thriller', 'Horror', 'Adventure', 'Science Fiction', 'Natural horror films']",1990,9
5841329,Killer Diller,2004,['United States of America'],"['Musical', 'Film adaptation', 'Drama', 'Indie']",2000,4
3071743,Star Trek,2009,"['Germany', 'United States of America']","['Action', 'Adventure', 'Reboot', 'Science Fiction']",2000,9
27876042,The Shiver of the Vampires,1971,['France'],"['World cinema', 'Horror']",1970,1
10929128,Tex Granger,1948,['United States of America'],"['Action', 'Black-and-white', 'Western', 'Adventure']",1940,8
16913663,Constantine's Sword,2007,['United States of America'],"['History', 'Documentary', 'War film', 'Culture & Society']",2000,7
14744818,Let's Get Tough!,1942,['United States of America'],"['Action', 'Black-and-white', 'Comedy']",1940,2
18992327,The Queen's Guards,1961,['United Kingdom'],['Drama'],1960,1
225615,Terminator 3: Rise of the Machines,2003,"['United Kingdom', 'Germany', 'United States of America']","['Action', 'Time travel', 'Action/Adventure', 'Thriller', 'Doomsday film', 'Science Fiction']",2000,3
6880278,Black Irish,2006,['United States of America'],"['Coming of age', 'Family Drama', 'Indie', 'Drama']",2000,6
11419179,The Vanishing Duck,1958,['United States of America'],"['Animation', 'Short Film', 'Comedy', 'Family Film']",1950,8
1133816,Around the World in Eighty Days,1957,['United States of America'],"['Action', 'Action/Adventure', 'Comedy', 'Roadshow theatrical release', 'Adventure', 'Drama', 'Family Film']",1950,7
10366448,Caravan,1971,['India'],"['Musical', 'Romance Film', 'Comedy']",1970,1
9974407,Pappa ante Portas,1991,['Germany'],['Comedy'],1990,1
5122432,El Pez que Fuma,1977,['Venezuela'],"['Drama', 'Comedy']",1970,7
7724880,A Piano for Mrs. Cimino,1982,['United States of America'],['Drama'],1980,2
22610220,Patriotic Martyr An Jung-gun,1972,['South Korea'],"['Historical fiction', 'Historical drama', 'Drama']",1970,2
8673346,The Sorrows of Satan,1926,['United States of America'],"['Romantic fantasy', 'Silent film', 'Fantasy']",1920,6
2247831,Undead,2003,['Australia'],"['Comedy', 'Horror Comedy', 'World cinema', 'Zombie Film', 'Sci-Fi Horror', 'Horror', 'Alien Film', 'Supernatural', 'Science Fiction']",2000,3
61480,Broadway Melody of 1936,1935,['United States of America'],"['Musical', 'Black-and-white', 'Backstage Musical', 'Comedy', 'Musical comedy', 'Romance Film']",1930,5
605939,Akira,1988,['Japan'],"['Animation', 'Japanese Movies', 'Dystopia', 'Epic', 'Anime', 'Science Fiction', 'Fantasy']",1980,8
98506,"The Russians Are Coming, the Russians Are Coming",1966,['United States of America'],"['Action', 'Political cinema', 'Action/Adventure', 'Satire', 'Comedy', 'Black comedy', 'War film']",1960,6
1586802,Black Robe,1991,"['Canada', 'Australia']","['Action/Adventure', 'Adventure', 'Historical fiction', 'Drama']",1990,1
24799628,'R Xmas,2001,"['France', 'United States of America']","['Crime Fiction', 'Indie', 'Thriller', 'Crime Thriller', 'Drama']",2000,1
6394251,Flirt,1995,"['Germany', 'United States of America', 'Japan']","['LGBT', 'Japanese Movies', 'Romance Film', 'Drama']",1990,5
23720172,A Girl from Hunan,1988,['China'],['Drama'],1980,8
12897281,College Swing,1938,['United States of America'],"['Musical', 'Black-and-white', 'Comedy', 'Musical comedy']",1930,8
13180961,Il Vedovo,1959,['Italy'],"['Black comedy', 'Black-and-white', 'Comedy']",1950,9
27956755,Bale Pandiya,1962,['India'],['Comedy film'],1960,2
29047988,The Lotus Eater,1921,['United States of America'],['Silent film'],1920,1
442333,Mask,1985,['United States of America'],"['Biography', 'Drama']",1980,5
5794124,The Comedy of Terrors,1964,['United States of America'],"['Parody', 'Slasher', 'Horror Comedy', 'Comedy', 'Horror']",1960,4
14944773,The Corsican Brothers,1941,['United States of America'],"['Swashbuckler films', 'Black-and-white']",1940,1
10598747,Daag: A Poem of Love,1972,['India'],"['Musical', 'Bollywood', 'World cinema']",1970,2
1230304,Monkey Business,1931,['United States of America'],"['Black-and-white', 'Screwball comedy', 'Comedy']",1930,1
612656,The Funeral,1996,['United States of America'],"['Period piece', 'Crime Fiction', 'Gangster Film', 'Drama']",1990,6
4177747,Mard,1985,['India'],['Bollywood'],1980,5
26473841,Hipsters,2008,['Russia'],"['Musical', 'Musical Drama', 'Comedy', 'World cinema', 'Romance Film', 'Drama', 'Period piece', 'Political cinema', 'Political drama']",2000,8
23831635,Deacons for Defense,2003,"['Canada', 'United States of America']","['Social problem film', 'Political drama', 'Drama']",2000,3
4969590,Austerlitz,1960,"['France', 'Italy']",['War film'],1960,0
20631788,While Telling a Story,2007,['India'],"['Drama', 'Comedy']",2000,7
7675076,Yaji and Kita: The Midnight Pilgrims,2005,['Japan'],"['LGBT', 'Japanese Movies', 'Action/Adventure', 'Comedy', 'World cinema']",2000,5
35755021,Breakthrough,1950,['United States of America'],"['War film', 'Drama']",1950,0
23417724,Excuse Me,1925,['United States of America'],"['Black-and-white', 'Comedy', 'Silent film', 'Romance Film', 'Romantic comedy']",1920,5
317703,Baby the Rain Must Fall,1965,['United States of America'],"['Romance Film', 'Romantic drama', 'Drama']",1960,5
1646113,The Sugarland Express,1974,['United States of America'],"['Action', 'Crime Fiction', 'Adventure', 'Drama', 'Chase Movie', 'New Hollywood', 'Crime Drama', 'Road movie']",1970,4
11056005,Gharonda,1977,['India'],['Bollywood'],1970,7
4754477,Jeepers Creepers,1939,['United States of America'],['Short Film'],1930,9
8466260,Angyali üdvözlet,1984,['Hungary'],['Drama'],1980,4
1166096,All the King's Men,2006,"['Germany', 'United States of America']","['Period piece', 'Film adaptation', 'Thriller', 'Remake', 'Political drama', 'Drama']",2000,6
2853895,The Pirate,1948,['United States of America'],"['Musical', 'Romance Film', 'Swashbuckler films']",1940,8
28336440,London,1926,['United Kingdom'],['Silent film'],1920,6
7128657,The Brothers Solomon,2007,['United States of America'],"['Comedy', 'Black comedy', 'Slapstick', 'Absurdism']",2000,7
3753182,My Bodyguard,1980,['United States of America'],"['Family Drama', 'Coming of age', 'Comedy', 'Teen', 'Comedy-drama', 'Drama', 'Family Film']",1980,0
6804255,Three On A Couch,1966,['United States of America'],"['Romantic comedy', 'Slapstick', 'Comedy']",1960,6
31245238,On Again-Off Again,1937,['United States of America'],"['Musical', 'Comedy']",1930,7
7503399,No! No! A Thousand Times No!!,1935,['United States of America'],"['Musical', 'Animation', 'Short Film', 'Comedy', 'Family Film']",1930,5
14836650,Tiyanaks,2007,['Philippines'],"['Filipino Movies', 'Comedy horror', 'Horror', 'World cinema', 'Drama']",2000,7
29381597,Turn the Key Softly,1953,['United Kingdom'],"['Drama', 'Crime Fiction']",1950,3
19822985,Beethoven's Big Break,2008,['United States of America'],"['Comedy', 'Animal Picture', ""Children's/Family"", 'Reboot', 'Adventure', 'Family Film']",2000,8
6048196,Tru Confessions,2002,['United States of America'],"['Family Drama', 'Drama']",2000,2
1673514,Life,1999,['United States of America'],"['Action', 'Crime Fiction', 'Action/Adventure', 'Buddy film', 'Comedy', 'Comedy-drama', 'Drama']",1990,9
35826458,Penitentiary 2,1982,['United States of America'],"['Action', 'Blaxploitation', 'Prison', 'Crime Fiction', 'Action/Adventure', 'Thriller', 'Crime Drama']",1980,2
14612768,Ek Daav Bhutacha,1982,['India'],['Fantasy'],1980,2
5707225,Opera,1987,['Italy'],"['Giallo', 'Slasher', 'Horror', 'World cinema', 'Cult']",1980,7
16167538,Raajjiyam,2002,['India'],"['Drama', 'World cinema']",2000,2
1249014,Knife in the Water,1962,['Poland'],"['Marriage Drama', 'Thriller', 'World cinema', 'Drama']",1960,2
1597753,Tom White,2004,['Australia'],['Drama'],2000,4
5985349,Biohazard 4D Executer,2000,['Japan'],"['Zombie Film', 'Japanese Movies', 'Short Film']",2000,0
29651684,Sunset Heat,1992,['United States of America'],['Thriller'],1990,2
11558194,The Duke Steps Out,1929,['United States of America'],"['Black-and-white', 'Drama', 'Indie', 'Comedy', 'Silent film', 'Comedy-drama']",1920,9
5930667,Crank,2006,['United States of America'],"['Action', 'Crime Fiction', 'Action Thrillers', 'Action/Adventure', 'Thriller', 'Crime Thriller']",2000,6
14123618,Madonna of the Seven Moons,1945,['United Kingdom'],"['Black-and-white', 'Crime Fiction', 'Romance Film', 'Drama']",1940,5
30570375,2012: Supernova,2009,['United States of America'],"['Action/Adventure', 'Thriller', 'Disaster', 'Science Fiction']",2000,9
24028744,Chain of Desire,1992,['United States of America'],"['Romance Film', 'Drama']",1990,2
2103217,Factory Girl,2006,['United States of America'],"['Period piece', 'Drama', 'Indie', 'Biography', 'Biographical film', 'Biopic [feature]']",2000,6
23675245,Mr. Brahmachari,2003,['India'],['Comedy-drama'],2000,3
7218457,A Blind Bargain,1922,['United States of America'],"['Creature Film', 'Black-and-white', 'Horror', 'Silent film']",1920,2
3618333,The Perfect Storm,2000,['United States of America'],"['Action', 'Drama', 'Thriller', 'Disaster', 'Adventure']",2000,0
34202918,Pocong vs Kuntilanak,2008,['Indonesia'],['Horror'],2000,8
5939591,Salvation!,1987,['United States of America'],"['Parody', 'Satire', 'Comedy', 'Black comedy']",1980,7
18950355,Between Love and Hate,1993,['United States of America'],"['Drama', 'Crime Fiction']",1990,3
6818981,Bavagaru Bagunnara?,1998,['India'],"['Comedy', 'Drama', 'Family Film']",1990,8
618929,Ghostbusters II,1989,['United States of America'],"['Action', 'Action/Adventure', 'Satire', 'Comedy', 'Supernatural', 'Science Fiction', 'Fantasy']",1980,9
897713,Vagabond,1985,['France'],"['Drama', 'World cinema']",1980,5
16846937,Something to Shout About,1943,['United States of America'],"['Musical', 'Black-and-white']",1940,3
16672614,Hardbodies,1984,['United States of America'],"['Softcore Porn', 'Comedy', 'Adult', 'Sex comedy']",1980,4
16190026,Unstable Fables: 3 Pigs & a Baby,2008,['United States of America'],"['Family Film', 'Animation']",2000,8
9505256,A Lucky Day,2002,"['Argentina', 'Spain', 'Italy']","['Indie', 'Drama', 'World cinema']",2000,2
9098193,Pride,2007,"['Germany', 'United States of America']","['Crime Fiction', 'Sports', 'Drama', 'Family Film']",2000,7
225535,"Cousin, cousine",1976,['France'],"['Romance Film', 'Romantic comedy', 'Comedy']",1970,6
20015755,Goodbye Solo,2008,['United States of America'],"['Indie', 'Drama']",2000,8
24816600,Design for Leaving,1954,[],"['Animation', 'Short Film', 'Family Film']",1950,4
6301742,Sunburn,1979,"['United Kingdom', 'United States of America']","['Comedy', 'Detective']",1970,9
2208258,Phase IV,1974,['United States of America'],"['Science Fiction', 'Natural horror films', 'Horror']",1970,4
21972505,Hot Rod Girls Save The World,2008,['United States of America'],['Science Fiction'],2000,8
76402,Twelve O'Clock High,1949,['United States of America'],"['Combat Films', 'Action', 'Black-and-white', 'Action/Adventure', 'War film']",1940,9
1888983,The Jetsons Meet the Flintstones,1987,['United States of America'],"['Animation', 'Time travel', 'Comedy', 'Romance Film', ""Children's/Family"", 'Science Fiction', 'Fantasy']",1980,7
22915104,Buchanan Rides Alone,1958,['United States of America'],"['Action', 'Western', 'Action/Adventure']",1950,8
17349370,Scorched,2008,['Australia'],"['Thriller', 'Television movie', 'Science Fiction', 'Drama']",2000,8
22677361,Demonwarp,1988,['United States of America'],"['Horror', 'Science Fiction']",1980,8
2611302,Once Upon a Forest,1993,"['United Kingdom', 'United States of America']","['Animation', 'Family-Oriented Adventure', ""Children's/Family"", 'Adventure', 'Drama', ""Children's Fantasy"", 'Family Film', 'Fantasy']",1990,3
9465102,Gideon's Day,1958,"['United Kingdom', 'United States of America']","['Action', 'Crime Fiction', 'Drama']",1950,8
20669402,Sunflower,2006,['South Korea'],"['Action', 'Drama', 'Crime Fiction', 'Crime']",2000,6
348979,Oliver & Company,1988,['United States of America'],"['Music', 'Musical', 'Animation', ""Children's"", 'Adventure', 'Family Film']",1980,8
17842609,Circle of Iron,1978,"['United Kingdom', 'United States of America']","['Action', 'Action/Adventure', 'Martial Arts Film', 'Fantasy']",1970,8
3872275,Marking Time,2003,['Australia'],"['Romantic drama', 'Drama']",2000,3
9803762,Jab We Met,2007,['India'],"['Musical', 'Romantic drama', 'Comedy', 'Bollywood', 'World cinema', 'Romance Film', 'Drama', 'Romantic comedy']",2000,7
4727,Batman,1966,['United States of America'],"['Action', 'Parody', 'Action/Adventure', 'Comedy', 'Superhero movie', 'Camp', 'Fantasy']",1960,6
28088242,Lea,1996,"['Germany', 'Czech Republic']","['Romantic drama', 'World cinema', 'Romance Film', 'Drama']",1990,6
9132122,Slim Susie,2003,['Sweden'],"['Black comedy', 'Comedy', 'World cinema']",2000,3
4538926,Night of the Demons 2,1994,['United States of America'],"['Comedy', 'Teen', 'Horror']",1990,4
9038322,Attack of the Puppet People,1958,['United States of America'],"['Black-and-white', 'Horror Comedy', 'Horror', 'B-movie', 'Science Fiction']",1950,8
5545800,Mannequin: On the Move,1991,['United States of America'],"['Indie', 'Comedy', 'Romance Film', 'Romantic comedy', 'Fantasy']",1990,1
15399672,A Rage to Live,1965,['United States of America'],"['Film adaptation', 'Black-and-white', 'Romantic drama', 'Romance Film', 'Drama']",1960,5
18006800,Sweet Mud,2006,"['Japan', 'Israel', 'France', 'Germany']","['Japanese Movies', 'Drama', 'World cinema']",2000,6
1031185,My Name is Modesty,2003,['United States of America'],"['Action', 'Action Thrillers', 'Action/Adventure', 'Thriller', 'Glamorized Spy Film']",2000,3
2642594,El ángel exterminador,1962,"['Mexico', 'Spain']","['Surrealism', 'Art film', 'Mystery', 'Comedy', 'World cinema', 'Drama', 'Fantasy']",1960,2
3943033,For Catherine,2005,['United States of America'],"['Indie', 'Comedy', 'Romance Film', 'Romantic comedy']",2000,5
2863319,Bee Movie,2007,['United States of America'],"['Computer Animation', 'Animation', 'Comedy', ""Children's/Family"", 'Adventure', 'Family Film']",2000,7
12932711,Filhaal...,2002,['India'],['Drama'],2000,2
3587038,In Praise of Love,2001,"['Switzerland', 'France']","['Black-and-white', 'Romantic drama', 'World cinema', 'Romance Film', 'Drama']",2000,1
24407838,Coffin Rock,2009,"['United Kingdom', 'Australia']","['Suspense', 'Indie', 'Thriller']",2000,9
3527498,It's the Rage,2000,['United States of America'],"['Drama', 'Indie', 'Comedy', 'Social problem film', 'Black comedy', 'Comedy-drama', 'Ensemble Film']",2000,0
461335,The Last House on the Left,1972,['United States of America'],"['Indie', 'Slasher', 'Thriller', 'Horror', 'Cult']",1970,2
997955,Look Who's Talking Too,1990,['United States of America'],['Comedy'],1990,0
24636995,Judas,2004,['United States of America'],"['Biography', 'Television movie', 'Epic', 'Drama']",2000,4
1843039,100 Rifles,1969,['United States of America'],"['Action', 'Drama', 'Action/Adventure', 'Western', 'Indian Western']",1960,9
13409492,Return to Paradise,1953,['United States of America'],['Drama'],1950,3
11575861,Having Wonderful Time,1938,['United States of America'],"['Comedy', 'Romance Film', 'Drama', 'Family Film']",1930,8
1051820,She's All That,1999,['United States of America'],"['Comedy', 'Teen', 'Romance Film', 'Romantic comedy', 'Comedy-drama']",1990,9
27763376,The Groundstar Conspiracy,1972,"['Canada', 'United States of America']","['Action', 'Crime Fiction', 'Mystery']",1970,2
9104359,The Blow Out,1936,['United States of America'],"['Black-and-white', 'Comedy', 'Family Film']",1930,6
6768753,June R,2005,['India'],"['Drama', 'Family Film']",2000,5
1228941,Manhattan Murder Mystery,1993,['United States of America'],"['Screwball comedy', 'Indie', 'Mystery', 'Comedy', 'Thriller', 'Black comedy', 'Crime Thriller', 'Comedy Thriller']",1990,3
418154,Basic Training,1985,['United States of America'],"['Indie', 'Parody', 'Comedy', 'Sex comedy']",1980,5
5547674,Baby It's You,1983,['United States of America'],"['Drama', 'Indie', 'Romantic drama', 'Comedy', 'Romance Film', 'Romantic comedy']",1980,3
27808552,In a Glass Cage,1987,['Spain'],"['Psychological thriller', 'Suspense', 'Thriller', 'Horror', 'World cinema', 'Drama']",1980,7
22611823,Blood Relation,1963,['South Korea'],['Drama'],1960,3
2155481,A Crack in the Floor,2000,['United States of America'],"['Psychological thriller', 'Slasher', 'Thriller', 'Horror', 'Teen']",2000,0
36055281,Radar Secret Service,1950,['United States of America'],"['Action', 'Crime Fiction', 'Adventure']",1950,0
289591,Spy Game,2001,"['Japan', 'France', 'Germany', 'United States of America']","['Action', 'Spy', 'Crime Fiction', 'Japanese Movies', 'Action/Adventure', 'Thriller', 'Political thriller']",2000,1
19400604,The Broken Land,1962,['United States of America'],['Western'],1960,2
284752,Anastasia,1997,['United States of America'],"['Music', 'Musical', 'Animation', 'Comedy', 'Remake', ""Children's"", 'Adventure', 'Drama', 'History', 'Family Film', 'Fantasy']",1990,7
2046815,Love At First Bite,1979,['United States of America'],"['Parody', 'Comedy', 'Horror', 'Romance Film']",1970,9
30035318,Terrorism and Kebab,1992,['Egypt'],"['Action', 'Crime Fiction', 'Comedy film']",1990,2
5429326,Naked Killer,1992,['Hong Kong'],"['Action', 'Action Thrillers', 'Action/Adventure', 'Thriller', 'World cinema', 'Crime Thriller', 'Chinese Movies', 'Martial Arts Film', 'Erotic thriller']",1990,2
7855965,Limit of Love: Umizaru,2006,['Japan'],"['Action', 'Japanese Movies', 'Drama']",2000,6
1130769,The Messenger: The Story of Joan of Arc,1999,['France'],"['Biography', 'Biographical film', 'World cinema', 'Drama', 'Period piece', 'History', 'Biopic [feature]', 'Historical Epic', 'Historical fiction', 'Epic', 'Hagiography', 'War film']",1990,9
5469422,The Poof Point,2001,['United States of America'],"['Comedy', ""Children's/Family"", 'Science Fiction', 'Family Film']",2000,1
7896385,Come Early Morning,2006,['United States of America'],"['Romantic drama', 'Indie', 'Romance Film', 'Drama']",2000,6
2421463,Tough Guys,1986,['United States of America'],['Comedy'],1980,6
20617600,The Burial Society,2002,"['Canada', 'United States of America']","['Drama', 'Crime Fiction', 'Indie', 'Thriller', 'Detective', 'Black comedy', 'Crime Thriller']",2000,2
2164722,Zoot Suit,1981,['United States of America'],"['Musical', 'Period piece', 'Crime Fiction', 'Drama']",1980,1
4327278,Dead of Winter,1987,['United States of America'],"['Psychological thriller', 'Suspense', 'Mystery', 'Thriller', 'Horror']",1980,7
8949714,Year of the Dog,2007,['United States of America'],"['Drama', 'Indie', 'Comedy', 'Black comedy', 'Comedy-drama', 'Workplace Comedy']",2000,7
23674766,Coma Girl: The State of Grace,2005,['United Kingdom'],"['Indie', 'Comedy']",2000,5
434542,Accident,1967,['United Kingdom'],"['Crime Fiction', 'Romantic drama', 'Romance Film', 'Drama']",1960,7
10934072,The Silver Chalice,1954,['United States of America'],"['Christian film', 'Epic', 'Adventure', 'Drama']",1950,4
21499125,Fruit Fly,2009,['United States of America'],"['Musical', 'LGBT', 'Musical Drama', 'Drama', 'Gay Themed', 'Gay', 'Gay Interest', 'Feature film']",2000,9
29287983,The Thirteenth Hour,1927,[],['Silent film'],1920,7
189695,The Battle of the River Plate,1956,['United Kingdom'],"['Action', 'Drama', 'Action/Adventure', 'War film']",1950,6
4009572,Voice,2005,['South Korea'],"['World cinema', 'Horror']",2000,5
2331380,And Then There Were None,1974,"['Spain', 'France', 'Germany', 'Italy']","['Mystery', 'Thriller']",1970,4
2608958,Nothing to Lose,1997,['United States of America'],"['Action', 'Crime Fiction', 'Action/Adventure', 'Buddy film', 'Comedy']",1990,7
496640,The Barbarian Invasions,2003,"['Canada', 'France']","['Indie', 'Comedy', 'Comedy-drama', 'Drama', 'Ensemble Film']",2000,3
26737520,Bridge,1949,['China'],"['War film', 'Drama']",1940,9
602644,Robin Hood Daffy,1958,['United States of America'],"['Animation', 'Short Film', 'Comedy', 'Family Film']",1950,8
14469507,In the Sweet Pie and Pie,1941,['United States of America'],"['Black-and-white', 'Short Film', 'Comedy', 'Slapstick']",1940,1
3083330,A Cock and Bull Story,2006,['United Kingdom'],"['Mockumentary', 'Indie', 'Comedy']",2000,6
1129583,Blade: Trinity,2004,['United States of America'],"['Action', 'Action Thrillers', 'Superhero', 'Action/Adventure', 'Thriller', 'Adventure', 'Horror', 'Superhero movie', 'Fantasy']",2000,4
25898800,A Hole in One,2005,['United States of America'],"['Black comedy', 'Indie', 'Comedy']",2000,5
17752771,Beyond the Clouds,1995,"['France', 'Germany', 'Italy']","['Romantic drama', 'World cinema', 'Romance Film', 'Drama']",1990,5
9420496,Doli Saja Ke Rakhna,1998,['India'],['Romance Film'],1990,8
14440290,Saved by the Belle,1939,['United States of America'],"['Short Film', 'Black-and-white', 'Comedy']",1930,9
2125458,Blood and Sand,1922,['United States of America'],"['Black-and-white', 'Indie', 'Silent film', 'Romance Film', 'Drama']",1920,2
24066535,My Sister Eileen,1955,['United States of America'],"['Musical', 'Comedy']",1950,5
17117633,I Dismember Mama,1974,['United States of America'],"['Slasher', 'Thriller', 'Horror']",1970,4
15164556,The Bliss of Mrs. Blossom,1968,['United Kingdom'],"['Romance Film', 'Romantic comedy', 'Comedy']",1960,8
2303104,Herbie Goes Bananas,1980,['United States of America'],"['Comedy', 'Family-Oriented Adventure', 'Adventure', 'Drama', 'Family Film']",1980,0
24043964,Mid-August Lunch,2008,['Italy'],"['Comedy', 'World cinema', 'Slice of life story', 'Drama', 'Ensemble Film']",2000,8
4343437,The Smokers,2000,['United States of America'],"['Indie', 'Comedy', 'Teen', 'Black comedy']",2000,0
11862595,Shadrach,1998,['United States of America'],"['Period piece', 'Family Drama', 'Indie', 'Drama', 'Family Film']",1990,8
1980829,Beau Hunks,1931,['United States of America'],"['Foreign legion', 'Black-and-white', 'Parody', 'Short Film', 'Comedy']",1930,1
7495301,Incendiary Blonde,1945,['United States of America'],"['Musical', 'Musical Drama', 'Biographical film', 'Biopic [feature]']",1940,5
6573412,I-Man,1986,['United States of America'],"['Action', 'Adventure', 'Fantasy']",1980,6
29645,Scared to Death,1947,['United States of America'],"['Mystery', 'Thriller', 'Horror']",1940,7
2242508,Parwaana,1971,['India'],"['Romance Film', 'Thriller']",1970,1
3644151,If I Had A Million,1932,['United States of America'],"['Black-and-white', 'Comedy', 'Drama']",1930,2
4091441,Untamed,1929,['United States of America'],"['Romance Film', 'Black-and-white', 'Drama']",1920,9
7816124,Plymouth Adventure,1952,['United States of America'],"['Dogme 95', 'Period piece', 'Action/Adventure', 'Epic', 'Adventure', 'Drama']",1950,2
8476705,The Bronte Sisters,1979,['France'],"['Biography', 'Drama']",1970,9
9104429,The Miracle Woman,1931,['United States of America'],"['Black-and-white', 'Drama']",1930,1
32214275,Ang Pinakamagandang Hayop sa Balat ng Lupa,1974,['Philippines'],['Filipino Movies'],1970,4
871318,The Gambler,1974,['United States of America'],"['Crime Fiction', 'Gangster Film', 'Thriller', 'Crime Thriller', 'Drama']",1970,4
958539,Time Chasers,1994,['United States of America'],"['Time travel', 'Indie', 'Science Fiction']",1990,4
2110246,Go Figure,2005,['United States of America'],"['Comedy', 'Drama', 'Family Film']",2000,5
4453379,The Woman Next Door,1981,['France'],"['Drama', 'World cinema']",1980,1
6446044,For Your Eyes Only,1981,['United Kingdom'],"['Action', 'Spy', 'Action/Adventure', 'Thriller', 'Glamorized Spy Film']",1980,1
5125242,Jenifer,2005,['Italy'],"['Docudrama', 'Drama', 'Medical fiction', 'Slasher', 'Biopic [feature]', 'Horror', 'Television movie', 'Cult']",2000,5
57820,Donnie Darko,2001,['United States of America'],"['Psychological thriller', 'Mystery', 'Indie', 'Satire', 'Thriller', 'Teen', 'Drama', 'Tragedy', 'Period piece', 'Time travel', 'Coming of age', 'Comedy-drama', 'Doomsday film', 'Science Fiction', 'Fantasy']",2000,1
22086983,Sheesha,2005,['India'],"['Romantic drama', 'World cinema', 'Romance Film', 'Drama']",2000,5
6012106,Joe Somebody,2001,['United States of America'],"['Workplace Comedy', 'Comedy', 'Romantic comedy', 'Comedy-drama', 'Drama']",2000,1
8573584,Money No Enough,1998,['Singapore'],['Comedy'],1990,8
2108776,FernGully: The Last Rainforest,1992,"['United States of America', 'Australia']","['Animation', 'Thriller', 'Social problem film', ""Children's/Family"", 'Adventure', ""Children's Fantasy"", 'Family Film', 'Fantasy']",1990,2
8678373,Ace Eli and Rodger of the Skies,1973,['United States of America'],"['Drama', 'Americana', 'Comedy']",1970,3
4640513,The Second Chance,2006,['United States of America'],"['Christian film', 'Buddy film', 'Drama']",2000,6
7319564,A Hope,2008,['Hong Kong'],"['Comedy', 'World cinema', 'Chinese Movies', 'Science Fiction', 'Drama', 'Family Film', 'Fantasy']",2000,8
224487,Ali G Indahouse,2002,"['United Kingdom', 'France', 'Germany', 'United States of America']","['Political cinema', 'Gross-out film', 'Political satire', 'Parody', 'Gross out', 'Stoner film', 'Comedy']",2000,2
14237082,Black Legion,1937,['United States of America'],"['Black-and-white', 'Crime Drama', 'Social problem film', 'Drama']",1930,7
5885538,Sissy Frenchfry,2005,['United States of America'],"['Gay Themed', 'Gay', 'Short Film', 'Gay Interest', 'Comedy']",2000,5
26917890,Exception to the Rule,1997,"['Germany', 'United States of America', 'Canada']","['Action', 'Thriller']",1990,7
3405310,Näköradiomiehen ihmeelliset siekailut,1969,['Finland'],['Comedy'],1960,9
27363110,A Long Return,1975,['Spain'],"['Romance Film', 'Science Fiction', 'Drama']",1970,5
2288762,Magenta,1996,['United States of America'],"['Thriller', 'Drama']",1990,6
696925,The Trip,1967,['United States of America'],['Drama'],1960,7
921891,Cradle 2 the Grave,2003,['United States of America'],"['Action', 'Crime Fiction', 'Action Thrillers', 'Action/Adventure', 'Buddy film', 'Thriller', 'Crime Thriller', 'Master Criminal Films', 'Martial Arts Film']",2000,3
2409484,Transporter 2,2005,"['United States of America', 'France']","['Action', 'Action Thrillers', 'Thriller', 'Crime Thriller', 'Martial Arts Film']",2000,5
1088677,The Draughtsman's Contract,1982,"['United Kingdom', 'England']","['Crime Fiction', 'Mystery', 'Romantic drama', 'Black comedy', 'Romance Film', 'Drama', 'Period piece', 'Comedy-drama', 'Comedy of manners']",1980,2
17188323,Post Grad,2009,['United States of America'],"['Screwball comedy', 'Indie', 'Comedy', 'Romance Film', 'Romantic comedy', 'Domestic Comedy']",2000,9
25839955,Dossier K.,2009,['Belgium'],"['Crime Fiction', 'Mystery', 'Thriller', 'Detective']",2000,9
8446486,Fong Sai-Yuk,1993,['Hong Kong'],"['Action', 'Action/Adventure', 'Comedy', 'Thriller', 'World cinema', 'Chinese Movies', 'Martial Arts Film', 'History']",1990,3
3702221,The Insect Woman,1963,['Japan'],"['Art film', 'Japanese Movies', 'Satire', 'World cinema', 'Black comedy', 'Comedy-drama', 'Drama']",1960,3
9595500,The Monster That Challenged the World,1957,['United States of America'],"['Creature Film', 'Monster movie', 'Black-and-white', 'Monster', 'Horror', 'Science Fiction']",1950,7
673469,Flatliners,1990,['United States of America'],"['Psychological thriller', 'Thriller', 'Supernatural', 'Science Fiction']",1990,0
29002631,The Waiting City,2009,['Australia'],"['Romantic drama', 'World cinema', 'Romance Film', 'Drama']",2000,9
5521165,Black Hole,2006,['United States of America'],"['Television movie', 'Science Fiction', 'Thriller']",2000,6
3054601,Summer Magic,1963,['United States of America'],"[""Children's/Family"", 'Adventure', 'Drama', 'Family Film']",1960,3
1688153,Tais-toi!,2003,['France'],"['Crime Fiction', 'Chase Movie', 'Buddy film', 'Comedy', 'Crime Comedy']",2000,3
1915443,Love 'em and Weep,1927,['United States of America'],"['Black-and-white', 'Indie', 'Short Film', 'Comedy', 'Silent film']",1920,7
13819727,Dark Blue Almost Black,2006,['Spain'],"['LGBT', 'Drama', 'World cinema']",2000,6
3151531,Bugs Bunny and the Three Bears,1944,['United States of America'],"[""Children's/Family"", 'Comedy', 'Family Film']",1940,4
20018854,It's Breaking News,2007,['India'],"['Musical', 'Art film', 'Bollywood', 'World cinema', 'Drama']",2000,7
10364521,A Date with Darkness: The Trial and Capture of Andrew Luster,2003,['United States of America'],['Drama'],2000,3
25533110,Solitary Man,2009,['United States of America'],"['Comedy', 'Romance Film', 'Comedy-drama', 'Drama']",2000,9
26216172,Hard Boiled Mahoney,1947,['United States of America'],"['Crime Fiction', 'Mystery', 'Comedy']",1940,7
1730084,101 Dalmatians II: Patch's London Adventure,2002,['United States of America'],"['Musical', 'Animated cartoon', 'Animation', 'Animated Musical', ""Children's/Family"", 'Adventure', 'Family Film']",2000,2
17839776,The Red Lily,1924,['United States of America'],"['Silent film', 'Black-and-white', 'Drama']",1920,4
965432,The Bridge at Remagen,1969,['United States of America'],"['Combat Films', 'Action', 'Action/Adventure', 'War film']",1960,9
27361432,The Redhead and the Cowboy,1951,['United States of America'],"['Action', 'Spy', 'Action/Adventure', 'Western']",1950,1
15053838,Passengers,2008,"['Canada', 'United States of America']","['Psychological thriller', 'Mystery', 'Thriller', 'Romance Film', 'Disaster', 'Supernatural', 'Drama']",2000,8
2477108,Guns of El Chupacabra,1997,['United States of America'],"['Horror', 'Natural horror films']",1990,7
42137,The Greatest Show on Earth,1952,['United States of America'],"['Romance Film', 'Adventure', 'Drama', 'Family Film']",1950,2
4993297,A Terracotta Warrior,1990,['Hong Kong'],"['History', 'Comedy', 'Romance Film', 'Chinese Movies', 'Adventure', 'Fantasy']",1990,0
6572584,The Silver Lining,1921,['United States of America'],"['Black-and-white', 'Drama', 'Indie', 'Silent film']",1920,1
35773659,Fateh,1991,['India'],['Action'],1990,1
6449665,Legion of Fire: Killer Ants!,1998,['United States of America'],['Horror'],1990,8
19162273,The Gilded Six Bits,2001,['United States of America'],['Short Film'],2000,1
9245595,The Key,1961,['Soviet Union'],"['Comedy', 'Animation']",1960,1
61904,Sunrise: A Song of Two Humans,1927,['United States of America'],"['Black-and-white', 'Drama', 'Crime Fiction', 'Indie', 'Romantic drama', 'Silent film', 'Romance Film']",1920,7
25450027,La Zandunga,1938,['Mexico'],"['Romance Film', 'Drama']",1930,8
12302621,Paar,1984,['India'],['Art film'],1980,4
13926072,The Void,2001,['United States of America'],"['Action', 'Action Thrillers', 'Action/Adventure', 'Thriller', 'Science Fiction', 'Drama']",2000,1
9379703,My Sassy Girl,2008,['United States of America'],"['Comedy', 'Romance Film', 'Romantic comedy', 'Drama']",2000,8
3546038,Jinnah,1998,"['United Kingdom', 'Pakistan']","['Period piece', 'Biographical film', 'Biopic [feature]', 'Historical fiction', 'Political drama']",1990,8
3644025,Flesh for Frankenstein,1974,"['France', 'Italy', 'United States of America']","['Creature Film', 'Drama', 'Indie', 'Monster', 'Horror', 'Science Fiction', 'Cult']",1970,4
22747963,Not Forgotten,2009,['United States of America'],"['Mystery', 'Supernatural', 'Thriller']",2000,9
18570812,God's Step Children,1938,['United States of America'],"['Black-and-white', 'Drama']",1930,8
3368406,Short Time,1990,['United States of America'],"['Action', 'Comedy']",1990,0
2666318,Get Real,1998,"['United Kingdom', 'England']","['LGBT', 'Romantic drama', 'Comedy', 'Teen', 'Romance Film', 'Drama', 'Gay Themed', 'Gay', 'Coming of age', 'Gay Interest', 'Comedy-drama']",1990,8
22498439,Blair Thumb,2001,['United States of America'],"['Parody', 'Short Film', 'Comedy']",2000,1
14881706,The Enemy,1927,['United States of America'],"['Black-and-white', 'Drama', 'Indie', 'Silent film']",1920,7
11270479,Tera Jadoo Chal Gaya,2000,['India'],"['Musical', 'Romantic drama', 'Bollywood', 'World cinema', 'Romance Film', 'Drama']",2000,0
4539015,Thieves Like Us,1974,['United States of America'],"['Crime Fiction', 'Romantic drama', 'Romance Film', 'Americana', 'Drama', 'New Hollywood', 'Crime Drama', 'Road movie']",1970,4
24143349,The Shopping Bag Lady,1976,['United States of America'],"['Short Film', 'Drama']",1970,6
14643875,The Threat,1949,['United States of America'],"['Black-and-white', 'Crime Fiction', 'Thriller', 'Film noir', 'Drama']",1940,9
20091427,Toofan Aur Deeya,1956,['India'],"['Musical', 'Romantic drama', 'Bollywood', 'World cinema', 'Romance Film', 'Drama']",1950,6
1203778,Titanic,1953,['United States of America'],"['Action', 'Black-and-white', 'Romantic drama', 'Action/Adventure', 'Romance Film', 'Disaster', 'Drama']",1950,3
24282217,The Naked Kitchen,2009,['South Korea'],"['Romantic drama', 'Comedy', 'World cinema', 'Romance Film', 'Comedy-drama', 'Drama']",2000,9
2673320,Grand Canyon,1991,['United States of America'],['Drama'],1990,1
24917225,Murders in the Zoo,1933,[],"['Crime Fiction', 'Mystery', 'Horror']",1930,3
28788758,Jessica,1962,"['France', 'Italy', 'United States of America']","['Film adaptation', 'Comedy', 'World cinema', 'Romance Film', 'Drama']",1960,2
1376388,Smallpox,2002,['United Kingdom'],"['Docudrama', 'Drama']",2000,2
11584546,The Wig,2005,['South Korea'],"['World cinema', 'Horror']",2000,5
7693284,Wrestling Ernest Hemingway,1993,['United States of America'],"['Romance Film', 'Buddy film', 'Drama']",1990,3
9945689,Louvre Come Back to Me,1962,['United States of America'],"['Animation', 'Short Film', 'Comedy film', 'Family Film']",1960,2
4688237,"Once upon a Time, Cinema",1992,['Iran'],"['History', 'Comedy']",1990,2
11963262,Margot at the Wedding,2007,['United States of America'],"['Indie', 'Family Drama', 'Comedy', 'Black comedy', 'Tragicomedy', 'Drama', 'Comedy-drama', 'Ensemble Film']",2000,7
4611346,The Boy Who Loved Trolls,1984,['United States of America'],"[""Children's"", 'Family-Oriented Adventure', ""Children's/Family"", 'Adventure', 'Family Film', 'Fantasy']",1980,4
13670373,Terminator Salvation,2009,"['United Kingdom', 'Germany', 'Italy', 'United States of America']","['Action', 'Action/Adventure', 'Thriller', 'Apocalyptic and post-apocalyptic fiction', 'Adventure', 'Doomsday film', 'War film', 'Science Fiction']",2000,9
24479155,The Sporting Venus,1925,['United States of America'],"['Silent film', 'Romance Film']",1920,5
21752454,Bachelor in Paradise,1961,['United States of America'],"['Romantic comedy', 'Comedy', 'Comedy of manners']",1960,1
16638626,China Town,1962,['India'],"['Musical', 'Bollywood', 'World cinema', 'Drama']",1960,2
13362932,Jis Desh Mein Ganga Rehta Hain,2000,['India'],"['Musical', 'Comedy']",2000,0
1048388,Hot Shots!,1991,['United States of America'],"['Action', 'Parody', 'Action/Adventure', 'Comedy', 'Slapstick', 'War film', 'Absurdism']",1990,1
16166305,Simhasanam,1986,['India'],"['Adventure', 'Drama']",1980,6
3213280,Miracle in Milan,1951,['Italy'],"['Black-and-white', 'Parody', 'Comedy', 'World cinema', 'Drama', 'Fantasy']",1950,1
5242749,Coldblooded,1995,['United States of America'],"['Action', 'Action/Adventure', 'Comedy Thriller', 'Thriller', 'Comedy', 'Black comedy']",1990,5
24645176,Went to Coney Island on a Mission from God: Be Back By Five,1998,[],"['Indie', 'Drama']",1990,8
28075586,Kisses for My President,1964,['United States of America'],['Comedy film'],1960,4
19875036,Postman,1995,"['China', 'Hong Kong']","['Chinese Movies', 'Indie', 'Drama']",1990,5
23319831,Our Very Own,1950,['United States of America'],['Drama'],1950,0
11335429,Meri Jung,1985,['India'],"['Bollywood', 'World cinema']",1980,5
4148842,The Cowboy Way,1994,['United States of America'],"['Action', 'Action Comedy', 'Action/Adventure', 'Western', 'Buddy film', 'Comedy']",1990,4
12776957,Thirty Day Princess,1934,['United States of America'],"['Comedy', 'Black-and-white']",1930,4
9866571,Adam at Six A.M.,1970,['United States of America'],['Drama'],1970,0
5352532,Lapitch the Little Shoemaker,2000,"['Croatia', 'Germany']","['Music', 'Musical', 'Animation', 'World cinema', ""Children's"", 'Adventure', 'Family Film', 'Fantasy']",2000,0
15738569,A Breed Apart,1984,['United States of America'],"['Action', 'Suspense', 'Action/Adventure', 'Thriller', 'Adventure', 'Drama']",1980,4
20004625,True Story of Jesse James,1957,['United States of America'],"['Drama', 'Action/Adventure', 'Western', 'Biographical film', 'Crime']",1950,7
7093500,Sunset Park,1996,['United States of America'],"['Sports', 'Drama']",1990,6
5887808,Johnny,2003,['India'],"['Tollywood', 'Romantic drama', 'World cinema', 'Romance Film', 'Drama']",2000,3
4658214,Satya,1998,['India'],"['Musical', 'Action/Adventure', 'Thriller', 'Bollywood', 'World cinema', 'Crime Thriller', 'Drama']",1990,8
1681589,The Girl on the Bridge,1999,['France'],"['Romantic drama', 'Comedy', 'World cinema', 'Romance Film', 'Drama']",1990,9
7696753,Lord of the Flies,1963,['United Kingdom'],"['Film adaptation', 'Dystopia', 'Adventure', 'Drama']",1960,3
11523957,Blind Terror,2001,['Canada'],"['Psychological thriller', 'Suspense', 'Mystery', 'Thriller', 'Television movie', 'Crime Thriller', 'Drama']",2000,1
12719322,Commandos Strike at Dawn,1942,['United States of America'],"['Action', 'Drama', 'Action/Adventure', 'War film']",1940,2
5744162,Funny Games U.S.,2007,"['Austria', 'United Kingdom', 'France', 'Germany', 'Italy', 'United States of America']","['Psychological thriller', 'Suspense', 'Drama', 'Crime Fiction', 'Indie', 'Thriller', 'Horror']",2000,7
8847411,Deck the Halls,2005,['Canada'],"['Christmas movie', 'Family Film']",2000,5
142447,As Good as It Gets,1997,['United States of America'],"['LGBT', 'Comedy', 'Romance Film', 'Romantic comedy', 'Comedy-drama', 'Drama', 'Slice of life story']",1990,7
10508900,Girls Town,1996,['United States of America'],"['Indie', 'Comedy', 'Drama']",1990,6
7903848,Lies My Mother Told Me,2005,['Canada'],"['Crime Fiction', 'Thriller', 'Television movie', 'Drama']",2000,5
13926329,You Belong to Me,1941,['United States of America'],"['Romance Film', 'Black-and-white']",1940,1
18623322,Pehla Nasha,1993,['India'],"['Drama', 'Mystery', 'Thriller']",1990,3
53964,Star Wars Episode V: The Empire Strikes Back,1980,['United States of America'],"['Action', 'Adventure', 'Space opera', 'Science Fiction', 'Family Film', 'Fantasy']",1980,0
9377317,Kilometer 31,2007,['Mexico'],['Horror'],2000,7
28785785,Beautiful,2009,"['New Zealand', 'Australia']","['Suspense', 'Mystery', 'Thriller', 'World cinema', 'Crime Thriller']",2000,9
26451721,The Great Sinner,1949,['United States of America'],['Drama'],1940,9
680337,Ruthless People,1986,['United States of America'],"['Black comedy', 'Comedy', 'Crime Comedy']",1980,6
3208494,The Big Noise,1944,['United States of America'],['Comedy'],1940,4
2682902,Missing in Action,1984,['United States of America'],"['Action', 'Action/Adventure', 'Thriller', 'War film']",1980,4
5882959,The Snapper,1993,"['Kingdom of Great Britain', 'United Kingdom', 'Ireland']","['Film adaptation', 'Drama', 'Indie', 'Comedy', 'Comedy of manners', 'Domestic Comedy', 'Comedy-drama']",1990,3
1385323,The Minus Man,1999,['United States of America'],"['Psychological thriller', 'Drama', 'Crime Fiction', 'Indie', 'Thriller', 'Crime Thriller', 'Road movie']",1990,9
19747745,Yoyes,1999,['Spain'],['Drama'],1990,9
9899953,Nit-witty Kitty,1951,['United States of America'],"['Animated cartoon', 'Short Film', 'Family Film']",1950,1
22428085,Spirit of the Marathon,2008,['United States of America'],"['Sports', 'Documentary']",2000,8
12240280,Zhizn i priklyucheniya chetyrekh druzei 3/4,1981,"['Russia', 'Soviet Union']","['Animation', 'Comedy', 'Adventure', ""Children's"", 'Family Film']",1980,1
12674435,Memories of tomorrow,2006,['Japan'],"['Japanese Movies', 'World cinema']",2000,6
4940876,Welcome to Collinwood,2002,"['Germany', 'United States of America']","['Crime Fiction', 'Screwball comedy', 'Caper story', 'Comedy', 'Crime Comedy']",2000,2
21308895,Captain Jack,1999,['United Kingdom'],"['Action/Adventure', 'Comedy', 'Adventure']",1990,9
35738632,The Red Dance,1928,['United States of America'],"['Romance Film', 'Drama']",1920,8
9022669,Aa Ab Laut Chalen,1999,['India'],"['Musical', 'World cinema', 'Romance Film', 'Drama']",1990,9
5925044,Pure Country,1992,"['Canada', 'United States of America']","['Romance Film', 'Romantic drama', 'Drama']",1990,2
16431349,Evil Calls: The Raven,2008,['United Kingdom'],['Horror'],2000,8
20019382,Short Eyes,1977,['United States of America'],"['Prison', 'Crime Fiction', 'Drama']",1970,7
1131593,Se Tutte le Donne del Mondo,1966,"['Italy', 'United States of America']","['Spy', 'Parody', 'Comedy']",1960,6
16348691,Naiyya,1979,['India'],"['Drama', 'Family Film']",1970,9
8971641,Nehlle Pe Dehlla,2006,['India'],"['Thriller', 'World cinema']",2000,6
4213193,Protocol,1984,['United States of America'],"['Political cinema', 'Political satire', 'Comedy', 'Media Satire', 'Romantic comedy']",1980,4
24358829,Vice,2008,['United States of America'],"['Action', 'Action/Adventure', 'Thriller', 'Crime Thriller']",2000,8
33775463,Love Toy,1968,['United States of America'],"['Drama', 'Erotica', 'Adult']",1960,8
2853175,Agni Natchathiram,1988,['India'],"['Action', 'Drama', 'Crime Fiction', 'Tamil cinema']",1980,8
311179,Ichi the Killer,2001,"['South Korea', 'China', 'Japan']","['Action', 'Surrealism', 'Crime Fiction', 'Comedy', 'Thriller', 'World cinema', 'Crime Thriller', 'Chinese Movies', 'Martial Arts Film', 'Drama', 'Japanese Movies', 'Horror', 'Crime Drama']",2000,1
7447003,Amazing Grace and Chuck,1987,['United States of America'],"['Social problem film', 'Sports', 'Drama']",1980,7
22365460,Decadent Evil,2005,['United States of America'],"['Monster movie', 'B-movie', 'Horror']",2000,5
15359592,Open Season 2,2008,['United States of America'],"['Animation', 'Comedy', 'Family-Oriented Adventure', ""Children's/Family"", 'Adventure', 'Family Film']",2000,8
21492428,Mr. Chedworth Steps Out,1939,['Australia'],"['Crime Fiction', 'Drama', 'Comedy film']",1930,9
7223973,Fried Green Tomatoes,1991,['United States of America'],"['Period piece', 'Film adaptation', 'LGBT', 'Female buddy film', 'Comedy', 'Drama']",1990,1
2352505,Bones,2001,"['Canada', 'United States of America']","['Action', 'Blaxploitation', 'Horror']",2000,1
26834440,Forget Me Not,2009,['United States of America'],"['Teen', 'Thriller', 'Horror']",2000,9
22557257,The Moment After 2: The Awakening,2006,['United States of America'],"['Drama', 'Science Fiction', 'Thriller']",2000,6
23690953,Billy the Kid Returns,1938,['United States of America'],"['Musical', 'Western', 'Action/Adventure']",1930,8
1794686,Whisky Romeo Zulu,2004,['Argentina'],"['Drama', 'Indie', 'Thriller', 'World cinema', 'Docudrama', 'Disaster']",2000,4
7278946,Blood of Dracula's Castle,1969,['United States of America'],"['Creature Film', 'Horror']",1960,9
1925273,The Fantastic Four,1994,['United States of America'],['Superhero movie'],1990,4
580960,Velvet Goldmine,1998,"['United Kingdom', 'United States of America']","['Music', 'Period piece', 'Musical', 'LGBT', 'Drama', 'Indie']",1990,8
18410798,Amusement,2008,['United States of America'],"['Slasher', 'Thriller', 'Horror']",2000,8
3119484,Barfuss,2005,['Germany'],['Romantic comedy'],2000,5
474571,Alex & Emma,2003,['United States of America'],"['Romance Film', 'Romantic comedy', 'Comedy']",2000,3
7601499,Mayookham,2005,['India'],"['Musical', 'Romance Film', 'Drama']",2000,5
31856500,Fair Lady,1922,['United States of America'],['Silent film'],1920,2
4673196,Barbie in the Nutcracker,2001,['United States of America'],"['Animation', 'Animated Musical', ""Children's/Family"", ""Children's"", 'Adventure', 'Computer Animation', 'Fairy tale', ""Children's Fantasy"", 'Family Film', 'Fantasy']",2000,1
1576940,The Harder They Come,1973,['Jamaica'],"['Crime Fiction', 'Musical Drama', 'Crime Drama', 'Drama']",1970,3
12233591,Frightmare,1983,['United States of America'],"['Indie', 'Slasher', 'Horror', 'B-movie', 'Zombie Film']",1980,3
8202158,Lured,1947,['United States of America'],"['Psychological thriller', 'Black-and-white', 'Crime Fiction', 'Mystery', 'Thriller', 'Film noir', 'Crime Thriller', 'Drama', 'Suspense']",1940,7
15004264,Aadmi Khilona Hai,1993,['India'],"['Drama', 'World cinema']",1990,3
14509075,The Man Who Came to Dinner,1942,['United States of America'],"['Comedy', 'Black-and-white']",1940,2
17608971,Nuvvu Nenu,2001,['India'],['Romance Film'],2000,1
30094590,Jolene,2008,['United States of America'],"['Film adaptation', 'Drama', 'Coming of age', 'Indie', 'Romantic drama', 'Romance Film', 'Road movie']",2000,8
2091355,The Evil of Frankenstein,1963,['United Kingdom'],"['Creature Film', 'Gothic Film', 'Horror', 'Costume Horror', 'Science Fiction']",1960,3
8658217,Sujata,1959,['India'],"['Bollywood', 'World cinema', 'Romance Film', 'Drama']",1950,9
2372198,The Return of Frank James,1940,['United States of America'],"['Action', 'Drama', 'Action/Adventure', 'Western', 'Biographical film']",1940,0
8118414,Zorro Rides Again,1937,['United States of America'],"['Action', 'Black-and-white', 'Action/Adventure', 'Superhero movie', 'Swashbuckler films', 'Adventure']",1930,7
4110259,The Night They Raided Minsky's,1968,['United States of America'],['Comedy'],1960,8
12453903,Vlak u snijegu,1976,"['Yugoslavia', 'Croatia']","['Drama', ""Children's"", 'Adventure']",1970,6
2539442,Dr. Jekyll and Sister Hyde,1971,['United Kingdom'],"['Science Fiction', 'Sci-Fi Horror', 'Horror']",1970,1
15083715,Mantra,2007,['India'],"['Musical', 'Thriller', 'Horror', 'Tamil cinema', 'World cinema']",2000,7
29617007,Parannu Parannu Parannu,1984,['India'],"['Romance Film', 'Drama']",1980,4
21062039,Raat,1992,['India'],"['Crime Fiction', 'Thriller', 'Horror']",1990,2
5791363,Tideland,2005,"['Canada', 'United Kingdom']","['Indie', 'Thriller', 'Childhood Drama', 'Drama', 'Fantasy']",2000,5
24002990,Tribute,2009,['United States of America'],"['Film adaptation', 'Romantic drama', 'Romance Film', 'Television movie', 'Drama']",2000,9
9186209,Seniman Bujang Lapok,1961,"['Singapore', 'Malaysia']","['Musical', 'Black-and-white', 'Comedy']",1960,1
15296215,Meu Nome Não É Johnny,2008,['Brazil'],"['Crime Fiction', 'Biographical film', 'Drama']",2000,8
9460139,"Ride Him, Cowboy",1932,['United States of America'],"['Action', 'Film adaptation', 'Drama', 'Action/Adventure', 'Western']",1930,2
22392461,His Brother,2003,['France'],"['LGBT', 'Drama', 'World cinema']",2000,3
15348996,The Little Mermaid: Ariel's Beginning,2008,['United States of America'],"['Music', 'Fantasy Adventure', 'Animation', ""Children's/Family"", ""Children's"", 'Family Film', 'Fantasy']",2000,8
11975716,Adventure in Iraq,1943,['United States of America'],"['Adventure', 'Black-and-white']",1940,3
21815189,Story of a Kiss,2002,['Spain'],"['Romance Film', 'Drama']",2000,2
30336596,Asha Jyoti,1984,['India'],"['Musical', 'Bollywood', 'World cinema', 'Drama']",1980,4
13263642,Once You're Born You Can No Longer Hide,2005,"['France', 'Italy']",['Drama'],2000,5
26764519,Laserhawk,1997,['Canada'],"['Thriller', 'Teen', 'Alien Film', 'Science Fiction']",1990,7
18515623,Dangerous When Wet,1953,['United States of America'],"['Musical', 'Comedy', 'Musical comedy', 'Romance Film', 'Romantic comedy']",1950,3
13813241,Running Out of Time 2,2001,['Hong Kong'],"['Action', 'Action Thrillers', 'Action/Adventure', 'Thriller', 'World cinema', 'Chinese Movies']",2000,1
6237571,David & Layla,2006,['United States of America'],"['Indie', 'Comedy', 'Romance Film', 'Romantic comedy', 'Comedy-drama', 'Slice of life story']",2000,6
21080013,Mail Order Bride,2008,['United States of America'],"['Romantic drama', 'Western', 'Romance Film', 'Television movie', 'Drama']",2000,8
1848081,Kingpin,1996,['United States of America'],"['Screwball comedy', 'Buddy film', 'Comedy', 'Black comedy', 'Sports', 'Cult']",1990,6
3936740,Anthony Zimmer,2005,['France'],"['Thriller', 'World cinema', 'Romance Film', 'Crime Thriller']",2000,5
3329045,The Lovers on the Bridge,1991,['France'],"['Romantic drama', 'World cinema', 'Romance Film', 'Drama']",1990,1
1086261,Quill,2004,['Japan'],['Japanese Movies'],2000,4
30275589,The War of the Roses,1989,['United States of America'],"['Film adaptation', 'Satire', 'Comedy', 'Black comedy', 'Drama']",1980,9
35790650,Kadhaludan,2003,['India'],"['Romance Film', 'Drama']",2000,3
4970576,Don,1978,['India'],"['Action', 'Musical', 'Crime Fiction', 'Thriller', 'Bollywood']",1970,8
1236122,Gettysburg,1993,['United States of America'],"['Period piece', 'Action', 'Film adaptation', 'War film', 'Epic', 'Costume drama', 'Drama']",1990,3
19963092,We're Talking Serious Money,1992,['United States of America'],['Comedy'],1990,2
6810529,The Rise and Rise of Michael Rimmer,1970,['United Kingdom'],"['Political satire', 'Satire', 'Comedy', 'Media Satire']",1970,0
21546650,Talent for the Game,1991,['United States of America'],"['Sports', 'Drama']",1990,1
4006786,High School Musical 2,2007,['United States of America'],"['Musical', 'Family Drama', 'Comedy', 'Teen', ""Children's"", 'Drama', 'Family Film']",2000,7
3145085,Man in the Shadow,1957,['United States of America'],"['Detective fiction', 'Crime Fiction', 'Action/Adventure', 'Western', 'Thriller', 'Detective']",1950,7
2055559,Valmont,1989,"['Kingdom of Great Britain', 'France', 'United States of America']","['Film adaptation', 'Indie', 'Romantic drama', 'World cinema', 'Romance Film', 'Costume drama', 'Drama', 'Period piece']",1980,9
6484887,Gimme an 'F',1984,['United States of America'],"['Drama', 'Comedy', 'Teen']",1980,4
9190793,Buenos Aires me mata,1998,['Argentina'],"['Musical', 'Drama']",1990,8
1847082,Anniyan,2005,['India'],"['Musical', 'Psychological thriller', 'Thriller', 'World cinema', 'Tamil cinema', 'Drama', 'Short Film', 'Horror']",2000,5
666378,Donald's Nephews,1938,['United States of America'],"['Animation', 'Short Film', 'Comedy', 'Family Film']",1930,8
23398644,Tum Mile,2009,['India'],"['Romance Film', 'Drama', 'World cinema']",2000,9
1492011,F for Fake,1973,"['Iran', 'France', 'Germany', 'West Germany']","['Essay Film', 'Biography', 'Avant-garde', 'Documentary', 'Experimental film', 'Film']",1970,3
31136421,That Funny Feeling,1965,['United States of America'],"['Romance Film', 'Romantic comedy', 'Comedy']",1960,5
301574,The Little Mermaid,1989,['United States of America'],"['Musical', 'Animation', 'Romance Film', 'Costume drama', 'Family Film', 'Fantasy']",1980,9
740744,Peter Pan,2003,"['United Kingdom', 'Australia', 'United States of America']","['Romance Film', 'Costume drama', 'Adventure', 'Family Film', 'Fantasy']",2000,3
5008724,Purab Aur Paschim,1979,['India'],"['Musical', 'World cinema', 'Drama', 'Family Film']",1970,9
26044473,Sutjeska,1973,['Yugoslavia'],"['Drama', 'War film', 'Biopic [feature]']",1970,3
183828,"Sorry, Wrong Number",1948,['United States of America'],"['Psychological thriller', 'Crime Fiction', 'Mystery', 'Thriller', 'Film noir', 'Crime Thriller', 'Drama']",1940,8
3417500,The Cat o' Nine Tails,1971,"['France', 'West Germany', 'Italy']","['Psychological thriller', 'Giallo', 'Thriller', 'Horror', 'World cinema', 'Whodunit', 'Crime Thriller']",1970,1
8457548,Rebecca,1997,"['United Kingdom', 'Germany']","['Film adaptation', 'Mystery', 'Romantic drama', 'Thriller', 'Romance Film', 'Drama', 'Period piece', 'Television movie']",1990,7
4714316,The Hills Have Eyes Part II,1985,"['United Kingdom', 'United States of America']","['Monster movie', 'Horror', 'Road-Horror', 'Cult']",1980,5
213270,Back to the Future Part II,1989,['United States of America'],"['Time travel', 'Humour', 'Comedy', 'Adventure', 'Sci-Fi Adventure', 'Science Fiction', 'Family Film']",1980,9
10103815,Unknown Pleasures,2002,"['South Korea', 'China', 'Japan', 'France']","['Japanese Movies', 'World cinema', 'Chinese Movies', 'Drama']",2000,2
2154180,Twilight's Last Gleaming,1977,"['Germany', 'United States of America', 'West Germany']","['Thriller', 'Political thriller']",1970,7
5208575,Majaa,2005,['India'],"['Musical', 'Romantic drama', 'Bollywood', 'World cinema', 'Romance Film', 'Drama']",2000,5
14615533,Wham Bam Slam,1955,['United States of America'],"['Short Film', 'Black-and-white', 'Comedy']",1950,5
5472438,The Ballad of Narayama,1983,['Japan'],"['Art film', 'Japanese Movies', 'Comedy', 'World cinema', 'Drama']",1980,3
9311494,Adhu Oru Kana Kaalam,2005,['India'],"['Musical', 'Romantic drama', 'Bollywood', 'World cinema', 'Romance Film', 'Drama']",2000,5
133574,Unforgiven,1992,['United States of America'],"['Western', 'Drama']",1990,2
4520121,Nothing But Trouble,1991,['United States of America'],"['Black comedy', 'Comedy', 'Horror']",1990,1
23299279,Let's Talk About Youth,1976,['South Korea'],['Drama'],1970,6
21593765,Teesri Aankh: The Hidden Camera,2006,['India'],"['Action', 'Musical', 'Crime Fiction', 'Thriller', 'Bollywood', 'World cinema', 'Drama']",2000,6
854045,De-Lovely,2004,"['United Kingdom', 'United States of America']","['Musical', 'LGBT', 'Biography', 'Musical Drama', 'Biographical film', 'Drama', 'Period piece', 'Marriage Drama', 'Biopic [feature]']",2000,4
10417862,Sharaabi,1984,['India'],"['Musical', 'Romantic drama', 'Bollywood', 'World cinema', 'Romance Film', 'Drama']",1980,4
5907816,Vettaiyaadu Vilaiyaadu,2006,['India'],"['Action', 'Crime Fiction', 'Thriller', 'Romance Film']",2000,6
850349,Wild Style,1982,['United States of America'],"['Musical', 'Documentary', 'Hip hop movies', 'Drama']",1980,2
5409260,Critic's Choice,1963,['United States of America'],"['Romance Film', 'Comedy-drama', 'Comedy']",1960,3
6944899,Es geschah am hellichten Tag,1958,"['Spain', 'Switzerland', 'West Germany']",['Drama'],1950,8
20149505,The Hard Way,1943,['United States of America'],['Black-and-white'],1940,3
2038244,Judwaa,1997,['India'],"['Musical', 'Romantic drama', 'Comedy', 'Bollywood', 'World cinema', 'Romance Film', 'Drama', 'Romantic comedy']",1990,7
12457184,Genesis,1986,['India'],['Art film'],1980,6
14238656,The Man from Earth,2007,['United States of America'],"['Indie', 'Science Fiction', 'Drama']",2000,7
17697603,The Big Timer,1932,['United States of America'],"['Black-and-white', 'Drama']",1930,2
14015304,Mohan Joshi Hazir Ho!,1984,['India'],['Art film'],1980,4
2513047,"Hey There, It's Yogi Bear!",1964,['United States of America'],"['Animation', ""Children's"", 'Comedy', 'Romance Film', 'Adventure', 'Family Film']",1960,4
18596409,A Month in the Country,1987,['United Kingdom'],['Drama'],1980,7
2120282,Nickelodeon,1976,"['United Kingdom', 'United States of America']","['Period piece', 'Comedy-drama', 'Comedy']",1970,6
2342941,Aquamarine,2006,"['United States of America', 'Australia']","['Comedy', 'Teen', 'Romance Film', ""Children's"", 'Coming of age', 'Fantasy Comedy', 'Family Film', 'Fantasy']",2000,6
7142769,"Abbott and Costello Meet the Killer, Boris Karloff",1949,['United States of America'],"['Detective fiction', 'Black-and-white', 'Mystery', 'Comedy', 'Thriller', 'Slapstick', 'Parody', 'Detective', 'Horror', 'Family Film']",1940,9
9391669,Gambler's Choice,1944,['United States of America'],"['Black-and-white', 'Crime Fiction', 'Drama']",1940,4
7671705,Gowri,2004,['India'],"['Romantic drama', 'World cinema', 'Romance Film', 'Drama']",2000,4
3863333,Indira,1996,['India'],"['Drama', 'Tamil cinema']",1990,6
1367452,Jagged Edge,1985,['United States of America'],"['Psychological thriller', 'Crime Fiction', 'Mystery', 'Thriller', 'Romance Film', 'Crime Thriller', 'Courtroom Drama']",1980,5
18755806,Picture Claire,2001,"['Canada', 'United States of America']","['Action', 'Suspense', 'Mystery', 'Indie', 'Action/Adventure', 'Thriller', 'Crime Thriller']",2000,1
14526878,A Gem of a Jam,1943,['United States of America'],"['Short Film', 'Black-and-white', 'Comedy']",1940,3
8418064,Clowning around,1992,"['France', 'United States of America', 'Australia']","['Indie', ""Children's/Family"", ""Children's"", 'Drama', 'Family Film']",1990,2
19468127,Joe the King,1999,['United States of America'],"['Period piece', 'Drama', 'Crime Fiction', 'Coming of age', 'Indie', 'Family Drama']",1990,9
4625048,Raam,2005,['India'],"['Musical', 'Thriller', 'Bollywood', 'World cinema', 'Drama']",2000,5
6948099,WXIII: Patlabor the Movie 3,2001,['Japan'],"['Action', 'Animation', 'Thriller', ""Children's"", 'Drama', 'Japanese Movies', 'Future noir', 'Anime', 'Science Fiction']",2000,1
2917795,Innocent Blood,1992,['United States of America'],"['Action', 'Gangster Film', 'Action/Adventure', 'Comedy', 'Thriller', 'Horror Comedy', 'Black comedy', 'Horror']",1990,2
3300211,Assassins,1995,"['France', 'United States of America']","['Action', 'Crime Fiction', 'Action Thrillers', 'Chase Movie', 'Action/Adventure', 'Thriller', 'Crime Thriller']",1990,5
3161156,Modern Romance,1981,['United States of America'],"['Romance Film', 'Romantic comedy', 'Comedy']",1980,1
14206542,Feast 2: Sloppy Seconds,2008,['United States of America'],"['Slasher', 'Comedy', 'Horror']",2000,8
18902161,The Killer Is Loose,1956,['United States of America'],"['Psychological thriller', 'Black-and-white', 'Crime Fiction', 'Thriller', 'Film noir', 'Drama']",1950,6
24864009,To pontikaki,1954,['Greece'],"['Comedy film', 'Crime Fiction']",1950,4
612866,Secrets & Lies,1996,"['United Kingdom', 'France']","['Drama', 'Comedy']",1990,6
3814352,Jealousy is My Middle Name,2002,['South Korea'],"['Romance Film', 'Drama']",2000,2
1922686,Kabhi Alvida Naa Kehna,2006,['India'],"['Romantic drama', 'Marriage Drama', 'Bollywood', 'World cinema', 'Romance Film', 'Drama', 'Family Film']",2000,6
3749701,The Source,2002,['United States of America'],"['Biography', 'Thriller', 'Teen', 'Language & Literature', 'History', 'Horror', 'Supernatural', 'Science Fiction']",2000,2
23229918,Harry's War,1981,['United States of America'],"['Political cinema', 'Indie', 'Parody', 'Comedy']",1980,1
4501185,Universal Soldier: The Return,1999,['United States of America'],"['Action', 'Action/Adventure', 'Science Fiction', 'Thriller', 'Martial Arts Film']",1990,9
12202005,Beyond Evil,1980,['United States of America'],"['B-movie', 'Haunted House Film', 'Horror']",1980,0
24146063,The Beat,2003,['United States of America'],"['Drama', 'Hip hop movies', 'Fantasy']",2000,3
670386,Bull Durham,1988,['United States of America'],"['Comedy', 'Baseball', 'Romantic comedy', 'Romance Film', 'Sports']",1980,8
1734816,The Brave,1997,['United States of America'],"['Family Drama', 'Drama']",1990,7
13350171,I Love You,2002,['China'],"['Romance Film', 'Drama', 'Chinese Movies']",2000,2
5605738,Leave 'Em Laughing,1928,['United States of America'],"['Black-and-white', 'Indie', 'Short Film', 'Comedy', 'Silent film']",1920,8
8174574,Captain January,1924,['United States of America'],"['Silent film', 'Indie', 'Drama']",1920,4
3195539,A Charlie Brown Valentine,2002,[],"['Animation', ""Children's/Family"", 'Holiday Film', 'Family Film']",2000,2
10986642,Seacoal,1985,['United Kingdom'],['Docudrama'],1980,5
7156807,Bienvenue chez les Rozes,2003,['France'],['Comedy'],2000,3
32710519,My Little Pony: A Very Pony Place,2007,[],['Animation'],2000,7
16263752,Pocahontas,1994,"['Japan', 'United States of America']","['History', 'Animation', 'Adventure', 'Family Film']",1990,4
7853339,Defence of the Realm,1986,"['United Kingdom', 'United States of America']","['Suspense', 'Thriller', 'Crime Thriller', 'Political thriller']",1980,6
10454813,Wake in Fright,1971,"['United States of America', 'Australia']","['Thriller', 'Drama']",1970,1
4738713,Death on the Nile,1978,['United Kingdom'],"['Suspense', 'Crime Fiction', 'Mystery', 'Thriller', 'Detective', 'Crime Thriller']",1970,8
9691132,He Was Cool,2004,['South Korea'],"['Romance Film', 'Comedy']",2000,4
4958412,Johnny Be Good,1988,['United States of America'],"['Sports', 'Comedy', 'Teen']",1980,8
6767900,Nammal,2002,['India'],"['Comedy', 'Romance Film', 'Romantic comedy', 'Drama']",2000,2
11143191,Tik Tik Tik,1981,['India'],"['Crime Fiction', 'Mystery', 'Thriller']",1980,1
5220823,3 Chains o' Gold,1994,['United States of America'],['Music'],1990,4
5517504,Elippathayam,1981,['India'],"['Drama', 'Malayalam Cinema']",1980,1
705925,Far and Away,1992,['United States of America'],"['Period piece', 'Romantic drama', 'Romance Film', 'Epic', 'Costume drama', 'Drama']",1990,2
30457816,Porky's Railroad,1937,[],"['Animation', 'Short Film', 'Comedy film', 'Family Film']",1930,7
2773473,Carlito's Way: Rise to Power,2005,['United States of America'],"['Action', 'Period piece', 'Crime Fiction', 'Gangster Film', 'Thriller', 'Crime Drama', 'Drama']",2000,5
11358526,Captives,1994,['United Kingdom'],"['Crime Fiction', 'Mystery', 'Indie', 'Romantic drama', 'Thriller', 'Romance Film', 'Drama', 'Suspense']",1990,4
1688639,They're a Weird Mob,1966,"['United Kingdom', 'Australia']","['Romantic comedy', 'Adventure']",1960,6
10387789,The Secret Heart,1946,['United States of America'],"['Black-and-white', 'Drama']",1940,6
2473161,Distant Thunder,1988,['United States of America'],"['War film', 'Drama']",1980,8
11827606,Skins,2002,['United States of America'],"['Crime Fiction', 'Indie', 'Family Drama', 'Social problem film', 'Drama']",2000,2
7999587,Knight Without Armour,1937,['United Kingdom'],"['Period piece', 'Spy', 'Black-and-white', 'Romantic drama', 'Melodrama', 'Drama']",1930,7
9991132,"Three for Bedroom ""C""",1952,['United States of America'],"['Travel', 'Comedy']",1950,2
25620902,The Graveyard,2006,['United States of America'],"['Indie', 'Slasher', 'Teen', 'Horror']",2000,6
1238514,Christmas with the Kranks,2004,['United States of America'],"['Film adaptation', 'Slapstick', 'Comedy', 'Holiday Film', 'Christmas movie', 'Family Film']",2000,4
10574197,Les Mystéres du Château du Dé,1929,['France'],"['Surrealism', 'Short Film', 'Avant-garde', 'Experimental film']",1920,9
12186543,"So Evil, So Young",1961,['United Kingdom'],"['Drama', 'Crime Fiction']",1960,1
503562,Slacker,1991,['United States of America'],"['Drama', 'Indie', 'Comedy', 'Cult']",1990,1
11517297,The Law of the Range,1928,['United States of America'],"['Silent film', 'Indie', 'Western']",1920,8
2491582,Eyes Without a Face,1959,"['France', 'Italy']","['Black-and-white', 'Gothic Film', 'Horror', 'World cinema']",1950,9
14299281,The Sex Thief,1974,['United Kingdom'],"['Comedy', 'Cult']",1970,4
4979081,One Deadly Summer,1983,['France'],"['Erotic Drama', 'Marriage Drama', 'Thriller', 'World cinema', 'Erotica', 'Drama']",1980,3
7971480,The Fixer-Uppers,1935,['United States of America'],"['Short Film', 'Black-and-white', 'Comedy']",1930,5
3159738,Dementia,1955,['United States of America'],"['Mystery', 'Horror']",1950,5
1661137,Elizabethtown,2005,['United States of America'],"['Family Drama', 'Romantic drama', 'Comedy', 'Romance Film', 'Romantic comedy', 'Comedy-drama', 'Drama']",2000,5
5391207,Boys,1996,['United States of America'],"['Mystery', 'Thriller', 'Teen', 'Romance Film', 'Drama']",1990,6
8513914,Hacks,2003,['United States of America'],"['Indie', 'Stand-up comedy', 'Comedy', 'Mockumentary']",2000,3
4981196,Homeless Hare,1950,['United States of America'],"['Animation', 'Short Film', 'Family Film']",1950,0
25737602,"Vincent, François, Paul and the Others",1974,"['France', 'Italy']",['Drama'],1970,4
14053126,American Cuisine,1998,['France'],['Comedy'],1990,8
22611682,The Memorial Gate for Virtuous Women,1962,['South Korea'],"['Romantic drama', 'Melodrama']",1960,2
24640021,La bonne année,1973,"['France', 'Italy']","['Romantic drama', 'Comedy', 'World cinema', 'Romance Film', 'Drama', 'Caper story', 'Romantic comedy', 'Comedy-drama']",1970,3
14812001,Frozen River,2008,['United States of America'],"['Crime Fiction', 'Indie', 'Thriller', 'Crime Thriller', 'Drama']",2000,8
9720148,The Paper Chase,1973,['United States of America'],"['Film adaptation', 'Coming of age', 'Romantic drama', 'Romance Film', 'Legal drama', 'Drama', 'Ensemble Film']",1970,3
19206451,Quasimodo d'El Paris,1999,['France'],"['Parody', 'Comedy']",1990,9
2737751,Peppermint Candy,2000,"['Japan', 'South Korea']","['Japanese Movies', 'Romance Film', 'Political drama', 'Drama']",2000,0
27237642,The Crimson City,1928,[],['Silent film'],1920,8
7487961,Betty Boop's Big Boss,1933,['United States of America'],"['Animation', 'Short Film', 'Comedy', 'Family Film']",1930,3
23276270,Last Exit to Brooklyn,1989,"['United Kingdom', 'Germany', 'West Germany', 'United States of America']","['Period piece', 'Film adaptation', 'LGBT', 'Drama']",1980,9
19715507,Swearing Allegiance,1997,['United States of America'],['Drama'],1990,7
14669549,Right Now,2004,['France'],"['Period piece', 'Black-and-white', 'Crime Fiction', 'World cinema', 'Crime Drama', 'Road movie', 'Drama']",2000,4
7134551,Partie de campagne,1936,['France'],"['Short Film', 'Drama']",1930,6
14250331,Woodstock Villa,2008,['India'],"['Musical', 'Thriller', 'Bollywood', 'World cinema']",2000,8
8694451,Crash and Burn,1990,['United States of America'],"['Dystopia', 'Indie', 'Thriller', 'Science Fiction']",1990,0
6099156,Tholi Prema,1998,['India'],['Romantic comedy'],1990,8
22365625,Fanfan la Tulipe,2003,['France'],"['Romance Film', 'Comedy', 'Adventure']",2000,3
1448266,Rajnigandha,1974,['India'],"['Comedy', 'Bollywood']",1970,4
5251346,Take A Chance,2006,['United States of America'],"['Comedy', 'Romance Film', 'Romantic comedy', 'Religious Film']",2000,6
12872401,The Matchmaker,1958,['United States of America'],"['Black-and-white', 'Comedy', 'Romance Film', 'Romantic comedy']",1950,8
10069804,Bloody Murder,2000,['United States of America'],"['Slasher', 'Teen', 'Horror']",2000,0
24911114,Nema problema,2004,['Italy'],"['War film', 'Drama']",2000,4
1859733,Phool Aur Kaante,1991,['India'],"['Bollywood', 'World cinema']",1990,1
1751270,The Toast of New Orleans,1950,['United States of America'],"['Musical', 'Romantic drama', 'Musical Drama', 'Romance Film', 'Drama']",1950,0
22228418,The Iron Curtain,1948,['United States of America'],"['Action', 'Spy', 'Black-and-white', 'Thriller']",1940,8
5315533,A Tale of Autumn,1998,['France'],"['Romance Film', 'Drama']",1990,8
74577,Rear Window,1954,['United States of America'],"['Psychological thriller', 'Suspense', 'Mystery', 'Thriller', 'Crime Thriller']",1950,4
4292181,Six Ways To Sunday,1997,['United States of America'],"['Gangster Film', 'Comedy', 'Crime Comedy', 'Black comedy', 'Comedy-drama']",1990,7
11996246,Three Brothers,1981,"['France', 'Italy']","['Drama', 'World cinema']",1980,1
12135182,Death of a Cyclist,1955,['Spain'],"['Black-and-white', 'Art film', 'World cinema', 'Crime Drama', 'Social problem film', 'Drama']",1950,5
5137533,Enter the Ninja,1981,['United States of America'],"['Action', 'Martial Arts Film']",1980,1
183769,Possessed,1947,['United States of America'],"['Black-and-white', 'Crime Fiction', 'Romantic drama', 'Thriller', 'Film noir', 'Romance Film', 'Drama']",1940,7
15667389,Fright,1972,['United Kingdom'],"['Suspense', 'Slasher', 'Horror']",1970,2
867952,Drunken Angel,1948,['Japan'],"['Japanese Movies', 'World cinema', 'Drama', 'Medical fiction']",1940,8
11822123,The Legend of Lobo,1962,['United States of America'],"['Animal Picture', 'Adventure', 'Family Film']",1960,2
3329130,The Eddy Duchin Story,1956,['United States of America'],"['Musical', 'Musical Drama', 'Biography', 'Romantic drama', 'Biographical film', 'Romance Film', 'Drama', 'Period piece', 'Biopic [feature]']",1950,6
13839964,Odour of Chrysanthemums,2002,['United Kingdom'],['Short Film'],2000,2
19699054,L'Enfer,1994,['France'],"['Crime Fiction', 'Drama', 'World cinema']",1990,4
14030783,Kishen Kanhaiya,1990,['India'],"['Drama', 'Family Film']",1990,0
5540886,Buddy Boy,2000,['United States of America'],"['Psychological thriller', 'Indie', 'Thriller', 'Erotic thriller']",2000,0
20568913,Rudolph the Red-Nosed Reindeer: The Movie,1998,['United States of America'],"['Animation', 'Adventure', ""Children's"", 'Family Film']",1990,8
16890064,Un rey en la Habana,2005,['Spain'],"['Comedy', 'World cinema']",2000,5
10301454,Steelyard Blues,1973,['United States of America'],"['Crime Fiction', 'Caper story', 'Satire', 'Comedy', 'Drama']",1970,3
303847,Love and Death on Long Island,1997,"['Canada', 'United Kingdom']","['LGBT', 'Indie', 'Romantic drama', 'Comedy', 'Romance Film', 'Drama', 'Gay Themed', 'Gay', 'Gay Interest', 'Romantic comedy', 'Comedy-drama']",1990,7
303039,Santa with Muscles,1996,['United States of America'],"[""Children's/Family"", 'Comedy', 'Comedy of Errors']",1990,6
26140666,Grave of the Vampire,1974,['United States of America'],['Horror'],1970,4
31977275,Sameera,1981,[],"['Drama', 'Family Film']",1980,1
4541243,Laaj,2003,['Pakistan'],"['Action', 'Drama']",2000,3
663968,Killing Zoe,1994,"['United States of America', 'France']","['Heist', 'Crime Fiction', 'Indie', 'Caper story', 'Drama', 'Thriller', 'Crime Thriller']",1990,4
26525407,Shalini Ente Koottukari,1978,['India'],"['Romance Film', 'Drama']",1970,8
1337210,Mandingo,1975,['United States of America'],"['Period piece', 'Blaxploitation', 'Film adaptation', 'Romance Film', 'Melodrama', 'Drama']",1970,5
21113228,Precious: Based on the Novel Push by Sapphire,2009,['United States of America'],"['Film adaptation', 'Indie', 'Drama']",2000,9
6883127,Voor een paar knikkers meer,2006,['Netherlands'],"['Short Film', 'Family Film']",2000,6
4470950,Field Mouse,1927,"['Korea', 'South Korea']","['Silent film', 'Black-and-white', 'Indie']",1920,7
4871302,An Easter Carol,2004,[],"['Musical', 'Animation', 'Short Film', ""Children's""]",2000,4
5348143,Half Nelson,2006,['United States of America'],"['Social problem film', 'Drama']",2000,6
8265606,Dick Tracy's G-Men,1939,['United States of America'],"['Action', 'Black-and-white', 'Crime Fiction', 'Mystery', 'Superhero', 'Adventure', 'Detective', 'Superhero movie']",1930,9
18849127,Nativity,2009,['United Kingdom'],"['Religious Film', 'Holiday Film', 'Comedy']",2000,9
23094610,Knights of Bloodsteel,2009,['Canada'],"['Adventure', 'Drama', 'Fantasy']",2000,9
19473036,The Minion,1998,"['Canada', 'United States of America']","['Action', 'Action/Adventure', 'Thriller', 'Horror', 'Doomsday film', 'Supernatural']",1990,8
15464704,No Noise,1923,['United States of America'],"['Black-and-white', 'Indie', 'Short Film', 'Comedy', 'Silent film', 'Family Film']",1920,3
24607515,I'll Get You for This,1951,['United Kingdom'],"['Drama', 'Crime Fiction']",1950,1
1022698,Captain Horatio Hornblower,1951,"['United Kingdom', 'United States of America']","['Action', 'Costume Adventure', 'Action/Adventure', 'War film', 'Costume drama', 'Adventure']",1950,1
7450016,The Littlest Rebel,1935,['United States of America'],"['Musical', 'Black-and-white', 'Family Drama', 'Comedy', 'Musical comedy', 'Drama', 'Family Film']",1930,5
22622597,The Wheel,1984,['South Korea'],['Drama'],1980,4
2101253,Riverworld,2003,['Canada'],"['Thriller', 'Adventure', 'Television movie', 'Science Fiction', 'Fantasy']",2000,3
2881459,The Argentine,2008,"['France', 'Spain', 'United States of America']","['Roadshow theatrical release', 'Biographical film']",2000,8
887025,Wishcraft,2002,['United States of America'],"['Slasher', 'Teen', 'Horror']",2000,2
9207788,Traci Townsend,2005,['United States of America'],"['Romance Film', 'Romantic comedy', 'Comedy']",2000,5
24815671,Whiskey School,2007,['United States of America'],"['Addiction Drama', 'Drama']",2000,7
1365530,The Young Philadelphians,1959,['United States of America'],"['Melodrama', 'Drama', 'Courtroom Drama']",1950,9
2310527,The Specials,2000,['United States of America'],"['Action', 'Superhero', 'Indie', 'Parody', 'Action/Adventure', 'Comedy', 'Superhero movie']",2000,0
415881,Beau travail,1999,['France'],"['Foreign legion', 'LGBT', 'World cinema', 'Drama']",1990,9
34772363,Super Hornio Brothers,1993,['United States of America'],"['Comedy film', 'Adult', 'Fantasy']",1990,3
5795788,War,2007,['United States of America'],"['Action', 'Gangster Film', 'Action/Adventure', 'Thriller', 'Crime Thriller', 'Martial Arts Film']",2000,7
9289841,Dual,2007,['United States of America'],"['Period piece', 'Drama', 'Indie', 'Western', 'Action/Adventure', 'Romantic drama', 'Romance Film']",2000,7
3951914,Just for Kicks,2003,['United States of America'],"['Comedy', 'Sports', 'Adventure', 'Family Film']",2000,3
4279572,Satan's Little Helper,2005,['United States of America'],"['Slasher', 'Horror']",2000,5
5054128,The Delicate Delinquent,1957,['United States of America'],"['Parody', 'Slapstick', 'Comedy']",1950,7
7889520,Shwaas,2004,['India'],"['Musical', 'Art film', 'Family Drama', 'Bollywood', 'World cinema', 'Drama', 'Medical fiction']",2000,4
2099943,Night of the Demon,1957,['United Kingdom'],"['Black-and-white', 'Supernatural', 'Horror']",1950,7
22060589,Purple Haze,1983,['United States of America'],['Drama'],1980,3
4127710,Left Luggage,1998,"['United Kingdom', 'Netherlands', 'Belgium']","['Period piece', 'Family Drama', 'Indie', 'World cinema', 'Drama']",1990,8
18648379,Meravanige,2008,['India'],"['Romance Film', 'Drama']",2000,8
3795349,Four Shades of Brown,2004,['Sweden'],"['Drama', 'Comedy']",2000,4
22982386,Artificially Speaking,2009,['United States of America'],"['Short Film', 'Comedy']",2000,9
2197752,Alam Ara,1931,['India'],"['Black-and-white', 'Fantasy']",1930,1
209301,From the Terrace,1960,['United States of America'],"['Romantic drama', 'Marriage Drama', 'Romance Film', 'Drama']",1960,0
9035550,Henry VIII,2003,['United Kingdom'],"['Romance Film', 'Historical fiction', 'Costume drama', 'Drama']",2000,3
19273389,Made in Paris,1966,['United States of America'],['Romantic comedy'],1960,6
5276908,L'Ami de mon amie,1987,['France'],"['Comedy', 'World cinema', 'Romance Film', 'Romantic comedy']",1980,7
1850269,Kekexili: Mountain Patrol,2004,"['Hong Kong', 'China', 'United States of America']","['Action', 'Drama', 'Action/Adventure', 'World cinema', 'Chinese Movies']",2000,4
4201126,The Job,2003,['United States of America'],"['Action', 'Action/Adventure', 'Thriller', 'Crime Thriller']",2000,3
35509205,Night Eyes 2,1991,['United States of America'],"['Adult', 'Thriller', 'Erotica', 'Drama']",1990,1
20372296,Commissioner,1994,['India'],"['Action', 'Crime Fiction', 'Bollywood']",1990,4
31156961,Ravanan,2006,[],"['Action', 'Thriller']",2000,6
27970670,Service with a Smile,1937,[],"['Short Film', 'Animation']",1930,7
31806250,C.C. and Company,1970,['United States of America'],"['Action', 'Drama', 'Comedy']",1970,0
3565365,The Molly Maguires,1970,['United States of America'],"['Period piece', 'Crime Fiction', 'Docudrama', 'Drama']",1970,0
11035177,The Pizza Triangle,1970,"['Spain', 'Italy']",['Comedy'],1970,0
1829448,The Plague of the Zombies,1966,"['United Kingdom', 'United States of America']","['Creature Film', 'Zombie Film', 'Horror']",1960,6
1382226,The Naked Jungle,1954,['United States of America'],"['Action', 'Romantic drama', 'Action/Adventure', 'Romance Film', 'Adventure', 'Drama', 'Jungle Film', 'Horror', 'Natural horror films']",1950,4
8167343,The State of Things,1983,"['Portugal', 'Germany', 'West Germany', 'United States of America']","['Black-and-white', 'Drama']",1980,3
22947649,Banovic Strahinja,1983,['Yugoslavia'],"['Action', 'Adventure', 'Fantasy']",1980,3
770098,Steamboy,2004,['Japan'],"['Action', 'Fantasy Adventure', 'Animation', 'Period piece', 'Japanese Movies', 'Anime', 'Steampunk', 'Science Fiction']",2000,4
3546099,Life 101,1995,['United States of America'],"['Period piece', 'Comedy', 'Comedy-drama', 'Drama']",1990,5
15383448,Threshold,2003,"['Canada', 'United States of America']","['Television movie', 'Science Fiction', 'Thriller']",2000,3
1575869,Cube Zero,2004,['Canada'],"['Psychological thriller', 'Science Fiction', 'Thriller', 'Horror', 'Sci-Fi Horror']",2000,4
1091346,Alfie,2004,"['United Kingdom', 'United States of America']","['Romantic drama', 'Comedy', 'Remake', 'Romance Film', 'Drama', 'Romantic comedy', 'Comedy-drama', 'Sex comedy']",2000,4
73875,The Godfather Part II,1974,['United States of America'],"['Crime Fiction', 'Gangster Film', 'Crime Drama', 'Drama']",1970,4
19767434,Satan's Triangle,1975,['United States of America'],"['Mystery', 'Drama', 'Horror']",1970,5
35033607,Trapped in the Closet Chapters 1–12,2005,[],['Musical'],2000,5
22662100,Non ci resta che piangere,1984,['Italy'],['Comedy'],1980,4
5794648,Angels and Demons,2009,['United States of America'],"['Suspense', 'Film adaptation', 'Mystery', 'Thriller', 'Crime Thriller']",2000,9
3332886,The Unsaid,2001,"['Canada', 'United States of America']","['Psychological thriller', 'Crime Thriller', 'Thriller']",2000,1
10190604,The Great Gambler,1979,['India'],"['Action', 'Romance Film', 'Crime Fiction']",1970,9
22568535,Invasion of the Blood Farmers,1972,['United States of America'],['Horror'],1970,2
30047048,Special People,2007,[],['Drama'],2000,7
5016546,Movie Crazy,1932,['United States of America'],"['Black-and-white', 'Comedy', 'Biopic [feature]', 'Slapstick', 'Romance Film', 'Family Film']",1930,2
24207129,A Single Man,2009,['United States of America'],"['Film adaptation', 'LGBT', 'Romantic drama', 'Romance Film', 'Drama']",2000,9
13393041,What Happens in Vegas...,2008,['United States of America'],"['Romance Film', 'Comedy']",2000,8
3819103,Un flic,1972,['France'],"['Thriller', 'Crime Fiction']",1970,2
27423486,Mara of the Wilderness,1965,['United States of America'],"['Action/Adventure', 'Adventure']",1960,5
3025805,Undertow,2004,['United States of America'],"['Crime Fiction', 'Indie', 'Thriller', 'Drama']",2000,4
25079696,Ski Troop Attack,1963,['United States of America'],"['Combat Films', 'Action', 'Action/Adventure', 'Adventure', 'War film']",1960,3
17100455,The Miracle Man,1932,['United States of America'],"['Black-and-white', 'Drama']",1930,2
6435205,"Lipstick and Dynamite, Piss and Vinegar: The First Ladies of Wrestling",2005,['United States of America'],"['Sports', 'Documentary']",2000,5
8804073,"Please, Not Now!",1961,['France'],"['Comedy', 'World cinema']",1960,1
32412377,Shri Datta Darshanam,1985,['India'],"['Musical', 'Drama']",1980,5
17718246,Blind Date,2008,['United States of America'],"['Romantic drama', 'Indie', 'Romance Film', 'Drama']",2000,8
7128768,Spring Breakdown,2008,['United States of America'],"['Indie', 'Comedy']",2000,8
5097628,Above and Beyond,1952,['United States of America'],"['War film', 'Biographical film', 'Drama']",1950,2
2671380,Neighbours,1952,['Canada'],"['Animation', 'Short Film', 'Comedy']",1950,2
6846153,Horses' Collars,1935,['United States of America'],"['Short Film', 'Black-and-white', 'Comedy']",1930,5
4481841,Species III,2004,['United States of America'],"['Thriller', 'Horror', 'Sci-Fi Horror', 'Science Fiction']",2000,4
9289964,Cannibal Hookers,1987,['United States of America'],['Horror'],1980,7
657764,Uncle Buck,1989,['United States of America'],"['Comedy', 'Domestic Comedy', 'Drama', 'Family Film']",1980,9
1210579,The Winter Guest,1997,"['Kingdom of Great Britain', 'United Kingdom', 'United States of America']","['Indie', 'Family Drama', 'Drama']",1990,7
15797817,Mute Witness,1994,"['Russia', 'United Kingdom', 'Germany', 'United States of America']","['Psychological thriller', 'Drama', 'Indie', 'Thriller', 'Horror', 'World cinema']",1990,4
26924588,Cruel Map of Women's Bodies,1967,['Japan'],['Japanese Movies'],1960,7
22210654,"Gabriela, Cravo e Canela",1983,['Brazil'],"['Period piece', 'Film adaptation', 'Romantic drama', 'Comedy film', 'Romance Film', 'Drama']",1980,3
5586167,Orwell Rolls in His Grave,2004,['United States of America'],"['Social issues', 'Political cinema', 'Documentary', 'Media Studies', 'Culture & Society']",2000,4
14812466,The Damned United,2009,['United Kingdom'],"['Period piece', 'Film adaptation', 'Comedy', 'Biographical film', 'Sports', 'Drama']",2000,9
17747518,School Days,1995,"['Hong Kong', 'Taiwan']","['Action', 'Drama', 'Comedy', 'Romance Film', 'Chinese Movies']",1990,5
19270295,Biyer Lagna,2008,['India'],['Drama'],2000,8
16909489,Emanuelle Escapes from Hell,1983,['Italy'],"['Action', 'Drama']",1980,3
2691895,R-Point,2004,['South Korea'],"['Creature Film', 'Action', 'Action/Adventure', 'World cinema', 'Horror', 'War film']",2000,4
8215662,Comin' Round The Mountain,1951,['United States of America'],"['Black-and-white', 'Family Film']",1950,1
2378574,There Was a Crooked Man...,1970,['United States of America'],"['Action', 'Action/Adventure', 'Western', 'Comedy', 'Black comedy']",1970,0
3267654,Sökarna,1993,[],['Crime Fiction'],1990,3
12493840,Bang Bang You're Dead,2002,['United States of America'],"['Crime Fiction', 'Thriller', 'Teen', 'Social problem film', 'Drama']",2000,2
396470,The Banger Sisters,2002,['United States of America'],"['Comedy-drama', 'Buddy film', 'Comedy']",2000,2
32605350,Hotel De Love,1996,"['New Zealand', 'Australia']","['Indie', 'Comedy', 'World cinema', 'Romance Film', 'Romantic comedy']",1990,6
13725556,Mohabbataan Sachiyaan,2007,['Pakistan'],"['Musical', 'Romance Film']",2000,7
297111,Reservoir Dogs,1992,['United States of America'],"['Drama', 'Crime Fiction', 'Gangster Film', 'Indie', 'Mystery', 'Thriller', 'Crime Thriller']",1990,2
4403780,The Great Impostor,1961,['United States of America'],"['Comedy', 'Biopic [feature]', 'Comedy-drama', 'Docudrama', 'Drama']",1960,1
24987301,Crazy Heart,2009,['United States of America'],"['Music', 'Romantic drama', 'Romance Film', 'Drama']",2000,9
654742,Jimmy Neutron: Boy Genius,2001,['United States of America'],"[""Children's Fantasy"", 'Fantasy', ""Children's/Family"", 'Adventure', 'Family Film', 'Computer Animation']",2000,1
26173892,Immoral Women,1979,['France'],"['Drama', 'World cinema']",1970,9
19491183,Raw Nerve,1991,['United States of America'],"['Drama', 'Mystery', 'Thriller']",1990,1
23084130,Ben and Arthur,2002,['United States of America'],"['LGBT', 'Indie', 'Thriller', 'Romance Film', 'Drama']",2000,2
3492883,Kronk's New Groove,2005,['United States of America'],"[""Children's/Family"", 'Animation', 'Family Film']",2000,5
22380440,"Sorry, Thanks",2009,['United States of America'],"['Drama', 'Indie', 'Romantic drama', 'Comedy', 'Romance Film', 'Romantic comedy']",2000,9
16893762,Strange Justice,1999,['United States of America'],['Drama'],1990,9
8687830,Switchin' Kitten,1961,['United States of America'],"['Animation', 'Short Film', 'Comedy', 'Family Film']",1960,1
8570876,Rakkilippattu,2000,['India'],['Drama'],2000,0
5396159,Gunmen's Blues,1981,['United States of America'],"['Indie', 'Short Film']",1980,1
690105,The Hunted,2003,['United States of America'],"['Action', 'Drama', 'Crime Fiction', 'Thriller']",2000,3
18908777,Holiday Camp,1947,['United Kingdom'],"['Comedy', 'Adventure']",1940,7
12668580,Luther,1973,"['United Kingdom', 'United States of America', 'Canada']","['Period piece', 'Biography', 'Christian film', 'Drama']",1970,3
2093628,Deconstructing Harry,1997,['United States of America'],"['Indie', 'Comedy', 'Black comedy', 'Romance Film', 'Drama', 'Sex comedy', 'Fantasy', 'Comedy of manners', 'Ensemble Film']",1990,7
3133515,The Viking,1928,['United States of America'],"['Drama', 'Indie', 'Silent film', 'Adventure']",1920,8
163454,Save the Tiger,1973,['United States of America'],"['Drama', 'Crime Fiction']",1970,3
34296392,He Couldn't Say No,1938,['United States of America'],"['Crime Fiction', 'Comedy film', 'Romance Film', 'Adventure']",1930,8
8486272,Once Upon A Christmas,2000,['Canada'],"[""Children's/Family"", 'Holiday Film', 'Fantasy Comedy', 'Family Film']",2000,0
20973286,Eddie Macon's Run,1983,['United States of America'],"['Action', 'Crime Fiction', 'Action/Adventure', 'Thriller', 'Escape Film', 'Adventure', 'Drama', 'Chase Movie']",1980,3
12938853,Nicholas Nickleby,2002,"['United Kingdom', 'Germany', 'Netherlands', 'United States of America']","['Period piece', 'Coming of age', 'Family Drama', 'Costume drama', 'Drama', 'Family Film']",2000,2
8365306,High School U.S.A.,1983,['United States of America'],"['Coming of age', 'Comedy', 'Teen']",1980,3
12401310,Phantom from Space,1953,['United States of America'],"['Alien Film', 'Science Fiction', 'Horror']",1950,3
5267049,Saawariya,2007,['India'],"['Musical', 'Romantic drama', 'Bollywood', 'World cinema', 'Romance Film', 'Drama']",2000,7
14358421,Camila,1984,"['Argentina', 'Spain']","['History', 'Romantic drama', 'World cinema', 'Romance Film', 'Drama']",1980,4
21371379,Frankenstein Island,1981,['United States of America'],"['Monster', 'Jungle Film', 'Horror', 'B-movie', 'Science Fiction']",1980,1
5271413,Toxic,2007,['United States of America'],"['Action', 'Action/Adventure', 'Thriller', 'Crime Thriller']",2000,7
6698816,Hunt Angels,2006,['Australia'],"['Indie', 'Biographical film', 'Drama']",2000,6
14232431,The Cabin in the Cotton,1932,['United States of America'],"['Black-and-white', 'Melodrama', 'Drama']",1930,2
3736614,Viva Max!,1969,['United States of America'],"['Comedy', 'Satire']",1960,9
24491618,Le Masque de fer,1962,"['France', 'Italy']",['Adventure'],1960,2
7515924,Zula Hula,1937,['United States of America'],"['Short Film', 'Animation']",1930,7
2729561,Carson City,1952,['United States of America'],['Western'],1950,2
1137529,Deathwatch,2002,"['United Kingdom', 'France', 'Germany', 'Italy']","['Period piece', 'Thriller', 'Horror', 'War film', 'Supernatural']",2000,2
17424270,The Answer Man,2009,['United States of America'],"['Indie', 'Comedy', 'Romance Film', 'Romantic comedy', 'Comedy-drama', 'Slice of life story']",2000,9
19096424,Poet's Pub,1949,['United Kingdom'],"['Comedy Thriller', 'Comedy', 'Thriller']",1940,9
872497,The Count of Monte Cristo,2002,"['United Kingdom', 'Ireland', 'United States of America']","['Action', 'Film adaptation', 'Crime Fiction', 'Action/Adventure', 'Thriller', 'Romance Film', 'Costume drama', 'Adventure', 'Swashbuckler films', 'Drama', 'Period piece', 'History']",2000,2
9828183,It's Only Talk,2005,['Japan'],"['Japanese Movies', 'Drama']",2000,5
1113278,Bulletproof,1996,['United States of America'],"['Action', 'Crime Fiction', 'Gangster Film', 'Action/Adventure', 'Buddy film', 'Comedy']",1990,6
17832555,The Baby Doll Night,2008,['Egypt'],['Drama'],2000,8
5683155,American Ninja 2: The Confrontation,1987,['United States of America'],"['Action', 'Crime Fiction', 'Martial Arts Film']",1980,7
6035965,Seed,2007,['Canada'],"['Slasher', 'Horror']",2000,7
817996,Liquid Sky,1982,['United States of America'],"['Satire', 'Comedy', 'Comedy of manners', 'Black comedy', 'Science Fiction']",1980,2
31573907,Molla Barir Bou,2005,['Bangladesh'],"['Drama', 'Family Film']",2000,5
17404922,Bright Star,2009,"['United Kingdom', 'France', 'Australia']","['Period piece', 'Romantic drama', 'Biography', 'Romance Film', 'Drama']",2000,9
17670152,Long Night in 1943,1960,['Italy'],['Black-and-white'],1960,0
16168362,6'2,2005,['India'],"['Musical', 'Action/Adventure', 'Thriller', 'Bollywood', 'World cinema']",2000,5
777032,Suddenly,1954,['United States of America'],"['Black-and-white', 'Crime Fiction', 'Mystery', 'Thriller', 'Film noir', 'Crime Thriller', 'Drama', 'Suspense']",1950,4
22947127,The Real Glory,1939,['United States of America'],"['Action', 'Black-and-white', 'Action/Adventure', 'Adventure', 'War film']",1930,9
18436536,2012,2009,['United States of America'],"['Action', 'Action/Adventure', 'Thriller', 'Natural disaster', 'Apocalyptic and post-apocalyptic fiction', 'Disaster', 'Adventure', 'Drama', 'Dystopia', 'Doomsday film', 'Science Fiction']",2000,9
26409033,Palletooru,1952,['India'],['Drama'],1950,2
13484069,Harrison's Flowers,2002,['France'],"['Romance Film', 'War film', 'Political drama', 'Drama']",2000,2
5806110,White Lightning,1973,['United States of America'],"['Action', 'Auto racing', 'Crime Fiction', 'Action/Adventure', 'Thriller', 'Sports']",1970,3
23244306,Evil Town,1987,['United States of America'],['Horror'],1980,7
12821593,"Carlos Saura Dance Trilogy, Part 3: El Amor Brujo",1986,['Spain'],"['Musical', 'Art film', 'Romantic drama', 'World cinema', 'Romance Film', 'Drama']",1980,6
425930,Der Fuehrer's Face,1943,['United States of America'],"['Short Film', 'Comedy', 'Propaganda film']",1940,3
2619545,The Tin Star,1957,['United States of America'],"['Action/Adventure', 'Western', 'Romance Film', 'Drama']",1950,7
8929212,Stargate: The Ark of Truth,2008,"['Canada', 'United States of America']","['Science Fiction', 'Adventure']",2000,8
16788011,Graduation,2008,['United States of America'],"['Action', 'Heist', 'Crime Fiction', 'Coming of age', 'Indie', 'Action/Adventure', 'Teen']",2000,8
18941018,Valdez Horses,1973,"['France', 'Spain', 'Italy']","['Action', 'Western', 'Action/Adventure']",1970,3
8053331,Rudaali,1993,['India'],"['Drama', 'Art film', 'Bollywood']",1990,3
6729759,The Fuzzy Pink Nightgown,1957,['United States of America'],"['Film adaptation', 'Black-and-white', 'Comedy', 'Romance Film', 'Drama']",1950,7
3737258,Carry On Screaming,1966,['United Kingdom'],"['Detective fiction', 'Parody', 'Horror Comedy', 'Detective', 'Comedy', 'Horror', 'Slapstick']",1960,6
28658542,Crayon Shin-chan: The Secret Treasure of Buri Buri Kingdom,1994,['Japan'],"['Japanese Movies', 'Animation']",1990,4
1448684,Fever Pitch,2005,"['Germany', 'United States of America']","['Film adaptation', 'Comedy', 'Romance Film', 'Sports', 'Drama']",2000,5
9252434,Relax...It's Just Sex,1998,['United States of America'],"['Gay Themed', 'LGBT', 'Comedy', 'Romance Film', 'Romantic comedy', 'Drama']",1990,8
10217534,Midnight Manhunt,1945,['United States of America'],"['Black-and-white', 'Crime Fiction', 'Mystery', 'Comedy', 'Thriller', 'Crime Comedy']",1940,5
3879903,The Dungeonmaster,1985,['United States of America'],"['Indie', 'Thriller', 'Science Fiction', 'Fantasy']",1980,5
31323877,SAS 181 antwortet nicht,1959,['German Democratic Republic'],"['Adventure', 'Drama']",1950,9
240907,Daddy Day Care,2003,['United States of America'],"['Slapstick', 'Comedy', 'Domestic Comedy', 'Workplace Comedy', ""Children's"", 'Family Film']",2000,3
28928397,Stars in Your Eyes,1957,['United Kingdom'],['Musical'],1950,7
4174679,Tenchi Forever!,1999,['Japan'],['Japanese Movies'],1990,9
24572493,War Paint,1926,[],['Silent film'],1920,6
20839451,Sonic Impact,2000,['United States of America'],"['Action', 'Thriller']",2000,0
10262142,Pamahiin,2006,['Philippines'],"['Filipino Movies', 'Thriller', 'Horror', 'World cinema', 'Drama']",2000,6
17215446,The Devil Commands,1941,['United States of America'],"['Black-and-white', 'Horror', 'Sci-Fi Horror', 'Science Fiction']",1940,1
36229099,Bugs,2003,"['Canada', 'United States of America']","['Science Fiction', 'Thriller', 'Horror']",2000,3
974374,Churchill: The Hollywood Years,2004,['United Kingdom'],"['Comedy', 'Satire']",2000,4
5767879,Samba,2004,['India'],"['Romance Film', 'World cinema']",2000,4
2748244,Yeh Raaste Hain Pyaar Ke,2001,['India'],['World cinema'],2000,1
12673724,The Kentuckian,1955,['United States of America'],"['Western', 'Action/Adventure', 'Adventure']",1950,5
17877496,We Did It,1936,['United States of America'],"['Animation', 'Short Film', 'Comedy']",1930,6
23464956,Little Miss Marker,1980,['United States of America'],"['Family Drama', 'Romantic drama', 'Comedy', 'Romance Film', 'Drama', 'Family Film']",1980,0
16426208,My Best Girl,1927,['United States of America'],"['Black-and-white', 'Family Drama', 'Romantic drama', 'Comedy', 'Romance Film', 'Drama', 'Silent film', 'Romantic comedy', 'Comedy-drama', 'Melodrama']",1920,7
6855079,Sherman's way,2008,['United States of America'],"['Drama', 'Indie', 'Comedy', 'Road movie']",2000,8
3838108,Gasbags,1940,['United Kingdom'],"['Action', 'Screwball comedy', 'Action Comedy', 'Action/Adventure', 'Comedy', 'Adventure']",1940,0
31811736,Black Beauty,1946,['United States of America'],"['Romance Film', 'Drama', 'Family Film']",1940,6
35950812,Thanga Pathakkam,1974,['India'],['Drama'],1970,4
5813769,Captain Nemo and the Underwater City,1969,['United Kingdom'],"['Science Fiction', 'Steampunk', 'Adventure']",1960,9
2422489,Yellow Submarine,1968,"['United Kingdom', 'England', 'United States of America']","['Musical', 'Animation', 'Comedy', 'Adventure', 'Family Film', 'Fantasy']",1960,8
19128723,Best Wishes for Tomorrow,2008,['Japan'],['Japanese Movies'],2000,8
8383780,The Thief Lord,2006,"['United Kingdom', 'Germany', 'Luxembourg']","['Fantasy Adventure', 'Family-Oriented Adventure', ""Children's/Family"", 'Adventure', 'Family Film', 'Fantasy']",2000,6
3592111,Moving,1988,['United States of America'],"['Screwball comedy', 'Comedy']",1980,8
737840,An American Werewolf in Paris,1997,"['Luxembourg', 'United Kingdom', 'France', 'Netherlands', 'United States of America']","['Horror', 'Comedy', 'Horror Comedy']",1990,7
10640935,Velaikaran,1987,['India'],"['Action', 'Drama']",1980,7
9140961,Cattle Queen of Montana,1954,['United States of America'],"['Action/Adventure', 'Western']",1950,4
24152307,Bulldog Drummond Escapes,1937,['United States of America'],"['Action', 'Detective fiction', 'Black-and-white', 'Detective']",1930,7
16231566,The Prisoner of Zenda,1922,['United States of America'],"['Silent film', 'Black-and-white', 'Swashbuckler films']",1920,2
76356,Sky High,1922,['United States of America'],"['Silent film', 'Black-and-white', 'Indie']",1920,2
165359,Melody Ranch,1940,['United States of America'],"['Action', 'Black-and-white', 'Western', 'Action/Adventure']",1940,0
3520792,Smart House,1999,['United States of America'],"['Comedy', ""Children's/Family"", 'Science Fiction', 'Fantasy Comedy', 'Family Film']",1990,9
10891106,Karm,1977,['India'],"['Romantic drama', 'World cinema', 'Romance Film', 'Drama']",1970,7
2889423,The Guests,2005,['Israel'],"['Comedy', 'Drama', 'World cinema']",2000,5
6441628,The White Masai,2005,['Germany'],"['Romance Film', 'Romantic drama', 'Drama']",2000,5
11532350,Monkey Trouble,1994,['United States of America'],"['Comedy', 'Animal Picture', 'Family-Oriented Adventure', ""Children's/Family"", 'Adventure', 'Family Film']",1990,4
3017705,Strong Enough to Break,2005,['United States of America'],"['Music', 'Biography', 'Documentary']",2000,5
28378323,Nagina,1986,['India'],"['Romance Film', 'Fantasy']",1980,6
34400393,Alabama Moon,2009,['United States of America'],"['Coming of age', 'Family Drama', 'Adventure', 'Drama', 'Family Film']",2000,9
5047454,Biggles: Adventures in Time,1986,"['United Kingdom', 'United States of America']","['Time travel', 'Indie', 'Adventure', 'Science Fiction', 'Family Film', 'Fantasy']",1980,6
5104358,Butterfly,1999,['Spain'],"['Music', 'World cinema', 'War film', 'Political drama', 'Drama']",1990,9
5578215,Pournami,2006,['India'],"['Romantic drama', 'World cinema', 'Romance Film', 'Drama']",2000,6
16179650,Oru Naal Oru Kanavu,2005,['India'],"['Musical', 'Romantic drama', 'Bollywood', 'World cinema', 'Romance Film', 'Drama']",2000,5
6491972,The Nephew,1998,['Ireland'],"['Family Drama', 'Drama']",1990,8
12522844,The Life of Reilly,2007,['United States of America'],"['Gender Issues', 'Film & Television History', 'Biography', 'Comedy', 'Biographical film', 'Documentary', 'Film', 'Culture & Society']",2000,7
21630948,Mademoiselle Mozart,1936,['France'],['Comedy-drama'],1930,6
8763119,Back to the Woods,1937,['United States of America'],"['Short Film', 'Black-and-white', 'Comedy']",1930,7
18551187,The Haunted Drum,2008,['Thailand'],"['World cinema', 'Thriller', 'Horror']",2000,8
518018,Freddy Got Fingered,2001,['United States of America'],"['Surrealism', 'Action', 'Gross out', 'Gross-out film', 'Screwball comedy', 'Action/Adventure', 'Comedy', 'Thriller', 'Black comedy', 'Absurdism']",2000,1
11585,Show Me Love,1998,"['Sweden', 'Denmark']","['LGBT', 'Romantic drama', 'Comedy', 'Teen', 'World cinema', 'Romance Film', 'Drama', 'Gay Themed', 'Gay', 'Coming of age', 'Gay Interest', 'Comedy-drama']",1990,8
1599509,Ice Princess,2005,"['Canada', 'United States of America']","['Comedy', 'Sports', 'Drama', 'Family Film']",2000,5
377287,The Party,1968,['United States of America'],['Comedy'],1960,8
7528620,Joshua Then and Now,1985,['Canada'],"['Coming of age', 'Comedy', 'Comedy-drama', 'Drama']",1980,5
29549556,Qatal-E-Aam,2005,['India'],['Action'],2000,5
676054,In the Line of Fire,1993,['United States of America'],"['Action', 'Suspense', 'Action/Adventure', 'Thriller', 'Political thriller']",1990,3
15115743,Psy,1992,['Poland'],"['Crime Fiction', 'Action/Adventure', 'Thriller', 'World cinema', 'Drama']",1990,2
12361350,Francis,1950,['United States of America'],"['Black-and-white', 'Comedy', 'Animal Picture', ""Children's/Family"", 'War film', 'Fantasy']",1950,0
2974264,A Countess from Hong Kong,1967,"['United Kingdom', 'United States of America']","['Romance Film', 'Romantic comedy', 'Comedy']",1960,7
1374351,Levity,2003,"['United States of America', 'France']","['Prison', 'Crime Fiction', 'Indie', 'Drama']",2000,3
14507834,White Mane,1952,['France'],"['Black-and-white', 'Short Film', 'World cinema', ""Children's"", 'Drama']",1950,2
2293553,Submerged,2005,"['United Kingdom', 'Bulgaria', 'United States of America']","['Action', 'Action/Adventure', 'Thriller', 'Crime Thriller', 'Martial Arts Film']",2000,5
21863848,Green Street 2: Stand Your Ground,2009,['United States of America'],"['Crime Fiction', 'Sports', 'Drama']",2000,9
6873331,Species IV,2007,['United States of America'],"['Horror', 'Science Fiction']",2000,7
24461886,Highball,1997,['United States of America'],"['Indie', 'Comedy', 'Romance Film', 'Romantic comedy', 'Drama']",1990,7
32200677,Desh Dekhi Bidesh,2008,['Nepal'],['Drama'],2000,8
5522723,Teesri Kasam,1966,['India'],"['Romantic drama', 'Bollywood', 'World cinema', 'Romance Film', 'Drama']",1960,6
29850238,Shikari: The Hunter,1991,['India'],['Action'],1990,1
6060331,Kings Go Forth,1958,['United States of America'],"['Action', 'Film adaptation', 'Black-and-white', 'Romance Film', 'Melodrama', 'War film', 'Drama']",1950,8
16167685,Banda Paramasivam,2003,['India'],"['Romance Film', 'Comedy film']",2000,3
17933239,Bigger Than Life,1956,['United States of America'],"['Family Drama', 'Drama']",1950,6
28938547,The Man Who Liked Funerals,1959,['United Kingdom'],['Comedy film'],1950,9
29524136,We're Going to Eat You,1980,['Hong Kong'],"['Chinese Movies', 'Action/Adventure', 'Horror', 'World cinema', 'Martial Arts Film']",1980,0
31218046,Amor Estranho Amor,1982,['Brazil'],['Drama'],1980,2
1367451,"Greystoke - The Legend of Tarzan, Lord of the Apes",1984,['United Kingdom'],"['Period piece', 'Film adaptation', 'Action/Adventure', 'Adventure', 'Drama']",1980,4
8020341,Chaahat,1996,['India'],['Bollywood'],1990,6
2210682,Blast From the Past,1999,['United States of America'],"['Time travel', 'Comedy', 'Comedy of manners', 'Romance Film', 'Romantic comedy', 'Drama']",1990,9
2303957,Daikyojū Gappa,1967,['Japan'],"['Monster movie', 'Japanese Movies', 'World cinema', 'Science Fiction']",1960,7
26206020,Meet Me After the Show,1951,['United States of America'],"['Musical', 'Comedy']",1950,1
27970922,On With the New,1938,[],"['Animation', 'Short Film', 'Comedy film']",1930,8
23733675,Secrets,1992,['United States of America'],"['Romance Film', 'Drama']",1990,2
4039693,50 Ways of Saying Fabulous,2005,"['New Zealand', 'Australia']","['Period piece', 'Gay Themed', 'LGBT', 'Drama', 'Coming of age', 'Indie', 'World cinema']",2000,5
1882500,The Flamingo Kid,1984,['United States of America'],"['Coming of age', 'Comedy', 'Teen', 'Romantic comedy', 'Romance Film', 'Comedy-drama']",1980,4
7096573,Same Old Song,1997,"['United Kingdom', 'France', 'Switzerland']","['Musical', 'Romantic drama', 'Comedy', 'World cinema', 'Romance Film', 'Romantic comedy', 'Drama']",1990,7
10870570,Panama Lady,1939,['United States of America'],"['Romance Film', 'Romantic comedy', 'Drama']",1930,9
1204699,That Darn Cat!,1965,['United States of America'],"['Mystery', 'Comedy', 'Adventure', 'Drama', 'Family Film']",1960,5
294998,Home Alone 2: Lost in New York,1992,['United States of America'],"['Crime Fiction', 'Comedy', 'Thriller', ""Children's/Family"", 'Christmas movie', 'Slapstick', 'Adventure', 'Family Film']",1990,2
464724,Spanking the Monkey,1994,['United States of America'],"['Indie', 'Comedy', 'Black comedy', 'Domestic Comedy']",1990,4
76314,Salesman,1969,['United States of America'],"['History', 'Biography', 'Documentary', 'Culture & Society']",1960,9
3116779,The Black Windmill,1974,['United Kingdom'],"['Psychological thriller', 'Spy', 'Thriller']",1970,4
18953977,Tease for Two,1965,['United States of America'],"['Animation', 'Short Film', 'Comedy', 'Family Film']",1960,5
13718952,Terminal Voyage,1994,['United States of America'],['Science Fiction'],1990,4
3189585,Dragonheart: A New Beginning,2000,"['Slovakia', 'United States of America']","['Fantasy Adventure', 'Adventure', 'Sword and sorcery films', 'Science Fiction', 'Fantasy']",2000,0
2994806,What's Bugging Seth,2005,['United States of America'],['Drama'],2000,5
14737134,Fright Night,1947,['United States of America'],"['Short Film', 'Black-and-white', 'Comedy']",1940,7
8067044,"H.M. Pulham, Esq.",1941,['United States of America'],"['Black-and-white', 'Comedy', 'Romance Film', 'Drama']",1940,1
10621215,Moondru Mugam,1983,['India'],"['Action', 'Drama']",1980,3
1118765,Spider Baby,1968,['United States of America'],"['Gothic Film', 'Comedy', 'Horror', 'Black comedy', 'B-movie']",1960,8
7901159,Easy Money,1948,['United Kingdom'],"['Film adaptation', 'Black-and-white', 'Crime Fiction', 'Comedy', 'Drama']",1940,8
5185573,Badal,2000,['India'],"['Musical', 'Romantic drama', 'Bollywood', 'World cinema', 'Romance Film', 'Drama']",2000,0
18912773,The Closet,2007,['Hong Kong'],"['Chinese Movies', 'Horror']",2000,7
5159254,The Messengers,2007,"['Canada', 'United States of America']","['Drama', 'Thriller', 'Horror']",2000,7
2329964,Tunes of Glory,1960,['United Kingdom'],['Drama'],1960,0
12282438,The Stepford Children,1987,['United States of America'],"['Psychological thriller', 'Thriller', 'Horror', 'Television movie', 'Science Fiction']",1980,7
3768444,Mercenary for Justice,2006,"['Aruba', 'South Africa', 'United States of America']","['Action', 'Drama', 'Action Thrillers', 'Action/Adventure', 'Thriller']",2000,6
2990096,La perla,1947,['Mexico'],['Drama'],1940,7
13981639,British Intelligence,1940,"['United Kingdom', 'United States of America']","['Spy', 'Black-and-white']",1940,0
24566827,"Quo Vadis, Baby?",2005,['Italy'],"['Thriller', 'Drama']",2000,5
26742680,Sharja To Sharja,2001,['India'],"['Action', 'Drama', 'Comedy']",2000,1
20182947,The Orange Girl,2009,['Norway'],"['Coming of age', 'Romantic drama', 'Drama']",2000,9
22399999,Catfish in Black Bean Sauce,2000,['United States of America'],"['Drama', 'Family Drama', 'Indie', 'Coming of age', 'Comedy', 'Comedy-drama']",2000,0
3374673,"Count Yorga, Vampire",1970,['United States of America'],['Horror'],1970,0
171568,The Hurricane,1999,['United States of America'],"['Crime Fiction', 'Biography', 'Sports', 'Drama', 'Courtroom Drama']",1990,9
3216798,Night of the Living Dead 3D,2006,['United States of America'],"['Creature Film', 'Indie', 'Horror', 'Zombie Film']",2000,6
969971,Too Late the Hero,1970,['United Kingdom'],"['Action', 'Drama', 'Action/Adventure', 'War film']",1970,0
5812847,Gator,1976,['United States of America'],"['Action', 'Crime Fiction', 'Action Thrillers', 'Action/Adventure', 'Comedy Thriller', 'Thriller']",1970,6
5420499,The Burning Train,1980,['India'],"['Action', 'Thriller']",1980,0
15559187,Cougar Club,2007,['United States of America'],"['Coming of age', 'Comedy', 'Drama', 'Sex comedy']",2000,7
6613755,Bloodfist II,1990,['United States of America'],"['Action', 'Indie', 'Action/Adventure', 'Sports', 'Martial Arts Film']",1990,0
31010782,The Bat People,1974,['United States of America'],"['Monster movie', 'Horror']",1970,4
26726333,Searchers 2.0,2007,['United States of America'],"['Indie', 'Comedy', 'Drama']",2000,7
22539062,Pony Express,1953,['United States of America'],"['Action', 'Western', 'Action/Adventure']",1950,3
5864450,Gold Diggers of Broadway,1929,['United States of America'],"['Musical', 'Goat gland', 'Pre-Code']",1920,9
26187246,Night Fright,1967,['United States of America'],"['Monster movie', 'B-movie', 'Horror']",1960,7
16113730,Cheri,2009,"['United Kingdom', 'France', 'Germany']","['Romance Film', 'Comedy', 'Drama']",2000,9
145621,Angels with Dirty Faces,1938,['United States of America'],"['Black-and-white', 'Crime Fiction', 'Gangster Film', 'Crime Drama', 'Drama']",1930,8
16563970,Adam and Evelyne,1949,['United Kingdom'],"['Black-and-white', 'Comedy', 'Romance Film', 'Romantic comedy', 'Melodrama', 'Drama']",1940,9
18435298,One More Kiss,2000,"['United Kingdom', 'Scotland']","['Romantic drama', 'Romance Film', 'Comedy-drama', 'Tragicomedy', 'Drama', 'Medical fiction']",2000,0
3135187,"Mohammad, Messenger of God",1976,"['Morocco', 'Lebanon', 'United Kingdom', 'Kuwait', 'Libya']","['Action', 'World cinema', 'Political drama', 'Costume drama', 'Drama', 'Period piece', 'Epic', 'War film']",1970,6
7556986,Cool Air,1999,['United States of America'],"['Film adaptation', 'Black-and-white', 'Horror', 'Drama']",1990,9
25389799,Love and a Bullet,2002,['United States of America'],"['Action', 'Crime Fiction', 'Gangster Film', 'Action/Adventure', 'Thriller', 'Crime Drama', 'Drama']",2000,2
2068890,The Sandlot,1993,['United States of America'],"['Comedy', 'Teen', ""Children's/Family"", 'Americana', 'Drama', 'Period piece', 'Coming of age', 'Comedy-drama', 'Sports', 'Family Film']",1990,3
2020037,Tere Naam,2003,['India'],"['Musical', 'Romantic drama', 'Bollywood', 'World cinema', 'Romance Film', 'Drama']",2000,3
28486405,So This Is Africa,1933,['United States of America'],['Comedy film'],1930,3
190405,Anastasia,1956,['United States of America'],"['Period piece', 'Romantic drama', 'Romance Film', 'Epic', 'Drama']",1950,6
6801340,Out of the Blue,2007,"['New Zealand', 'Australia']","['Drama', 'Crime Fiction', 'Indie', 'World cinema']",2000,7
22837134,A Town Called Panic,2009,"['France', 'Luxembourg', 'Belgium']","['Animation', 'Comedy', 'World cinema', 'Stop motion', 'Family-Oriented Adventure', ""Children's/Family"", 'Adventure', 'Family Film', 'Fantasy']",2000,9
11176488,My Name Is Anthony Gonsalves,2008,['India'],"['Musical', 'Comedy', 'Bollywood', 'World cinema', 'Drama', 'Comedy of Errors', 'Crime Comedy', 'Romantic comedy']",2000,8
18065848,Whip It!,2009,['United States of America'],"['Drama', 'Indie', 'Coming of age', 'Comedy', 'Comedy-drama', 'Sports']",2000,9
171160,Porco Rosso,1992,['Japan'],"['Fantasy Adventure', 'Animation', 'World cinema', 'Family-Oriented Adventure', ""Children's"", 'Adventure', 'Drama', 'Japanese Movies', 'Anime', 'Family Film', 'Fantasy']",1990,2
15022200,Aafat,1977,['India'],['Action'],1970,7
417891,The Ninth Gate,1999,"['France', 'Spain', 'United States of America']","['Psychological thriller', 'Mystery', 'Thriller', 'Horror', 'Supernatural', 'Drama', 'Fantasy']",1990,9
570263,"Ghidorah, the Three-Headed Monster",1964,['Japan'],"['Monster', 'Japanese Movies', 'Horror', 'World cinema', 'Science Fiction', 'Cult', 'Fantasy']",1960,4
154790,Quo Vadis,1951,['United States of America'],"['Period piece', 'Romantic drama', 'Christian film', 'Romance Film', 'Epic', 'Costume drama', 'Drama']",1950,1
25424083,Personals: College Girls Seeking...,2001,['United States of America'],"['Romance Film', 'Drama']",2000,1
3142516,Tokyo Pop,1988,"['Japan', 'United States of America']","['Japanese Movies', 'Indie', 'Comedy', 'Comedy-drama']",1980,8
28208037,Admission Free,1932,['United States of America'],['Short Film'],1930,2
5188636,Baby Buggy Bunny,1954,['United States of America'],"['Animation', 'Short Film', 'Family Film']",1950,4
6643828,Galerians:Rion,2004,['Japan'],"['Action', 'Japanese Movies', 'Horror', 'Science Fiction', 'Computer Animation']",2000,4
4575756,Frank and Jesse,1994,['United States of America'],"['Biography', 'Action/Adventure', 'Western', 'Biopic [feature]']",1990,4
23428014,Slaughter,1972,['United States of America'],"['Action', 'Blaxploitation', 'Crime Fiction', 'Action/Adventure', 'Thriller', 'Crime Thriller', 'Drama', 'Horror']",1970,2
23580474,Parasuram,2003,['India'],"['Drama', 'World cinema']",2000,3
2591449,Le Temps du Loup,2003,"['France', 'Germany', 'Austria']","['Crime Fiction', 'World cinema', 'Doomsday film', 'Science Fiction', 'Drama']",2000,3
17175786,Kaalpurush,2008,['India'],"['Musical', 'Bollywood', 'World cinema', 'Drama']",2000,8
28358401,The Code Conspiracy,2002,['United States of America'],"['Action', 'Mystery', 'Action/Adventure', 'Thriller']",2000,2
27359766,"The House of 1,000 Dolls",1967,['United States of America'],"['Crime', 'Mystery', 'Drama']",1960,7
17528066,The Uninvited,2008,['United States of America'],"['Psychological thriller', 'Thriller', 'Horror']",2000,8
11705958,A Run for Your Money,1949,['United Kingdom'],"['Adventure Comedy', 'Ealing Comedies', 'Black-and-white', 'Comedy']",1940,9
1246956,Love Happy,1950,['United States of America'],"['Black-and-white', 'Parody', 'Comedy', 'Absurdism']",1950,0
2925678,Tumbleweeds,2000,['United States of America'],"['Coming of age', 'Indie', 'Drama']",2000,0
1343165,The Alamo,2004,['United States of America'],"['Period piece', 'Action', 'Action/Adventure', 'Western', 'War film', 'Costume drama', 'Drama']",2000,4
5090209,Upkar,1967,['India'],"['Bollywood', 'World cinema', 'War film', 'Drama']",1960,7
25928203,Prison Break,1938,['United States of America'],"['Crime Fiction', 'Mystery', 'Thriller', 'Crime Thriller', 'Drama']",1930,8
6599431,Buddy,1997,['United States of America'],"['Comedy', 'Biographical film', ""Children's"", 'Drama', 'Family Film']",1990,7
2739891,Bruce Lee and I,1975,['Hong Kong'],"['Chinese Movies', 'Martial Arts Film']",1970,5
28149238,A Merry War,1997,['United Kingdom'],"['Comedy', 'Satire', 'Romance Film', 'Romantic comedy', 'Drama']",1990,7
19268144,The Call of the Wild,1972,"['Spain', 'United Kingdom', 'France', 'West Germany', 'Italy']","['Action', 'Film adaptation', 'Action/Adventure', 'Adventure', 'Drama', 'Family Film']",1970,2
1738939,Cindy,1978,['United States of America'],"['Musical', 'Period piece', 'Romance Film']",1970,8
12081183,Getting Straight,1970,['United States of America'],"['Comedy-drama', 'War film', 'Comedy']",1970,0
8611948,No. 5 The Film,2004,['United States of America'],['Short Film'],2000,4
443917,Catch That Kid,2004,"['Germany', 'United States of America']","['Crime Fiction', 'Comedy', 'Teen', 'Family-Oriented Adventure', ""Children's/Family"", ""Children's"", 'Adventure', 'Caper story', 'Crime Comedy', 'Family Film']",2000,4
1472852,Down and Out in Beverly Hills,1986,['United States of America'],"['Comedy', 'Remake', 'Comedy of manners', 'Black comedy', 'Domestic Comedy']",1980,6
4011733,After the Game,1997,['United States of America'],"['Suspense', 'Mystery', 'Thriller', 'Film noir', 'Crime Thriller', 'Drama']",1990,7
24001036,The Only Son,1936,['Japan'],"['Black-and-white', 'Japanese Movies', 'World cinema', 'Drama']",1930,6
171621,Quills,2000,"['United Kingdom', 'Germany', 'United States of America']","['Film adaptation', 'Erotic Drama', 'Biography', 'Romantic drama', 'Romance Film', 'Drama', 'Period piece', 'History', 'Biopic [feature]']",2000,0
11973790,Hellbreeder,2004,['United Kingdom'],"['Psychological thriller', 'Mystery', 'Slasher', 'Thriller', 'Horror', 'B-movie']",2000,4
719062,Zenon: Girl of the 21st Century,1999,['United States of America'],"[""Children's"", 'Comedy', 'Adventure', ""Children's/Family"", 'Science Fiction', 'Family Film']",1990,9
19723946,Fear(s) of the Dark,2007,['France'],"['Computer Animation', 'Animation', 'World cinema', 'Horror', 'Supernatural', 'Drama']",2000,7
20533051,Scalp Treatment,1952,['United States of America'],"['Short Film', 'Animation']",1950,2
36057879,Subash,1996,['India'],['Action'],1990,6
6663412,Severance,2006,['United Kingdom'],"['Action', 'Action/Adventure', 'Comedy', 'Thriller', 'Black comedy', 'Slasher', 'Horror', 'Cult']",2000,6
5696805,Darna Mana Hai,2003,['India'],"['World cinema', 'Bollywood', 'Horror']",2000,3
19876793,Killer's Carnival,1966,"['France', 'Austria', 'Italy']","['Action', 'Spy', 'Crime Fiction', 'Adventure']",1960,6
30784671,Spirit of the Wind,1979,['United States of America'],"['Adventure', 'Drama', 'Family Film']",1970,9
13424283,Spring Subway,2002,['China'],"['Romantic drama', 'World cinema', 'Romance Film', 'Chinese Movies', 'Drama']",2000,2
13888061,Sadak,1991,['India'],"['Romance Film', 'Drama', 'Bollywood']",1990,1
4986369,Rupert and the Frog Song,1985,['United Kingdom'],"['Animation', 'Short Film', ""Children's/Family"", ""Children's Entertainment""]",1980,5
3933930,One Night in the Tropics,1940,['United States of America'],"['Musical', 'Black-and-white', 'Comedy', 'Musical comedy', 'Romance Film', 'Romantic comedy']",1940,0
33947543,The Curse of El Charro,2004,['United States of America'],"['Slasher', 'B-movie', 'Horror']",2000,4
2478900,House of Games,1987,['United States of America'],"['Psychological thriller', 'Crime Fiction', 'Mystery', 'Thriller', 'Crime Thriller', 'Drama']",1980,7
24461292,The Firm,2009,['United Kingdom'],['Drama'],2000,9
10342783,Men of the Sky,1931,['United States of America'],"['Action', 'Musical', 'Spy']",1930,1
33226976,Madhyanam Hathya,2004,[],"['Thriller', 'Crime Fiction']",2000,4
18118679,Torch Song Trilogy,1988,['United States of America'],"['Gay Themed', 'LGBT', 'Comedy', 'Romance Film', 'Romantic comedy', 'Comedy-drama', 'Drama']",1980,8
938564,Journey Back to Oz,1974,['United States of America'],"['Fantasy Adventure', ""Children's Fantasy"", ""Children's/Family"", 'Fantasy']",1970,4
21419791,Huracán Ramírez,1953,['Mexico'],"['Action', 'Crime Fiction', 'Drama']",1950,3
7274197,The Return of the Vampire,1944,['United States of America'],"['Creature Film', 'Horror']",1940,4
3044570,Hold Back Tomorrow,1955,['United States of America'],"['Prison', 'Black-and-white', 'Drama']",1950,5
26613350,Samastha Keralam PO,2009,['India'],[],2000,9
2709646,Android,1982,['United States of America'],"['Drama', 'Science Fiction', 'Thriller']",1980,2
9678000,Selva,1996,['India'],[],1990,6
30873849,Hitler: The Rise of Evil,2003,"['Canada', 'United States of America']","['Biography', 'Biopic [feature]', 'Television movie', 'Drama']",2000,3
856716,Shampoo,1975,['United States of America'],"['Romantic drama', 'Satire', 'Comedy', 'Romance Film', 'Drama', 'Ensemble Film', 'Parody', 'New Hollywood', 'Romantic comedy', 'Comedy-drama', 'Sex comedy']",1970,5
3038054,A Nightmare on Elm Street 5: The Dream Child,1989,['United States of America'],"['Slasher', 'Teen', 'Horror', 'Supernatural']",1980,9
142588,Dead Alive,1993,['New Zealand'],"['Comedy', 'Horror Comedy', 'Black comedy', 'Zombie Film', 'Creature Film', 'Splatter film', 'Horror', 'Stop motion']",1990,3
14644512,Send Me No Flowers,1964,['United States of America'],"['Comedy', 'Romance Film', 'Romantic comedy', 'Comedy of Errors']",1960,4
17604789,The Black Candle,2008,['United States of America'],"['Indie', 'Culture & Society', 'Documentary']",2000,8
957179,Bright Young Things,2003,['United Kingdom'],"['Period piece', 'Drama', 'Indie', 'Comedy', 'Comedy of manners', 'Comedy-drama', 'War film']",2000,3
5331654,The Initiation of Sarah,2006,['United States of America'],"['Thriller', 'Horror', 'Teen', 'Television movie', 'Supernatural']",2000,6
29197597,Pit of Darkness,1961,[],"['Crime Fiction', 'Thriller']",1960,1
1310543,Hare Brush,1955,['United States of America'],"['Animation', 'Short Film', 'Comedy', 'Family Film']",1950,5
34023246,Gemini,2002,['India'],"['Action', 'Drama', 'Crime Fiction', 'Comedy film', 'World cinema']",2000,2
7144866,Happy You and Merry Me,1936,['United States of America'],"['Short Film', 'Animation']",1930,6
31721239,Nightwalking,2008,"['United Kingdom', 'Germany']","['Crime Fiction', 'Short Film', 'Comedy', 'Thriller', 'Horror', 'Drama']",2000,8
9976141,Stepping Out,1991,"['Canada', 'United States of America']",['Comedy'],1990,1
7068258,Abbott and Costello Go to Mars,1953,['United States of America'],"['Black-and-white', 'Parody', 'Comedy', 'Slapstick', 'Adventure', 'Science Fiction', 'Family Film']",1950,3
7208117,Car Babes,2007,['United States of America'],"['Indie', 'Comedy']",2000,7
6684682,The Black Shield of Falworth,1954,['United States of America'],"['Period piece', 'Costume Adventure', 'Costume drama', 'Adventure']",1950,4
6102307,Angels in the Infield,2000,['United States of America'],"['Heavenly Comedy', 'Comedy', ""Children's/Family"", 'Sports', 'Family Film', 'Fantasy']",2000,0
8360654,Balls of Fury,2007,['United States of America'],"['Action', 'Crime Fiction', 'Comedy', 'Romance Film', 'Sports']",2000,7
18803418,OM,2003,['India'],"['Musical', 'Romantic drama', 'Bollywood', 'World cinema', 'Romance Film', 'Drama']",2000,3
14412141,The Young Stranger,1957,['United States of America'],"['Family Drama', 'Drama']",1950,7
32997239,A Rough Passage,1922,[],['Silent film'],1920,2
1598832,Sesame Street presents Follow That Bird,1985,"['United Kingdom', 'United States of America', 'Canada']","['Musical', ""Children's"", 'Comedy', 'Adventure', 'Drama', 'Family Film']",1980,5
19286442,Kalangarai Vilakkam,1965,['India'],[],1960,5
4954774,Cleopatra,1963,"['United Kingdom', 'Switzerland', 'United States of America']","['Romantic drama', 'Biographical film', 'Romance Film', 'Roadshow theatrical release', 'Costume drama', 'Drama', 'Period piece', 'History', 'Epic', 'War film']",1960,3
5020303,Hyderabad Blues,1998,['India'],"['Bollywood', 'Drama']",1990,8
12719760,"A Girl, Three Guys, and a Gun",2001,['United States of America'],"['Action', 'Indie', 'Action/Adventure', 'Comedy', 'Black comedy', 'Heist', 'Romantic comedy', 'Cult']",2000,1
583273,Limelight,1952,['United States of America'],"['Musical', 'Black-and-white', 'Romantic drama', 'Comedy']",1950,2
6877206,Seventeen Again,2000,['United States of America'],"['Family Drama', 'Comedy', ""Children's/Family"", 'Drama', 'Family Film']",2000,0
8538374,The Last Mimzy,2007,['United States of America'],"[""Children's Fantasy"", 'Adventure', ""Children's/Family"", 'Science Fiction', 'Family Film', 'Fantasy']",2000,7
2034460,The Bat,1959,['United States of America'],"['Film adaptation', 'Black-and-white', 'Mystery', 'Indie', 'Thriller', 'Crime Thriller', 'Suspense', 'Horror']",1950,9
2771954,Accused of Murder,1956,['United States of America'],"['Detective fiction', 'Crime Fiction', 'Mystery', 'Thriller', 'Detective', 'Film noir', 'Crime Thriller']",1950,6
24790646,Touch of Death,1988,['Italy'],"['Black comedy', 'World cinema', 'Horror']",1980,8
1326091,Kuch Naa Kaho,2003,['India'],"['Romantic drama', 'Comedy', 'World cinema', 'Romance Film', 'Romantic comedy', 'Drama']",2000,3
34672064,Dr. Vidya,1962,['India'],"['Romance Film', 'Family Film']",1960,2
21073588,Anwar,2007,['India'],"['Musical', 'Bollywood', 'World cinema', 'Drama']",2000,7
20097181,The Jungle Captive,1945,['United States of America'],"['Black-and-white', 'Horror']",1940,5
13281115,How About You,2007,"['Ireland', 'United Kingdom']","['Indie', 'Comedy', 'Comedy-drama', 'Holiday Film', 'Slice of life story']",2000,7
22844430,A Good Baby,1998,['United States of America'],"['Mystery', 'Indie', 'Thriller', 'Drama']",1990,8
1380618,Permanent Midnight,1998,['United States of America'],"['Drama', 'Indie', 'Biography', 'Addiction Drama']",1990,8
31197982,Mangamma,1997,[],['Drama'],1990,7
4584458,Dillagi,1999,['India'],"['Musical', 'Romantic drama', 'Bollywood', 'World cinema', 'Romance Film', 'Drama']",1990,9
3139643,How the West Was Fun,1994,['United States of America'],"['Family Drama', 'Action/Adventure', 'Comedy', ""Children's/Family"", 'Drama', 'Western', 'Television movie', 'Family Film']",1990,4
1463335,Lemonade Joe,1964,"['Czechoslovakia', 'Czech Republic']","['Musical', 'Action/Adventure', 'Comedy', 'World cinema', 'Romance Film', 'Adventure', 'Comedy Western', 'Parody', 'Western']",1960,4
3092323,Ski Party,1965,['United States of America'],"['Musical', 'Comedy', 'Teen', 'Romance Film']",1960,5
1969580,Perfect Strangers,1945,['United Kingdom'],"['Black-and-white', 'Drama']",1940,5
10404153,Notebook,2006,['India'],"['Musical', 'Bollywood', 'World cinema', 'Romance Film', 'Drama']",2000,6
11760645,Legacy,1998,['United States of America'],"['Action', 'Indie', 'Action/Adventure', 'Thriller']",1990,8
3945952,Pumpkinhead II: Blood Wings,1994,['United States of America'],"['Monster movie', 'Supernatural', 'Horror']",1990,4
642744,Bicycle Thieves,1948,['Italy'],"['Black-and-white', 'Crime Fiction', 'World cinema', 'Drama']",1940,8
31519189,Song of Scheherazade,1947,['United States of America'],"['Drama', 'Musical Drama', 'Biopic [feature]']",1940,7
444245,Hoffa,1992,['United States of America'],"['Crime Fiction', 'Gangster Film', 'Biography', 'Mystery', 'Biographical film', 'Thriller', 'Crime Thriller', 'Docudrama', 'Drama', 'Period piece', 'Biopic [feature]', 'Political drama', 'Political thriller']",1990,2
6169082,Cop and a Half,1993,['United States of America'],"['Action', 'Action/Adventure', 'Buddy film', 'Comedy', 'Family Film']",1990,3
14334939,Saraband for Dead Lovers,1948,['United Kingdom'],"['Romantic drama', 'Romance Film', 'Historical fiction', 'War film', 'Drama']",1940,8
7469030,Red Ribbon Blues,1996,['United States of America'],"['LGBT', 'Crime Fiction', 'Comedy', 'Comedy-drama', 'Drama']",1990,6
3167956,LOC Kargil,2003,['India'],"['Drama', 'War film', 'Bollywood']",2000,3
32377792,Ghost Mamma,1996,['South Korea'],"['Romance Film', 'Drama', 'Fantasy']",1990,6
5652838,Fletch Lives,1989,['United States of America'],"['Action', 'Crime Fiction', 'Mystery', 'Comedy', 'Thriller', 'Whodunit', 'Adventure', 'Comedy Thriller', 'Cult']",1980,9
2705839,Jungle Book,1942,['United States of America'],"['Action', 'Adventure']",1940,2
15371070,Box of Death,1955,['South Korea'],"['Action', 'Drama']",1950,5
15239088,Private Buckaroo,1942,['United States of America'],"['Musical', 'Black-and-white', 'Comedy']",1940,2
11924028,Possession,2008,['United States of America'],"['Psychological thriller', 'Mystery', 'Thriller', 'Romance Film', 'Crime Thriller', 'Supernatural', 'Drama']",2000,8
4829230,Swiss Family Robinson,1940,['United States of America'],"['Action', 'Black-and-white', 'Action/Adventure', 'Costume drama', 'Adventure', 'Drama', 'Family Film']",1940,0
20798851,Very Annie Mary,2001,"['United Kingdom', 'France']","['Musical', 'Coming of age', 'Comedy']",2000,1
13569155,The Spider's Web,1938,['United States of America'],"['Black-and-white', 'Crime Fiction', 'Superhero movie', 'Adventure']",1930,8
1339563,Strange Days,1995,['United States of America'],"['Action', 'Crime Fiction', 'Gangster Film', 'Mystery', 'Thriller', 'Crime Thriller', 'Drama', 'Suspense', 'Dystopia', 'Future noir', 'Science Fiction']",1990,5
12186683,Mad Dog Morgan,1976,['Australia'],"['Drama', 'Crime Fiction', 'Indie', 'Action/Adventure', 'Western', 'World cinema', 'Crime Drama']",1970,6
10811554,Dolores Claiborne,1995,['United States of America'],"['Psychological thriller', 'Suspense', 'Film adaptation', 'Crime Fiction', 'Mystery', 'Thriller', 'Drama']",1990,5
3565940,Smart Money,1931,['United States of America'],"['Black-and-white', 'Crime Fiction', 'Drama']",1930,1
8590427,Andaz,1971,['India'],"['Drama', 'World cinema']",1970,1
10835849,Yuganthaya,1983,['Sri Lanka'],['Drama'],1980,3
18733013,Benny's Bathtub,1971,['Denmark'],['Animation'],1970,1
21044888,The Story on Page One,1959,['United States of America'],['Drama'],1950,9
14611324,A Family Secret,2006,['Canada'],"['Drama', 'Comedy']",2000,6
534408,Kill and Kill Again,1981,['South Africa'],"['Action', 'Drama', 'Indie', 'Action/Adventure', 'Thriller', 'World cinema', 'Martial Arts Film']",1980,1
15553721,The Boogie Man Will Get You,1942,['United States of America'],"['Black-and-white', 'Comedy', 'Horror Comedy', 'Horror']",1940,2
8969561,Ekskul,2006,['Indonesia'],['Thriller'],2000,6
2398332,Sheena,1984,"['United Kingdom', 'United States of America']","['Action', 'Action/Adventure', 'Jungle Film', 'Adventure', 'Drama', 'Fantasy']",1980,4
452211,M. Butterfly,1993,['United States of America'],"['Action', 'Period piece', 'Spy', 'Erotic Drama', 'Romantic drama', 'Romance Film', 'Drama']",1990,3
1688060,"Au revoir, les enfants",1987,"['France', 'Germany', 'West Germany']","['Coming of age', 'World cinema', 'War film', 'Drama']",1980,7
25549165,Adieu Gary,2009,['France'],['Drama'],2000,9
4107291,Cool Blue,1990,['United States of America'],"['Indie', 'Comedy', 'Thriller', 'Romance Film', 'Romantic comedy']",1990,0
5637772,The Principal,1987,['United States of America'],"['Action', 'Crime Fiction', 'Comedy', 'Comedy-drama', 'Drama']",1980,7
29752895,Arjun Devaa,2001,[],['Action'],2000,1
15352210,W.,2008,"['Hong Kong', 'China', 'Switzerland', 'Australia', 'United States of America']","['Biographical film', 'Biopic [feature]', 'Chinese Movies', 'Political drama', 'Drama']",2000,8
14613035,Yellow Canary,1943,['United Kingdom'],"['Spy', 'Black-and-white']",1940,3
12155366,"Jerry, Jerry, Quite Contrary",1966,['United States of America'],"['Animation', 'Short Film', 'Family Film']",1960,6
23160762,The Karate Killers,1967,['United States of America'],"['Action', 'Spy']",1960,7
6982498,Kim,1950,['United States of America'],"['Adventure', 'Drama', 'Family Film']",1950,0
17850156,Ever Since Eve,1937,['United States of America'],"['Romantic comedy', 'Black-and-white']",1930,7
18250205,The House of Tomorrow,1949,['United States of America'],"['Animation', 'Short Film', 'Comedy', 'Family Film']",1940,9
15397951,Back Stage,1923,['United States of America'],"['Black-and-white', 'Indie', 'Short Film', 'Comedy', 'Silent film']",1920,3
25947669,Repo Chick,2009,['United States of America'],"['Indie', 'Comedy', 'Cult']",2000,9
19870531,Modern Vampires,1999,['United States of America'],"['Action', 'Action/Adventure', 'Thriller', 'Horror']",1990,9
17341391,Pink Panzer,1965,[],"['Short Film', 'Animation']",1960,5
18612973,Doraemon: Nobita and the Robot Kingdom,2002,['Japan'],['Japanese Movies'],2000,2
20049234,Rottweiler,2004,['Spain'],"['Horror', 'Science Fiction']",2000,4
14264650,The Kid from Cleveland,1949,['United States of America'],"['Black-and-white', 'Sports', 'Drama']",1940,9
25277019,Mosagallaku Mosagadu,1971,['India'],['Adventure'],1970,1
10090252,Ghost Cat,2003,['Canada'],"['Mystery', 'Thriller', ""Children's/Family"", 'Family Film']",2000,3
707823,Cry Freedom,1987,"['United Kingdom', 'South Africa']","['Crime Fiction', 'Biography', 'Political drama', 'Drama']",1980,7
3828251,Forces of Nature,1999,['United States of America'],"['Romance Film', 'Romantic comedy', 'Comedy']",1990,9
4960924,Circus World,1964,"['Spain', 'United States of America']","['Indie', 'Western', 'Drama']",1960,4
3047329,The Fourth Man,1983,['Netherlands'],"['Psychological thriller', 'LGBT', 'Mystery', 'Thriller', 'World cinema', 'Romance Film', 'Black comedy', 'Drama', 'Horror', 'Erotic thriller']",1980,3
3528982,Life Stinks,1991,"['United States of America', 'France']","['Parody', 'Comedy', 'Comedy-drama', 'Slapstick']",1990,1
8267687,Spy Smasher,1942,['United States of America'],"['Action', 'Spy', 'Black-and-white', 'Thriller', 'Melodrama', 'Adventure', 'Drama']",1940,2
1960065,A Good Woman,2004,"['Spain', 'Luxembourg', 'United Kingdom', 'Italy', 'United States of America']","['Film adaptation', 'Romantic drama', 'Comedy', 'Romance Film', 'Drama', 'Period piece', 'Romantic comedy', 'Comedy of manners']",2000,4
26346721,Bhairava Dweepam,1994,['India'],"['Action', 'Musical', 'Drama']",1990,4
3702166,The Citadel,1938,['United Kingdom'],"['Black-and-white', 'Romance Film', 'Drama', 'Medical fiction']",1930,8
28513216,Sidewalks of Bangkok,1984,[],"['Action', 'Thriller']",1980,4
22374348,Séraphine,2008,"['France', 'Belgium']","['Period piece', 'Biographical film', 'World cinema', 'Drama']",2000,8
28009904,The Enchanted Forest,1945,['United States of America'],"['Drama', 'Family Film']",1940,5
10214302,August,2008,['United States of America'],"['Indie', 'Drama']",2000,8
28150358,Namma Basava,2009,[],[],2000,9
2199657,Daughters Courageous,1939,['United States of America'],"['Black-and-white', 'Family Drama', 'Drama']",1930,9
28493186,Metastases,2009,['Croatia'],"['Drama', 'Crime Fiction']",2000,9
21008312,Galileo,1975,"['United Kingdom', 'United States of America']","['Period piece', 'Biography', 'Drama']",1970,5
24449235,White Pongo,1945,['United States of America'],"['Monster movie', 'B-movie', 'Horror']",1940,5
3520927,Zenon: The Zequel,2001,"['New Zealand', 'United States of America']","['Comedy', ""Children's/Family"", 'Science Fiction', 'Family Film']",2000,1
13205924,Bosko's Picture Show,1933,['United States of America'],"['Animation', 'Short Film', 'Comedy']",1930,3
30541820,Arante Mulla Kochu Mulla,1984,[],"['Romance Film', 'Drama', 'Comedy film']",1980,4
8494294,War Feels Like War,2004,['United Kingdom'],"['Biography', 'Documentary', 'Media Studies', 'War film', 'Culture & Society']",2000,4
5088118,Evil speak,1981,['United States of America'],"['Supernatural', 'Horror']",1980,1
3978441,Flash Gordon,1980,"['United Kingdom', 'United States of America']","['Action', 'Action/Adventure', 'Comedy', 'Thriller', 'Camp', 'Adventure', 'Superhero movie', 'Science Fiction', 'Fantasy']",1980,0
33262898,Shararat,2002,['India'],['World cinema'],2000,2
12710259,Los Tres Huastecos,1948,['Mexico'],"['Comedy', 'Drama', 'World cinema']",1940,8
142837,The Big Pond,1930,['United States of America'],"['Musical', 'Black-and-white', 'Comedy', 'Romance Film', 'Romantic comedy']",1930,0
14977038,Beyond Loch Ness,2008,['Canada'],"['Creature Film', 'Mystery', 'Thriller', 'Horror', 'Television movie', 'Sci Fi Pictures original films']",2000,8
8397735,Aurora Borealis,2006,"['Canada', 'United States of America']","['Romantic drama', 'Indie', 'Romance Film', 'Drama']",2000,6
12813163,Young Ideas,1943,['United States of America'],"['Black-and-white', 'Drama']",1940,3
7087167,The Country Girl,1954,['United States of America'],"['Musical', 'Drama']",1950,4
793025,Gothika,2003,['United States of America'],"['Psychological thriller', 'Mystery', 'Thriller', 'Horror', 'Crime Thriller', 'Supernatural']",2000,3
22538938,Little House on the Prairie,1974,['United States of America'],"['Drama', 'Biographical film']",1970,4
6559383,You Kill Me,2007,['United States of America'],"['Action', 'Crime Fiction', 'Gangster Film', 'Action/Adventure', 'Comedy', 'Crime Comedy', 'Black comedy']",2000,7
16166233,Maayi,2000,['India'],"['Action', 'Drama']",2000,0
22900924,Hero of the Rails,2009,"['United Kingdom', 'United States of America', 'Canada']","['Family Film', 'Animation']",2000,9
9253157,Small Town Girl,1936,['United States of America'],"['Romance Film', 'Black-and-white', 'Comedy']",1930,6
1249019,Killer Klowns from Outer Space,1988,['United States of America'],"['Comedy', 'Horror Comedy', 'Sci-Fi Horror', 'Parody', 'Horror', 'Alien Film', 'Science Fiction', 'Cult']",1980,8
15169291,12 Rounds,2009,['United States of America'],"['Action', 'Crime Fiction', 'Action Thrillers', 'Thriller']",2000,9
5674771,Red River Range,1938,['United States of America'],"['Action', 'Black-and-white', 'Western']",1930,8
10731314,Laila Majnu,1976,"['Soviet Union', 'India', 'German Democratic Republic']","['Musical', 'Romance Film', 'Drama']",1970,6
2257809,Judas Kiss,1998,['United States of America'],"['Drama', 'Crime Fiction', 'Thriller']",1990,8
22248224,The High Command,1938,['United Kingdom'],"['Melodrama', 'Drama']",1930,8
1305939,Uptown Girls,2003,['United States of America'],"['Coming of age', 'Buddy film', 'Comedy', 'Romance Film', 'Drama']",2000,3
3828036,Ask A Policeman,1939,['United Kingdom'],"['Black-and-white', 'Crime Fiction', 'Comedy']",1930,9
2806649,Prime,2005,['United States of America'],"['Comedy', 'Comedy of manners', 'Romance Film', 'Romantic comedy', 'Comedy-drama']",2000,5
32365051,Five Senses of Eros,2009,['South Korea'],['Romance Film'],2000,9
399435,The Slipper and the Rose,1976,['United Kingdom'],"['Musical', 'Romantic fantasy', 'Romance Film', 'Costume drama', 'Fantasy']",1970,6
6183577,The Escapist,2006,['United Kingdom'],"['Psychological thriller', 'Crime Thriller', 'Thriller']",2000,6
22029078,Blush,1995,"['China', 'Hong Kong']","['Romantic drama', 'Romance Film', 'Chinese Movies', 'Drama']",1990,5
25855928,Tora's Pure Love,1976,['Japan'],['Japanese Movies'],1970,6
29246582,Shrimad Virat Veerabrahmendra Swami Charitra,1984,['India'],"['Musical', 'History', 'Biographical film', 'Drama']",1980,4
6796782,Tagged: The Jonathan Wamback Story,2001,['Canada'],"['Social problem film', 'Docudrama', 'Drama']",2000,1
21653186,Three Orphan Kittens,1935,['United States of America'],"['Animation', 'Short Film', 'Comedy film', 'Family Film']",1930,5
22087976,A Knight for a Day,1946,['United States of America'],"['Animation', 'Short Film', 'Comedy', 'Family Film']",1940,6
20478345,Muscle Heat,2004,['Japan'],"['Action', 'Japanese Movies', 'Action Thrillers', 'Action/Adventure', 'World cinema', 'Martial Arts Film']",2000,4
20904269,Azaad,1978,['India'],['Thriller'],1970,8
1661980,"After Dark, My Sweet",1990,['United States of America'],"['Psychological thriller', 'Film adaptation', 'Neo-noir', 'Crime Fiction', 'Mystery', 'Thriller', 'Crime Thriller', 'Drama', 'Erotic thriller', 'Crime Drama']",1990,0
18600374,The Texans,1938,['United States of America'],['Western'],1930,8
2642293,The Tao of Steve,2000,['United States of America'],"['Indie', 'Comedy', 'Comedy of manners', 'Romance Film', 'Romantic comedy']",2000,0
584256,Carry On England,1976,['United Kingdom'],"['Parody', 'Slapstick', 'Comedy']",1970,6
4219088,Gregory's Two Girls,1999,"['United Kingdom', 'Scotland']","['Comedy-drama', 'Comedy of Errors']",1990,9
17759441,Troublesome Night 4,1998,['Hong Kong'],"['Chinese Movies', 'Horror']",1990,8
2853589,Fight For Your Life,1977,['United States of America'],"['Action', 'Indie', 'Action/Adventure', 'Thriller', 'Crime Thriller']",1970,7
20913539,Pacquiao: The Movie,2006,['Philippines'],"['Action', 'Filipino Movies', 'World cinema', 'Drama']",2000,6
5125761,Imprint,2006,['Japan'],"['Psychological thriller', 'Japanese Movies', 'Horror', 'Television movie', 'Cult']",2000,6
33868856,Boom Boom,1936,[],"['Animation', 'Short Film', 'Comedy film', 'War film', 'Family Film']",1930,6
13033252,The Substitute 2: School's Out,1998,['United States of America'],"['Action', 'Action Thrillers', 'Mystery', 'Action/Adventure', 'Thriller']",1990,8
3549346,The Incubus,1982,['Canada'],"['Thriller', 'Horror']",1980,2
30729952,Way Out West,1930,['United States of America'],"['Western', 'Comedy', 'Drama']",1930,0
22682240,The Severed Arm,1973,['United States of America'],"['Crime Fiction', 'Slasher', 'Horror', 'Cult']",1970,3
10780993,Vicky Cristina Barcelona,2008,"['Spain', 'United States of America']","['Romance Film', 'Romantic drama', 'Drama']",2000,8
3595407,Chicken Rice War,2000,['Singapore'],"['Romance Film', 'Romantic comedy', 'Comedy']",2000,0
5595708,Eight-Diagram Pole Fighter,1983,['Hong Kong'],"['Action/Adventure', 'World cinema', 'Chinese Movies', 'Martial Arts Film', 'Drama']",1980,3
24469731,Delirium,1987,['Italy'],"['Slasher', 'Horror']",1980,7
2833493,Bad Moon,1996,['United States of America'],"['Creature Film', 'Horror']",1990,6
5558650,On the Edge,2001,['Ireland'],"['Romantic drama', 'Indie', 'Romance Film', 'Drama']",2000,1
34220997,Kohram,1999,['India'],"['Action', 'Drama', 'Thriller', 'World cinema']",1990,9
1552798,Faust,1994,"['United Kingdom', 'France', 'Czech Republic']","['Surrealism', 'Animation', 'World cinema', 'Experimental film', 'Stop motion', 'Drama', 'Fantasy']",1990,4
1014229,Napoleon and Samantha,1972,['United States of America'],"['Animal Picture', 'Family-Oriented Adventure', ""Children's/Family"", 'Adventure', 'Drama', 'Family Film']",1970,2
10216667,I Want Candy,2007,['United Kingdom'],['Comedy'],2000,7
880056,Scary Movie 3,2003,"['Canada', 'United States of America']","['Gross out', 'Gross-out film', 'Horror Comedy', 'Comedy', 'Teen', 'Slapstick', 'Absurdism', 'Parody', 'Horror']",2000,3
16014546,The Last Days of Patton,1986,['United States of America'],"['Biography', 'Biographical film', 'Biopic [feature]', 'Television movie', 'War film', 'Drama']",1980,6
22611251,Deaf Sam-yong,1964,['South Korea'],['Drama'],1960,4
2557480,The Web,1947,['United States of America'],['Film noir'],1940,7
922077,His Majesty O'Keefe,1954,['United States of America'],"['Action', 'Period piece', 'Film adaptation', 'Action/Adventure', 'Docudrama', 'Adventure', 'Drama']",1950,4
30283732,Swathi Thirunal,1987,[],['Biographical film'],1980,7
1430395,Genevieve,1953,['United Kingdom'],"['Auto racing', 'Comedy']",1950,3
12759589,Max Steel: Countdown,2006,['United States of America'],['Animation'],2000,6
3490106,Mr Bones,2001,['South Africa'],['Comedy'],2000,1
10009844,Red Planet Mars,1952,['United States of America'],"['Black-and-white', 'Science Fiction', 'Alien Film', 'Propaganda film']",1950,2
5880297,A Rumor of Angels,2001,['United States of America'],"['Drama', 'Family Drama', 'Indie', 'Childhood Drama']",2000,1
13547819,The Singles 2nd Ward,2007,['United States of America'],"['Romance Film', 'Romantic comedy', 'Comedy']",2000,7
28853738,The Moon and Sixpence,1942,['United States of America'],['Drama'],1940,2
3418874,Wal-Mart: The High Cost of Low Price,2005,['United States of America'],"['Social issues', 'Indie', 'Documentary', 'Business', 'Culture & Society']",2000,5
1131046,Caravaggio,1986,['United Kingdom'],"['Period piece', 'LGBT', 'Drama', 'Biography', 'Indie', 'Romantic drama', 'Romance Film']",1980,6
3305282,Phantasm IV: OblIVion,1998,['United States of America'],"['Zombie Film', 'Supernatural', 'Horror']",1990,8
20629940,Not Easily Broken,2009,['United States of America'],"['Film adaptation', 'Romantic drama', 'Comedy', 'Romance Film', 'Drama', 'Tragedy']",2000,9
1994507,They Made Me a Fugitive,1947,['United Kingdom'],"['Crime Fiction', 'Thriller', 'Crime Drama', 'Film noir', 'Crime Thriller', 'Drama']",1940,7
9249428,Así No Hay Cama Que Aguante,1980,['Argentina'],['Comedy'],1980,0
4539387,Buffalo Bill and the Indians,1976,['United States of America'],"['Action', 'Parody', 'Action/Adventure', 'Western', 'Comedy']",1970,6
14569569,Disco Beaver from Outer Space,1978,['United States of America'],['Comedy'],1970,8
5974081,Deepavali,2007,['India'],"['Romance Film', 'Tamil cinema']",2000,7
24473861,Aarti,1962,['India'],"['Musical', 'Romantic drama', 'Bollywood', 'World cinema', 'Romance Film', 'Melodrama', 'Drama']",1960,2
10759815,The Man Who Understood Women,1959,['United States of America'],"['Drama', 'Comedy-drama']",1950,9
24977255,"Lad, A Dog",1962,['United States of America'],['Drama'],1960,2
2659373,The Iron Maiden,1963,['United Kingdom'],['Comedy'],1960,3
15047111,Dark of the Sun,1968,"['United Kingdom', 'United States of America']","['Adventure', 'War film']",1960,8
19479460,X-Men,2000,['United States of America'],"['Action', 'Superhero', 'Action/Adventure', 'Thriller', 'Superhero movie', 'Science Fiction', 'Fantasy']",2000,0
25412715,Eden Is West,2009,"['France', 'Italy', 'Greece']","['Art film', 'Drama', 'World cinema']",2000,9
8627618,The Lawless Nineties,1936,['United States of America'],"['B-Western', 'Black-and-white', 'Western', 'Action/Adventure']",1930,6
29716826,Amrutham Gamaya,1987,['India'],['Drama'],1980,7
13846751,El Greco,2007,"['Spain', 'Hungary', 'Greece']","['Biographical film', 'Drama', 'World cinema']",2000,7
8898667,The Raggedy Rawney,1988,['United Kingdom'],"['Indie', 'Adventure', 'Drama']",1980,8
24722022,Valente Quintero,1973,['Mexico'],"['Western', 'Historical fiction', 'Adventure', 'Drama']",1970,3
10846406,Alluri Seetharama Raju,1974,['India'],"['Action/Adventure', 'Drama', 'World cinema']",1970,4
163451,Julia,1977,['United States of America'],"['Period piece', 'Biography', 'New Hollywood', 'Drama']",1970,7
23531556,Down the Drain,1990,['United States of America'],"['Action', 'Heist', 'Crime Fiction', 'Action/Adventure', 'Comedy film']",1990,0
18238496,Go Go Amigo,1965,['United States of America'],"['Animation', 'Short Film', 'Comedy', 'Family Film']",1960,5
7505990,Nomads,1986,['United States of America'],"['Indie', 'Thriller', 'Horror', 'Supernatural']",1980,6
9757430,Sol de otoño,1996,['Argentina'],"['Drama', 'Indie', 'Romantic drama', 'Comedy', 'World cinema', 'Romance Film', 'Religious Film']",1990,6
26719946,Srivariki Premalekha,1984,['India'],['Comedy film'],1980,4
5624816,Game 6,2006,['United States of America'],"['Indie', 'Comedy-drama', 'Sports', 'Drama']",2000,6
33470992,Follow the Prophet,2009,['United States of America'],"['Crime Fiction', 'Indie', 'Drama']",2000,9
3671998,Raising Cain,1992,['United States of America'],"['Psychological thriller', 'Thriller', 'Horror']",1990,2
3146408,G.O.R.A.,2004,['Turkey'],"['Science Fiction', 'Comedy', 'Adventure']",2000,4
2300167,A Place in the Sun,1951,['United States of America'],"['Film adaptation', 'Crime Fiction', 'Romantic drama', 'Film noir', 'Romance Film', 'Drama']",1950,1
10626143,My Young Auntie,1981,['Hong Kong'],"['Action', 'Martial Arts Film', 'Action Comedy', 'Action/Adventure', 'Comedy', 'World cinema', 'Chinese Movies']",1980,1
27168351,Eighteen,2005,['Canada'],"['Gay Themed', 'LGBT', 'Indie', 'Drama']",2000,5
8924944,Alice,2005,['Portugal'],['Drama'],2000,5
13901,Heathers,1988,['United States of America'],"['Black comedy', 'Comedy', 'Teen']",1980,8
4002677,The 39 Steps,1959,['United Kingdom'],"['Action', 'Spy', 'Film adaptation', 'Mystery', 'Action/Adventure', 'Thriller', 'Remake', 'Drama', 'Suspense']",1950,9
4544022,It Happened on 5th Avenue,1947,['United States of America'],"['Screwball comedy', 'Comedy']",1940,7
1751923,Joint Security Area,2000,['South Korea'],"['Drama', 'Detective', 'World cinema']",2000,0
14760023,Aha Naa Pellanta,1987,['India'],['Comedy'],1980,7
1581992,Deewana,1992,['India'],"['Bollywood', 'World cinema']",1990,2
8860418,Heaven Help Us,1985,['United States of America'],"['Indie', 'Comedy', 'Teen', 'Romance Film', 'Drama', 'Coming of age', 'Religious Film', 'Comedy-drama']",1980,5
3676065,Fire Over England,1937,['United Kingdom'],"['British Empire Film', 'Costume Adventure', 'Black-and-white', 'Costume drama', 'Adventure', 'Drama']",1930,7
2395072,Naruto the Movie 3: The Animal Riot of Crescent Moon Island,2006,['Japan'],"['Action', 'Animation', 'Anime', 'Adventure']",2000,6
12362700,ABBA - The Movie,1977,"['Sweden', 'Australia']","['Rockumentary', 'Documentary']",1970,7
5016805,Besieged,1998,"['United Kingdom', 'Italy']","['Erotic Drama', 'Romantic drama', 'World cinema', 'Romance Film', 'Political drama', 'Drama']",1990,8
537101,Roustabout,1964,['United States of America'],"['Musical', 'Romance Film']",1960,4
24226858,Little Big Shot,1935,['United States of America'],['Black-and-white'],1930,5
6701449,Padayappa,1999,['India'],"['Romance Film', 'Drama']",1990,9
7133616,Ella Enchanted,2004,"['United Kingdom', 'Ireland', 'United States of America']","['Romantic fantasy', 'Comedy', 'Teen', 'Romance Film', 'Costume drama', 'Romantic comedy', 'Fantasy Comedy', 'Family Film', 'Fantasy']",2000,4
742641,Over the Edge,1979,['United States of America'],"['Drama', 'Crime Fiction', 'Indie', 'Teen']",1970,9
9552709,Blue Sunshine,1978,['United States of America'],"['Psychological thriller', 'Mystery', 'Indie', 'Thriller', 'Horror', 'Crime Thriller']",1970,8
18332411,The Stringless Violin,2003,['Indonesia'],"['Romance Film', 'Drama']",2000,3
5109789,The Sisterhood,2004,"['United Kingdom', 'United States of America']","['Supernatural', 'Horror']",2000,4
6097476,Aata,2007,['India'],"['Romance Film', 'Tollywood']",2000,7
177835,Becky Sharp,1935,['United States of America'],"['Period piece', 'Film adaptation', 'Romantic drama', 'Romance Film', 'Melodrama', 'Drama']",1930,5
24193797,La belle équipe,1936,[],['Drama'],1930,6
23892202,Who the Hell Is Juliette?,1998,['Mexico'],"['Gender Issues', 'Social issues', 'Music', 'Interpersonal Relationships', 'Biography', 'Documentary', 'Culture & Society']",1990,8
28207043,Bimbo's Express,1931,['United States of America'],['Short Film'],1930,1
3599765,Beyond a Reasonable Doubt,1956,['United States of America'],"['Film noir', 'Black-and-white']",1950,6
6488515,Satyam Shivam Sundaram,1978,['India'],"['Romantic drama', 'Bollywood', 'World cinema', 'Romance Film', 'Drama']",1970,8
12629555,Tycoon,1947,['United States of America'],"['Action/Adventure', 'Adventure', 'Romance Film', 'Drama']",1940,7
6073527,Children of the Corn: Revelation,2001,['United States of America'],"['Supernatural', 'Cult', 'Horror']",2000,1
2888116,Manhood,2003,['United States of America'],"['Family Drama', 'Black comedy', 'Drama', 'Ensemble Film']",2000,3
5451260,The Las Vegas Story,1952,['United States of America'],"['Black-and-white', 'Marriage Drama', 'Film noir', 'Crime Drama', 'Drama']",1950,2
1515881,Story of Ermei,2004,['China'],"['Chinese Movies', 'Drama']",2000,4
2346581,Human Desire,1954,['United States of America'],"['Suspense', 'Black-and-white', 'Crime Fiction', 'Thriller', 'Film noir', 'Drama']",1950,4
3045845,Sirocco,1951,['United States of America'],"['Suspense', 'Black-and-white', 'Thriller', 'Film noir', 'Drama']",1950,1
26139404,Summertree,1971,['United States of America'],['Drama'],1970,1
8562282,Attack Force,2006,['United States of America'],"['Action', 'Action Thrillers', 'Action/Adventure', 'Thriller']",2000,6
24201336,Like Dandelion Dust,2009,['United States of America'],"['Film adaptation', 'Indie', 'Drama']",2000,9
2557546,Two of a Kind,1951,['United States of America'],"['Black-and-white', 'Crime Fiction', 'Thriller', 'Film noir', 'Drama']",1950,1
2750377,"To Sir, with Love II",1996,['United States of America'],['Coming of age'],1990,6
7787845,Living Out Loud,1998,['United States of America'],"['Film adaptation', 'Romantic drama', 'Comedy', 'Romance Film', 'Drama', 'Feminist Film', 'Romantic comedy', 'Comedy-drama']",1990,8
19804280,The Bold Caballero,1936,['United States of America'],"['Action', 'Action/Adventure', 'Adventure', 'Spaghetti Western', 'Swashbuckler films']",1930,6
22494035,Crash Landing,1999,['China'],"['Chinese Movies', 'Thriller']",1990,9
222328,Sankarabharanam,1979,['India'],"['Musical', 'Drama']",1970,9
582398,Nine to Five,1980,['United States of America'],"['Screwball comedy', 'Crime Fiction', 'Comedy', 'Workplace Comedy', 'Feminist Film']",1980,0
28922059,Flames of Passion,1922,['United Kingdom'],['Silent film'],1920,2
28557616,Neythukaran,2002,['India'],['Drama'],2000,2
4955624,Executioners from Shaolin,1976,['Hong Kong'],"['Action', 'Drama', 'Chinese Movies', 'Martial Arts Film']",1970,6
2852779,Nemesis Game,2003,"['United Kingdom', 'New Zealand', 'Canada']","['Psychological thriller', 'Suspense', 'Mystery', 'Thriller', 'Crime Thriller']",2000,3
1374014,Kiss of the Dragon,2001,"['France', 'United States of America']","['Action', 'Action Thrillers', 'Thriller', 'Crime Thriller', 'Martial Arts Film', 'Drama']",2000,1
35876700,Nightmares,1980,['Australia'],"['Thriller', 'Horror']",1980,0
22787283,A Ham in a Role,1949,[],"['Animation', 'Short Film', 'Family Film']",1940,9
14600357,Case Closed: Full Score of Fear,2008,['Japan'],"['Detective fiction', 'Japanese Movies', 'Mystery', 'Detective', 'Anime']",2000,8
2426058,Proof,2005,['United States of America'],['Drama'],2000,5
4908704,Marianne and Juliane,1981,"['Germany', 'West Germany']",['Drama'],1980,1
9048883,Veronico Cruz,1988,"['Argentina', 'United Kingdom']","['Drama', 'Indie', 'World cinema', 'Political drama']",1980,8
11681963,Webs,2003,['United States of America'],"['Horror', 'Television movie', 'Sci-Fi Horror', 'Science Fiction']",2000,3
6851519,Noll Tolerans,1999,['Sweden'],['Action'],1990,9
9014467,9 millimeter,1997,['Sweden'],"['Crime Fiction', 'Romantic drama', 'Crime Drama', 'Drama']",1990,7
2308633,Eureka,2000,"['France', 'Japan']","['Crime Fiction', 'Japanese Movies', 'World cinema', 'Drama']",2000,0
1637470,Near Dark,1987,['United States of America'],"['Western', 'Teen', 'Horror', 'Cult']",1980,7
1721169,Village of the Damned,1960,['United Kingdom'],"['Horror', 'Science Fiction']",1960,0
18399439,Dragon Ball: Yo! Son Goku and His Friends Return!!,2008,['Japan'],"['Short Film', 'Japanese Movies']",2000,8
6031889,Hannibal Brooks,1969,['United Kingdom'],"['Action', 'Comedy', 'Melodrama', 'Comedy-drama', 'Drama']",1960,9
26886022,Nightmare Beach,1988,['United States of America'],"['Slasher', 'Teen', 'Horror']",1980,8
34073457,Among The Great Apes With Michelle Yeoh,2009,['Malaysia'],['Documentary'],2000,9
12136473,Tortilla Heaven,2007,['United States of America'],"['Drama', 'Indie', 'Comedy', 'Religious Film', 'Comedy-drama']",2000,7
9035329,Aakrosh,1998,['India'],"['Action', 'Thriller', 'Drama']",1990,8
340570,"Simon, Simon",1970,['United Kingdom'],"['Short Film', 'Comedy']",1970,0
5020056,The Deal,2003,"['United Kingdom', 'England']","['Television movie', 'Political drama', 'Drama']",2000,3
5068379,Jongno,1933,"['Korea', 'South Korea']","['Black-and-white', 'Indie', 'Silent film', 'Romance Film', 'Drama']",1930,3
11362250,I cento passi,2000,['Italy'],"['Thriller', 'World cinema', 'Crime Drama', 'Political drama', 'Drama', 'Political thriller']",2000,0
23982248,Evil - In the Time of Heroes,2009,['Greece'],"['Comedy', 'Horror', 'World cinema', 'Zombie Film', 'Adventure']",2000,9
21430607,Giliap,1975,['Sweden'],['Drama'],1970,5
1345780,Richard III,1955,['United Kingdom'],"['Film adaptation', 'Biographical film', 'Epic', 'Roadshow theatrical release', 'Costume drama', 'Drama', 'Tragedy']",1950,5
28911662,Oppol,1980,['India'],['Drama'],1980,0
3405788,Seemabaddha,1974,['India'],"['Art film', 'Drama', 'World cinema']",1970,4
10223140,Purple Storm,1999,['Hong Kong'],"['Action', 'Action/Adventure', 'Thriller', 'World cinema', 'Chinese Movies', 'Martial Arts Film']",1990,9
14545140,Calendar,1993,"['Armenia', 'Germany', 'Canada']","['Drama', 'Indie', 'Romantic drama', 'Marriage Drama', 'Comedy', 'Romance Film']",1990,3
20903442,Gehri Chaal,1973,['India'],['Thriller'],1970,3
10556466,Intruso,1993,['Spain'],"['Romantic drama', 'Drama', 'World cinema']",1990,3
5601707,The Fraternity,2002,['Canada'],"['Suspense', 'LGBT', 'Mystery', 'Coming of age', 'Thriller', 'Crime Thriller']",2000,2
23487733,Kadhalna Summa Illai,2009,['India'],['Drama'],2000,9
2666695,Wonder Man,1945,['United States of America'],['Comedy'],1940,5
26910460,Love on Wheels,1932,['United Kingdom'],['Musical'],1930,2
24962756,Kiki,1926,['United States of America'],"['Silent film', 'Drama']",1920,6
8444243,First Monday in October,1981,['United States of America'],"['Romantic drama', 'Comedy', 'Romance Film', 'Drama', 'Political cinema', 'Romantic comedy', 'Comedy-drama', 'Political drama']",1980,1
13882169,Shadowzone,1990,['United States of America'],"['Creature Film', 'Horror', 'Sci-Fi Horror', 'Science Fiction']",1990,0
11536051,Mahal,1969,['India'],"['Action', 'Drama', 'Crime Fiction', 'Mystery', 'Thriller']",1960,9
3600324,Happy Times,2000,['China'],"['Romantic drama', 'Comedy', 'World cinema', 'Romance Film', 'Romantic comedy', 'Chinese Movies', 'Drama']",2000,0
261448,An Alan Smithee Film: Burn Hollywood Burn,1998,['United States of America'],"['Parody', 'Comedy']",1990,8
23257913,The Two Mr. Kissels,2008,['United States of America'],"['Drama', 'Television movie']",2000,8
3072026,Love in Thoughts,2004,['Germany'],"['LGBT', 'World cinema', 'Romance Film', 'Drama']",2000,4
3793631,Children of Men,2006,"['United Kingdom', 'United States of America']","['Action', 'Film adaptation', 'Action Thrillers', 'Mystery', 'Action/Adventure', 'Thriller', 'Adventure', 'Drama', 'Doomsday film', 'Dystopia', 'Future noir', 'Science Fiction']",2000,6
5555253,Underground Comedy Movie,1999,['United States of America'],"['Indie', 'Comedy', 'Cult']",1990,9
5243411,Chori Chori,1956,['India'],"['Musical', 'Romance Film', 'Black-and-white']",1950,6
33113634,The Unforgettable Year 1919,1952,[],"['Historical fiction', 'Drama']",1950,2
492200,S.O.B.,1981,['United States of America'],"['Comedy', 'Satire', 'Black comedy', 'Tragicomedy', 'Sex comedy']",1980,1
13162689,Deewana Mastana,1997,['India'],"['Comedy', 'Bollywood', 'World cinema']",1990,7
2299232,Elling,2001,['Norway'],"['Film adaptation', 'Comedy', 'World cinema', 'Black comedy', 'Comedy-drama', 'Drama']",2000,1
18737103,On War,2008,['France'],"['War film', 'Drama', 'Comedy film']",2000,8
15985034,Lucky 7,2003,['United States of America'],"['Indie', 'Comedy', 'Romance Film', 'Romantic comedy']",2000,3
33855734,The Mailman,2004,[],"['Slasher', 'Thriller', 'Horror']",2000,4
10160738,Cactus Flower,1969,['United States of America'],"['Screwball comedy', 'Comedy', 'Romance Film', 'Romantic comedy']",1960,9
29301223,Ex$pendable,2008,[],['Crime Fiction'],2000,8
19069326,Ananda Bhairavi,1984,['India'],"['Musical', 'Drama', 'Family Film']",1980,4
31644556,Television Spy,1939,['United States of America'],"['Action', 'Spy']",1930,9
8102911,Ayya,2005,['India'],"['Action', 'Drama', 'Bollywood', 'Romance Film']",2000,5
25526521,I Ought to Be in Pictures,1982,['United States of America'],"['Drama', 'Comedy']",1980,2
1071219,Shall We Dance?,2004,['United States of America'],"['Comedy', 'Remake', 'Dance', 'Romance Film', 'Romantic comedy', 'Drama']",2000,4
12911103,Villu,2008,['India'],"['Action', 'Drama', 'Comedy', 'Thriller']",2000,8
2642180,Kadosh,1999,"['Israel', 'France']","['Family Drama', 'Romantic drama', 'World cinema', 'Romance Film', 'Drama', 'Feminist Film']",1990,9
3070849,The Comeback,1978,['United Kingdom'],"['Mystery', 'Slasher', 'Thriller', 'Horror', 'Supernatural']",1970,8
5646653,Zoom,2006,['United States of America'],"['Action', 'Adventure', 'Science Fiction', 'Fantasy']",2000,6
11741850,Monster in the Closet,1986,['United States of America'],"['Creature Film', 'Monster movie', 'Parody', 'Comedy', 'Horror Comedy', 'Horror', 'B-movie']",1980,6
26015247,Witness,1988,['India'],"['Action', 'Mystery', 'Comedy', 'Thriller']",1980,8
21266572,Evil Eyes,2004,['United States of America'],"['Psychological thriller', 'Indie', 'Slasher', 'Horror', 'Supernatural']",2000,4
2261407,3-Iron,2004,"['Japan', 'South Korea']","['Crime Fiction', 'Japanese Movies', 'Art film', 'Romantic drama', 'World cinema', 'Romance Film', 'Drama']",2000,4
788543,New York Minute,2004,['United States of America'],"['Family Film', 'Comedy', 'Teen']",2000,4
4924882,The New Legend Of Shaolin,1994,"['Hong Kong', 'Taiwan']","['Action', 'Action/Adventure', 'Comedy', 'World cinema', 'Romance Film', 'Chinese Movies', 'Martial Arts Film', 'Adventure', 'Drama', 'History']",1990,4
24949183,Pains of Autumn,2009,['Turkey'],['Drama'],2000,9
13084160,Hail Mary,1985,"['United Kingdom', 'France', 'Switzerland']","['Erotic Drama', 'Avant-garde', 'World cinema', 'Experimental film', 'Erotica', 'Drama']",1980,5
19217319,Blindfold,1965,['United States of America'],"['Romance Film', 'Comedy', 'Thriller']",1960,5
8351040,The Painted Veil,1934,['United States of America'],"['Black-and-white', 'War film', 'Drama']",1930,4
473776,Wasabi,2001,"['France', 'Japan']","['Action', 'Action/Adventure', 'Comedy', 'Thriller', 'World cinema', 'Crime Thriller', 'Japanese Movies', 'Action Comedy']",2000,1
4413065,Sunshine,1999,"['Austria', 'Canada', 'Germany', 'Hungary']","['Period piece', 'Political drama', 'Drama']",1990,9
161880,Hud,1963,['United States of America'],"['Film adaptation', 'Action/Adventure', 'Western', 'Drama']",1960,3
26373339,Panchagni,1986,['India'],"['Drama', 'Crime Fiction']",1980,6
34322643,We Are Not Angels 3: Rock & Roll Strike Back,2006,['Serbia'],['Comedy film'],2000,6
24346683,O.K. Garage,1998,['United States of America'],"['Crime Fiction', 'Comedy', 'Drama']",1990,8
32296485,The Falling,1987,"['Spain', 'United States of America']","['Science Fiction', 'Drama', 'Horror']",1980,7
12875999,You're Only Young Once,1937,['United States of America'],"['Comedy', 'Black-and-white']",1930,7
26284204,Convoy,1940,['United Kingdom'],"['War film', 'Drama']",1940,0
17623455,Seven Servants,1996,['Germany'],"['Indie', 'Avant-garde', 'World cinema', 'Experimental film', 'Drama']",1990,6
8846718,Candy Land: The Great Lollipop Adventure,2005,['United States of America'],"['Animated cartoon', ""Children's Fantasy"", 'Animation', ""Children's"", ""Children's/Family"", 'Adventure', 'Family Film']",2000,5
6809623,Dheena,2001,['India'],['Action'],2000,1
8555713,Crooked Earth,2001,['New Zealand'],['Drama'],2000,1
12541481,Boy Culture,2006,['United States of America'],"['Film adaptation', 'LGBT', 'Indie', 'Romantic drama', 'Comedy', 'Romance Film', 'Drama', 'Gay Themed']",2000,6
10044747,Mungaru Male,2006,['India'],"['Music', 'Romance Film', 'Comedy']",2000,6
5541237,Undermind,2003,['United States of America'],"['Psychological thriller', 'Thriller']",2000,3
14710275,The Tommyknockers,1993,"['New Zealand', 'United States of America']","['Fantasy', 'Science Fiction', 'Horror']",1990,3
7031132,Perfume: The Story of a Murderer,2006,"['Spain', 'France', 'Germany', 'United States of America']","['Psychological thriller', 'Film adaptation', 'Crime Fiction', 'Thriller', 'World cinema', 'Romance Film', 'Drama', 'Period piece']",2000,6
31208671,Cool Dimension: Innocent Assassin,2006,['Japan'],"['Action', 'Drama', 'Japanese Movies', 'Action/Adventure', 'World cinema']",2000,6
7533919,Police,1985,"['France', 'Spain']","['Action', 'Action/Adventure', 'Comedy', 'Thriller', 'World cinema']",1980,5
13632871,La Femme Musketeer,2004,['Croatia'],"['Costume Adventure', 'Action/Adventure', 'Adventure', 'Swashbuckler films']",2000,4
5921096,Bus Conductor,2005,['India'],"['Family Drama', 'Malayalam Cinema', 'Drama']",2000,5
8590196,Confession of Pain,2006,['Hong Kong'],"['Crime Fiction', 'Thriller', 'Chinese Movies', 'Drama']",2000,6
12582043,Der Hauptmann von Köpenick,1931,"['Weimar Republic', 'Germany']","['Comedy', 'Black-and-white']",1930,1
17426666,Kispus,1956,['Denmark'],['Comedy'],1950,6
19995077,Life Show,2002,['China'],"['Drama', 'Chinese Movies', 'World cinema']",2000,2
357473,Die Hard: With a Vengeance,1995,['United States of America'],"['Action', 'Crime Fiction', 'Action/Adventure', 'Thriller']",1990,5
451821,EuroTrip,2004,['United States of America'],"['Comedy', 'Teen', 'Adventure', 'Sex comedy']",2000,4
10892704,Mashaal,1984,['India'],"['Drama', 'Bollywood', 'World cinema']",1980,4
724696,Circus,1936,['Soviet Union'],"['Musical', 'Black-and-white']",1930,6
22265300,Peruvazhiyambalam,1979,['India'],['Crime Fiction'],1970,9
8280962,Rudolph and Frosty's Christmas in July,1979,['United States of America'],"['Animation', 'Stop motion', 'Adventure', 'Family Film']",1970,9
9769970,Billy Jack Goes to Washington,1977,['United States of America'],"['Indie', 'Political drama', 'Drama']",1970,7
9143959,Woman Obsessed,1959,['United States of America'],"['Romance Film', 'Adventure', 'Drama']",1950,9
6965467,Boys in the Sand,1971,['United States of America'],"['Fictional film', 'Adult']",1970,1
5216204,The Bakery Girl of Monceau,1963,['France'],"['Black-and-white', 'Romantic drama', 'Short Film', 'World cinema', 'Romance Film', 'Drama']",1960,3
8586622,Planet Terror,2007,['United States of America'],"['Action', 'Action Thrillers', 'Indie', 'Action/Adventure', 'Thriller', 'Zombie Film', 'Disaster', 'Creature Film', 'Horror', 'Science Fiction', 'Cult']",2000,7
21517630,Hillside Cannibals,2006,['United States of America'],"['Indie', 'Slasher', 'Horror', 'B-movie']",2000,6
22381581,Move,1970,['United States of America'],['Comedy'],1970,0
766846,"Come Back to the Five and Dime, Jimmy Dean, Jimmy Dean",1981,['United States of America'],"['LGBT', 'Indie', 'Comedy', 'Drama']",1980,1
8610844,Three Violent People,1956,['United States of America'],"['Period piece', 'Family Drama', 'Western', 'Drama']",1950,6
20868663,One: On the Run,2003,"['France', 'Belgium']","['Crime Fiction', 'Thriller', 'Crime Thriller', 'Drama']",2000,3
10047161,Sharpe's Challenge,2006,['United Kingdom'],"['Action/Adventure', 'History']",2000,6
29143291,The Late Edwina Black,1951,[],"['Mystery', 'Drama']",1950,1
472652,The City of Lost Children,1995,"['France', 'Spain', 'Germany']","['Fantasy Adventure', 'Comedy', 'World cinema', 'Film noir', 'Escape Film', 'Adventure', 'Drama', 'Dystopia', 'Future noir', 'Steampunk', 'Science Fiction', 'Fantasy']",1990,5
3483217,Supervolcano,2005,"['Japan', 'United Kingdom', 'Germany', 'Italy', 'United States of America']","['Disaster', 'Japanese Movies']",2000,5
5467488,The Charge of the Light Brigade,1968,['United Kingdom'],"['Action', 'Drama', 'Action/Adventure', 'Epic', 'War film']",1960,8
2940677,The House by the Cemetery,1981,['Italy'],"['Monster', 'Splatter film', 'World cinema', 'Horror', 'Zombie Film', 'Supernatural', 'Haunted House Film']",1980,1
256713,Dancer in the Dark,2000,"['Iceland', 'Sweden', 'Finland', 'France', 'Italy', 'Spain', 'Denmark', 'Norway', 'Argentina', 'United Kingdom', 'Germany', 'Netherlands', 'United States of America']","['Musical', 'Drama', 'Crime Fiction', 'Indie', 'Musical Drama', 'Melodrama']",2000,0
24775488,International Guerillas,1990,['Pakistan'],"['Action', 'Comedy']",1990,0
14738272,Punchy Cowpunchers,1950,['United States of America'],"['Short Film', 'Black-and-white', 'Comedy']",1950,0
7322582,Play Dirty,1968,['United Kingdom'],"['Action', 'Drama', 'Action/Adventure', 'War film']",1960,8
1620886,Deep Shock,2003,['United States of America'],"['Creature Film', 'Horror', 'Sci-Fi Horror', 'Science Fiction']",2000,3
11172607,Timecop 2: The Berlin Decision,2003,['United States of America'],"['Action', 'Action Thrillers', 'Action/Adventure', 'Thriller', 'Martial Arts Film', 'Science Fiction']",2000,3
28269,Saving Private Ryan,1998,['United States of America'],"['Combat Films', 'Action', 'History', 'War film', 'Drama', 'Ensemble Film']",1990,8
1994205,Slackers,2002,"['Canada', 'United States of America']","['Gross out', 'Gross-out film', 'Stoner film', 'Comedy', 'Teen', 'Romance Film', 'Romantic comedy', 'Sex comedy']",2000,2
9951396,Arzoo,1965,['India'],"['Musical', 'Romantic drama', 'Comedy', 'Bollywood', 'World cinema', 'Romance Film', 'Drama']",1960,5
15316917,Illuminata,1999,"['Spain', 'Japan', 'United States of America']","['Indie', 'Comedy', 'Costume drama', 'Drama', 'Period piece', 'Japanese Movies', 'Parody', 'Romantic comedy', 'Comedy-drama']",1990,9
20318100,Breaking the Rules,1992,['United States of America'],['Drama'],1990,2
2252823,Passport to Paris,1999,['United States of America'],"['Comedy', 'Teen', 'Romance Film', ""Children's/Family"", 'Family Film']",1990,9
12665133,Safe Passage,1995,['United States of America'],"['Indie', 'Drama']",1990,5
17231552,Ek Din Pratidin,1979,['India'],"['Drama', 'Art film']",1970,9
7771844,"Suddenly, Last Summer",1959,['United States of America'],"['Drama', 'Mystery', 'Thriller']",1950,9
13573527,Identification of a Woman,1982,"['France', 'Italy']",['Drama'],1980,2
20700852,Grey Gardens,2009,['United States of America'],"['Period piece', 'Biographical film', 'Television movie', 'Drama']",2000,9
870946,The Bourne Supremacy,2004,"['Germany', 'United States of America']","['Action', 'Spy', 'Film adaptation', 'Crime Fiction', 'Action Thrillers', 'Mystery', 'Action/Adventure', 'Thriller', 'Martial Arts Film', 'Drama']",2000,4
22012794,The Naked and the Dead,1958,['United States of America'],['War film'],1950,8
14947020,Largo Winch,2008,"['France', 'Belgium']","['Action Thrillers', 'Adventure', 'Thriller']",2000,8
7993874,The Angel Wore Red,1960,"['Italy', 'United States of America']","['Black-and-white', 'Romance Film', 'War film', 'Drama']",1960,0
33808354,Alpine Antics,1936,[],"['Animation', 'Short Film', 'Comedy film', 'Sports']",1930,6
17916735,Observe and Report,2009,['United States of America'],"['Crime Fiction', 'Comedy', 'Black comedy', 'Drama']",2000,9
17202179,You Can't Have Everything,1937,['United States of America'],"['Musical', 'Black-and-white', 'Backstage Musical', 'Comedy', 'Romance Film']",1930,7
18152165,I'm Not Rappaport,1996,['United States of America'],"['Indie', 'Comedy']",1990,6
10750885,Minna no Ie,2001,['Japan'],"['Japanese Movies', 'Comedy', 'World cinema']",2000,1
4944618,Queen of the Amazons,1947,['United States of America'],"['Action', 'Black-and-white', 'Action/Adventure', 'Thriller', 'Jungle Film', 'Adventure']",1940,7
1575815,Tale of the Mummy,1998,"['United Kingdom', 'Luxembourg', 'United States of America']","['Creature Film', 'Monster movie', 'Horror', 'Adventure', 'Science Fiction', 'Fantasy']",1990,8
1026452,Fantastic Voyage,1966,['United States of America'],"['Science Fiction', 'Adventure']",1960,6
32820957,The Big Sombrero,1949,['United States of America'],['Western'],1940,9
25342113,Taken In Broad Daylight,2009,['United States of America'],"['Mystery', 'Thriller', 'Television movie', 'Crime Thriller']",2000,9
2876631,Dreamcatcher,2003,"['United States of America', 'Canada', 'Australia']","['Film adaptation', 'Thriller', 'Horror', 'Supernatural', 'Science Fiction', 'Drama']",2000,3
7236691,Anita and Me,2002,['United Kingdom'],"['Period piece', 'Film adaptation', 'Coming of age', 'Comedy', 'Teen', 'Comedy-drama', 'Drama']",2000,2
8098268,"'night, Mother",1986,['United States of America'],"['Family Drama', 'Drama']",1980,6
1923480,Brain Damage,1988,['United States of America'],"['Comedy', 'Horror Comedy', 'Monster movie', 'Splatter film', 'Slasher', 'Horror', 'Science Fiction', 'Cult']",1980,8
1896864,9½ Weeks,1986,['United States of America'],['Erotica'],1980,6
673306,Night of the Ghouls,1987,['United States of America'],"['Psychological thriller', 'Detective fiction', 'Detective', 'Horror', 'Haunted House Film', 'B-movie', 'Cult']",1980,7
25029324,Coyote Summer,1996,['United States of America'],"['Action', 'Adventure']",1990,6
34985844,Cedie,1996,['Philippines'],['Family Film'],1990,6
27556929,Deadly Voyage,1996,"['United Kingdom', 'United States of America']","['Action', 'Action Thrillers', 'Action/Adventure', 'Thriller', 'Drama', 'Suspense', 'Horror', 'Television movie']",1990,6
2229894,Romance & Cigarettes,2006,['United States of America'],"['Musical', 'Indie', 'Romantic drama', 'Comedy', 'Romance Film', 'Romantic comedy']",2000,6
6163787,Atomic Rulers of the World,1964,['Japan'],"['Japanese Movies', 'Action/Adventure', 'Horror', 'Superhero movie', 'Martial Arts Film', 'Science Fiction']",1960,4
26614055,Currency,2009,['India'],"['Comedy', 'Crime Fiction']",2000,9
19743387,Ashanti,1982,['India'],"['Action', 'Crime Fiction', 'Adventure']",1980,2
14339464,Spike and Suzy: The Texas Rangers,2008,"['Luxembourg', 'Netherlands', 'Belgium']","['Animation', 'Adventure', 'Family Film', 'Computer Animation']",2000,8
25550642,The Man Who Came Back,2008,['United States of America'],"['Action', 'Period piece', 'Crime Fiction', 'Western', 'Action/Adventure', 'Thriller', 'Drama']",2000,8
20638510,Murder Party,2007,['United States of America'],"['Slasher', 'Comedy', 'Horror', 'Black comedy', 'Cult']",2000,7
3649048,The Last Hunt,1956,['United States of America'],['Western'],1950,6
6389163,The Gingerbread Man,1998,['United States of America'],"['Neo-noir', 'Mystery', 'Thriller', 'Crime Thriller', 'Courtroom Drama']",1990,8
1525968,Liam,2000,"['United Kingdom', 'France', 'Germany', 'Italy']","['Period piece', 'Family Drama', 'Indie', 'Childhood Drama', 'Drama']",2000,0
9570503,Longford,2006,"['United Kingdom', 'United States of America']","['Crime Fiction', 'Indie', 'Biopic [feature]', 'Television movie', 'Drama']",2000,6
10298553,Sleepy Hollow High,2000,['United States of America'],"['Mystery', 'Horror']",2000,0
18943962,Steamboat Willie,1928,['United States of America'],"['Musical', 'Black-and-white', 'Short Film', 'Comedy']",1920,8
15451313,Sapoot,1996,['India'],['Action'],1990,6
4566179,Two Cents Worth of Hope,1952,['Italy'],"['Black-and-white', 'Romantic drama', 'Comedy', 'World cinema', 'Romance Film', 'Romantic comedy', 'Drama']",1950,2
14747011,For Crimin' Out Loud,1956,['United States of America'],"['Short Film', 'Black-and-white', 'Comedy']",1950,6
3815899,Dementia 13,1963,['United States of America'],"['Indie', 'Gothic Film', 'Thriller', 'Horror', 'Slasher', 'B-movie']",1960,3
7280252,Legend of the Werewolf,1975,['United Kingdom'],"['Creature Film', 'Costume drama', 'Horror']",1970,5
24641512,Robert et Robert,1978,['France'],['Comedy'],1970,8
1338396,Rebirth of Mothra III,1998,['Japan'],"['Monster', 'Japanese Movies']",1990,8
28338035,Strawberry Roan,1945,['United Kingdom'],['Drama'],1940,5
25446184,Mosagadu,1980,['India'],"['Action', 'Drama', 'Family Film']",1980,0
7874383,Svengali,1930,['United States of America'],"['Suspense', 'Black-and-white', 'Mystery', 'Thriller', 'Horror', 'Drama']",1930,0
14016156,Hobgoblins 2,2008,['United States of America'],"['Creature Film', 'Indie', 'Horror', 'B-movie', 'Science Fiction']",2000,8
19814287,Mogok,1957,['Singapore'],[],1950,7
9521029,This Revolution,2004,['United States of America'],"['Drama', 'Indie', 'Thriller', 'Political drama', 'Political thriller']",2000,4
4362641,American Me,1992,['United States of America'],"['Crime Fiction', 'Gangster Film', 'Biographical film', 'Crime Drama', 'Crime Thriller', 'Drama']",1990,2
2941852,Ernest Goes to Camp,1987,['United States of America'],"['Slapstick', 'Comedy', 'Family Film']",1980,7
28365073,To Be a Lady,1934,['United Kingdom'],"['Romance Film', 'Drama']",1930,4
15047895,The Amy Fisher Story,1993,['United States of America'],"['Crime Drama', 'Docudrama', 'Drama']",1990,3
21134123,Blood Freak,1972,['United States of America'],"['Horror', 'Science Fiction']",1970,2
23207678,The Beast in the Cellar,1970,['United Kingdom'],['Horror'],1970,0
6640052,Parijatham,2006,['India'],"['Musical', 'Bollywood', 'World cinema', 'Drama']",2000,6
15778726,La Vie secrète des gens heureux,2006,['Canada'],"['Drama', 'Comedy film']",2000,6
9912104,El Hijo del crack,1953,['Argentina'],['Black-and-white'],1950,3
7708618,I Dream of Jeanie,1952,['United States of America'],"['Musical', 'Comedy', 'Biopic [feature]', 'Romance Film']",1950,2
24764062,Miss Malini,1947,['India'],['Satire'],1940,7
256337,Charlie's Angels: Full Throttle,2003,['United States of America'],"['Action', 'Martial Arts Film', 'Crime Fiction', 'Action Comedy', 'Action/Adventure', 'Comedy', 'Adventure']",2000,3
9483457,Three Girls Lost,1931,['United States of America'],"['Black-and-white', 'Drama']",1930,1
882438,Murphy's War,1971,['United Kingdom'],"['Action', 'Drama', 'War film']",1970,1
29503213,The Delta Factor,1970,['United States of America'],"['Crime Fiction', 'Adventure', 'Drama']",1970,0
26735976,Ichi,2008,['Japan'],"['Action', 'Japanese Movies', 'Action/Adventure', 'World cinema', 'Martial Arts Film', 'Drama']",2000,8
90039,Flirting with Disaster,1996,['United States of America'],"['LGBT', 'Screwball comedy', 'Indie', 'Comedy', 'Romance Film', 'Comedy of Errors', 'Road movie', 'Romantic comedy', 'Cult', 'Sex comedy']",1990,6
6046099,They Only Kill Their Masters,1972,['United States of America'],"['Crime Fiction', 'Mystery', 'Drama']",1970,2
12377847,Nagabonar Jadi 2,2007,['Indonesia'],['Comedy'],2000,7
2091266,The Way to the Stars,1945,['United Kingdom'],"['War film', 'Drama']",1940,5
10158733,Ploy,2007,['Thailand'],"['Erotic Drama', 'Drama']",2000,7
76638,Within Our Gates,1920,['United States of America'],"['Black-and-white', 'Drama', 'Indie', 'Early Black Cinema', 'Silent film']",1920,0
14102789,The Young Teacher,1972,['South Korea'],"['Black-and-white', 'Drama', 'Family Film']",1970,2
11213660,The Natural,1984,['United States of America'],"['Period piece', 'Sports', 'Film adaptation', 'Baseball', 'Americana', 'Drama']",1980,4
10638245,Banarasi Babu,1972,['India'],"['Romance Film', 'Drama']",1970,2
36183483,The Lion Roars,2002,['Hong Kong'],"['Chinese Movies', 'Comedy film']",2000,2
24300269,Track 29,1988,"['United Kingdom', 'United States of America']",['Drama'],1980,8
10420453,Khoon Bhari Maang,1988,['India'],"['Bollywood', 'Thriller']",1980,8
73970,The Heiress,1949,['United States of America'],"['Period piece', 'Film adaptation', 'Black-and-white', 'Romantic drama', 'Romance Film', 'Drama']",1940,9
15098889,Go Fly a Kit,1957,['United States of America'],"['Animation', 'Short Film', 'Comedy', 'Family Film']",1950,7
6044779,Children of the Corn V: Fields of Terror,1998,['United States of America'],"['Supernatural', 'Cult', 'Horror']",1990,8
385706,The Lion King 1½,2004,"['United States of America', 'Australia']","['Animation', 'Animated Musical', 'Comedy', 'Animal Picture', ""Children's/Family""]",2000,4
4750994,Saaransh,1984,['India'],"['Drama', 'Bollywood', 'World cinema']",1980,4
14327942,Elves,1989,['United States of America'],['Horror'],1980,9
3210963,Slapstick of Another Kind,1984,['United States of America'],"['Science Fiction', 'Comedy']",1980,4
18996,Mean Streets,1973,['United States of America'],"['Crime Fiction', 'Coming of age', 'Gangster Film', 'Crime Drama', 'Drama']",1970,3
10132736,Superman,1941,['United States of America'],"['Superhero movie', 'Animated cartoon', 'Short Film']",1940,1
1436649,Brewster McCloud,1970,['United States of America'],"['Satire', 'New Hollywood', 'Comedy-drama', 'Fantasy Comedy']",1970,0
1688741,The Boy Who Turned Yellow,1972,['United Kingdom'],"[""Children's"", 'Adventure', 'Family Film']",1970,2
11220896,Baba Kalyani,2006,['India'],"['Action', 'Drama', 'Crime Fiction', 'Mystery']",2000,6
32577114,Thrill of the Kill,2006,[],"['Crime Fiction', 'Mystery', 'Thriller', 'Drama']",2000,6
22215882,Ondine,2009,"['Ireland', 'United States of America']","['Romantic drama', 'Romance Film', 'Science Fiction', 'Drama', 'Fantasy']",2000,9
18600327,Bats: Human Harvest,2007,['United States of America'],['Horror'],2000,7
2300433,The Killer That Stalked New York,1950,['United States of America'],"['Black-and-white', 'Crime Fiction', 'Film noir', 'Crime Thriller', 'Docudrama']",1950,0
581185,Kabhi Khushi Kabhie Gham,2001,['India'],"['Musical', 'Family Drama', 'Bollywood', 'World cinema', 'Romance Film', 'Drama', 'Romantic comedy', 'Family Film']",2000,1
2260358,River's Edge,1986,['United States of America'],"['Crime Fiction', 'Coming of age', 'Indie', 'Teen', 'Drama']",1980,6
10862322,King Solomon's Mines,1985,"['Zimbabwe', 'United States of America']","['Action', 'Parody', 'Action/Adventure', 'Satire', 'Comedy', 'Adventure']",1980,5
1184167,The Tailor of Panama,2001,"['Panama', 'United Kingdom', 'Ireland', 'United States of America']","['Spy', 'Film adaptation', 'Political satire', 'Satire', 'Thriller', 'Black comedy', 'Drama', 'Comedy-drama', 'Political drama']",2000,1
4267117,Kidulthood,2006,['United Kingdom'],"['Indie', 'Drama', 'Teen']",2000,6
27660461,Entre nos,2009,['United States of America'],"['Drama', 'World cinema']",2000,9
5211092,Vaah! Life Ho Toh Aisi!,2005,['India'],"['Drama', 'World cinema']",2000,5
8748773,The Gate of Heavenly Peace,1995,['United States of America'],"['Documentary', 'Crime Fiction', 'History']",1990,5
4865862,Little Manhattan,2005,['United States of America'],"['Coming of age', 'Comedy', 'Teen', 'Romantic comedy', 'Romance Film', ""Children's"", 'Family Film']",2000,5
9231651,Gentleman Jim,1943,['United States of America'],"['Boxing', 'Black-and-white', 'Biography', 'Comedy', 'Biographical film', 'Romance Film', 'Drama', 'Biopic [feature]', 'Sports']",1940,3
18393594,Kuduz,1989,"['Socialist Federal Republic of Yugoslavia', 'Bosnia and Herzegovina', 'Yugoslavia']",['Drama'],1980,9
5865566,Mischief,1985,['United States of America'],"['Romantic drama', 'Comedy', 'Romance Film', 'Drama', 'Period piece', 'Coming of age', 'Romantic comedy', 'Sex comedy']",1980,5
11417210,The Mouse from H.U.N.G.E.R.,1967,['United States of America'],"['Animation', 'Short Film', 'Family Film']",1960,7
35804217,Boston Blackie and the Law,1946,['United States of America'],"['Crime Fiction', 'Mystery', 'Drama']",1940,6
12510655,Sissi - The Young Empress,1956,"['Austria', 'Germany']","['Romantic drama', 'World cinema', 'Romance Film', 'Drama']",1950,6
24165878,The Don Is Dead,1973,['United States of America'],"['Crime Fiction', 'Gangster Film', 'Thriller', 'Crime Thriller', 'Drama']",1970,3
10726300,Aaj Ka Arjun,1990,['India'],"['Musical', 'Crime Fiction', 'Romantic drama', 'Bollywood', 'World cinema', 'Romance Film', 'Drama']",1990,0
8692493,Dracula,1931,['United States of America'],"['Black-and-white', 'Horror']",1930,1
5531995,The Dead Talk Back,1993,['United States of America'],"['Mystery', 'Crime Fiction']",1990,3
2742915,Texas Chainsaw Massacre: The Next Generation,1994,['United States of America'],"['Slasher', 'Teen', 'Horror', 'Road-Horror', 'Cult']",1990,4
18775696,Rules: Pyaar Ka Superhit Formula,2003,['India'],"['Musical', 'Romantic drama', 'Comedy', 'Bollywood', 'World cinema', 'Romance Film', 'Drama', 'Romantic comedy']",2000,3
12853359,No Parking Hare,1954,['United States of America'],"['Short Film', 'Comedy']",1950,4
23992427,The Unborn,1991,['United States of America'],"['Thriller', 'Horror', 'Science Fiction', 'Drama']",1990,1
21743705,The Objective,2009,"['Morocco', 'United States of America']","['Psychological thriller', 'Action', 'Thriller', 'Horror', 'War film', 'Supernatural', 'Science Fiction']",2000,9
11283436,Day Break,2005,['Iran'],"['Drama', 'World cinema']",2000,5
4764761,Miranda,2002,"['United Kingdom', 'United States of America']","['Psychological thriller', 'Crime Fiction', 'Thriller', 'Erotic thriller', 'Black comedy', 'Romance Film', 'Drama']",2000,2
16200312,Beyond the Ring,2007,['United States of America'],"['Action', 'Action/Adventure', 'Thriller', 'Martial Arts Film']",2000,7
28937087,Children of Glory,2006,['Hungary'],"['Romance Film', 'Historical fiction', 'Sports', 'War film', 'Drama']",2000,6
5979095,Tattoo,1981,['United States of America'],"['Thriller', 'Erotica']",1980,1
8349539,Moon Pilot,1962,['United States of America'],"['Science Fiction', 'Satire', 'Comedy']",1960,2
16877347,This Could Be the Night,1957,['United States of America'],"['Black-and-white', 'Comedy', 'Romance Film', 'Romantic comedy']",1950,7
3954298,Sordid Lives,2008,['United States of America'],"['LGBT', 'Indie', 'Comedy', 'Black comedy', 'Gay Themed', 'Gay', 'Gay Interest', 'Comedy of manners', 'Ensemble Film']",2000,8
19950670,Le Miroir à deux faces,1958,"['France', 'Italy']","['Romantic drama', 'Marriage Drama', 'Drama']",1950,8
15454699,Alien vs. Hunter,2008,['United States of America'],"['Indie', 'Thriller', 'Horror', 'Science Fiction']",2000,8
1553752,Hustler White,1996,"['Canada', 'Germany']","['LGBT', 'Satire', 'Comedy', 'Black comedy', 'Drama', 'Gay Themed', 'Gay', 'Gay Interest']",1990,6
468342,The Cooler,2003,['United States of America'],"['Drama', 'Crime Fiction', 'Gangster Film', 'Indie', 'Romantic drama', 'Romance Film']",2000,3
19598085,Motherhood,2009,['United States of America'],"['Comedy-drama', 'Indie', 'Comedy']",2000,9
22546305,Molly and Me,1945,['United States of America'],"['Comedy', 'Black-and-white']",1940,5
6749717,The End of Innocence,1990,['United States of America'],"['Indie', 'Family Drama', 'Drama']",1990,0
13194784,Gung Ho!,1943,['United States of America'],"['Combat Films', 'Action', 'Action/Adventure', 'War film']",1940,3
1345521,High Plains Drifter,1973,['United States of America'],"['Action', 'Revisionist Western', 'Action/Adventure', 'Western', 'Thriller']",1970,3
7671718,Scent of Mystery,1960,['United States of America'],"['Crime Fiction', 'Mystery', 'Adventure']",1960,0
11665713,One on One,1977,['United States of America'],['Drama'],1970,7
20903445,Joshila,1973,['India'],['Thriller'],1970,3
11470600,Where the Day Takes You,1992,['United States of America'],"['Crime Fiction', 'Indie', 'Drama']",1990,2
16330093,Somers Town,2008,['United Kingdom'],"['Coming of age', 'Indie', 'Comedy', 'Comedy-drama', 'Drama']",2000,8
13114104,The Uninvited,2009,"['Germany', 'United States of America', 'Canada']","['Psychological thriller', 'Mystery', 'Thriller', 'Horror', 'Crime Thriller', 'Supernatural', 'Drama']",2000,9
5800622,The Bear,1988,"['United States of America', 'France']","['Family Drama', 'Adventure', ""Children's"", 'Drama', 'Family Film']",1980,8
15971336,Ping Pong Playa,2008,['United States of America'],"['Indie', 'Comedy', 'Domestic Comedy', 'Sports', 'Family Film']",2000,8
4464025,Mr. Jones,1993,['United States of America'],"['Romantic drama', 'Romance Film', 'Drama', 'Medical fiction']",1990,3
6317013,The Heart of the Game,2006,['United States of America'],"['Gender Issues', 'Biography', 'Documentary', 'Sports', 'Culture & Society']",2000,6
180991,Ball of Fire,1941,['United States of America'],"['Black-and-white', 'Crime Fiction', 'Screwball comedy', 'Comedy', 'Romantic comedy', 'Romance Film']",1940,1
13237979,Push,2009,"['Canada', 'United States of America']","['Action', 'Science Fiction', 'Thriller']",2000,9
3305261,Phantasm III: Lord of the Dead,1994,['United States of America'],"['Zombie Film', 'Supernatural', 'Horror']",1990,4
2990106,Tarzan's New York Adventure,1942,['United States of America'],"['Black-and-white', 'Adventure', 'Jungle Film']",1940,2
9595369,The Ace of Scotland Yard,1929,['United States of America'],"['Action', 'Black-and-white', 'Crime Fiction', 'Indie', 'Detective', 'Silent film', 'Adventure']",1920,9
25389318,"Hold Me, Thrill Me, Kiss Me",1992,['United States of America'],"['Comedy', 'Satire']",1990,2
1057543,Voyage to the Bottom of the Sea,1961,['United States of America'],"['Action', 'Adventure', 'Doomsday film', 'Disaster', 'Science Fiction', 'Family Film']",1960,1
27773433,The Elder Son,2006,['United States of America'],"['Indie', 'Comedy', 'Drama']",2000,6
6190765,Outside Ozona,1998,['United States of America'],"['Comedy', 'Thriller', 'Romance Film', 'Comedy-drama', 'Drama', 'Ensemble Film']",1990,8
2892393,"Initiation: Silent Night, Deadly Night 4",1990,['United States of America'],['Horror'],1990,0
36354224,Take Me to Town,1953,['United States of America'],"['Western', 'Adventure', 'Comedy film']",1950,3
33231905,China Doll,1958,['United States of America'],"['Romantic drama', 'Romance Film', 'War film', 'Drama']",1950,8
24767455,The Ministers,2009,['United States of America'],"['Crime Fiction', 'Indie', 'Thriller', 'Crime Thriller', 'Drama']",2000,9
4914926,The Secret of the Sword,1985,['United States of America'],"['Action', 'Fantasy Adventure', 'Animation', 'Indie', 'Fantasy', 'Adventure', 'Sword and sorcery films']",1980,5
32098888,Aar Paar,1985,['India'],['Action'],1980,5
4270540,3:10 to Yuma,2007,['United States of America'],"['Action', 'Suspense', 'Crime Fiction', 'Action/Adventure', 'Western', 'Thriller', 'Drama']",2000,7
27215273,Trent's Last Case,1952,['United Kingdom'],['Mystery'],1950,2
62122,Stagecoach,1939,['United States of America'],"['Black-and-white', 'Western', 'Action/Adventure', 'Drama']",1930,9
705984,Magnum Force,1973,['United States of America'],"['Action', 'Crime Fiction', 'Action Thrillers', 'Mystery', 'Action/Adventure', 'Thriller']",1970,3
2421561,Firewall,2006,['United States of America'],"['Psychological thriller', 'Action', 'Action Thrillers', 'Action/Adventure', 'Thriller', 'Crime Thriller']",2000,6
3015054,The Beast Must Die,1974,['United Kingdom'],"['Action', 'Mystery', 'Indie', 'Thriller', 'Crime Thriller', 'Creature Film', 'Horror', 'Supernatural']",1970,4
6686820,"The Phantom from 10,000 Leagues",1955,['United States of America'],"['Black-and-white', 'Monster', 'Indie', 'Creature Film', 'Monster movie', 'Horror', 'B-movie', 'Science Fiction', 'Natural horror films']",1950,5
3641811,Heaven or Vegas,1999,['United States of America'],"['Drama', 'Road movie']",1990,9
24737580,Final Assignment,1980,['Canada'],"['Action', 'Mystery', 'Action/Adventure', 'Thriller', 'Crime Thriller']",1980,0
25487806,Paper Chasers,2004,['United States of America'],"['Music', 'Rockumentary', 'Biography', 'Indie', 'Documentary', 'Hip hop movies', 'Culture & Society', 'Finance & Investing']",2000,4
144813,Song of the Thin Man,1947,['United States of America'],"['Detective fiction', 'Screwball comedy', 'Mystery', 'Comedy', 'Thriller', 'Drama', 'Comedy Thriller', 'Detective']",1940,7
1364397,Tortilla Flat,1942,['United States of America'],"['Romance Film', 'Black-and-white', 'Drama']",1940,2
11218181,Man Pasand,1980,['India'],"['Comedy', 'Drama', 'Family Film']",1980,0
27900724,Yeddi Ogul Isterem,1970,[],['Drama'],1970,0
5832380,The Day of the Triffids,1962,['United Kingdom'],"['Monster', 'Thriller', 'Horror', 'Doomsday film', 'Science Fiction']",1960,2
15131446,A Change of Seasons,1980,['United States of America'],"['Romantic drama', 'Comedy', 'Romance Film', 'Romantic comedy', 'Comedy-drama', 'Drama']",1980,0
545187,Volcano,1997,['United States of America'],"['Action', 'Drama', 'Action/Adventure', 'Thriller', 'Disaster']",1990,7
24495731,La Piscine,1969,"['France', 'Italy']","['Crime Fiction', 'Thriller', 'World cinema', 'Crime Thriller', 'Drama']",1960,9
8215175,Termites of 1938,1938,['United States of America'],"['Black-and-white', 'Short Film', 'Comedy', 'Slapstick']",1930,8
9417884,A Millionaire's First Love,2006,['South Korea'],['Romantic drama'],2000,6
684515,Zapata: El sueño de un héroe,2004,['Mexico'],"['Biographical film', 'War film', 'Drama', 'Fantasy']",2000,4
5420277,The Babysitters,2007,['United States of America'],"['Drama', 'Indie', 'Crime Drama', 'Black comedy', 'Melodrama', 'Juvenile Delinquency Film']",2000,7
8323828,Beyond the Door,1974,"['Italy', 'United States of America']","['Supernatural', 'Horror']",1970,4
13048913,Devon's Ghost: Legend of the Bloody Boy,2005,['United States of America'],"['Action', 'Slasher', 'Teen', 'Horror', 'B-movie']",2000,5
3827883,Memento Mori,1999,['South Korea'],"['LGBT', 'Thriller', 'Horror', 'World cinema', 'Drama', 'Fantasy']",1990,9
28172227,Are Parents People?,1925,['United States of America'],"['Family Drama', 'Satire', 'Silent film', 'Comedy-drama']",1920,5
28080410,Nuvvu Vastavani,2000,['India'],['Family Film'],2000,0
18002340,Pavithram,1994,['India'],"['Drama', 'Comedy']",1990,4
10488711,Mickey One,1965,['United States of America'],"['Black-and-white', 'Drama', 'Crime Fiction', 'Indie', 'Chase Movie', 'Kafkaesque', 'Cult']",1960,5
8512105,The Magic Pipe,1998,['Russia'],['Stop motion'],1990,8
21943134,Baksho Rahashya,1996,['India'],['Adventure'],1990,6
22265112,Yavanika,1982,['India'],"['Mystery', 'Thriller']",1980,2
106335,Ordinary People,1980,['United States of America'],"['Film adaptation', 'Coming of age', 'Family Drama', 'Existentialism', 'Drama']",1980,0
2272969,The Odd Couple II,1998,['United States of America'],"['Buddy film', 'Slapstick', 'Comedy']",1990,8
1260184,Casper Meets Wendy,1998,['United States of America'],"[""Children's Fantasy"", ""Children's/Family"", 'Adventure', 'Family Film']",1990,8
17041345,Princess,2008,['Canada'],"['Teen', 'Romance Film', 'Television movie', 'Drama', 'Family Film', 'Fantasy']",2000,8
9858014,Diez segundos,1949,['Argentina'],['Black-and-white'],1940,9
22645050,"FL 19,99",1998,['Netherlands'],['Comedy'],1990,8
33416420,Deyyam,1996,['India'],['Horror'],1990,6
14667216,The Hands of Orlac,1924,"['Austria', 'Germany']","['Drama', 'Indie', 'Thriller', 'Horror', 'World cinema', 'Silent film']",1920,4
6628336,Tail Sting,2001,['United States of America'],"['Action', 'Action/Adventure', 'Thriller', 'Horror', 'Sci-Fi Horror', 'Natural horror films']",2000,1
13887546,From the Earth to the Moon,1958,['United States of America'],['Science Fiction'],1950,8
25000378,Housewife,1934,['United States of America'],"['Romance Film', 'Drama']",1930,4
7010451,Markova:Comfort Gay,2000,['Philippines'],"['Filipino Movies', 'LGBT', 'World cinema', 'Drama']",2000,0
8600276,A Lizard in a Woman's Skin,1971,['Italy'],"['Psychological thriller', 'Giallo', 'Mystery', 'Thriller', 'Horror', 'World cinema']",1970,1
11567269,Montana Moon,1930,['United States of America'],"['Musical', 'Black-and-white', 'Western', 'Comedy', 'Drama']",1930,0
14557350,Tricky Dicks,1953,['United States of America'],"['Short Film', 'Black-and-white', 'Comedy']",1950,3
22740984,Enter the Void,2009,"['Canada', 'France', 'Germany', 'Italy']","['Surrealism', 'Drama', 'Avant-garde', 'Experimental film', 'Adult', 'Fantasy']",2000,9
11703526,Tyrannosaurus Azteca,2007,['United States of America'],"['Action', 'Fantasy']",2000,7
1357149,The Affair of the Necklace,2001,['United States of America'],"['Romantic drama', 'Historical drama', 'Romance Film', 'Costume drama', 'Drama', 'Period piece', 'Historical fiction', 'Political drama']",2000,1
25614506,Nireekshana,1982,['India'],"['Romance Film', 'Drama']",1980,2
19874156,The Lodger,2009,['United States of America'],"['Mystery', 'Slasher', 'Thriller', 'Crime Thriller']",2000,9
2933910,Wild Orchid,1990,['United States of America'],"['Erotic Drama', 'Romantic drama', 'Indie', 'Adult', 'Romance Film', 'Drama', 'Softcore Porn', 'Erotica']",1990,0
1306698,Island in the Sun,1957,['United States of America'],"['Film adaptation', 'Crime Fiction', 'Political drama', 'Drama']",1950,7
11314595,Shredderman Rules,2007,['United States of America'],"['Comedy', 'Family-Oriented Adventure', ""Children's/Family"", ""Children's""]",2000,7
36057876,Parambarai,1996,['India'],['Drama'],1990,6
32493096,Oolkatal,1979,[],['Musical'],1970,9
1829944,Raincoat,2004,['India'],"['Art film', 'Romantic drama', 'Bollywood', 'World cinema', 'Romance Film', 'Drama']",2000,4
14502344,Matri-Phony,1942,['United States of America'],"['Short Film', 'Black-and-white']",1940,2
25475247,A Map of the World,2000,['United States of America'],"['Prison', 'Family Drama', 'Melodrama', 'Drama', 'Courtroom Drama']",2000,0
2918007,Xiu Xiu: The Sent Down Girl,1998,"['Hong Kong', 'Taiwan', 'United States of America']","['Indie', 'World cinema', 'Chinese Movies', 'Political drama', 'Drama']",1990,8
3783131,A Better Tomorrow 3,1989,['Hong Kong'],"['Action', 'Action/Adventure', 'Thriller', 'World cinema', 'Chinese Movies', 'War film']",1980,9
20070131,No Exit,1962,"['Argentina', 'United States of America']","['Existentialism', 'Drama']",1960,2
1438861,The Thirteenth Floor,1999,"['Germany', 'United States of America']","['Future noir', 'Thriller', 'Crime Thriller', 'Science Fiction']",1990,9
17968290,Pyaar Tune Kya Kiya,2001,['India'],"['Romantic drama', 'Bollywood', 'World cinema', 'Romance Film', 'Drama']",2000,1
2279601,Gaslight,1944,['United States of America'],"['Psychological thriller', 'Suspense', 'Black-and-white', 'Mystery', 'Thriller', 'Film noir', 'Costume drama']",1940,4
33514494,Turbo-Charged Prelude to 2 Fast 2 Furious,2003,[],['Short Film'],2000,3
367616,Pom Poko,1994,['Japan'],"['Fantasy Adventure', 'Animation', 'Comedy', 'Drama', 'Japanese Movies', 'Anime', 'Family Film', 'Fantasy']",1990,4
4764431,Cruel Intentions 3,2004,['United States of America'],"['Psychological thriller', 'Crime Fiction', 'Romantic drama', 'Teen', 'Thriller', 'Romance Film', 'Crime Thriller', 'Drama', 'Erotic thriller', 'Erotica']",2000,4
133550,The Prince of Tides,1991,['United States of America'],"['Film adaptation', 'Romantic drama', 'Romance Film', 'Melodrama', 'Drama']",1990,1
4180684,Witchboard,1986,"['United Kingdom', 'United States of America']","['Supernatural', 'B-movie', 'Horror']",1980,6
6941760,30 Days of Night,2007,['United States of America'],"['Creature Film', 'Thriller', 'Horror']",2000,7
12709909,Descent,2007,['United States of America'],"['Thriller', 'Indie', 'Drama']",2000,7
2187263,Garfield in Paradise,1986,['United States of America'],"['Animation', 'Short Film', 'Comedy']",1980,6
25915982,Sreedharante Onnam Thirumurivu,1987,['India'],"['Comedy', 'Bollywood', 'Romance Film', 'Drama']",1980,7
846654,The Night Porter,1974,['Italy'],"['Erotic Drama', 'Indie', 'Romance Film', 'Erotica', 'Drama']",1970,4
26015405,Athirathram,1984,[],"['Action', 'Drama', 'Crime Fiction', 'Bollywood']",1980,4
28855740,Just One More Time,1974,['United Kingdom'],['Comedy'],1970,4
1863169,Secondhand Lions,2003,['United States of America'],"['Family Drama', 'Comedy', 'Childhood Drama', 'Adventure', 'Drama', 'Period piece', 'Coming of age', 'Comedy-drama', 'Family Film']",2000,3
1582173,Reptilicus,1961,"['Denmark', 'United States of America']","['Creature Film', 'Monster', 'Horror', 'Stop motion', 'Fantasy']",1960,1
3210534,Saw,2003,['Australia'],"['Psychological thriller', 'Indie', 'Short Film', 'Slasher', 'Thriller', 'Horror']",2000,3
886892,Breaker Morant,1980,"['New Zealand', 'Australia']","['British Empire Film', 'Drama', 'Courtroom Drama', 'Anti-war', 'Period piece', 'History', 'Anti-war film', 'War film']",1980,0
10387098,Guest Wife,1945,['United States of America'],"['Comedy', 'Black-and-white']",1940,5
29569873,Maisie Was a Lady,1941,['United States of America'],"['Romance Film', 'Comedy']",1940,1
4144690,Whisky,2004,"['Spain', 'Argentina', 'Germany', 'Uruguay']","['Art film', 'Indie', 'Comedy', 'World cinema', 'Drama', 'Comedy of Errors']",2000,4
2144775,The Man from Laramie,1955,['United States of America'],"['Action/Adventure', 'Western']",1950,5
24218025,Persécution,2009,"['France', 'Germany']","['LGBT', 'Drama', 'World cinema']",2000,9
2895635,Mr. and Mrs. Iyer,2002,"['India', 'United States of America']","['Musical', 'Art film', 'Romantic drama', 'Bollywood', 'World cinema', 'Political drama', 'Drama']",2000,2
25505387,Once in a Lifetime,1994,['United States of America'],"['Film adaptation', 'Romantic drama', 'Romance Film', 'Television movie', 'Drama']",1990,4
187091,Detective Story,1951,['United States of America'],"['Black-and-white', 'Crime Fiction', 'Thriller', 'Film noir', 'Drama']",1950,1
3677015,Where the Wild Things Are,2009,"['Germany', 'United States of America', 'Australia']","['Adventure', ""Children's"", 'Drama', 'Family Film', 'Fantasy']",2000,9
667845,Shaolin Chamber of Death,1976,['Hong Kong'],"['Action', 'Chinese Movies', 'Martial Arts Film']",1970,6
10189385,Mikres Aphrodites,1963,['Greece'],"['Art film', 'Romantic drama', 'World cinema', 'Romance Film', 'Drama']",1960,3
21019986,Rhinoceros,1974,"['United Kingdom', 'United States of America', 'Canada']","['Comedy film', 'Black comedy', 'Fantasy Comedy', 'Drama', 'Fantasy']",1970,4
13137023,Monster Mash,2000,['United States of America'],"['Animation', ""Children's"", 'Comedy']",2000,0
9246760,Everything Will Be OK,2006,['United States of America'],"['Short Film', 'Animation']",2000,6
583758,Cannonball Run II,1984,['United States of America'],"['Action', 'Auto racing', 'Action Comedy', 'Action/Adventure', 'Comedy', 'Road movie', 'Adventure']",1980,4
16814130,Star Runner,2003,"['Hong Kong', 'South Korea']","['Action', 'Action/Adventure', 'Thriller', 'World cinema', 'Romance Film', 'Chinese Movies', 'Martial Arts Film', 'Drama']",2000,3
2363621,"Traci, I Love You",1987,['United States of America'],"['Drama', 'Pornographic movie', 'Romance Film', 'Adult']",1980,7
11217044,Fantaghirò,1991,['Italy'],"['Adventure', 'Family Film']",1990,1
20520879,Shootfighter: Fight to the Death,1993,['United States of America'],"['Action', 'Martial Arts Film']",1990,3
12696164,Rango,1931,['United States of America'],"['Black-and-white', 'Adventure', 'Documentary']",1930,1
21839663,Shuttle,2009,['United States of America'],"['Suspense', 'Thriller', 'Horror', 'Crime Thriller', 'Drama']",2000,9
24981628,When Michael Calls,1972,['United States of America'],"['Psychological thriller', 'Supernatural', 'Thriller']",1970,2
12640611,Casual Sex?,1988,['United States of America'],"['Comedy', 'Erotica', 'Romance Film', 'Romantic comedy', 'Sex comedy']",1980,8
667372,Harry Potter and the Goblet of Fire,2005,"['United Kingdom', 'United States of America']","['Fantasy Adventure', 'Mystery', 'Thriller', ""Children's/Family"", 'Adventure', ""Children's Fantasy"", 'Supernatural', 'Science Fiction', 'Family Film', 'Fantasy']",2000,5
25183068,Naughty or Nice,2006,['United States of America'],['Comedy-drama'],2000,6
20080263,Man in the Sky,1957,['United Kingdom'],"['Thriller', 'Drama']",1950,7
446934,Dirty Rotten Scoundrels,1988,['United States of America'],"['Crime Fiction', 'Comedy', 'Crime Comedy', 'Remake', 'Slapstick']",1980,8
42383,Going My Way,1944,['United States of America'],"['Music', 'Musical', 'Musical Drama', 'Comedy', 'Christian film', 'Religious Film', 'Drama']",1940,4
3286162,"Zorro, The Gay Blade",1981,['United States of America'],"['Adventure Comedy', 'Action', 'LGBT', 'Action/Adventure', 'Comedy', 'Swashbuckler films', 'Slapstick', 'Adventure', 'Parody']",1980,1
2852303,Baghban,2003,['India'],"['Musical', 'Bollywood', 'World cinema', 'Drama']",2000,3
7430662,Hercules and Xena - The Animated Movie: The Battle for Mount Olympus,1998,['United States of America'],"['Animation', 'Adventure', 'Family Film', 'Fantasy']",1990,8
4602705,Young and Dangerous 3,1996,['Hong Kong'],"['Action', 'Action/Adventure', 'World cinema', 'Crime Drama', 'Chinese Movies', 'Martial Arts Film']",1990,6
2063551,The Mouse and His Child,1977,"['Mexico', 'Japan', 'India', 'United States of America']","[""Children's Fantasy"", 'Animation', 'Japanese Movies', ""Children's/Family"", 'Adventure', 'Family Film', 'Fantasy']",1970,7
6141619,Son of Lassie,1945,['United States of America'],"['Family Drama', 'Animal Picture', 'Adventure', 'Drama', 'Family Film']",1940,5
99304,Pearl Harbor,2001,['United States of America'],"['Action', 'Romantic drama', 'Action/Adventure', 'Romance Film', 'Drama', 'Period piece', 'Airplanes and airports', 'War film']",2000,1
6910992,Bella,2007,"['Mexico', 'United States of America']","['Romantic drama', 'Indie', 'Romance Film', 'Drama']",2000,7
21007868,The Beaverskin,1949,['German Democratic Republic'],['Drama'],1940,9
21006714,The Warrior and the Wolf,2009,"['Hong Kong', 'China', 'Japan', 'Singapore', 'United States of America']","['Action', 'Drama', 'Japanese Movies', 'World cinema', 'Chinese Movies']",2000,9
16767019,The Little Foxes,1941,['United States of America'],"['Romance Film', 'Black-and-white', 'Drama']",1940,1
20336234,The Adventure,1974,[],['Black-and-white'],1970,4
19694473,The Man From M.A.R.S.,1922,['United States of America'],"['Silent film', 'Science Fiction']",1920,2
74962,Modern Times,1936,['United States of America'],"['Comedy', 'Satire', 'Silent film', 'Drama', 'Family Film']",1930,6
25830373,Limbo,1972,['United States of America'],['Drama'],1970,2
9935414,The Sperm,2007,['Thailand'],"['Science Fiction', 'Comedy']",2000,7
2594435,8 Women,2002,['France'],"['Musical', 'LGBT', 'Crime Fiction', 'Mystery', 'Comedy', 'Thriller', 'World cinema', 'Black comedy', 'Crime Thriller', 'Drama', 'Comedy of manners', 'Ensemble Film']",2000,2
16676041,Failure of Engineer Garin,1973,['Soviet Union'],['Science Fiction'],1970,3
2676601,Dickie Roberts: Former Child Star,2003,['United States of America'],"['Parody', 'Slapstick', 'Comedy']",2000,3
15112860,Lucky Break,2001,"['United Kingdom', 'Germany']","['Action', 'Prison', 'Action/Adventure', 'Comedy', 'Comedy of manners']",2000,1
11202648,Nine Lives,2002,['United Kingdom'],"['Supernatural', 'Horror']",2000,2
13237020,Backstreet Dreams,1990,['United States of America'],"['Crime Fiction', 'Romantic drama', 'Romance Film', 'Melodrama', 'Crime Thriller', 'Drama']",1990,0
1216093,The Cocoanuts,1929,['United States of America'],"['Musical', 'Black-and-white', 'Screwball comedy', 'Satire', 'Comedy', 'Slapstick', 'Pre-Code', 'Absurdism']",1920,9
4726,Batman,1989,"['United Kingdom', 'United States of America']","['Action', 'Crime Fiction', 'Action/Adventure', 'Thriller', 'Superhero movie', 'Drama']",1980,9
4399897,Across the Universe,2007,['United States of America'],"['Musical', 'Period piece', 'LGBT', 'Romantic drama', 'Romance Film', 'Jukebox musical', 'Drama']",2000,7
17722006,Große Freiheit Nr. 7,1944,['Germany'],"['Musical', 'Drama']",1940,4
455224,Ladyhawke,1985,['United States of America'],"['Fantasy Adventure', 'Romantic fantasy', 'Action/Adventure', 'Costume drama', 'Adventure', 'Fantasy']",1980,5
24785563,Blond Cheat,1938,['United States of America'],"['Romance Film', 'Romantic comedy', 'Comedy']",1930,8
640040,10.5,2004,['United States of America'],"['Action/Adventure', 'Thriller', 'Television movie', 'Natural disaster', 'Disaster', 'Drama']",2000,4
12111866,Essex Boys,2000,['United Kingdom'],"['Action', 'Crime Fiction', 'Action Thrillers', 'Indie', 'Action/Adventure', 'Thriller', 'Crime Thriller']",2000,0
15589712,New Year's Evil,1980,['United States of America'],"['Indie', 'Slasher', 'Horror']",1980,0
1375185,The Raid,1954,['United States of America'],['Drama'],1950,4
4399176,Karuththamma,1994,['India'],['Drama'],1990,4
488556,Dead Heat,1988,['United States of America'],"['Action', 'Action/Adventure', 'Comedy', 'Horror', 'Black comedy', 'Zombie Film', 'Science Fiction']",1980,8
21465561,My Sons,1991,['Japan'],"['Romance Film', 'Japanese Movies', 'Comedy']",1990,1
17578735,An Education,2009,"['United Kingdom', 'United States of America']","['Period piece', 'Film adaptation', 'Coming of age', 'Romantic drama', 'Romance Film', 'Drama']",2000,9
26547644,T-Force,1994,['United States of America'],"['Action', 'Action/Adventure', 'Thriller']",1990,4
4026106,Aaina,1993,['India'],"['Romantic drama', 'World cinema', 'Romance Film', 'Drama']",1990,3
1083614,Samsara,2002,"['India', 'France', 'Germany', 'Italy']","['Romance Film', 'Adventure', 'Drama']",2000,2
3135310,Ulysses' Gaze,1995,"['Albania', 'France', 'Bosnia and Herzegovina', 'Romania', 'Greece', 'Italy', 'Yugoslavia', 'United Kingdom', 'Germany']","['War film', 'World cinema', 'Road movie', 'Political drama', 'Drama']",1990,5
2926597,A City of Sadness,1989,"['United Kingdom', 'Hong Kong', 'Taiwan']","['Drama', 'Chinese Movies', 'War film']",1980,9
70091,Spirited Away,2001,['Japan'],"['Animation', 'Japanese Movies', 'World cinema', 'Adventure', 'Family Film', 'Fantasy']",2000,1
7755496,Cannibal Girls,1973,['Canada'],"['Slasher', 'Comedy', 'Horror Comedy', 'Horror']",1970,3
4566486,Hell Drivers,1957,['United Kingdom'],"['Crime Drama', 'Crime Fiction', 'Drama']",1950,7
26724532,Three Secrets,1950,['United States of America'],['Drama'],1950,0
5375236,Checkered Flag,1990,['United States of America'],"['Action', 'Drama']",1990,0
27550733,Legend of the Wolf,1997,['Hong Kong'],"['Action/Adventure', 'World cinema', 'Chinese Movies', 'Martial Arts Film']",1990,7
689947,Southlander,2003,['United States of America'],"['Indie', 'Comedy', 'Drama']",2000,3
35790655,Putham Pudhu Payanam,1991,['India'],['Drama'],1990,1
27370713,Woman of Desire,1993,['United States of America'],"['Drama', 'Crime Fiction', 'Indie', 'Thriller', 'Erotic thriller', 'Romance Film', 'Crime Thriller']",1990,3
2234324,Beverly Hills Family Robinson,1997,"['United States of America', 'Australia']","['Screwball comedy', 'Comedy', 'Family Film']",1990,7
9922304,The Black Stallion Returns,1983,['United States of America'],"['Film adaptation', 'Family-Oriented Adventure', ""Children's/Family"", 'Adventure', 'Drama', 'Coming of age', 'Animal Picture', 'Family Film']",1980,3
15522092,The Millionaire,1931,['United States of America'],"['Romance Film', 'Black-and-white', 'Comedy']",1930,1
2074089,Dominion: Prequel to the Exorcist,2005,['United States of America'],"['Psychological thriller', 'Horror', 'Supernatural', 'Cult']",2000,5
2055366,Dracula's Daughter,1936,['United States of America'],"['Black-and-white', 'Horror']",1930,6
15075444,Charlie Chan at the Race Track,1936,['United States of America'],"['Detective fiction', 'Black-and-white', 'Crime Fiction', 'Mystery', 'Comedy', 'Thriller', 'Crime Thriller', 'Detective', 'Sports']",1930,6
18393490,Brahmanandam Drama Company,2008,['India'],"['Mystery', 'Comedy', 'Thriller', 'Romance Film']",2000,8
11375095,Robin Hoodwinked,1958,['United States of America'],"['Comedy', ""Children's/Family""]",1950,8
9850876,Winnie the Pooh Discovers the Seasons,1981,['United States of America'],"['Short Film', 'Family Film', 'Computer Animation']",1980,1
11912461,When Good Ghouls Go Bad,2001,"['United States of America', 'Australia']","[""Children's Fantasy"", 'Comedy', 'Black comedy', 'Fantasy']",2000,1
23745400,Watercolors,2008,['United States of America'],"['LGBT', 'Indie', 'Romantic drama', 'Romance Film', 'Drama']",2000,8
11279152,Laughter,1930,['United States of America'],"['Romance Film', 'Romantic comedy', 'Comedy']",1930,0
21997689,Word of Honor,1981,['United States of America'],"['Crime Fiction', 'Thriller', 'Television movie', 'Crime Thriller', 'Drama', 'Courtroom Drama']",1980,1
3715646,F.T.W.,1994,['United States of America'],"['Crime Fiction', 'Romantic drama', 'Crime Drama', 'Romance Film', 'Drama']",1990,4
5150992,When the Cat's Away,1996,['France'],"['Romance Film', 'Comedy']",1990,6
5637822,Lipstick,1976,['United States of America'],"['Psychological thriller', 'Thriller', 'Drama', 'Courtroom Drama']",1970,6
13275999,Young People Fucking,2007,['Canada'],"['Indie', 'Comedy', 'Romantic comedy', 'Sex comedy']",2000,7
2456941,Malaga,1954,['United Kingdom'],"['Crime Fiction', 'Adventure', 'Drama']",1950,4
26667879,Stella Does Tricks,1996,['United Kingdom'],['Drama'],1990,6
3374650,3:10 to Yuma,1957,['United States of America'],"['Action', 'Western', 'Action/Adventure']",1950,7
6838424,Par Où T'es Rentré? On T'a Pas Vu Sortir,1984,['France'],['Comedy'],1980,4
31213331,One Sunday Afternoon,1933,['United States of America'],"['Romance Film', 'Comedy film']",1930,3
4410044,America's Music: The Roots of Country,1996,['United States of America'],['Documentary'],1990,6
10995901,The Money Trap,1965,['United States of America'],"['Crime Fiction', 'Comedy', 'Film noir', 'Crime Thriller', 'Drama']",1960,5
26640523,Diplomatic Courier,1952,['United States of America'],"['Action', 'Spy', 'Action Thrillers', 'Mystery', 'Thriller', 'Drama']",1950,2
766348,Dead Bang,1989,['United States of America'],"['Action', 'Crime Fiction', 'Action Thrillers', 'Action/Adventure', 'Thriller', 'Crime Thriller', 'Drama', 'Suspense']",1980,9
9983290,Black Box,2002,['Argentina'],"['Black-and-white', 'Indie', 'Drama']",2000,2
13131253,The Case of the Howling Dog,1934,['United States of America'],"['Detective fiction', 'Black-and-white', 'Crime Fiction', 'Mystery', 'Detective', 'Courtroom Drama']",1930,4
11727129,Mandabi,1968,"['France', 'Senegal']","['Parody', 'Satire', 'Comedy', 'World cinema', 'Drama']",1960,8
352455,City Slickers,1991,['United States of America'],"['Action', 'Adventure Comedy', 'Action/Adventure', 'Comedy', 'Buddy film', 'Adventure', 'Drama', 'Comedy Western', 'Western', 'Comedy-drama']",1990,1
3433026,Tales from Earthsea,2006,['Japan'],"['Fantasy Adventure', 'Animation', 'World cinema', 'Adventure', 'Drama', 'Japanese Movies', 'Coming of age', 'Anime', 'Fantasy']",2000,6
19496914,Senza pietà,1950,['Italy'],"['Black-and-white', 'War film', 'Drama']",1950,0
33096502,Red vs. Blue: Recreation,2009,['United States of America'],"['Action', 'Animation', 'Anime', 'Science Fiction']",2000,9
24864646,The Happy Hooker,1975,['United States of America'],"['Film adaptation', 'Romantic drama', 'Comedy', 'Romance Film', 'Drama']",1970,5
5996232,Khilona,1970,['India'],"['Musical', 'Romantic drama', 'Bollywood', 'World cinema', 'Romance Film', 'Drama']",1970,0
2774060,Trapped,1949,['United States of America'],"['Black-and-white', 'Crime Fiction', 'Mystery', 'Thriller', 'Film noir', 'Crime Thriller', 'Drama']",1940,9
23049004,22 June 1897,1979,['India'],"['Historical drama', 'Drama']",1970,9
19878462,Mag-ingat Ka Sa... Kulam,2008,['Philippines'],"['Filipino Movies', 'Thriller', 'Horror', 'World cinema']",2000,8
21099947,Rusty Knife,1958,['Japan'],"['Action', 'Crime Fiction']",1950,8
18758476,Saas bahu aur Sensex,2008,['India'],"['Media Satire', 'Satire', 'Comedy']",2000,8
19283524,Partner,2008,['India'],"['Drama', 'Comedy']",2000,8
1630493,Godzilla 2000: Millennium,1999,['Japan'],"['Japanese Movies', 'Monster', 'World cinema', 'Science Fiction', 'Cult']",1990,9
26735672,My Mother's Laptop,2008,['India'],['Drama'],2000,8
10776705,Uphaar,1971,['India'],['Bollywood'],1970,1
25803545,Exam,2009,['United Kingdom'],"['Mystery', 'Thriller']",2000,9
19626055,Little Ashes,2009,"['United Kingdom', 'Spain', 'United States of America']","['LGBT', 'Indie', 'Romantic drama', 'Romance Film', 'Docudrama', 'Drama', 'Period piece', 'Gay Themed', 'Gay', 'Gay Interest']",2000,9
6999509,Garden of Heaven,2003,['South Korea'],"['Romantic drama', 'World cinema', 'Romance Film', 'Melodrama', 'Drama']",2000,3
6069135,The Tiger and the Snow,2005,"['Italy', 'United States of America']","['Romantic drama', 'Comedy', 'World cinema', 'Romance Film', 'Drama', 'Romantic comedy', 'Comedy-drama', 'War film']",2000,5
61501,Top Hat,1935,['United States of America'],"['Musical', 'Black-and-white', 'Screwball comedy', 'Comedy', 'Musical comedy', 'Romance Film', 'Romantic comedy']",1930,5
451003,Rabid,1977,['Canada'],"['Indie', 'Thriller', 'Horror', 'Zombie Film', 'Science Fiction']",1970,7
9198608,Dreamship Surprise: Period 1,2004,['Germany'],"['Parody', 'Science Fiction']",2000,4
6764425,Under Two Flags,1936,['United States of America'],"['Foreign legion', 'Black-and-white']",1930,6
4481850,Straightheads,2007,['United Kingdom'],"['Action', 'Crime Fiction', 'Action/Adventure', 'Thriller', 'Road-Horror', 'Drama']",2000,7
15945437,Cannibal Apocalypse,1980,"['Spain', 'Italy']","['Thriller', 'Horror']",1980,0
8681526,Jet Lag,2002,"['United Kingdom', 'France']","['Comedy', 'World cinema', 'Romance Film', 'Romantic comedy']",2000,2
7920068,Fracture,2007,"['Germany', 'United States of America']","['Psychological thriller', 'Crime Fiction', 'Mystery', 'Thriller', 'Crime Thriller', 'Drama', 'Courtroom Drama']",2000,7
12446777,The Cottage,2008,['United Kingdom'],"['Slasher', 'Comedy', 'Horror Comedy', 'Horror', 'Black comedy', 'Crime Thriller']",2000,8
13166062,Wagon Master,1950,['United States of America'],"['Action/Adventure', 'Western']",1950,0
12556054,Traces of Love,2006,['South Korea'],"['Drama', 'Tragedy']",2000,6
23823057,Disgrace,2008,"['South Africa', 'New Zealand', 'Australia']",['Drama'],2000,8
980211,Das Experiment,2001,['Germany'],"['Thriller', 'Drama']",2000,1
4989559,The Dukes of Hazzard: Reunion!,1997,['United States of America'],"['Action', 'Action/Adventure', 'Comedy', 'Television movie']",1990,7
36422681,A Cry in the Night,1956,['United States of America'],"['Crime Fiction', 'Thriller', 'Film noir', 'Drama']",1950,6
5869916,Omega Doom,1997,['United States of America'],"['Action', 'Doomsday film', 'Science Fiction']",1990,7
1052753,Irony of Fate,1975,"['Russia', 'Soviet Union']","['Romantic drama', 'Comedy', 'World cinema', 'Romance Film', 'Romantic comedy', 'Drama']",1970,5
21456144,The Final Test,1953,[],['Drama'],1950,3
2533693,New Dragon Gate Inn,1992,['Hong Kong'],"['Wuxia', 'Chinese Movies', 'Martial Arts Film']",1990,2
13292846,Backstage,1988,"['United States of America', 'Australia']",['Drama'],1980,8
6055271,Wanderer of the Wasteland,1924,['United States of America'],"['Silent film', 'Indie', 'Western']",1920,4
14054342,Bye Bye Braverman,1968,['United States of America'],"['Comedy-drama', 'Comedy', 'Ensemble Film']",1960,8
5316735,Dr. Mabuse the Gambler,1922,"['Weimar Republic', 'Germany']","['Black-and-white', 'Crime Fiction', 'Mystery', 'Indie', 'Thriller', 'Silent film']",1920,2
21385847,Before You Say I Do,2009,['United States of America'],"['Romantic fantasy', 'Comedy', 'Romance Film', 'Romantic comedy', 'Television movie', 'Comedy-drama']",2000,9
2833942,Reach for Glory,1963,['United Kingdom'],"['LGBT', 'Crime Fiction', 'Black-and-white', 'War film', 'Drama']",1960,3
5292439,Gog,1954,['United States of America'],"['Detective fiction', 'Mystery', 'Thriller', 'Detective', 'Crime Thriller', 'Science Fiction']",1950,4
79848,Bachelor Mother,1939,['United States of America'],"['Comedy', 'Black-and-white']",1930,9
16967207,Sport Goofy in Soccermania,1986,['United States of America'],"['Animation', 'Mockumentary', 'Short Film', 'Comedy', 'Sports', 'Family Film']",1980,6
6214427,Charlotte's Web 2: Wilbur's Great Adventure,2003,['United States of America'],"['Music', ""Children's Fantasy"", 'Animation', ""Children's"", ""Children's/Family"", 'Adventure', 'Family Film']",2000,3
3894411,A Good Year,2006,"['United Kingdom', 'United States of America']","['Film adaptation', 'Romantic drama', 'Comedy', 'Romance Film', 'Drama', 'Romantic comedy', 'Comedy-drama', 'Comedy of manners', 'Slice of life story']",2000,6
19793512,Falling for a Dancer,1998,['United Kingdom'],"['Period piece', 'Romantic drama', 'Romance Film', 'Drama']",1990,8
24570734,The Denial,1925,['United States of America'],['Silent film'],1920,5
13931147,Insanitarium,2008,['United States of America'],"['Creature Film', 'Slasher', 'Horror']",2000,8
4744487,Kiltro,2006,['Chile'],"['Action', 'Action/Adventure', 'Thriller', 'World cinema', 'Martial Arts Film']",2000,6
23142490,Legacy,2008,['United States of America'],"['Crime Fiction', 'Comedy-drama', 'Comedy']",2000,8
2881415,They Drive by Night,1940,['United States of America'],"['Black-and-white', 'Crime Fiction', 'Film noir', 'Drama']",1940,0
11244593,Alvin and the Chipmunks,2007,['United States of America'],"['Music', 'Musical', 'Comedy', ""Children's/Family"", ""Children's"", 'Drama', 'Computer Animation', 'Family Film']",2000,7
32014207,Ek Nadir Galpo,2008,['India'],['Drama'],2000,8
11477710,The Heirloom,2005,"['China', 'Taiwan']","['Psychological thriller', 'Chinese Movies', 'Horror', 'World cinema']",2000,5
19104743,The Turning Point,1982,['German Democratic Republic'],['Drama'],1980,2
19853830,Retour de manivelle,1957,"['France', 'Italy']","['Crime Fiction', 'Thriller', 'Crime Thriller', 'Drama']",1950,7
171011,Reversal of Fortune,1990,"['United Kingdom', 'Japan', 'United States of America']","['Mystery', 'Japanese Movies', 'Thriller', 'Drama', 'Courtroom Drama']",1990,0
21303335,Palayathu Amman,2000,['India'],['Religious Film'],2000,0
24250799,The Cat Piano,2009,['Australia'],"['Music', 'Animation', 'Mystery', 'Short Film', 'Thriller', 'Fantasy']",2000,9
12050171,Evadi Gola Vaadidi,2004,['India'],"['Musical', 'Romantic drama', 'Comedy', 'Bollywood', 'World cinema', 'Romance Film', 'Drama']",2000,4
1056686,Cat People,1942,['United States of America'],"['Black-and-white', 'Thriller', 'Horror', 'Film noir', 'Romance Film']",1940,2
666762,Runaway Brain,1995,['United States of America'],"['Animation', 'Short Film', 'Thriller', 'Comedy film', 'Science Fiction', 'Family Film']",1990,5
12058465,Tom & Thomas,2002,"['United Kingdom', 'Netherlands']","['Family Drama', 'Adventure', 'Drama', 'Family Film']",2000,2
11412224,Zombie Strippers,2008,['United States of America'],"['Horror Comedy', 'Comedy', 'Horror', 'Black comedy', 'B-movie', 'Zombie Film', 'Cult']",2000,8
12467910,Corn,2002,['United States of America'],"['Mystery', 'Indie', 'Thriller', 'Drama']",2000,2
20239110,My Wife Got Married,2008,['South Korea'],"['Romance Film', 'Romantic comedy']",2000,8
2929705,Screwed,2000,['United States of America'],"['Action', 'Crime Fiction', 'Screwball comedy', 'Action/Adventure', 'Buddy film', 'Comedy']",2000,0
6124288,Dragon Tiger Gate,2006,['Hong Kong'],"['Action', 'Action Thrillers', 'Action/Adventure', 'Thriller', 'World cinema', 'Chinese Movies', 'Martial Arts Film', 'Wuxia', 'Superhero movie']",2000,6
9505271,Finian's Rainbow,1968,"['Ireland', 'United States of America']","['Musical', 'Satire', 'Comedy', 'Musical comedy', 'Drama', 'Family Film', 'Fantasy']",1960,8
2843380,The President's Last Bang,2005,['South Korea'],"['Political cinema', 'Political satire', 'Satire', 'Comedy', 'World cinema', 'Black comedy']",2000,5
8414299,The Attic,2006,['United States of America'],"['Thriller', 'Horror']",2000,6
35896860,Pacar Ketinggalan Kereta,1989,['Indonesia'],[],1980,9
14244443,"Healthy, Wealthy and Dumb",1938,['United States of America'],"['Black-and-white', 'Short Film', 'Comedy', 'Slapstick', 'Absurdism']",1930,8
16364045,Yash,1996,['India'],['Musical'],1990,6
1675523,A Man Apart,2003,"['Germany', 'United States of America']","['Action', 'Crime Fiction', 'Action Thrillers', 'Action/Adventure', 'Thriller', 'Crime Thriller', 'Drama']",2000,3
4347027,[[Caltiki - Il mostro immortale]],1959,['Italy'],['Horror'],1950,9
4512765,Shakedown: Return of the Sontarans,1994,['United Kingdom'],['Science Fiction'],1990,4
6184362,Song of the West,1930,['United States of America'],"['Musical', 'Western', 'Pre-Code']",1930,0
26987591,Jayasimha,1955,['India'],['Drama'],1950,5
8691806,The Flapper,1920,['United States of America'],"['Black-and-white', 'Indie', 'Comedy', 'Silent film']",1920,0
29880089,Curse of the Undead,1959,['United States of America'],"['Horror', 'Western']",1950,9
7027409,NANA 2,2006,['Japan'],"['Japanese Movies', 'World cinema', 'Romantic comedy', 'Drama']",2000,6
9376918,Dream Wife,1953,['United States of America'],"['Romance Film', 'Romantic comedy', 'Comedy']",1950,3
1569634,Save the Last Dance,2001,['United States of America'],"['Music', 'Romantic drama', 'Musical Drama', 'Teen', 'Dance', 'Romance Film', 'Drama']",2000,1
16275086,Paathshaala,2009,['India'],"['Drama', 'World cinema']",2000,9
2621073,Willie Dynamite,1974,['United States of America'],"['Action', 'Blaxploitation', 'Crime Fiction', 'Action/Adventure', 'Biopic [feature]', 'Drama']",1970,4
6781437,The Patsy,1964,['United States of America'],['Comedy'],1960,4
20002742,Palm Springs Weekend,1963,['United States of America'],"['Comedy', 'Romance Film', 'Romantic comedy', 'Drama']",1960,3
9441132,Outlaw,2007,['United Kingdom'],"['Action', 'Drama', 'Crime Fiction', 'Action/Adventure', 'Thriller']",2000,7
65669,A Knight's Tale,2001,['United States of America'],"['Action', 'Costume Adventure', 'Action/Adventure', 'Comedy', 'Adventure', 'Drama', 'Period piece', 'Romantic comedy']",2000,1
21836707,The Keeper,2009,['United States of America'],"['Action', 'Crime Fiction', 'Action/Adventure', 'Thriller']",2000,9
27409433,Good Neighbor,2001,['United States of America'],['Thriller'],2000,1
26730444,Romeoo,2007,['India'],"['Musical', 'Comedy', 'Bollywood', 'World cinema']",2000,7
20981824,Like a Dragon,2007,['Japan'],"['Action', 'Crime Fiction', 'Action Thrillers', 'Japanese Movies', 'Comedy']",2000,7
21509421,Immediate Family,1989,['United States of America'],"['Family Drama', 'Drama']",1980,9
32809045,Strong Is the Seed,1949,['Australia'],['Drama'],1940,9
8729494,The Triple Echo,1972,"['United Kingdom', 'United States of America']",['Drama'],1970,2
7506680,Poor Little Rich Girl: The Barbara Hutton Story,1987,['United States of America'],"['Drama', 'Biographical film', 'Biopic [feature]']",1980,7
1769325,Doctor in the House,1954,['United Kingdom'],"['Film adaptation', 'Parody', 'Comedy', 'Drama']",1950,4
1042309,Cellular,2004,['United States of America'],"['Action', 'Action/Adventure', 'Thriller', 'Crime Thriller']",2000,4
28790520,30 Days,1999,['United States of America'],"['Romance Film', 'Indie', 'Comedy']",1990,9
17382714,Knight-mare Hare,1955,['United States of America'],"['Animation', 'Short Film', 'Family Film']",1950,5
142421,Babe,1995,"['United States of America', 'Australia']","['Comedy', 'Comedy-drama', 'Adventure', 'Drama', 'Family Film', 'Fantasy']",1990,5
7307622,Captain Valedor,2006,['United States of America'],"['Short Film', 'Comedy film', 'Science Fiction', 'Drama']",2000,6
596119,The Whales of August,1987,['United States of America'],"['Drama', 'Family Drama', 'Indie', 'Biography']",1980,7
3775827,Disco Dancer,1982,['India'],"['Musical', 'Bollywood', 'World cinema', 'Drama']",1980,2
25526318,Blood Mania,1970,['United States of America'],"['Horror', 'B-movie']",1970,0
2367208,Just like Heaven,2005,['United States of America'],"['Comedy', 'Romance Film', 'Romantic comedy', 'Fantasy']",2000,5
20130701,First Squad,2009,"['Russia', 'Canada', 'Japan']","['Animation', 'World cinema', 'Drama', 'History', 'Japanese Movies', 'Anime', 'War film', 'Science Fiction', 'Fantasy']",2000,9
142453,The Full Monty,1997,['United Kingdom'],"['LGBT', 'Indie', 'Buddy film', 'Comedy', 'Dance', 'Comedy-drama', 'Ensemble Film']",1990,7
21509689,Black Belly of the Tarantula,1971,['Italy'],"['Thriller', 'Horror', 'World cinema', 'Crime Thriller']",1970,1
6811552,Nightmare in the Sun,1965,['United States of America'],"['Drama', 'Crime Fiction']",1960,5
24957657,Pisau Cukur,2009,['Malaysia'],['Comedy film'],2000,9
21407170,The Kid Stakes,1927,['Australia'],"['Black-and-white', 'Silent film', 'Drama', 'Family Film']",1920,7
4406314,Hansel and Gretel,2002,['United States of America'],['Family Film'],2000,2
543162,Boys Don't Cry,1999,['United States of America'],"['Gay Themed', 'Crime Fiction', 'Gay', 'Gay Interest', 'Romance Film', 'Docudrama', 'Drama']",1990,9
22950949,Barbie and the Three Musketeers,2009,['United States of America'],"['Animation', 'Family-Oriented Adventure', ""Children's/Family"", 'Adventure', 'Family Film']",2000,9
26079077,Unnikrishnante Adyathe Christmas,1989,['India'],['Drama'],1980,9
8770314,Naajayaz,1995,['India'],"['Bollywood', 'World cinema']",1990,5
11650500,First Love,1977,['United States of America'],"['Coming of age', 'Romantic drama', 'Romance Film', 'Drama']",1970,7
21429084,Evil Cat,1986,['Hong Kong'],"['Chinese Movies', 'World cinema', 'Horror']",1980,6
2944850,Dragon Ball: Mystical Adventure,1988,['Japan'],"['Action', 'Animation', 'World cinema', ""Children's"", 'Japanese Movies', 'Anime', 'Science Fiction', 'Fantasy']",1980,8
74942,Meet Me in St. Louis,1944,['United States of America'],"['Musical', 'Family Drama', 'Romance Film', 'Americana']",1940,4
7777717,Whipped,2000,['United States of America'],"['Indie', 'Comedy', 'Black comedy', 'Romantic comedy', 'Romance Film']",2000,0
1488066,Lolita,1962,"['United Kingdom', 'United States of America']","['Film adaptation', 'Black-and-white', 'Romantic drama', 'Satire', 'Comedy', 'Black comedy', 'Romance Film', 'Drama', 'Comedy-drama']",1960,2
3826817,Far Cry,2008,"['Germany', 'Canada', 'Netherlands']","['Action', 'Action/Adventure', 'Thriller', 'Horror', 'World cinema', 'Science Fiction']",2000,8
508985,Afterglow,1997,['United States of America'],"['Romance Film', 'Indie', 'Comedy']",1990,7
2020187,Common Law Cabin,1967,['United States of America'],"['Melodrama', 'Drama']",1960,7
6787518,The Black Knight,1954,"['United Kingdom', 'United States of America']","['Action', 'Costume drama', 'Adventure']",1950,4
5890489,Camera Buff,1989,['Poland'],"['Political satire', 'Satire', 'Comedy', 'World cinema', 'Drama', 'Political cinema', 'Parody', 'Political drama']",1980,9
5374848,Komodo vs. Cobra,2005,['United States of America'],"['Creature Film', 'Monster', 'Horror', 'Science Fiction']",2000,5
4525665,The Student Prince in Old Heidelberg,1927,['United States of America'],"['Black-and-white', 'Indie', 'Comedy', 'Romance Film', 'Drama', 'Silent film', 'Romantic comedy', 'Melodrama', 'Comedy-drama']",1920,7
2761187,The Prophecy 3: The Ascent,2000,['United States of America'],"['Cult', 'Horror']",2000,0
25827961,Break Through!,2004,['Japan'],"['Action', 'Drama', 'Japanese Movies', 'Comedy', 'Romance Film']",2000,4
10640901,Guru Sishyan,1988,['India'],[],1980,8
13863765,Osmanlı Kartalı,1969,['Turkey'],"['War film', 'Drama']",1960,9
12527314,Feather Dusted,1955,['United States of America'],"['Animation', 'Comedy', 'Family Film']",1950,5
2839410,Cannibal Ferox,1981,['Italy'],"['Jungle Film', 'Horror']",1980,1
10010910,Skin,1995,['United Kingdom'],['Short Film'],1990,5
25366879,The Red Detachment of Women,1970,['China'],"['World cinema', 'Chinese Movies', 'War film', 'Drama']",1970,0
14725310,Letters from Iwo Jima,2006,"['Japan', 'United States of America']","['Action', 'Combat Films', 'World cinema', 'Drama', 'Anti-war', 'History', 'Japanese Movies', 'Anti-war film', 'War film']",2000,6
2652478,The Plank,1967,['United Kingdom'],['Comedy'],1960,7
5082101,Horrors of the Black Museum,1959,['United Kingdom'],"['Psychological thriller', 'Slasher', 'Horror']",1950,9
17941295,Night School,1981,['United States of America'],"['Slasher', 'Horror']",1980,1
851285,Looney Tunes: Back in Action,2003,['United States of America'],"['Adventure Comedy', 'Animated cartoon', 'Animation', 'Slapstick', 'Comedy', 'Family Film', 'Adventure']",2000,3
7306005,L'étoile du nord,1982,['France'],"['Crime Drama', 'Drama']",1980,2
9970689,Rules of Dating,2005,['South Korea'],"['Romance Film', 'Comedy']",2000,5
15662990,Nam Naadu,2007,['India'],"['Action', 'Drama', 'Crime Fiction', 'Mystery', 'Thriller']",2000,7
5020192,An Evening in Paris,1967,['India'],"['Action', 'Musical', 'Thriller', 'World cinema']",1960,7
2268630,The Missouri Breaks,1976,['United States of America'],"['Western', 'Revisionist Western', 'Action/Adventure']",1970,6
17599713,The Italian Straw Hat,1928,"['France', 'Germany']","['Silent film', 'Black-and-white', 'Comedy']",1920,8
29079479,Take Aim,1975,['Soviet Union'],[],1970,5
15705596,Aas Paas,1981,['India'],"['Romantic drama', 'World cinema', 'Romance Film', 'Drama']",1980,1
1494750,The Crucible,1996,['United States of America'],"['Period piece', 'Courtroom Drama', 'Film adaptation', 'Historical fiction', 'Epic', 'Drama']",1990,6
30448760,5 Against the House,1955,['United States of America'],"['Heist', 'Crime Fiction', 'Thriller', 'Film noir', 'Drama']",1950,5
28115273,The Stranger In Between,1952,['United Kingdom'],['Buddy film'],1950,2
33548173,The Sea Ghost,1931,['United States of America'],"['War film', 'Drama']",1930,1
4527276,Fight for Life,1987,['United States of America'],"['Television movie', 'Docudrama', 'Drama']",1980,7
7604698,The Good Die Young,1954,['United Kingdom'],"['Black-and-white', 'Crime Fiction', 'Mystery', 'Thriller']",1950,4
103021,Midnight Express,1978,"['United Kingdom', 'United States of America']","['Prison', 'LGBT', 'Crime Fiction', 'Indie', 'Biographical film', 'Thriller', 'Escape Film', 'Adventure', 'Drama', 'Biopic [feature]']",1970,8
703970,Anaconda,1997,"['Brazil', 'Peru', 'United States of America']","['Action', 'Action/Adventure', 'Thriller', 'Horror', 'Adventure', 'Natural horror films']",1990,7
9547806,Toby Tyler,1960,['United States of America'],"['Action', 'Family Drama', 'Childhood Drama', ""Children's/Family"", 'Adventure', 'Drama', 'Animal Picture', 'Family Film']",1960,0
31952713,The Strip,1951,['United States of America'],"['Music', 'Film noir', 'Drama']",1950,1
16262738,Pink Ice,1965,[],"['Short Film', 'Animation']",1960,5
25808637,Trifling Women,1922,['United States of America'],"['Silent film', 'Romance Film']",1920,2
14143964,Hop Harrigan,1946,['United States of America'],"['Adventure', 'Black-and-white']",1940,6
8412164,Guantanamera,1994,['Cuba'],"['Romantic drama', 'Comedy', 'World cinema', 'Romance Film', 'Romantic comedy', 'Drama']",1990,4
1328239,Flirting Scholar,1993,['Hong Kong'],"['Romantic drama', 'Comedy', 'World cinema', 'Romance Film', 'Chinese Movies', 'Martial Arts Film', 'Drama', 'Romantic comedy']",1990,3
1456329,An American Tail: Fievel Goes West,1991,['United States of America'],"['Music', 'Animation', 'Comedy', 'Family-Oriented Adventure', ""Children's/Family"", ""Children's"", 'Adventure', ""Children's Fantasy"", 'Family Film']",1990,1
10156421,Visas and Virtue,1997,['United States of America'],"['Short Film', 'Biographical film', 'Drama']",1990,7
28888446,One Man Show,2001,['India'],"['Drama', 'Comedy film']",2000,1
1094787,Cat City,1986,['Hungary'],"['Action', 'Animation', 'Parody', 'Action/Adventure', 'Comedy', 'World cinema']",1980,6
205400,Jubilee,1977,['United Kingdom'],"['Time travel', 'Indie', 'Experimental film', 'Punk rock', 'Fantasy']",1970,7
26810356,Kurukkante Kalyanam,1982,['India'],"['Drama', 'Comedy']",1980,2
21340893,The Substitute 4: Failure Is Not An Option,2001,['United States of America'],"['Action', 'Crime Fiction', 'Action Thrillers', 'Action/Adventure', 'Thriller', 'Crime Thriller']",2000,1
3440849,The Best of Times,1986,['United States of America'],"['Sports', 'Comedy']",1980,6
12411647,Love Sick,2006,"['Romania', 'France']","['LGBT', 'Drama']",2000,6
3303413,Awake,2007,['United States of America'],"['Psychological thriller', 'Drama', 'Thriller']",2000,7
18912832,Over 21,1945,['United States of America'],"['Black-and-white', 'War film', 'Comedy']",1940,5
11611500,Bury My Heart at Wounded Knee,2007,['United States of America'],"['Film adaptation', 'Drama', 'Period piece', 'History', 'Western', 'Historical Epic', 'Television movie', 'Historical fiction', 'Political drama']",2000,7
29128744,The Temptation of Barbizon,1946,['France'],['Romance Film'],1940,6
6139424,China Gate,1957,['United States of America'],"['Action', 'Action/Adventure', 'Thriller', 'War film']",1950,7
775421,Berserker,1987,['United States of America'],"['Slasher', 'Horror']",1980,7
10668307,Necromancy,1972,['United States of America'],"['Supernatural', 'Horror']",1970,2
4164806,Bangaram,2006,['India'],"['Action', 'Tollywood']",2000,6
5221499,Chilbeontong sosageon,1936,['Korea'],['Action'],1930,6
2962736,Formosa,2005,['United States of America'],['Comedy'],2000,5
4908814,Evil Under the Sun,1982,['United Kingdom'],"['Suspense', 'Crime Fiction', 'Mystery', 'Thriller', 'Crime Thriller', 'Drama']",1980,2
8388013,The Monkey's Mask,2000,"['Canada', 'Japan', 'Australia', 'France', 'Italy']","['Detective fiction', 'Crime Fiction', 'Mystery', 'Thriller', 'Drama', 'Gay Themed', 'Gay', 'Japanese Movies', 'Gay Interest', 'Detective']",2000,0
5673005,Lone Wolf and Cub: White Heaven in Hell,1974,['Japan'],"['Japanese Movies', 'Action/Adventure', 'World cinema', 'Martial Arts Film']",1970,4
736200,Multiplicity,1996,['United States of America'],"['Comedy', 'Romance Film', 'Romantic comedy', 'Domestic Comedy', 'Science Fiction', 'Fantasy']",1990,6
10749850,L'Innocente,1976,['Italy'],"['Art film', 'Drama', 'World cinema']",1970,6
6393703,Man In The Mirror: The Michael Jackson Story,2004,['United States of America'],"['Musical', 'Biography', 'Biographical film', 'Biopic [feature]', 'Television movie', 'Drama']",2000,4
23322195,The Men Who Stare at Goats,2009,"['United Kingdom', 'United States of America']","['Film adaptation', 'Political cinema', 'Political satire', 'Parody', 'Comedy', 'War film']",2000,9
6632229,Submarine command,1951,['United States of America'],"['Combat Films', 'Action', 'Drama', 'Action/Adventure', 'War film']",1950,1
15565499,Black River,2001,['United States of America'],"['Mystery', 'Science Fiction']",2000,1
76634,The Wind,1928,['United States of America'],"['Black-and-white', 'Drama', 'Indie', 'Silent film']",1920,8
19392462,Andha Naal,1954,['India'],"['Drama', 'Thriller', 'World cinema']",1950,4
982874,The Hitchhiker's Guide to the Galaxy,2005,"['United Kingdom', 'United States of America']","['Science Fiction', 'Comedy', 'Adventure']",2000,5
11681107,Sisters,2001,['Russia'],"['Action', 'Drama', 'Crime Fiction', 'Gangster Film', 'Thriller']",2000,1
15908338,Ab Tak Chhappan,2004,['India'],"['Musical', 'Crime Fiction', 'Gangster Film', 'Action/Adventure', 'Bollywood', 'World cinema', 'Drama']",2000,4
4180595,Happy Birthday to Me,1981,['Canada'],"['Indie', 'Slasher', 'Teen', 'Horror']",1980,1
11921473,XXY,2007,"['Argentina', 'Spain', 'France']","['Gay Themed', 'LGBT', 'Gay', 'Coming of age', 'Gay Interest', 'World cinema', 'Drama']",2000,7
7690409,Faerie Tale Theatre: Goldilocks and the Three Bears,1983,[],"['Fairy tale', ""Children's Fantasy"", ""Children's/Family"", 'Fantasy']",1980,3
34164539,Mahaanta: The Film,1997,['India'],"['Action', 'Drama', 'Crime Fiction', 'Romance Film']",1990,7
649120,Cutthroat Island,1995,"['France', 'Germany', 'Italy', 'United States of America']","['Costume Adventure', 'Action/Adventure', 'Adventure', 'Costume drama', 'Swashbuckler films']",1990,5
19138595,Final Yamato,1983,['Japan'],"['Action', 'Animation', 'Japanese Movies', 'Anime', 'Science Fiction']",1980,3
8573314,Playing the Victim,2006,['Russia'],"['Black comedy', 'World cinema']",2000,6
23784006,MASH,1970,['United States of America'],"['Political cinema', 'Parody', 'Comedy', 'New Hollywood', 'Black comedy', 'War film']",1970,0
26862467,Lucky Man,1995,['India'],"['Comedy film', 'Drama', 'Family Film', 'Fantasy']",1990,5
27606552,Beyond the Law,1968,"['West Germany', 'Monaco', 'Italy']",['Spaghetti Western'],1960,8
24564800,Strangers Kiss,1983,[],['Drama'],1980,3
634114,"Mr. Death: The Rise and Fall of Fred A. Leuchter, Jr.",1999,['United States of America'],"['Law & Crime', 'Crime Fiction', 'History', 'Biography', 'Documentary']",1990,9
32842780,Hotel Chelsea,2009,[],['Thriller'],2000,9
1512830,Blue Chips,1994,['United States of America'],"['Sports', 'Drama']",1990,4
2222699,Rush Hour 3,2007,"['France', 'Germany', 'United States of America']","['Action', 'Crime Fiction', 'Action/Adventure', 'Buddy film', 'Thriller', 'Comedy', 'Martial Arts Film', 'Action Comedy']",2000,7
25930191,Swallow the Sun,2009,[],[],2000,9
4311587,The Curse of the Mummy's Tomb,1964,['United Kingdom'],"['Creature Film', 'Thriller', 'Horror', 'Archaeology', 'Costume Horror']",1960,4
13549802,A Matter of Loaf and Death,2008,['United Kingdom'],"['Animation', 'Short Film', 'Comedy', 'Stop motion', 'Family Film', 'Fantasy']",2000,8
27695067,The Mystery of Mr. X,1934,['United States of America'],"['Psychological thriller', 'Detective fiction', 'Mystery', 'Thriller', 'Detective']",1930,4
26200965,Mr. Hex,1946,['United States of America'],['Comedy'],1940,6
1210684,Queen Bee,1955,['United States of America'],"['Black-and-white', 'Drama']",1950,5
11097321,Shackleton,2002,"['United Kingdom', 'Australia']","['Action/Adventure', 'Adventure', 'Historical fiction', 'Television movie', 'Drama']",2000,2
12801908,Rotation,1949,['Germany'],"['Family Drama', 'Drama', 'World cinema']",1940,9
20948918,Christine,1958,"['France', 'Italy']","['Romance Film', 'Drama']",1950,8
5140171,One Missed Call,2005,['Japan'],"['Japanese Movies', 'Horror', 'World cinema', 'Supernatural']",2000,5
7117484,Meatballs 4,1992,['United States of America'],"['Sports', 'Comedy', 'Teen']",1990,2
3090779,Ivan the Terrible,1944,['Soviet Union'],['Biographical film'],1940,4
5932413,Rhubarb Rhubarb,1980,['United Kingdom'],"['Short Film', 'Comedy']",1980,0
22672205,Enas delikanis,1963,['Greece'],['Comedy'],1960,3
3579131,To Whom Does the World Belong?,1932,"['Switzerland', 'Weimar Republic', 'Germany', 'South Africa']","['Black-and-white', 'Drama']",1930,2
33456604,Daughters of Pharmacist Kim,1963,['South Korea'],"['Drama', 'Family Film']",1960,3
791765,Road,2002,['India'],['Bollywood'],2000,2
2702787,They Won't Believe Me,1947,['United States of America'],"['Black-and-white', 'Crime Fiction', 'Film noir', 'Crime Drama', 'Drama']",1940,7
31301713,Sahara,1995,[],['War film'],1990,5
21328419,Back in the Day,2005,['United States of America'],"['Crime Drama', 'Crime Fiction', 'Drama']",2000,5
1343973,Nevada Smith,1966,['United States of America'],"['Action/Adventure', 'Western']",1960,6
32872881,Waltzing Matilda,1933,['Australia'],['Comedy film'],1930,3
2372920,Riding in Cars with Boys,2001,['United States of America'],"['Comedy', 'Drama', 'Biographical film']",2000,1
14359212,White Bim Black Ear,1977,['Soviet Union'],['Drama'],1970,7
13671238,Legally Blondes,2009,['United States of America'],"['Comedy', 'Teen']",2000,9
10887942,Dead Tone,2007,['United States of America'],"['Slasher', 'Teen', 'Horror']",2000,7
292453,Longshot,2002,['United States of America'],"['Crime Thriller', 'Comedy', 'Teen']",2000,2
23266862,Sons,2006,['Norway'],['Drama'],2000,6
19367800,Street Knight,1993,['United States of America'],"['Action', 'Drama']",1990,3
28252472,"Two Living, One Dead",1961,['Sweden'],['Drama'],1960,1
19592948,Hum Dono,1985,['India'],"['Musical', 'Comedy', 'Romance Film', 'Family Film']",1980,5
30033566,Jeevan Ki Shatranj,1993,['India'],"['Action', 'Crime Fiction', 'Comedy film']",1990,3
22022829,Heir-Conditioned,1955,[],"['Animation', 'Short Film', 'Family Film']",1950,5
9765282,Dreamland,2007,['United States of America'],"['Horror', 'Science Fiction']",2000,7
14863130,The White Sister,1923,['United States of America'],"['Black-and-white', 'Drama', 'Indie', 'Silent film']",1920,3
8062510,Case Closed: Captured in Her Eyes,2000,['Japan'],"['Action', 'Animation', 'Japanese Movies', 'Thriller', 'World cinema', 'Crime Thriller', 'Anime']",2000,0
18119679,Spin the Bottle,2003,['Ireland'],['Comedy'],2000,3
19792885,Zift,2008,['Bulgaria'],"['Crime Fiction', 'Thriller', 'World cinema', 'Crime Thriller', 'Drama']",2000,8
6819266,Mechanic Alludu,1993,['India'],"['Comedy', 'Family Film']",1990,3
14871898,Zen the Movie,2007,['United States of America'],"['Action', 'Martial Arts Film', 'Drama']",2000,7
780873,Phone Booth,2003,['United States of America'],"['Psychological thriller', 'Suspense', 'Crime Fiction', 'Thriller']",2000,3
25496382,Anveshana,1985,['India'],"['Mystery', 'Thriller']",1980,5
8602796,Anupama,1966,['India'],"['Bollywood', 'World cinema', 'Drama', 'Family Film']",1960,6
8219325,Get Smart,2008,['United States of America'],"['Action', 'Parody', 'Action Comedy', 'Action/Adventure', 'Comedy', 'Romantic comedy']",2000,8
9914234,Snow Angels,2008,['United States of America'],"['Film adaptation', 'Drama', 'Indie', 'Family Drama', 'Romantic drama', 'Romance Film', 'Ensemble Film']",2000,8
2134804,Roadhouse 66,1984,['United States of America'],"['Action', 'Crime Fiction', 'Chase Movie', 'Action/Adventure', 'Buddy film', 'Comedy']",1980,4
5125134,Dance of the Dead,2005,[],"['Horror', 'Zombie Film', 'Television movie', 'Cult']",2000,5
163462,Harry and Tonto,1974,['United States of America'],"['Comedy', 'New Hollywood', 'Comedy-drama', 'Road movie', 'Americana', 'Drama']",1970,4
19151240,The Next Hit,2008,['United States of America'],"['Gangster Film', 'Thriller', 'Crime Thriller', 'Hip hop movies']",2000,8
26402297,The Bloody Brood,1959,"['Canada', 'United States of America']","['Detective fiction', 'Crime Fiction', 'Mystery', 'Thriller', 'Crime Thriller', 'Juvenile Delinquency Film', 'Drama', 'Detective', 'Crime Drama']",1950,9
34353767,Kuro Arirang,1989,['South Korea'],['Drama'],1980,9
24030227,To Catch a Spy,1971,"['United Kingdom', 'France', 'United States of America']","['Spy', 'Comedy']",1970,1
7660519,Rocky: The Rebel,2006,['India'],"['Action/Adventure', 'Drama', 'World cinema']",2000,6
2092651,"Rasputin, the Mad Monk",1966,['United Kingdom'],"['Period piece', 'Biography', 'Biopic [feature]', 'Horror', 'Drama']",1960,6
19068826,Morbid: A Love Story,2009,['United States of America'],"['Romance Film', 'Indie', 'Horror']",2000,9
14562213,Kaal,2005,['India'],"['Bollywood', 'Thriller', 'Horror', 'World cinema', 'Supernatural']",2000,5
28103324,Vanjikkottai Valiban,1958,['India'],"['Romance Film', 'Epic']",1950,8
19569381,Cowboy from Brooklyn,1938,['United States of America'],"['Musical', 'Black-and-white', 'Comedy']",1930,8
74862,Lassie Come Home,1943,['United States of America'],"['Family Drama', 'Animal Picture', 'Family-Oriented Adventure', ""Children's/Family"", 'Adventure', 'Drama', 'Family Film']",1940,3
8356657,Naagu,1984,['India'],"['Action', 'Drama', 'Family Film']",1980,4
26369030,The Fire Raisers,1934,['United Kingdom'],['Crime Fiction'],1930,4
13344162,Varannan vecka,2006,['Sweden'],"['Romance Film', 'Comedy', 'Drama']",2000,6
3932174,Wackiki Wabbit,1943,['United States of America'],"['Animation', 'Short Film', 'Comedy', 'Family Film']",1940,3
23146200,Cecilia,1982,['Cuba'],"['Romantic drama', 'World cinema', 'Romance Film', 'Drama']",1980,2
29443845,Paper Man,1971,[],['Drama'],1970,1
11926477,"Crime, Inc.",1945,['United States of America'],"['Action', 'Musical', 'Crime Fiction', 'Thriller', 'Crime Drama', 'Crime Thriller', 'Drama']",1940,5
9006010,Zameer: The Awakening of a Soul,1997,['India'],['Drama'],1990,7
9422274,Unlawful Entry,1992,['United States of America'],"['Psychological thriller', 'Suspense', 'Mystery', 'Thriller', 'Crime Thriller']",1990,2
6608572,Les Bronzés,1978,['France'],"['Adult', 'Comedy film']",1970,8
23881223,Call of the Yukon,1938,['United States of America'],"['Action', 'Black-and-white', 'Action/Adventure', 'Thriller', 'Horror', 'Adventure']",1930,8
32070681,I Am The Law,1938,['United States of America'],"['Drama', 'Crime Fiction']",1930,8
2101749,Steel,1997,['United States of America'],"['Action', 'Crime Fiction', 'Superhero movie', 'Science Fiction']",1990,7
18919313,Carry on Admiral,1957,['United Kingdom'],['Comedy'],1950,7
16668626,Scarecrow Slayer,2003,['United States of America'],"['Slasher', 'B-movie', 'Horror']",2000,3
12006505,The Rich are Always With Us,1932,['United States of America'],"['Romance Film', 'Drama']",1930,2
19583968,The Triumphs of a Man Called Horse,1982,['United States of America'],['Western'],1980,2
10542206,Untraceable,2008,['United States of America'],"['Psychological thriller', 'Suspense', 'Slasher', 'Thriller', 'Crime Thriller', 'Drama']",2000,8
1925631,The Wild Angels,1966,['United States of America'],"['Action', 'Drama', 'Outlaw biker film', 'Biker Film', 'Indie', 'Action/Adventure', 'Road movie']",1960,6
21576291,French Film,2009,['United Kingdom'],"['Indie', 'Comedy', 'Satire', 'Romance Film', 'Romantic comedy']",2000,9
10196144,The Children of Huang Shi,2008,"['China', 'Australia', 'Germany', 'New Zealand']","['Period piece', 'Chinese Movies', 'World cinema', 'Docudrama', 'War film', 'Adventure', 'Drama']",2000,8
4270213,Living & Dying,2006,['United States of America'],"['Action', 'Heist', 'Crime Fiction', 'Caper story', 'Thriller', 'Crime Thriller']",2000,6
14240262,The Sitter Downers,1937,['United States of America'],"['Short Film', 'Black-and-white', 'Comedy']",1930,7
22342771,Pure Shit,1975,['Australia'],['Drama'],1970,5
149748,A Night at the Roxbury,1998,['United States of America'],"['Buddy film', 'Comedy', 'Cult']",1990,8
26367115,Stingray,1978,['United States of America'],"['Action', 'Crime Fiction', 'Comedy']",1970,8
872485,The Apprenticeship of Duddy Kravitz,1974,['Canada'],"['Film adaptation', 'Coming of age', 'Comedy', 'Comedy-drama', 'Tragicomedy', 'Drama']",1970,4
4844617,City Hunter,1993,"['Hong Kong', 'Japan']","['Action', 'Action/Adventure', 'Comedy', 'World cinema', 'Romance Film', 'Chinese Movies', 'Martial Arts Film', 'Japanese Movies']",1990,3
875305,Spider,2002,"['Canada', 'United Kingdom']","['Psychological thriller', 'Mystery', 'Thriller', 'Drama']",2000,2
16881572,Help Me Eros,2008,"['China', 'Taiwan']","['Drama', 'Chinese Movies', 'World cinema']",2000,8
35030671,The Flying Fleet,1929,['United States of America'],"['Romance Film', 'Adventure', 'Drama']",1920,9
25114906,Manna from Heaven,2002,[],"['Family Drama', 'Indie', 'Comedy', 'Ensemble Film']",2000,2
7128210,Fatal Beauty,1987,"['Japan', 'United States of America']","['Action', 'Crime Fiction', 'Action Thrillers', 'Action/Adventure', 'Comedy', 'Thriller', 'Drama', 'Japanese Movies']",1980,7
10564861,Love Stories,1997,['Poland'],"['Romantic drama', 'Comedy', 'World cinema', 'Romance Film', 'Drama']",1990,7
9008173,Mr. Horn,1979,['United States of America'],"['Western', 'Biopic [feature]']",1970,9
2638634,Frankenstein Unbound,1990,['United States of America'],"['Time travel', 'Monster', 'Horror', 'Science Fiction', 'Drama']",1990,0
8012981,Red Road,2006,"['United Kingdom', 'Scotland', 'Denmark']","['Drama', 'Crime Fiction', 'Mystery', 'Indie', 'Thriller', 'Erotica']",2000,6
62084,The Adventures of Robin Hood,1938,['United States of America'],"['Action', 'Action/Adventure', 'Romance Film', 'Costume drama', 'Adventure', 'Drama', 'Swashbuckler films']",1930,8
16804757,Gulabi,1996,['India'],"['Romantic drama', 'World cinema', 'Romance Film', 'Drama']",1990,6
10543058,Doing Time for Patsy Cline,1997,"['New Zealand', 'Australia']","['Drama', 'Indie', 'Comedy', 'Crime Comedy', 'World cinema', 'Road movie']",1990,7
3597588,Cement,1999,['United States of America'],"['Crime Fiction', 'Indie', 'Thriller', 'Crime Thriller', 'Drama']",1990,9
3604814,Donald's Better Self,1938,['United States of America'],"['Animation', 'Short Film', 'Comedy', 'Family Film', 'Fantasy']",1930,8
12213090,Traitor,2008,['United States of America'],"['Action', 'Spy', 'Crime Fiction', 'Action/Adventure', 'Thriller', 'Crime Thriller', 'Drama', 'Suspense']",2000,8
12383140,His Private Secretary,1933,['United States of America'],"['Black-and-white', 'Comedy', 'Romance Film', 'Romantic comedy', 'Drama']",1930,3
12741677,Pin...,1988,['Canada'],"['Psychological thriller', 'Film adaptation', 'Drama', 'Indie', 'Thriller', 'Horror']",1980,8
26306030,Krithyam,2005,['India'],"['Action', 'Thriller']",2000,5
915556,The Maggie,1954,['United Kingdom'],"['Ealing Comedies', 'Comedy']",1950,4
26483188,Aadyathe Kanmani,1995,['India'],"['Drama', 'Comedy film']",1990,5
2646948,Cry Wolf,2005,['United States of America'],"['Slasher', 'Teen', 'Horror', 'Cult']",2000,5
7715240,The Most Dangerous Game,1932,['United States of America'],"['Psychological thriller', 'Black-and-white', 'Mystery', 'Thriller', 'Pre-Code', 'Adventure', 'Suspense', 'Chase Movie', 'Horror']",1930,2
6049256,Critters,1986,['United States of America'],"['Creature Film', 'Horror Comedy', 'Horror', 'Black comedy', 'Alien Film', 'Sci-Fi Horror', 'Science Fiction']",1980,6
5800283,That Championship Season,1982,['United States of America'],"['Sports', 'Drama']",1980,2
11944018,Haseena Maan Jayegi,1968,['India'],"['Romantic drama', 'Action/Adventure', 'World cinema', 'Romance Film', 'Drama']",1960,8
11141934,Varumayin Niram Sigappu,1980,['India'],['Drama'],1980,0
35742073,"Gambling, Gods and LSD",2002,[],['Documentary'],2000,2
10823667,Confessions of a Thug,2006,['United States of America'],"['Musical', 'Crime Fiction', 'Indie', 'Drama']",2000,6
7087854,Case of the Missing Hare,1942,[],"['Animation', 'Short Film', 'Comedy', 'Family Film']",1940,2
10618949,Shaolin Temple,1976,['Hong Kong'],"['Chinese Movies', 'Martial Arts Film']",1970,6
6209219,Covert One: The Hades Factor,2006,['United States of America'],"['Action', 'Action/Adventure', 'Thriller']",2000,6
22653289,Inherit the Wind,1960,['United States of America'],"['Period piece', 'Drama', 'Courtroom Drama']",1960,0
10844342,The Dog House,1952,['United States of America'],"[""Children's/Family""]",1950,2
2763233,"Happy, Texas",1999,['United States of America'],"['LGBT', 'Crime Fiction', 'Indie', 'Comedy', 'Romance Film', 'Romantic comedy', 'Comedy of Errors']",1990,9
22846761,Awaydays,2009,['United Kingdom'],"['Period piece', 'Film adaptation', 'Drama', 'Coming of age', 'Indie', 'Sports', 'Juvenile Delinquency Film']",2000,9
9134018,Shockproof,1949,['United States of America'],"['Film noir', 'Black-and-white', 'Drama']",1940,9
3260698,TMNT,2007,"['Hong Kong', 'United States of America']","['Action', 'Animation', 'Superhero', 'Chinese Movies', 'Martial Arts Film', 'Adventure', 'Computer Animation', 'Superhero movie', 'Fantasy']",2000,7
34299596,Puthiya Sagaptham,1985,['India'],['Drama'],1980,5
28706485,Necromancer,1988,[],['Horror'],1980,8
1353105,Das Testament des Dr. Mabuse,1932,"['Weimar Republic', 'Germany']","['Black-and-white', 'Crime Fiction', 'Art film', 'Thriller', 'World cinema', 'Crime Thriller', 'Master Criminal Films', 'Drama', 'Horror']",1930,2
27836887,Deep in the Valley,2009,['United States of America'],['Comedy'],2000,9
32854822,Wolf Moon,2009,['United States of America'],"['Monster movie', 'Horror']",2000,9
1210913,Pootie Tang,2001,['United States of America'],"['Action', 'Musical', 'Blaxploitation', 'Action/Adventure', 'Comedy', 'Martial Arts Film', 'Action Comedy', 'Parody']",2000,1
1780510,"Live a Little, Love a Little",1968,['United States of America'],"['Musical', 'Comedy', 'Musical comedy', 'Romance Film', 'Romantic comedy', 'Workplace Comedy']",1960,8
25664434,Decalogue VII,1988,['Poland'],['Drama'],1980,8
35018444,Suyamariyadhai,1992,['India'],[],1990,2
7497572,Godfather,1989,['India'],"['Musical', 'Comedy', 'Bollywood', 'Romance Film', 'Drama']",1980,9
277713,The Tuxedo,2002,['United States of America'],"['Action', 'Martial Arts Film', 'Action Comedy', 'Action/Adventure', 'Comedy', 'Science Fiction']",2000,2
31803985,Leela,2002,"['India', 'United States of America']","['Romance Film', 'Romantic drama', 'Drama']",2000,2
32720855,Ramalayam,1971,['India'],['Drama'],1970,1
5125674,Sick Girl,2006,"['Canada', 'United States of America']","['Erotic thriller', 'Horror']",2000,6
10328139,The Brothers Bloom,2008,['United States of America'],"['Action', 'Crime Fiction', 'Indie', 'Action/Adventure', 'Comedy', 'Romance Film', 'Adventure', 'Drama', 'Crime Comedy', 'Romantic comedy']",2000,8
23964220,Pontos,2008,['Australia'],"['Short Film', 'Drama']",2000,8
308930,The Phantom of the Opera,1925,"['England', 'United States of America']","['Silent film', 'Drama', 'Horror']",1920,5
3217,Army of Darkness,1992,['United States of America'],"['Action', 'Action/Adventure', 'Comedy', 'Horror Comedy', 'Black comedy', 'Zombie Film', 'Costume drama', 'Time travel', 'Horror', 'Stop motion', 'Cult', 'Fantasy']",1990,2
14729074,Through the fire,2006,['United States of America'],"['Sports', 'Documentary']",2000,6
30319579,Agnidevan,1995,['India'],"['Musical', 'Drama']",1990,5
31655548,Raja Bakthi,1956,['India'],"['Historical fiction', 'Epic']",1950,6
1136182,The Secret Garden,1993,"['United Kingdom', 'United States of America']","['Coming of age', 'Family Drama', 'Drama', 'Family Film']",1990,3
1743227,Les Misérables,1998,"['United Kingdom', 'Germany', 'United States of America']","['Crime Fiction', 'History', 'Romance Film', 'Christian film', 'Drama']",1990,8
1218494,Atanarjuat,2001,['Canada'],"['Drama', 'Fantasy']",2000,1
20351304,The Gathering,1977,['United States of America'],"['Family Drama', 'Christmas movie', 'Drama', 'Family Film']",1970,7
4390109,Genie Magic,2006,['United States of America'],"['Animation', 'Comedy', ""Children's"", 'Fantasy']",2000,6
5696691,Umrao Jaan,2006,['India'],"['Romantic drama', 'World cinema', 'Romance Film', 'Drama']",2000,6
19421454,Bird of Paradise,1932,['United States of America'],"['Romance Film', 'Black-and-white']",1930,2
3377808,Dandelion,2004,['United States of America'],"['Indie', 'Romantic drama', 'Romance Film', 'Drama', 'Tragedy']",2000,4
12599728,Assault at West Point: The Court-Martial of Johnson Whittaker,1994,['United States of America'],"['Thriller', 'Drama']",1990,4
6030966,Rakhi,2006,['India'],"['Musical', 'Bollywood', 'World cinema', 'Drama']",2000,6
20795248,Mutiny on the Buses,1972,['United Kingdom'],"['Slapstick', 'Comedy']",1970,2
10685691,Man About Dog,2004,"['Ireland', 'United Kingdom']","['Buddy film', 'Comedy']",2000,4
28200672,Paduka Pattabhishekam,1945,['India'],['Drama'],1940,5
7580945,Pammal K. Sambandam,2002,['India'],"['Musical', 'Comedy', 'Bollywood', 'World cinema']",2000,2
7558604,Little Jerusalem,2005,['France'],"['Art film', 'Coming of age', 'World cinema', 'Drama']",2000,5
12161086,Alien Thunder,1974,['Canada'],"['Action', 'Period piece', 'Drama', 'Indie', 'Action/Adventure', 'Western']",1970,4
12178995,Lady Chatterley's Lover,1981,"['United Kingdom', 'France', 'Germany', 'West Germany']","['Film adaptation', 'Erotic Drama', 'Romantic drama', 'Romance Film', 'Erotica', 'Drama']",1980,1
2073069,In Her Shoes,2005,"['Germany', 'United States of America']","['Family Drama', 'Comedy', 'Comedy of manners', 'Romance Film', 'Comedy-drama', 'Drama']",2000,5
1117164,Nobody Knows,2004,['Japan'],"['Japanese Movies', 'Drama', 'World cinema']",2000,4
30539482,Mako: The Jaws of Death,1976,['United States of America'],['Horror'],1970,6
1556567,Prince of Bel Air,1986,['United States of America'],"['Comedy', 'Romance Film', 'Romantic comedy', 'Television movie']",1980,6
31420018,Mimics Parade,1991,[],['Comedy film'],1990,1
1347741,Some Girls Do,1969,['United Kingdom'],"['Action', 'Spy', 'Detective fiction', 'Crime Fiction', 'Mystery', 'Detective', 'Adventure']",1960,9
10824285,Rites of Passage,1999,['United States of America'],"['Psychological thriller', 'LGBT', 'Mystery', 'Family Drama', 'Thriller', 'Crime Thriller', 'Drama', 'Suspense', 'Melodrama', 'Ensemble Film']",1990,9
14683064,Idiots Deluxe,1945,['United States of America'],"['Black-and-white', 'Short Film', 'Comedy', 'Slapstick']",1940,5
3150820,The Ducksters,1950,['United States of America'],"['Animation', 'Short Film', 'Comedy', 'Family Film']",1950,0
20691181,Bluff Master,1963,['India'],['Romance Film'],1960,3
9578547,Games of Love and Chance,2003,['France'],"['Romantic drama', 'World cinema', 'Romance Film', 'Drama']",2000,3
26631229,Bugis Street,1995,"['Hong Kong', 'Singapore', 'China']","['Chinese Movies', 'Drama']",1990,5
2846937,The Legend of the Roller Blade Seven,1992,['United States of America'],['Martial Arts Film'],1990,2
444767,Seabiscuit,2003,['United States of America'],"['Period piece', 'History', 'Sports', 'Drama']",2000,3
31616980,Udhyanapalakan,1996,[],['Romantic drama'],1990,6
1981903,Rififi,1955,['France'],"['Black-and-white', 'Crime Fiction', 'Gangster Film', 'Thriller', 'World cinema', 'Film noir', 'Crime Thriller', 'Drama', 'Heist', 'Caper story']",1950,5
6839059,A Private Function,1984,"['United Kingdom', 'England']","['Parody', 'Satire', 'Comedy']",1980,4
9457642,Man Trouble,1992,['United States of America'],"['Romance Film', 'Romantic comedy', 'Comedy']",1990,2
25411775,A Reasonable Man,1999,"['United States of America', 'South Africa']","['Crime Fiction', 'Mystery', 'Thriller', 'Drama', 'Courtroom Drama']",1990,9
8272260,Four Dogs Playing Poker,2000,['United States of America'],"['Suspense', 'Crime Fiction', 'Mystery', 'Thriller', 'Crime Drama', 'Black comedy', 'Drama']",2000,0
25896538,Easier with Practice,2009,['United States of America'],"['Drama', 'Indie', 'Comedy', 'Romance Film', 'Romantic comedy', 'Comedy-drama']",2000,9
731868,National Lampoon's Last Resort,1994,['United States of America'],"['Gross out', 'Gross-out film', 'Screwball comedy', 'Comedy']",1990,4
61175,The Thin Man,1934,['United States of America'],"['Crime Fiction', 'Mystery', 'Comedy Thriller', 'Comedy', 'Romance Film', 'Drama']",1930,4
2455295,Nô,1998,['Canada'],['Drama'],1990,8
23167491,Center Stage: Turn It Up,2008,"['Canada', 'United States of America']","['Dance', 'Drama']",2000,8
24282078,Tadipaar,1993,['India'],[],1990,3
7950163,Helmiä ja sikoja,2003,['Finland'],['Comedy'],2000,3
15671725,Student Exchange,1987,['United States of America'],"['Comedy', 'Teen']",1980,7
10349642,Throttle,2005,['United States of America'],"['Psychological thriller', 'Action', 'Action Thrillers', 'Action/Adventure', 'Thriller', 'Crime Thriller']",2000,5
22123631,Tres Mujeres en la Hoguera,1976,['Mexico'],['Drama'],1970,6
21116400,Oru Cheru Punchiri,2000,['India'],['Drama'],2000,0
21952011,The Moon and the Stars,2007,"['United Kingdom', 'Hungary', 'Italy']","['Period piece', 'Drama']",2000,7
29585850,Always Leave Them Laughing,1949,['United States of America'],"['Slapstick', 'Comedy-drama']",1940,9
8499752,Close to Leo,2002,['France'],"['LGBT', 'Art film', 'Family Drama', 'World cinema', 'Drama']",2000,2
242528,Frances,1982,['United States of America'],"['Period piece', 'Drama', 'Indie', 'Biographical film', 'Biopic [feature]']",1980,2
20511718,Stuck Like Chuck,2009,['United States of America'],"['Romance Film', 'Comedy']",2000,9
32891767,I Do...I Did,2009,['United States of America'],"['Romance Film', 'Romantic comedy', 'Comedy']",2000,9
7028102,War of the Colossal Beast,1958,['United States of America'],"['Creature Film', 'Science Fiction']",1950,8
6003924,Black Moon Rising,1986,['United States of America'],"['Action', 'Action Thrillers', 'Indie', 'Action/Adventure', 'Thriller', 'Crime Thriller']",1980,6
8227280,Zyzzyx Road,2006,['United States of America'],"['Psychological thriller', 'Suspense', 'Drama', 'Indie', 'Thriller', 'Crime Thriller']",2000,6
35226942,Sundara Pandian,1998,['India'],[],1990,8
18933002,Shrink,2009,['United States of America'],"['Indie', 'Black comedy', 'Comedy-drama', 'Drama']",2000,9
6000210,Gabrielle,2006,"['France', 'Italy']","['Period piece', 'Romantic drama', 'Marriage Drama', 'World cinema', 'Romance Film', 'Drama']",2000,6
15635606,21 Days,1940,['United Kingdom'],"['Black-and-white', 'Romantic drama', 'Romance Film', 'Melodrama', 'Drama']",1940,0
4667507,Danger Beneath the Sea,2001,['United States of America'],"['Action', 'Action Thrillers', 'Action/Adventure', 'Thriller', 'Television movie']",2000,1
2734962,The Other Side of the Bed,2002,['Spain'],"['Musical', 'LGBT', 'Romantic drama', 'Comedy', 'World cinema', 'Musical comedy', 'Romance Film', 'Drama', 'Romantic comedy', 'Sex comedy']",2000,2
25526308,Bad Reputation,2005,['United States of America'],"['Slasher', 'Teen', 'Horror', 'B-movie']",2000,5
339403,The Omega Man,1971,['United States of America'],"['Blaxploitation', 'Film adaptation', 'Action/Adventure', 'Apocalyptic and post-apocalyptic fiction', 'Disaster', 'Drama', 'Doomsday film', 'Dystopia', 'Albino bias', 'Science Fiction', 'Cult']",1970,1
5549065,Sweeney Todd: The Demon Barber of Fleet Street,2007,"['United Kingdom', 'United States of America']","['Musical', 'Crime Fiction', 'Horror', 'Supernatural', 'Drama', 'Tragedy']",2000,7
11143128,Sollathan Ninaikiren,1973,['India'],['Drama'],1970,3
3408082,On Moonlight Bay,1951,['United States of America'],"['Musical', 'Comedy', 'Romance Film', 'Romantic comedy']",1950,1
31946055,Hard Luck Duck,1995,[],['Short Film'],1990,5
992451,After the Sunset,2004,['United States of America'],"['Action', 'Crime Fiction', 'Action/Adventure', 'Comedy', 'Crime Thriller', 'Heist', 'Caper story', 'Crime Comedy']",2000,4
1508787,9 Songs,2004,['United Kingdom'],"['Musical', 'Erotic Drama', 'Romance Film', 'Erotica', 'Drama']",2000,4
30540674,Asthram,1983,[],['Drama'],1980,3
16023028,From the Hip,1987,['United States of America'],"['Courtroom Drama', 'Comedy']",1980,7
195776,Superfly,1972,['United States of America'],"['Action', 'Blaxploitation', 'Crime Fiction', 'Action/Adventure', 'Crime Drama', 'Drama']",1970,2
16141547,The Scoundrel's Wife,2002,['United States of America'],"['Period piece', 'Romantic drama', 'Romance Film', 'Drama']",2000,2
7860927,Danger List,1959,['United Kingdom'],['Short Film'],1950,9
31304298,13 Men and a Gun,1938,[],"['War film', 'Drama']",1930,8
6523148,Vanaja,2006,"['India', 'United States of America']","['Musical', 'Art film', 'World cinema', 'Drama']",2000,6
16187144,Attack,1956,['United States of America'],"['Action', 'Combat Films', 'Black-and-white', 'Action/Adventure', 'War film', 'Drama']",1950,6
62118,Ninotchka,1939,['United States of America'],"['Black-and-white', 'Satire', 'Comedy', 'Romance Film', 'Romantic comedy']",1930,9
9907279,Lost In Oz,2002,"['United States of America', 'Australia']",['Science Fiction'],2000,2
66853,The Conversation,1974,['United States of America'],"['Psychological thriller', 'Suspense', 'Mystery', 'Thriller', 'Drama']",1970,4
307072,Blue Crush,2002,"['Germany', 'United States of America']","['Coming of age', 'Romantic drama', 'Teen', 'Romance Film', 'Sports', 'Drama']",2000,2
13814165,Meet the Spartans,2008,"['Canada', 'United States of America']","['Period piece', 'Parody', 'Comedy', 'Sword and Sandal', 'War film']",2000,8
1934035,Grumpier Old Men,1995,['United States of America'],"['Romantic comedy', 'Buddy film', 'Comedy']",1990,5
7856287,The Midnight Meat Train,2008,['United States of America'],"['Psychological thriller', 'Mystery', 'Slasher', 'Thriller', 'Horror']",2000,8
10703992,Supermarket Woman,1996,['Japan'],['Japanese Movies'],1990,6
30759524,High Flyers,1937,['United States of America'],"['Musical', 'Comedy']",1930,7
34190121,Ninja,2009,[],"['Action', 'Martial Arts Film']",2000,9
11186374,Tum,2004,['India'],"['Romantic drama', 'World cinema', 'Romance Film', 'Drama']",2000,4
14143302,Overland with Kit Carson,1939,['United States of America'],"['Adventure', 'Black-and-white']",1930,9
35908377,No Room for the Groom,1952,['United States of America'],['Comedy'],1950,2
3920826,Flight 93,2006,"['Canada', 'United States of America']","['Psychological thriller', 'Airplanes and airports', 'History', 'Thriller', 'Docudrama', 'War film', 'Drama']",2000,6
36399031,Tasmania Story,1990,['Japan'],[],1990,0
30754247,Pancho Villa,1972,"['United Kingdom', 'Spain']","['Action', 'Animation', 'Western', 'Spaghetti Western']",1970,2
255931,Tampopo,1985,['Japan'],"['Japanese Movies', 'Satire', 'Comedy', 'Comedy of manners', 'World cinema', 'Drama']",1980,5
15946694,Double X: The Name of the Game,1992,['United Kingdom'],['Thriller'],1990,2
2661422,Jaanemann,2006,['India'],"['Musical', 'Romantic drama', 'Bollywood', 'World cinema', 'Romance Film', 'Drama']",2000,6
11625269,Bambai Ka Babu,1960,['India'],"['Romantic drama', 'Thriller', 'World cinema', 'Romance Film', 'Drama']",1960,0
593127,Kal Ho Naa Ho,2007,['India'],"['Musical', 'Family Drama', 'Romantic drama', 'Bollywood', 'World cinema', 'Romance Film', 'Drama', 'Comedy-drama', 'Ensemble Film']",2000,7
10639879,Martial Club,1981,['Hong Kong'],"['Action', 'Action/Adventure', 'World cinema', 'Chinese Movies', 'Martial Arts Film']",1980,1
14810149,The Cracker Factory,1979,['United States of America'],['Drama'],1970,9
5865377,On with the Show,1929,['United States of America'],"['Musical', 'Comedy']",1920,9
16842678,Three Girls About Town,1941,['United States of America'],"['Comedy', 'Black-and-white']",1940,1
29196889,The Garden of Eden,1928,['United States of America'],"['Silent film', 'Drama']",1920,8
20581421,Do Gaz Zameen Ke Neeche,1972,['India'],['Horror'],1970,2
32729135,A Cartoonist's Nightmare,1935,[],"['Animation', 'Short Film', 'Comedy film', 'Family Film']",1930,5
14472670,A Small Domain,1996,['United States of America'],['Short Film'],1990,6
28945997,Man's Castle,1933,['United States of America'],['Romantic drama'],1930,3
6565567,Hester Street,1975,['United States of America'],"['Period piece', 'Romantic drama', 'Romance Film', 'Drama']",1970,5
19286348,Padagotti,1964,[],"['Romance Film', 'Thriller']",1960,4
6744353,Gumnaam,1965,['India'],"['Bollywood', 'Thriller', 'World cinema', 'Drama']",1960,5
14195429,The Seller,1998,['United States of America'],"['Drama', 'Comedy']",1990,8
5604840,They Go Boom,1929,['United States of America'],"['Black-and-white', 'Short Film', 'Comedy', 'Slapstick']",1920,9
492540,Toys,1992,['United States of America'],"['Fantasy', 'Comedy', 'Adventure']",1990,2
1644429,"Masculin, féminin",1966,"['Sweden', 'France']","['Black-and-white', 'World cinema', 'Political drama', 'Drama']",1960,6
12821239,As Luck Would Have It,2002,['France'],"['LGBT', 'Comedy', 'World cinema', 'Drama', 'Comedy of Errors', 'Gay Themed', 'Gay', 'Gay Interest', 'Comedy-drama']",2000,2
24129324,The Gay Deception,1935,['United States of America'],"['Black-and-white', 'Comedy', 'Romance Film', 'Romantic comedy']",1930,5
8273761,Rudolph the Red-Nosed Reindeer and the Island of Misfit Toys,2001,['United States of America'],"['Musical', 'Animation', 'Comedy film', 'Family Film', 'Computer Animation']",2000,1
25714957,Pakshe,1994,['India'],"['Romance Film', 'Drama']",1990,4
18271027,I'll Be Yours,1947,['United States of America'],"['Musical', 'Black-and-white', 'Comedy', 'Musical comedy']",1940,7
3237313,It Happened in Brooklyn,1947,['United States of America'],"['Musical', 'Romance Film', 'Comedy film']",1940,7
23819161,Aladin,2009,['India'],"['Musical', 'Romantic drama', 'Bollywood', 'World cinema', 'Romance Film', 'Drama', 'Family Film']",2000,9
10506917,Jánošík,1921,"['Czechoslovakia', 'United States of America', 'Slovakia']","['Silent film', 'Historical fiction']",1920,1
2926860,Follow the Fleet,1936,['United States of America'],"['Musical', 'Black-and-white', 'Comedy', 'Romance Film', 'Romantic comedy']",1930,6
27484963,Himalay Putra,1997,['India'],"['Romance Film', 'Drama']",1990,7
3995273,Elizabeth I,2005,['United Kingdom'],"['Historical drama', 'Historical Epic', 'Television movie', 'Epic', 'Costume drama']",2000,5
239086,Amarcord,1973,['Italy'],"['Coming of age', 'Comedy', 'World cinema', 'Comedy-drama', 'Ensemble Film']",1970,3
1096949,The Prince and Me,2004,"['Czech Republic', 'United States of America']","['Romantic drama', 'Comedy', 'Teen', 'Romance Film', 'Romantic comedy', 'Drama']",2000,4
12605892,El diputado,1978,['Spain'],"['LGBT', 'Political drama', 'Drama']",1970,8
2807539,Buffalo Soldiers,2001,"['United Kingdom', 'Germany']","['Action', 'Crime Fiction', 'Action/Adventure', 'Comedy', 'Black comedy', 'War film', 'Drama', 'Period piece', 'Political cinema', 'Political drama']",2000,1
8326535,The Borrower,1991,['United States of America'],"['Horror', 'Science Fiction']",1990,1
4326127,Beerfest,2006,"['United States of America', 'Australia']","['Comedy', 'Absurdism']",2000,6
4109723,Alien Autopsy,2006,"['United Kingdom', 'Germany']","['Comedy', 'Media Satire', 'Mockumentary', 'Science Fiction']",2000,6
4196905,The Masque of the Red Death,1964,['United Kingdom'],"['Period piece', 'Film adaptation', 'Costume drama', 'Horror', 'Supernatural', 'Drama', 'Cult']",1960,4
878005,Ong-Bak: Muay Thai Warrior,2003,['Thailand'],"['Action', 'Action/Adventure', 'Thriller', 'World cinema', 'Chinese Movies', 'Martial Arts Film']",2000,3
19746061,Moster fra Mols,1943,['Denmark'],"['Black-and-white', 'Family Film']",1940,3
6143174,Mansfield Park,1999,['United Kingdom'],"['Period piece', 'Film adaptation', 'Romantic drama', 'Romance Film', 'Romantic comedy', 'Costume drama', 'Drama']",1990,9
22783772,Prayanam,2009,['India'],['Romance Film'],2000,9
168561,The Color of Money,1986,['United States of America'],"['Sports', 'Drama']",1980,6
20946348,Thangamani Rengamani,1989,['India'],['Drama'],1980,9
11555729,Tathastu,2006,['India'],"['Drama', 'World cinema']",2000,6
2038261,The Hatchet Man,1932,['United States of America'],"['Black-and-white', 'Mystery', 'Melodrama', 'Drama']",1930,2
22768591,Just Like the Son,2006,['United States of America'],"['Indie', 'Adventure', 'Road movie', ""Children's"", 'Drama']",2000,6
8632979,My Bollywood Bride,2007,"['India', 'United States of America']","['Comedy', 'World cinema', 'Romance Film', 'Romantic comedy', 'Comedy-drama']",2000,7
1712658,Alien Hunter,2003,['United States of America'],"['Action', 'Action/Adventure', 'Science Fiction', 'Thriller', 'Television movie']",2000,3
4881121,Circadian Rhythm,2005,['United States of America'],"['Action', 'Crime Fiction', 'Action Thrillers', 'Mystery', 'Action/Adventure', 'Thriller', 'Martial Arts Film', 'Drama', 'Science Fiction']",2000,5
7339280,Tears,2000,['South Korea'],['Drama'],2000,0
2509881,Critters 3,1991,['United States of America'],"['Creature Film', 'Horror Comedy', 'Horror', 'Black comedy', 'Sci-Fi Horror', 'Science Fiction']",1990,1
42507,In the Bedroom,2001,['United States of America'],"['Psychological thriller', 'Drama', 'Crime Fiction', 'Indie']",2000,1
26666832,Dr. Patient,2009,['India'],"['Drama', 'Comedy']",2000,9
3868207,My Lovely Week,2005,['South Korea'],"['Romance Film', 'Drama', 'Comedy film']",2000,5
14144230,The Great Adventures of Captain Kidd,1953,['United States of America'],"['Adventure', 'Black-and-white']",1950,3
156644,Die Another Day,2002,"['United Kingdom', 'United States of America']","['Action', 'Thriller', 'Glamorized Spy Film', 'Adventure']",2000,2
31229180,Your Cheatin' Heart,1964,['United States of America'],"['Musical', 'Drama', 'Biopic [feature]']",1960,4
32367366,Les Demoniaques,1974,"['France', 'Belgium']","['Horror', 'Adult', 'World cinema']",1970,4
32817768,Captain Thunderbolt,1953,['Australia'],['Adventure'],1950,3
9215002,Bolivia,2001,"['Argentina', 'Netherlands']","['Black-and-white', 'Indie', 'World cinema', 'Drama']",2000,1
12121822,A Christmas Carol,2009,['United States of America'],"['Animation', 'Family Drama', 'Costume drama', 'Adventure', 'Drama', 'Family Film', 'Fantasy']",2000,9
16733391,Une chambre en ville,1982,['France'],"['Musical', 'Comedy-drama', 'Drama', 'Ensemble Film']",1980,2
2918524,Secret Admirer,1985,['United States of America'],"['Indie', 'Comedy', 'Romance Film', 'Romantic comedy']",1980,5
407288,2 Fast 2 Furious,2003,"['Germany', 'United States of America']","['Action', 'Crime Fiction', 'Action Thrillers', 'Action/Adventure', 'Thriller', 'Crime Thriller', 'Sports']",2000,3
19463174,Krishna Cottage,2004,['India'],"['Action/Adventure', 'Thriller', 'World cinema']",2000,4
5870499,Lullaby of Broadway,1951,['United States of America'],"['Musical', 'Comedy', 'Romance Film', 'Romantic comedy']",1950,1
11632165,The Sisters,1938,['United States of America'],['Black-and-white'],1930,8
33412849,The Cry of the Owl,2009,"['Canada', 'United Kingdom', 'France', 'Germany']","['Psychological thriller', 'Suspense', 'Film adaptation', 'Mystery', 'Thriller', 'Crime Thriller', 'Drama']",2000,9
3911312,The Game,1997,['United States of America'],"['Action', 'Psychological thriller', 'Suspense', 'Mystery', 'Thriller', 'Adventure']",1990,7
10140052,Kyo Kii... Main Jhuth Nahin Bolta,2001,['India'],"['Comedy', 'World cinema', 'Drama', 'Fantasy']",2000,1
662329,Sirivennela,1986,['India'],"['Musical', 'Bollywood', 'World cinema', 'Drama']",1980,6
14811189,Executive Protection,2001,['Sweden'],"['Action', 'Detective']",2000,1
36252302,Dhund: The Fog,2003,['India'],"['World cinema', 'Thriller', 'Horror']",2000,3
23844677,"East Side, West Side",1949,['United States of America'],"['Thriller', 'Drama']",1940,9
4268077,Baxter,1989,['France'],"['Satire', 'World cinema', 'Horror', 'Animal Picture', 'Black comedy', 'Drama']",1980,9
18130859,The Runner Stumbles,1979,['United States of America'],"['Melodrama', 'Docudrama', 'Drama']",1970,9
23877633,Interrogation,1989,['Poland'],"['Drama', 'Crime Fiction']",1980,9
11036915,Mi amigo,2002,['United States of America'],"['Comedy Western', 'Action/Adventure', 'Western', 'Buddy film', 'Comedy']",2000,2
12915146,Hibiscus Town,1986,['China'],"['Chinese Movies', 'Drama']",1980,6
5813062,The Heavenly Kid,1985,['United States of America'],"['Heavenly Comedy', 'Comedy', 'Romance Film', 'Romantic comedy', 'Fantasy']",1980,5
2706105,Wolf Creek,2005,['Australia'],"['Crime Fiction', 'Indie', 'Slasher', 'Horror', 'Road movie', 'Road-Horror', 'Cult']",2000,5
6615324,Highway,2002,['United States of America'],"['Period piece', 'Crime Fiction', 'Indie', 'Drama']",2000,2
5703571,A Shot in the West,2006,['United Kingdom'],"['Short Film', 'Western']",2000,6
1852179,National Lampoon's European Vacation,1985,['United States of America'],"['Screwball comedy', 'Parody', 'Slapstick', 'Comedy', 'Family Film']",1980,5
24132517,"Liane, Jungle Goddess",1956,['West Germany'],"['Action', 'Action/Adventure', 'Thriller', 'Adventure', 'Drama', 'Fantasy']",1950,6
3524655,Scoop,2006,"['United Kingdom', 'United States of America']","['Mystery', 'Comedy', 'Thriller', 'Romance Film', 'Crime Thriller', 'Romantic comedy', 'Supernatural', 'Fantasy']",2000,6
27762733,Piccadilly Jim,1936,['United States of America'],['Romantic comedy'],1930,6
26200531,Gross Misconduct,1993,['Australia'],"['Thriller', 'Drama']",1990,3
1504619,Home Fries,1998,['United States of America'],"['Comedy', 'Crime Comedy', 'Black comedy', 'Romantic comedy', 'Romance Film', 'Drama']",1990,8
5292920,Hellboy,2004,['United States of America'],"['Action', 'Superhero', 'Action/Adventure', 'Thriller', 'Adventure', 'Creature Film', 'Superhero movie', 'Supernatural', 'Science Fiction', 'Fantasy']",2000,4
9057005,Lawaaris,1981,['India'],"['Musical', 'Bollywood', 'World cinema', 'Romance Film', 'Drama']",1980,1
5128035,Romance in Manhattan,1935,['United States of America'],"['Romance Film', 'Black-and-white', 'Comedy']",1930,5
15693672,Boots Malone,1952,['United States of America'],"['Action', 'Black-and-white', 'Adventure', 'Drama']",1950,2
4724575,The Hawk is Dying,2006,['United States of America'],"['Film adaptation', 'Indie', 'Drama']",2000,6
3036370,Shadow Man,2006,"['United Kingdom', 'Romania', 'United States of America']","['Action', 'Action/Adventure', 'Thriller']",2000,6
15122117,The Wrestler,2008,"['United States of America', 'France']","['Romance Film', 'Short Film', 'Drama']",2000,8
12561949,Il secondo tragico Fantozzi,1976,['Italy'],['Comedy'],1970,6
11251963,Homegrown,1998,['United States of America'],"['Crime Fiction', 'Stoner film', 'Indie', 'Buddy film', 'Thriller', 'Comedy', 'Black comedy', 'Crime Thriller', 'Drama']",1990,8
25021966,London Betty,2009,['United States of America'],"['Indie', 'Comedy']",2000,9
680398,Beverly Hills Cop,1984,['United States of America'],"['Action', 'Crime Fiction', 'Action/Adventure', 'Buddy film', 'Thriller', 'Comedy', 'Drama']",1980,4
25745702,Falling Up,2009,['United States of America'],"['Indie', 'Comedy', 'Romance Film', 'Romantic comedy']",2000,9
27309237,AK-47,2004,['India'],"['Action/Adventure', 'Drama', 'World cinema']",2000,4
12224834,Going Under,2004,['United States of America'],"['Romantic drama', 'Indie', 'Romance Film', 'Drama']",2000,4
166121,The World Is Not Enough,1999,"['United Kingdom', 'United States of America']","['Action', 'Spy', 'Action/Adventure', 'Thriller', 'Glamorized Spy Film']",1990,9
4884523,Andaz,1949,['India'],"['Drama', 'World cinema']",1940,9
5573873,Bad Ronald,1974,['United States of America'],"['Psychological thriller', 'Thriller', 'Horror']",1970,4
31044553,Hyménée,1947,[],['Drama'],1940,7
21589124,Wizards of Waverly Place: The Movie,2009,['United States of America'],"['Comedy', 'Teen', 'Adventure', ""Children's"", 'Drama', 'Family Film', 'Fantasy']",2000,9
17738146,Kiss Toledo Goodbye,1999,['United States of America'],"['Action', 'Crime Fiction', 'Gangster Film', 'Indie', 'Action/Adventure', 'Comedy', 'Thriller', 'Crime Thriller', 'Crime Comedy']",1990,9
633531,The Contender,2000,"['United Kingdom', 'France', 'Germany', 'United States of America']","['Suspense', 'Thriller', 'Political drama', 'Drama']",2000,0
76331,Scarface,1932,['United States of America'],"['Black-and-white', 'Crime Fiction', 'Gangster Film', 'Film noir', 'Pre-Code', 'Drama']",1930,2
19397838,Hi'-Neighbor!,1934,['United States of America'],"['Black-and-white', 'Short Film', 'Comedy', 'Family Film']",1930,4
3258852,Don't Come Knocking,2005,"['France', 'Germany', 'United States of America']","['Musical', 'Family Drama', 'Western', 'Indie', 'Drama']",2000,5
210316,Gerry,2003,"['Argentina', 'United States of America']","['Drama', 'Mystery', 'Indie', 'Buddy film', 'Avant-garde', 'Experimental film', 'Adventure']",2000,3
7597656,Chota Mumbai,2007,['India'],"['Action', 'Crime Fiction', 'Comedy']",2000,7
6947418,Gunda,1998,['India'],"['Action', 'Comedy']",1990,8
4681500,Speechless,1994,['United States of America'],"['Romance Film', 'Romantic comedy', 'Comedy']",1990,4
26092192,Khiladi 420,2000,['India'],['Action'],2000,0
21202777,The Winning Season,2009,['United States of America'],"['Sports', 'Indie', 'Comedy']",2000,9
25489035,Bad Karma,2002,['United Kingdom'],"['Short Film', 'Splatter film']",2000,2
27396469,Race for the Yankee Zephyr,1981,"['New Zealand', 'Australia', 'United States of America']","['Action', 'Action/Adventure', 'Thriller', 'World cinema', 'Adventure', 'Drama']",1980,1
26939387,The Figurine,2009,['Nigeria'],['Thriller'],2000,9
2382573,The Last Broadcast,1998,['United States of America'],"['Creature Film', 'Monster movie', 'Horror', 'B-movie']",1990,8
23923922,American Empire,1942,['United States of America'],"['Action/Adventure', 'Western']",1940,2
1364070,The Fortune Cookie,1966,['United States of America'],"['Comedy', 'Satire', 'Comedy of manners', 'Drama']",1960,6
4045254,Vampire's Kiss,1988,['United States of America'],"['Comedy', 'Horror Comedy', 'Horror', 'Black comedy']",1980,8
1329111,Bananas,1971,['United States of America'],"['Political cinema', 'Political satire', 'Parody', 'Satire', 'Comedy', 'Slapstick', 'Absurdism']",1970,1
685987,Major League,1989,['United States of America'],"['Satire', 'Sports', 'Comedy']",1980,9
11124990,The Sleeping Car Murders,1965,['France'],"['Psychological thriller', 'Crime Fiction', 'Mystery', 'Thriller', 'Drama']",1960,5
29676497,"Stalingrad: Dogs, Do You Want to Live Forever?",1959,[],"['War film', 'Drama']",1950,9
8233233,Lost in Alaska,1952,['United States of America'],"['Adventure Comedy', 'Black-and-white', 'Slapstick', 'Comedy', 'Family Film']",1950,2
26178850,The Power and the Prize,1956,['United States of America'],"['Romance Film', 'Crime Fiction', 'Drama']",1950,6
8237971,"April 1, 2000",1952,['Austria'],['Science Fiction'],1950,2
32883062,My Little Pony: Meet the Ponies,2008,[],['Animation'],2000,8
3745465,Hellraiser: Hellseeker,2002,['United States of America'],"['Mystery', 'Slasher', 'Thriller', 'Horror', 'Supernatural', 'Cult']",2000,2
17366149,St. George Shoots the Dragon,2008,"['Serbia', 'Bosnia and Herzegovina', 'Bulgaria']","['History', 'World cinema', 'War film', 'Drama']",2000,8
2102101,Mary Reilly,1996,"['United Kingdom', 'United States of America']","['Psychological thriller', 'Film adaptation', 'Thriller', 'Costume Horror', 'Costume drama', 'Drama', 'Period piece', 'Horror']",1990,6
21052275,Boondock Saints II: All Saints Day,2009,['United States of America'],"['Action', 'Drama', 'Comedy', 'Thriller', 'Crime Thriller']",2000,9
3971835,Scooby-Doo and the Reluctant Werewolf,1988,['United States of America'],"[""Children's Fantasy"", ""Children's/Family""]",1980,8
4280890,Repli-Kate,2002,['United States of America'],"['Fantasy', 'Comedy', 'Sex comedy']",2000,2
19858909,Nightlight,2003,"['Canada', 'United States of America']","['Mystery', 'Thriller', 'Television movie', 'Drama']",2000,3
1929835,Vuk,1981,['Hungary'],"[""Children's"", 'Animation']",1980,1
20259439,Feast 3: The Happy Finish,2009,['United States of America'],['Horror'],2000,9
2952125,The Deep,1977,['United States of America'],"['Action', 'Suspense', 'Crime Fiction', 'Action/Adventure', 'Adventure']",1970,7
2423947,Still Crazy,1998,['United Kingdom'],"['Road movie', 'Parody', 'Comedy']",1990,8
1284106,Anne of Green Gables: The Continuing Story,2000,['Canada'],"['Marriage Drama', 'Drama']",2000,0
8713368,The Man Who Saved Christmas,2002,['Canada'],"['Inspirational Drama', 'Holiday Film', 'Drama', 'Family Film']",2000,2
10182598,Jawani Diwani,1972,['India'],"['Romantic drama', 'World cinema', 'Romance Film', 'Drama']",1970,2
9446637,Cass Timberlane,1947,['United States of America'],"['Black-and-white', 'Marriage Drama', 'Romance Film', 'Melodrama', 'Drama']",1940,7
7936519,The Damned Thing,2006,['United States of America'],"['Television movie', 'Cult', 'Horror']",2000,6
6435440,Orion's Belt,1985,['Norway'],"['Action', 'Adventure', 'Thriller']",1980,5
10628894,Uzhaippali,1993,['India'],['Romantic comedy'],1990,3
2731003,Powder,1995,['United States of America'],"['Albino bias', 'Drama', 'Fantasy']",1990,5
14255798,The Mad Miss Manton,1938,['United States of America'],"['Detective fiction', 'Crime Fiction', 'Screwball comedy', 'Mystery', 'Romance Film', 'Crime Thriller', 'Detective', 'Comedy film']",1930,8
16233363,Ali Baba and the Forty Thieves,1944,['United States of America'],"['Action', 'Action/Adventure', 'Adventure']",1940,4
27542224,The Raccoons on Ice,1981,['Canada'],['Short Film'],1980,1
464189,Westworld,1973,['United States of America'],"['Western', 'Hybrid Western', 'Thriller', 'Science fiction Western', 'Science Fiction']",1970,3
17862288,Document of the Dead,1985,['United States of America'],"['Film & Television History', 'Indie', 'Biography', 'Documentary', 'Media Studies', 'Film']",1980,5
1466657,The Last Castle,2001,['United States of America'],"['Action', 'Prison', 'Action Thrillers', 'Action/Adventure', 'Thriller', 'Drama']",2000,1
213416,The Replacements,2000,['United States of America'],"['Action', 'Action/Adventure', 'Comedy', 'Comedy-drama', 'Sports']",2000,0
6614498,Bloodfist VI: Ground Zero,1995,['United States of America'],"['Action', 'Action Thrillers', 'Indie', 'Action/Adventure', 'Thriller', 'Martial Arts Film']",1990,5
4765643,Hats Off,1927,['United States of America'],"['Black-and-white', 'Indie', 'Short Film', 'Comedy', 'Documentary', 'Silent film']",1920,7
4119620,The Honeymoon Machine,1961,['United States of America'],"['Romantic comedy', 'Comedy']",1960,1
27486082,Getting Married in Buffalo Jump,1990,['Canada'],"['Film adaptation', 'Family Drama', 'Action/Adventure', 'Romantic drama', 'Romance Film', 'Drama', 'Western', 'Television movie', 'Family Film']",1990,0
273456,The Love Bug,1968,['United States of America'],"['Comedy', 'Auto racing', 'Drama', 'Family Film']",1960,8
103011,Coming Home,1978,['United States of America'],"['Romantic drama', 'New Hollywood', 'Political drama', 'Romance Film', 'War film', 'Drama']",1970,8
18550197,Blue Hill Avenue,2001,['United States of America'],"['Period piece', 'Crime Fiction', 'Crime Drama', 'Crime Thriller', 'Drama']",2000,1
2499412,Har Dil Jo Pyar Karega,2000,['India'],"['Musical', 'Romantic drama', 'Bollywood', 'World cinema', 'Romance Film', 'Drama']",2000,0
18258415,Nuan,2003,['China'],"['Romance Film', 'Drama', 'Chinese Movies']",2000,3
34132709,Chan Pardesi,1980,['India'],['Drama'],1980,0
9895475,Lies and Crimes,2007,['Canada'],"['Crime Fiction', 'Mystery', 'Drama']",2000,7
1009516,Mr. 3000,2004,['United States of America'],"['Comedy', 'Baseball', 'Sports', 'Drama']",2000,4
1357356,Tapeheads,1988,['United States of America'],"['Political cinema', 'Drama', 'Indie', 'Comedy', 'Media Satire', 'Political drama']",1980,8
4086317,Razorback,1984,"['United States of America', 'Australia']","['Thriller', 'Natural horror films', 'Horror']",1980,4
21191163,Born Equal,2006,['United Kingdom'],"['Social problem film', 'Drama']",2000,6
10664680,Night of the Demons 3,1997,"['Canada', 'United States of America']","['Haunted House Film', 'Teen', 'Horror']",1990,7
18766606,The Guilt of Janet Ames,1947,['United States of America'],"['Black-and-white', 'Drama']",1940,7
1090927,Atlantis: Milo's Return,2003,['United States of America'],"['Action', 'Animation', ""Children's/Family"", 'Adventure', 'Mythological Fantasy', ""Children's Fantasy"", 'Family Film', 'Fantasy']",2000,3
2882942,The Entertainer,1960,['United Kingdom'],"['Musical', 'British New Wave', 'Drama']",1960,0
13273083,Dishdogz,2005,['United States of America'],"['Coming of age', 'Comedy', 'Teen', 'Romance Film', 'Sports', ""Children's"", 'Drama']",2000,5
5440243,Beau Geste,1939,['United States of America'],"['Action', 'Film adaptation', 'Black-and-white', 'Action/Adventure', 'Adventure', 'Drama', 'Foreign legion', 'War film']",1930,9
19396361,Nirom,1999,['India'],"['Musical', 'Romance Film', 'Comedy']",1990,9
21426146,Thicker than Water,2005,['United States of America'],"['Drama', 'Television movie']",2000,5
20428509,Nora's Hair Salon 2: A Cut Above,2007,['United States of America'],"['Comedy', 'Comedy-drama', 'Workplace Comedy', 'Drama', 'Ensemble Film']",2000,7
4199282,A Tree Grows In Brooklyn,1945,['United States of America'],"['Period piece', 'Film adaptation', 'Coming of age', 'Family Drama', 'Drama', 'Family Film']",1940,5
9993367,Invasión,1969,['Argentina'],['Drama'],1960,9
74917,Magical Maestro,1952,['United States of America'],"['Short Film', 'Animation']",1950,2
24158456,Taivas tiellä,2000,['Finland'],"['Short Film', 'Drama']",2000,0
76647,Yankee Doodle Dandy,1942,['United States of America'],"['Musical', 'Black-and-white', 'Biography', 'Biopic [feature]', 'Biographical film', 'Musical Drama', 'Drama']",1940,2
1573381,The Celebration,1998,"['Sweden', 'Denmark']","['Dogme 95', 'Crime Fiction', 'Family Drama', 'World cinema', 'Comedy-drama', 'Drama', 'Ensemble Film']",1990,8
14286254,Happy-Go-Lucky,2008,['United Kingdom'],"['Indie', 'Comedy', 'Romance Film', 'Comedy-drama', 'Drama']",2000,8
261236,A Woman in Flames,1983,['Germany'],['Drama'],1980,3
26292590,Born Reckless,1958,['United States of America'],['Western'],1950,8
12893671,Spinning Into Butter,2007,['United States of America'],['Drama'],2000,7
14661434,My Name Is Juani,2006,['Spain'],"['Drama', 'Comedy']",2000,6
4314167,Jumping Ship,2001,"['United States of America', 'Australia']","['Action Thrillers', 'Comedy', 'Adventure', 'Drama', 'Family Film']",2000,1
5807082,The Rocketeer,1991,['United States of America'],"['Action', 'Superhero', 'Action/Adventure', 'Adventure', 'Airplanes and airports', 'Period piece', 'Superhero movie', 'Science Fiction', 'Family Film', 'Fantasy']",1990,1
35288836,New Battles Without Honor and Humanity,2000,['Japan'],['Drama'],2000,0
4767414,Deathrow,2000,['Philippines'],['Filipino Movies'],2000,0
10831021,The Promise,2007,['Philippines'],"['Filipino Movies', 'Romantic drama', 'World cinema', 'Romance Film', 'Drama']",2000,7
3759215,The Time Machine,2002,['United States of America'],"['Action', 'Film adaptation', 'Time travel', 'Adventure', 'Doomsday film', 'Science Fiction', 'Drama']",2000,2
28967195,Demons of War,1998,['Poland'],"['War film', 'Drama', 'World cinema']",1990,8
19876761,Mangamma Sapatham,1943,[],['Romance Film'],1940,3
25721019,Finishing School,1934,['United States of America'],"['Romantic drama', 'Romance Film', 'Melodrama', 'Drama']",1930,4
5033320,Dagon,2001,"['Spain', 'United States of America']","['Monster movie', 'Cult', 'Horror']",2000,1
21102984,Cosmopolitan,2003,"['India', 'United States of America']","['Indie', 'Comedy', 'Romantic comedy', 'Comedy-drama', 'Drama']",2000,3
2932229,Laserblast,1978,['United States of America'],"['Science Fiction', 'Horror', 'Alien Film', 'Stop motion', 'Cult']",1970,8
12256764,Wishmaster 3: Beyond the Gates of Hell,2001,"['Canada', 'United States of America']","['Creature Film', 'Monster movie', 'Horror', 'Supernatural']",2000,1
14942953,The Thacker Case,2008,['United States of America'],"['Crime Fiction', 'Mystery', 'Family Drama', 'Thriller', 'Horror', 'Drama', 'Courtroom Drama']",2000,8
30524,The Year of Living Dangerously,1983,"['New Zealand', 'Australia']","['Romantic drama', 'World cinema', 'Political drama', 'Romance Film', 'War film', 'Drama']",1980,3
15703651,Colma The Musical,2006,['United States of America'],"['Musical', 'Coming of age', 'Indie', 'Comedy', 'Romantic comedy', 'Romance Film']",2000,6
2322291,Pretty Persuasion,2005,['United States of America'],"['Indie', 'Comedy', 'Teen', 'Black comedy']",2000,5
24237235,Lady Moonflower,1976,['Japan'],"['Erotica', 'Japanese Movies', 'Pornographic movie']",1970,6
4200027,"Honey, We Shrunk Ourselves",1997,['United States of America'],"['Comedy', 'Family-Oriented Adventure', 'Adventure', 'Family Film']",1990,7
10506215,I Capture the Castle,2003,['United Kingdom'],"['Period piece', 'Coming of age', 'Romantic drama', 'Comedy', 'Romantic comedy', 'Romance Film', 'Drama']",2000,3
13725762,Godfather,2007,['Pakistan'],['Gangster Film'],2000,7
12240278,El Super,1979,['United States of America'],"['Comedy', 'Drama', 'World cinema']",1970,9
7943163,Like Mike 2: Streetball,2006,"['Canada', 'United States of America']","['Comedy', ""Children's/Family"", 'Sports', ""Children's"", 'Family Film']",2000,6
2338401,Proof of Life,2000,['United States of America'],"['Action', 'Crime Fiction', 'Romantic drama', 'Thriller', 'Romance Film', 'Crime Thriller', 'Drama', 'Adventure', 'Suspense', 'War film', 'Political thriller']",2000,0
19316811,Iluminados Por El Fuego,2005,"['Argentina', 'United Kingdom']","['War film', 'Drama', 'World cinema']",2000,5
13931836,Meet the Browns,2008,['United States of America'],"['Comedy', 'Romance Film', 'Comedy-drama', 'Drama']",2000,8
4600879,City of Ghosts,2003,['United States of America'],"['Crime Fiction', 'Thriller', 'Crime Thriller', 'Drama']",2000,3
2848051,Honeymoon in Vegas,1992,['United States of America'],"['Gangster Film', 'Comedy', 'Romance Film', 'Romantic comedy']",1990,2
7621504,Crazy as Hell,2002,['United States of America'],"['Psychological thriller', 'Thriller', 'Horror', 'Supernatural']",2000,2
35372452,Tarkeeb,1984,['India'],['Action'],1980,4
4903470,Jane Eyre,1973,['United Kingdom'],['Costume drama'],1970,3
1940119,Vive L'Amour,1996,"['China', 'Taiwan']","['Drama', 'Chinese Movies', 'World cinema']",1990,6
19273598,Sagan,2008,['France'],"['Drama', 'Biographical film', 'Biopic [feature]']",2000,8
10932642,Hapkido,1972,['Hong Kong'],"['Action', 'Action/Adventure', 'World cinema', 'Chinese Movies', 'Martial Arts Film']",1970,2
23523165,Amaravathi,2009,['India'],['Thriller'],2000,9
17257463,Chamku,2008,['India'],"['Musical', 'Romantic drama', 'Bollywood', 'World cinema', 'Romance Film', 'Drama']",2000,8
1336308,Sin City,2005,['United States of America'],"['Action', 'Neo-noir', 'Black-and-white', 'Crime Fiction', 'Gangster Film', 'Action/Adventure', 'Thriller', 'Crime Thriller', 'Drama', 'Dystopia', 'Superhero movie']",2000,5
15155033,A Single Spark,1995,['South Korea'],"['Docudrama', 'Political drama', 'Drama']",1990,5
9541248,Desert Saints,2002,['United States of America'],"['Action', 'Psychological thriller', 'Indie', 'Action/Adventure', 'Thriller', 'Crime Thriller']",2000,2
11125917,The Woman in Green,1945,['United States of America'],"['Film adaptation', 'Detective fiction', 'Black-and-white', 'Crime Fiction', 'Mystery', 'Thriller', 'Crime Thriller', 'Drama', 'Detective']",1940,5
17733106,Comic Book Villains,2002,['United States of America'],"['Action', 'Action/Adventure', 'Comedy', 'Crime Comedy', 'Superhero movie', 'Black comedy', 'Comedy-drama']",2000,2
4985426,The Beat That My Heart Skipped,2005,['France'],"['Music', 'Action', 'Crime Fiction', 'Thriller', 'World cinema', 'Romance Film', 'Drama', 'Crime Drama']",2000,5
9425532,Army,1996,['India'],['World cinema'],1990,6
12588275,Saptha Kanya,1993,['Sri Lanka'],['Drama'],1990,3
22964594,"Selma, Lord, Selma",1999,['United States of America'],"['Period piece', 'Biographical film', 'Television movie', 'Docudrama', 'Political drama', 'Drama']",1990,9
1683438,The Mudge Boy,2003,['United States of America'],"['LGBT', 'Coming of age', 'Family Drama', 'Indie', 'Drama']",2000,3
1469871,The Wedding Date,2004,['United States of America'],"['Comedy', 'Romance Film', 'Romantic comedy', 'Comedy of Errors']",2000,4
11959424,Lady of the Night,1925,['United States of America'],"['Black-and-white', 'Drama', 'Indie', 'Silent film', 'Romance Film', 'Melodrama']",1920,5
33027963,The Haunting of Hell House,1999,['United States of America'],"['Film adaptation', 'Thriller', 'Horror', 'Supernatural', 'Drama', 'Haunted House Film']",1990,9
35736893,Whirlpool,1934,['United States of America'],"['Romance Film', 'Crime Fiction', 'Drama']",1930,4
20692092,Seven Women from Hell,1961,['United States of America'],"['War film', 'Drama']",1960,1
2737528,The Brasher Doubloon,1947,['United States of America'],"['Film noir', 'Mystery', 'Thriller']",1940,7
31163724,Strange Intruder,1956,['United States of America'],"['Drama', 'Crime Fiction']",1950,6
6423927,Little Red Walking Hood,1937,['United States of America'],"['Short Film', 'Animation']",1930,7
8431192,The Prophecy: Uprising,2005,['United States of America'],['Horror'],2000,5
26262913,Tomorrow at Seven,1933,['United States of America'],"['Mystery', 'Crime Thriller', 'Thriller']",1930,3
20597258,Goopy Bagha Phire Elo,1991,['India'],"['Family Film', 'Fantasy']",1990,1
32967433,The Romance of Runnibede,1928,[],['Silent film'],1920,8
10413209,Les Biches,1968,"['France', 'Italy']","['LGBT', 'Erotic Drama', 'Romantic drama', 'World cinema', 'Romance Film', 'Drama', 'Gay Themed', 'Gay', 'Gay Interest']",1960,8
2768565,Police Story 2,1988,"['China', 'Hong Kong']","['Action', 'Crime Fiction', 'Action/Adventure', 'Comedy', 'World cinema', 'Chinese Movies', 'Martial Arts Film']",1980,8
3503363,The Grass Is Greener,1960,['United Kingdom'],"['Film adaptation', 'Comedy', 'Romance Film', 'Romantic comedy', 'Drama']",1960,0
691308,Manhattan Melodrama,1934,['United States of America'],"['Black-and-white', 'Crime Fiction', 'Buddy film', 'Crime Drama', 'Romance Film', 'Pre-Code', 'Drama']",1930,4
22816470,Wooden Staircase,1993,['Lithuania'],['Drama'],1990,3
1948713,Rio Lobo,1970,['United States of America'],"['Action/Adventure', 'Western']",1970,0
9121908,Mr. Woodcock,2007,['United States of America'],"['Comedy', 'Black comedy', 'Domestic Comedy', 'Slapstick']",2000,7
12356406,"Gandhi, My Father",2007,['India'],"['History', 'Family Drama', 'Biographical film', 'Biopic [feature]', 'World cinema', 'Drama']",2000,7
9381820,Samurai,2002,['India'],"['Action', 'Crime Fiction', 'Action/Adventure', 'Comedy', 'Disaster', 'Martial Arts Film', 'Adventure', 'Western']",2000,2
6778145,Km. 0,2000,['Spain'],"['LGBT', 'Comedy', 'World cinema', 'Romance Film', 'Romantic comedy', 'Drama']",2000,0
4286797,Armaan,2003,['India'],"['Romantic drama', 'Bollywood', 'World cinema', 'Romance Film', 'Drama']",2000,3
25603135,The Matinee Idol,1928,['United States of America'],"['Silent film', 'Romance Film', 'Comedy']",1920,8
6166201,Return to Innocence,2001,['United States of America'],"['Courtroom Drama', 'Film adaptation', 'Drama', 'Indie']",2000,1
6095252,Road to Singapore,1940,"['Singapore', 'United States of America']","['Adventure Comedy', 'Musical', 'Black-and-white', 'Screwball comedy', 'Action/Adventure', 'Buddy film', 'Comedy', 'Adventure']",1940,0
21620211,Against the Dark,2009,"['Romania', 'United States of America']","['Action', 'Action Thrillers', 'Action/Adventure', 'Thriller', 'Horror', 'Science Fiction']",2000,9
3037303,Daddy Long Legs,1955,['United States of America'],"['Musical', 'Film adaptation', 'Romance Film', 'Drama']",1950,5
5990955,Thotti Jaya,2005,['India'],['Thriller'],2000,5
4563048,World Without End,1956,['United States of America'],['Science Fiction'],1950,6
14876881,The Dolly Sisters,1945,['United States of America'],"['Musical', 'Comedy', 'Biopic [feature]', 'Biographical film', 'Romance Film', 'Drama']",1940,5
15826853,Banana Joe,1982,"['West Germany', 'Italy']",['Comedy film'],1980,2
32088645,Baazi,1984,['India'],['Action'],1980,4
20963714,The Harmonium in My Memory,1999,['South Korea'],"['Romantic drama', 'Comedy', 'World cinema', 'Romance Film', 'Drama', 'Romantic comedy', 'Comedy-drama', 'Ensemble Film']",1990,9
24327391,Lebanon,2009,"['Lebanon', 'Israel', 'France', 'Germany']","['War film', 'Drama', 'World cinema']",2000,9
11886787,Force of Arms,1951,['United States of America'],"['Black-and-white', 'Romance Film', 'War film', 'Drama']",1950,1
5078515,You Only Live Twice,1967,['United Kingdom'],"['Action', 'Spy', 'Action/Adventure', 'Thriller', 'Glamorized Spy Film']",1960,7
1944344,Double Platinum,1999,['United States of America'],"['Musical', 'Family Drama', 'Television movie', 'Family Film', 'Drama']",1990,9
1751153,The Juniper Tree,1987,['Iceland'],"['Drama', 'World cinema']",1980,7
35910162,Black Sun,1964,['Japan'],"['Musical', 'Drama', 'Thriller']",1960,4
171623,Training Day,2001,"['United States of America', 'Australia']","['Crime Fiction', 'Thriller', 'Crime Thriller', 'Adventure', 'Drama']",2000,1
9111772,Kanthaswamy,2009,['India'],"['Action', 'Crime Fiction', 'Thriller', 'Adventure', 'Science Fiction', 'Drama', 'Fantasy']",2000,9
2951117,Savage Sam,1963,['United States of America'],"['Animal Picture', 'Adventure', 'Drama']",1960,3
24227461,The Hangman,1959,['United States of America'],"['Western', 'Black-and-white']",1950,9
25438155,Cjamango,1967,['Italy'],['Spaghetti Western'],1960,7
23176853,Adventure in Manhattan,1936,['United States of America'],"['Comedy', 'Thriller', 'Crime Thriller', 'Drama']",1930,6
14141235,12,2007,['Russia'],"['Crime Fiction', 'Thriller', 'World cinema', 'War film', 'Drama', 'Courtroom Drama']",2000,7
12812712,El abuelo,1998,['Spain'],"['Drama', 'World cinema']",1990,8
13607881,The Barbarians,1987,['United States of America'],"['Action', 'Adventure', 'Sword and sorcery']",1980,7
336808,Ace Ventura: Pet Detective,1994,['United States of America'],"['Action', 'Gross out', 'Gross-out film', 'Mystery', 'Comedy', 'Thriller', 'Slapstick', 'Detective']",1990,4
16592478,Stronghold of Toughs,1967,['Yugoslavia'],['Drama'],1960,7
11335511,Hidden Places,2006,['United States of America'],"['Romantic drama', 'Romance Film', 'Television movie', 'Drama']",2000,6
17490919,A Blueprint for Murder,1953,['United States of America'],"['Detective fiction', 'Black-and-white', 'Crime Fiction', 'Mystery', 'Thriller', 'Film noir', 'Crime Thriller', 'Drama', 'Courtroom Drama', 'Detective']",1950,3
33105965,They Wanted Peace,1938,"['Soviet Union', 'Georgian SSR']","['History', 'Historical drama', 'War film', 'Drama']",1930,8
15838860,Static,1986,['United States of America'],"['Drama', 'Indie', 'Comedy', 'Comedy-drama']",1980,6
767783,Baise Moi,2000,['France'],"['Crime Fiction', 'Art film', 'Thriller', 'World cinema', 'Romance Film', 'Crime Thriller', 'Drama', 'Erotic thriller', 'Erotica']",2000,0
5340151,Jodi,1999,['India'],"['Drama', 'Tamil cinema']",1990,9
16168372,Alaiyadikkuthu,2005,['India'],['Drama'],2000,5
28419339,"Johnny, You're Wanted",1956,['United Kingdom'],"['Drama', 'Crime Fiction']",1950,6
7053488,The Story of Three Loves,1953,['United States of America'],"['Musical', 'Romantic drama', 'Romance Film', 'Drama']",1950,3
20222480,The Show Must Go On,2007,['South Korea'],"['Drama', 'Crime Fiction']",2000,7
1748912,The Killers,1964,['United States of America'],"['Crime Fiction', 'Mystery', 'Thriller', 'Film noir', 'Drama']",1960,4
8283351,King of the Carnival,1955,['United States of America'],"['Action', 'Spy', 'Black-and-white', 'Crime Fiction', 'Comedy Thriller', 'Thriller', 'Adventure']",1950,5
33655611,Afterburn,1992,['United States of America'],"['Television movie', 'Docudrama', 'Drama', 'Courtroom Drama']",1990,2
17120757,One Tough Cop,1998,['United States of America'],"['Action', 'Action Thrillers', 'Gangster Film', 'Action/Adventure', 'Thriller', 'Crime Thriller']",1990,8
448181,Decoys,2004,['Canada'],"['Horror Comedy', 'Thriller', 'Horror', 'Alien Film', 'Science Fiction']",2000,4
4181793,The Most Desired Man,1994,['Germany'],"['Gay Themed', 'LGBT', 'Gay', 'Gay Interest', 'Comedy', 'Romantic comedy']",1990,4
29584867,Satan's Princess,1990,['United States of America'],['Horror'],1990,0
1940533,"Oh, God!",1977,['United States of America'],"['Heavenly Comedy', 'Comedy', 'Religious Film', 'Fantasy Comedy', 'Fantasy']",1970,7
36015368,Epitome,1953,['Japan'],['Drama'],1950,3
20163110,Tintorettor Jishu,2008,['India'],['Mystery'],2000,8
5006061,Kranti,1981,['India'],"['Action', 'Drama', 'Adventure']",1980,1
31065306,Heaven with a Barbed Wire Fence,1939,['United States of America'],"['Romance Film', 'Drama']",1930,9
1425444,So Close,2002,['Hong Kong'],"['Action', 'Crime Fiction', 'Action/Adventure', 'Comedy', 'World cinema', 'Chinese Movies', 'Martial Arts Film', 'Adventure', 'Drama', 'Science Fiction']",2000,2
26742874,Gincho Wataridori,1972,['Japan'],"['Action', 'Japanese Movies', 'Action/Adventure', 'Thriller', 'World cinema', 'Martial Arts Film']",1970,2
2042539,The District!,2004,['Hungary'],"['Animation', 'Comedy', 'World cinema']",2000,4
9105523,Picture Bride,1994,"['Japan', 'United States of America']","['Japanese Movies', 'Romantic drama', 'Marriage Drama', 'World cinema', 'Romance Film', 'Docudrama', 'Drama']",1990,4
19268898,Stolen Holiday,1937,['United States of America'],"['Black-and-white', 'Crime Fiction', 'Romance Film', 'Political drama', 'Drama']",1930,7
19278406,The Jayne Mansfield Story,1980,['United States of America'],"['Biography', 'Biographical film', 'Biopic [feature]', 'Melodrama', 'Docudrama', 'Drama']",1980,0
2523070,Lilo & Stitch 2: Stitch Has a Glitch,2005,['United States of America'],"[""Children's Fantasy"", 'Animation', 'Comedy', ""Children's/Family"", ""Children's"", 'Family Film']",2000,5
45224,Animal Crackers,1930,['United States of America'],"['Musical', 'Black-and-white', 'Screwball comedy', 'Comedy', 'Pre-Code', 'Absurdism']",1930,0
2569219,Cover Girl,1944,['United States of America'],"['Musical', 'Comedy', 'Romance Film', 'Romantic comedy']",1940,4
22107634,The year of the plague,1978,['Mexico'],"['Drama', 'Science Fiction', 'Thriller']",1970,8
27612051,Perfect Strangers,1984,['United States of America'],"['Crime Fiction', 'Thriller', 'Crime Thriller', 'Drama']",1980,4
5162931,Vampire Hunter D,1985,['Japan'],"['Animation', 'Japanese Movies', 'World cinema', 'Horror', 'Anime', 'Fantasy']",1980,5
9477007,Veneno para las hadas,1984,['Mexico'],"['Horror', 'World cinema', 'Supernatural', 'Fantasy']",1980,4
11464872,Kiss the Bride,2002,['United States of America'],"['Romantic drama', 'Comedy', 'Romance Film', 'Romantic comedy', 'Drama']",2000,2
6248065,Castle Freak,1995,['United States of America'],"['Creature Film', 'Monster movie', 'Slasher', 'Horror', 'B-movie', 'Cult']",1990,5
1612686,Halloween Resurrection,2002,['United States of America'],"['Slasher', 'Teen', 'Horror', 'Cult']",2000,2
15830410,Solitary Fragments,2007,['Spain'],"['Drama', 'Slice of life story']",2000,7
3727473,Man on Fire,1987,"['France', 'Italy']","['Action', 'Drama', 'Indie', 'Thriller']",1980,7
4112455,Sleepaway Camp 3,1989,['United States of America'],"['Comedy horror', 'Indie', 'Slasher', 'Teen', 'Horror']",1980,9
25479657,New Delhi,1956,['India'],"['Musical', 'Romantic drama', 'Comedy', 'Bollywood', 'World cinema', 'Romance Film', 'Drama']",1950,6
469813,Hardcore,1979,['United States of America'],"['Crime Fiction', 'Mystery', 'Thriller', 'Crime Thriller', 'Drama']",1970,9
11841923,Sound of the Sea,2001,['Spain'],"['Romantic drama', 'World cinema', 'Romance Film', 'Drama']",2000,1
29153320,Umbartha,1981,['India'],"['Drama', 'World cinema']",1980,1
26533305,Vìctimas del Pecado,1951,['Mexico'],"['Drama', 'World cinema']",1950,1
17696129,On the Beat,1995,['China'],"['Chinese Movies', 'Comedy', 'World cinema']",1990,5
300972,Malcolm X,1992,['United States of America'],"['Period piece', 'Biography', 'Biographical film', 'Political drama', 'Drama']",1990,2
2433724,Village of the Giants,1965,['United States of America'],"['Coming of age', 'Comedy', 'Teen', 'Adventure', 'Juvenile Delinquency Film', 'Science Fiction', 'Cult']",1960,5
10620253,Dharmatma,1975,"['India', 'Afghanistan']","['Action/Adventure', 'Bollywood', 'Thriller', 'World cinema']",1970,5
25009958,Drango,1957,['United States of America'],"['Western', 'War film', 'Drama']",1950,7
9031071,Shrek the Halls,2007,['United States of America'],"['Animation', 'Comedy', 'Holiday Film', 'Adventure', 'Fairy tale', ""Children's Fantasy"", 'Short Film', 'Fantasy']",2000,7
9230147,All the Brothers Were Valiant,1953,['United States of America'],"['Romance Film', 'Adventure', 'Drama']",1950,3
6234983,The Promotion,2008,['United States of America'],"['Workplace Comedy', 'Indie', 'Comedy']",2000,8
8626367,The Young in Heart,1938,['United States of America'],"['Black-and-white', 'Screwball comedy', 'Comedy', 'Romance Film']",1930,8
23991059,Green Grow the Rushes,1951,['United Kingdom'],"['Black-and-white', 'Crime Fiction', 'Comedy', 'Crime Comedy', 'Comedy of Errors']",1950,1
4460314,Trespass,1992,['United States of America'],"['Action', 'Crime Fiction', 'Action/Adventure', 'Thriller', 'Crime Thriller']",1990,2
30011022,Marry Me Again,1953,[],['Comedy film'],1950,3
18967483,Through the Back Door,1921,['United States of America'],"['Black-and-white', 'Comedy', 'Silent film', 'Drama']",1920,1
11895033,Makdee,2002,['India'],['Bollywood'],2000,2
193862,Pillow Talk,1959,['United States of America'],"['Romance Film', 'Romantic comedy', 'Comedy']",1950,9
10612031,The Comedians,1967,"['United States of America', 'France']","['Romance Film', 'Drama']",1960,7
16334996,Stella,2008,['France'],"['Drama', 'World cinema']",2000,8
30742009,Jordon Saffron: Taste This!,2009,['United States of America'],"['Drama', 'Indie', 'Comedy', 'Mockumentary']",2000,9
32883826,Townies and Hayseeds,1923,[],['Comedy film'],1920,3
9398619,The Lady Iron Chef,2007,['Hong Kong'],"['Chinese Movies', 'Comedy', 'World cinema']",2000,7
11066455,Pazhani,2008,['India'],['Action'],2000,8
6795160,Pavithra,1994,['India'],['Drama'],1990,4
420692,Brigham Young,1940,['United States of America'],"['Black-and-white', 'Biography', 'Biopic [feature]', 'Historical fiction', 'Epic', 'Drama']",1940,0
2066293,Born Yesterday,1950,['United States of America'],"['Comedy', 'Satire', 'Romance Film', 'Romantic comedy']",1950,0
1197558,"Murder, My Sweet",1944,['United States of America'],"['Detective fiction', 'Black-and-white', 'Crime Fiction', 'Mystery', 'Thriller', 'Film noir', 'Crime Thriller', 'Drama', 'Detective']",1940,4
3471434,16 December,2001,['India'],"['Action', 'Thriller', 'World cinema']",2000,1
19347214,Small Talk,1929,['United States of America'],"['Short Film', 'Black-and-white', 'Comedy']",1920,9
29449916,Mickey's Champs,1930,['United States of America'],['Short Film'],1930,0
2473101,Showtime,2002,"['United States of America', 'Australia']","['Action', 'Crime Fiction', 'Parody', 'Action/Adventure', 'Comedy']",2000,2
8391403,The Year Without A Santa Claus,2006,['United States of America'],"['Comedy', 'Television movie', 'Family Film', 'Fantasy']",2000,6
20783851,The Red Danube,1949,['United States of America'],"['Romance Film', 'War film', 'Drama']",1940,9
2939335,I Live in Fear,1955,['Japan'],"['Japanese Movies', 'Comedy', 'World cinema', 'Drama']",1950,5
4513433,The Defender,2004,['United States of America'],"['Action', 'Action/Adventure', 'Thriller', 'Political thriller']",2000,4
183540,Steam: The Turkish Bath,1997,"['Italy', 'Turkey']","['Gay Themed', 'LGBT', 'Gay', 'Gay Interest', 'World cinema', 'Drama', 'Ensemble Film']",1990,7
61061,Shanghai Express,1932,['United States of America'],"['Black-and-white', 'Thriller', 'Pre-Code', 'Drama']",1930,2
2966368,Sprung,1997,['United States of America'],"['Romance Film', 'Romantic comedy', 'Comedy']",1990,7
21321046,Antaheen,2009,['India'],"['Romance Film', 'Drama']",2000,9
32010654,Sandhya Mayangum Neram,1983,[],"['Drama', 'Comedy film']",1980,3
9478609,The Secret Life of Walter Mitty,1947,['United States of America'],"['Comedy', 'Fantasy Comedy', 'Musical comedy']",1940,7
3414692,Mulawin The Movie,2005,['Philippines'],"['Action', 'Filipino Movies', 'World cinema', 'Filipino', 'Fantasy']",2000,5
147213,Shoah,1985,['France'],"['History', 'World History', 'Documentary', 'Television movie', 'War film']",1980,5
9882012,Q Planes,1939,['United Kingdom'],['Spy'],1930,9
6500990,Atom Age Vampire,1963,['Italy'],"['Creature Film', 'Black-and-white', 'Horror', 'Science Fiction']",1960,3
23749476,"Pier 5, Havana",1959,['United States of America'],"['Mystery', 'Adventure', 'Thriller']",1950,9
8267463,The Lone Ranger,1938,['United States of America'],"['Action', 'Black-and-white', 'Action/Adventure', 'Western', 'Adventure', 'Drama', 'Family Film']",1930,8
1543560,Pokémon: Jirachi Wishmaker,2004,"['Japan', 'United States of America']","['Action', 'Animated cartoon', 'Action/Adventure', ""Children's"", 'Japanese Movies', 'Anime', 'Family Film', 'Fantasy']",2000,4
26457515,Honeycomb,1969,['Spain'],['Drama'],1960,9
9415844,Hasta el viento tiene miedo,1968,['Mexico'],['Horror'],1960,8
5555565,Convict 13,1920,['United States of America'],"['Black-and-white', 'Indie', 'Short Film', 'Comedy', 'Silent film', 'Black comedy', 'Slapstick']",1920,0
24829235,Desperate for Love,1989,['United States of America'],"['Romance Film', 'Romantic drama', 'Drama']",1980,9
361280,Sons of the Desert,1933,['United States of America'],"['Black-and-white', 'Slapstick', 'Comedy']",1930,3
10296157,Side Show,1931,['United States of America'],"['Black-and-white', 'Musical comedy']",1930,1
9737671,Hand in Hand,1960,['United Kingdom'],"['Drama', 'Family Film']",1960,0
7077541,Ninth Street,1999,['United States of America'],"['Indie', 'Comedy-drama', 'Drama', 'Ensemble Film']",1990,9
20174145,Get Bruce,1999,['United States of America'],['Documentary'],1990,9
18583474,Muthina Haara,1990,['India'],['War film'],1990,0
3742549,Dentist in the Chair,1960,['United Kingdom'],['Comedy'],1960,0
7694669,Saw IV,2007,"['Canada', 'United States of America']","['Crime Fiction', 'Thriller', 'Horror']",2000,7
6255163,The War in Space,1977,['Japan'],"['Japanese Movies', 'World cinema', 'Adventure', 'Science Fiction']",1970,7
1584494,The Assassination of Richard Nixon,2004,"['Mexico', 'United States of America']","['Period piece', 'Psychological thriller', 'Docudrama', 'Political drama', 'Drama']",2000,4
659894,Tricks,2007,['Poland'],"['Drama', 'World cinema']",2000,7
4519654,Salakhain,2004,['Pakistan'],"['Action', 'Drama']",2000,4
629350,Grand Theft Auto,1977,['United States of America'],"['Action', 'Road movie', 'Action Comedy', 'Action/Adventure', 'Comedy', 'Romantic comedy', 'Adventure']",1970,7
18070237,Double Harness,1933,['United States of America'],"['Black-and-white', 'Comedy', 'Romance Film', 'Drama']",1930,3
17156061,"Thank You, Mr. Moto",1937,['United States of America'],"['Detective fiction', 'Black-and-white', 'Crime Fiction', 'Mystery', 'Thriller', 'Detective']",1930,7
2155462,Out of the Wilderness,2001,['United States of America'],"['Family Drama', 'Television movie', 'Family Film', 'Adventure', 'Drama']",2000,1
4969220,Beautiful Joe,2000,"['United Kingdom', 'United States of America']","['Crime Fiction', 'Gangster Film', 'Indie', 'Comedy', 'Black comedy', 'Romance Film', 'Drama', 'Crime Comedy', 'Romantic comedy']",2000,0
14479942,Mithunam,1993,['India'],"['Musical', 'Comedy', 'Bollywood', 'Drama']",1990,3
7211476,Betty Boop's Penthouse,1933,['United States of America'],['Comedy'],1930,3
1019521,Warriors of Heaven and Earth,2003,"['China', 'Hong Kong']","['Action', 'Action/Adventure', 'World cinema', 'Wuxia', 'Chinese Movies', 'Martial Arts Film']",2000,3
2856157,"Dude, Where's the Party?",2003,['United States of America'],"['Indie', 'Comedy', 'Comedy of manners']",2000,3
68079,The African Queen,1951,['United Kingdom'],"['Action', 'Film adaptation', 'Action/Adventure', 'Romance Film', 'War film', 'Adventure', 'Drama']",1950,1
24672079,Smother,2008,['United States of America'],"['Comedy', 'Romance Film', 'Romantic comedy', 'Domestic Comedy', 'Comedy-drama']",2000,8
21142046,The Big Gay Musical,2009,['United States of America'],"['Musical', 'LGBT', 'Indie', 'Comedy', 'Romance Film', 'Drama', 'Gay Themed', 'Gay', 'Gay Interest', 'Romantic comedy']",2000,9
12181304,Back Street,1961,['United States of America'],['Drama'],1960,1
32013917,Jeene Ki Arzoo,1981,[],['Action'],1980,1
36092739,Woman in Hiding,1950,['United States of America'],"['Film noir', 'Drama', 'Thriller']",1950,0
9893014,Young and Dangerous 6: Born to Be King,2000,['Hong Kong'],"['Crime Fiction', 'Action/Adventure', 'Thriller', 'World cinema', 'Chinese Movies', 'Martial Arts Film']",2000,0
14209782,When Eight Bells Toll,1971,['United Kingdom'],"['Action', 'Thriller', 'Drama']",1970,1
24419018,Just Like Before,2006,['Philippines'],"['Musical', 'Filipino Movies', 'World cinema', 'Drama']",2000,6
30871261,The Ring Two,2005,['United States of America'],"['Mystery', 'Thriller', 'Horror', 'Supernatural', 'Drama', 'Cult']",2000,5
8407971,Sahara Hare,1955,['United States of America'],"['Animation', 'Short Film', 'Comedy', 'Family Film']",1950,5
3875986,Geethanjali,1989,['India'],"['Tollywood', 'Romantic drama', 'World cinema', 'Romance Film', 'Drama']",1980,9
8422241,100 Days,1991,['India'],"['Suspense', 'World cinema', 'Horror']",1990,1
14451664,Rockin' Thru the Rockies,1940,['United States of America'],"['Adventure Comedy', 'Black-and-white', 'Short Film', 'Comedy']",1940,0
76515,The Transformers: The Movie,1986,"['Japan', 'United States of America']","['Action', 'Animation', 'Indie', 'Adventure', 'Japanese Movies', 'Anime', 'Science Fiction', 'Family Film']",1980,6
14836463,Pyaasa Sawan,1981,['India'],"['Musical', 'Romantic drama', 'Bollywood', 'World cinema', 'Romance Film', 'Drama']",1980,1
26412737,Aalappirandhavan,1987,['India'],"['Action', 'Romance Film', 'Fantasy']",1980,7
10791880,Bairavi,1978,['India'],"['Drama', 'Crime Fiction']",1970,8
24046280,Un aller simple,2001,['France'],"['Drama', 'Comedy']",2000,1
7195862,Keep Cool,1997,"['China', 'Hong Kong']","['Comedy', 'Black comedy', 'Romantic comedy', 'Chinese Movies']",1990,7
11312191,The Imaginarium of Dr. Parnassus,2009,"['United Kingdom', 'France', 'Canada']","['Mystery', 'Adventure', 'Science Fiction', 'Fantasy']",2000,9
1006385,Sirens,1994,"['United Kingdom', 'New Zealand', 'Australia']","['Indie', 'Romantic drama', 'Comedy', 'World cinema', 'Romance Film', 'Drama', 'Romantic comedy', 'Religious Film']",1990,4
60157,The Good Earth,1937,['United States of America'],"['Period piece', 'Film adaptation', 'Black-and-white', 'Drama']",1930,7
13061445,Ab-normal Beauty,2004,['Hong Kong'],"['Chinese Movies', 'Thriller', 'Horror', 'World cinema']",2000,4
1812216,Coneheads,1993,['United States of America'],"['Parody', 'Science Fiction', 'Comedy']",1990,3
2643013,Book Revue,1946,['United States of America'],"['Animation', 'Short Film', 'Comedy', 'Family Film']",1940,6
749718,Going for Broke,2003,['United States of America'],['Drama'],2000,3
18703865,Swarna Kamalam,1988,['India'],['Musical'],1980,8
3150333,Baby Bottleneck,1946,['United States of America'],"['Animation', 'Short Film', 'Family Film']",1940,6
972940,Millennium,1989,"['Canada', 'United States of America']","['Time travel', 'Indie', 'Thriller', 'Science Fiction', 'Drama']",1980,9
1396697,Rog,2005,['India'],"['Romantic drama', 'Thriller', 'World cinema', 'Romance Film', 'Drama']",2000,5
1062036,Morgan Stewart's Coming Home,1987,['United States of America'],"['Indie', 'Comedy', 'Teen', 'Romance Film', 'Domestic Comedy']",1980,7
3569957,Monkey Shines,1988,['United States of America'],"['Psychological thriller', 'Slasher', 'Horror', 'Cult', 'Natural horror films']",1980,8
846311,Armed and Dangerous,1986,['United States of America'],"['Action', 'Gangster Film', 'Action/Adventure', 'Comedy', 'Slapstick']",1980,6
5973874,Carrotblanca,1995,['United States of America'],"['Short Film', 'Comedy', 'Family Film']",1990,5
15109392,A Terrible Beauty,1960,"['United Kingdom', 'United States of America']",['Drama'],1960,0
2010815,How to Make a Monster,2001,['United States of America'],"['Action', 'Monster movie', 'Horror', 'Television movie', 'Science Fiction']",2000,1
4045252,The Outrage,1964,['United States of America'],"['Western', 'Action/Adventure', 'Drama']",1960,4
8126959,Alice's Birthday,2009,['Russia'],"['Animation', 'Science Fiction', 'Family Film']",2000,9
456588,Cheaper by the Dozen,2003,['United States of America'],"['Comedy', 'Drama', 'Family Film']",2000,3
6791551,Circuit,2001,['United States of America'],"['Gay Themed', 'LGBT', 'Romance Film', 'Drama']",2000,1
23761430,No Greater Love,1996,['United States of America'],"['Film adaptation', 'Romantic drama', 'Romance Film', 'Television movie', 'Drama']",1990,6
3193176,The Brink's Job,1978,['United States of America'],"['Action', 'Heist', 'Crime Fiction', 'Caper story', 'Comedy', 'Drama']",1970,8
11943972,Allonsanfàn,1973,['Italy'],"['Period piece', 'History', 'Political drama', 'Drama']",1970,3
12145390,Satan's Sadists,1969,['United States of America'],"['Action', 'Crime Fiction', 'Indie', 'Action/Adventure', 'Thriller', 'Adventure', 'Biker Film', 'Horror']",1960,9
20190305,Portrait of a Beauty,2008,['South Korea'],"['Period piece', 'Romance Film', 'Social problem film', 'Historical fiction', 'Drama']",2000,8
19287252,Ru Ba Ru,2008,['India'],"['Musical', 'Romantic drama', 'Bollywood', 'World cinema', 'Romance Film', 'Drama']",2000,8
30380016,Saazish,1998,[],['Drama'],1990,8
242539,An Officer and a Gentleman,1982,['United States of America'],"['Romance Film', 'Romantic drama', 'Drama']",1980,2
879000,Destination Moon,1950,['United States of America'],"['Science Fiction', 'Adventure']",1950,0
26282515,Vilkkanundu Swapnangal,1980,['India'],['Drama'],1980,0
25054264,Villagelo Vinayakudu,2009,[],"['Action', 'Comedy film']",2000,9
7701711,Luck by Chance,2008,['India'],"['Musical', 'Romantic drama', 'Comedy', 'Bollywood', 'World cinema', 'Romance Film', 'Drama']",2000,8
372218,Grand Theft Parsons,2003,"['United Kingdom', 'United States of America']","['Crime Fiction', 'Indie', 'Comedy', 'Black comedy', 'Drama', 'Period piece', 'Comedy-drama', 'Road movie']",2000,3
4362030,Spiceworld,1998,['United Kingdom'],"['Musical', 'Parody', 'Comedy']",1990,8
15086146,Tiefland,1954,"['Germany', 'Austria', 'West Germany']","['Period piece', 'Black-and-white', 'Romantic drama', 'World cinema', 'Melodrama', 'Drama']",1950,4
1537627,Alatriste,2006,"['France', 'Spain', 'United States of America']","['Action/Adventure', 'Thriller', 'World cinema', 'War film', 'Adventure', 'Swashbuckler films']",2000,6
3252445,Zero Effect,1998,['United States of America'],"['Mystery', 'Indie', 'Comedy Thriller', 'Thriller', 'Comedy', 'Black comedy', 'Crime Thriller']",1990,8
8318237,Where the Lilies Bloom,1974,['United States of America'],"['Family Drama', 'Drama']",1970,4
8162204,Last Holiday,1950,['United Kingdom'],"['Black comedy', 'Drama']",1950,0
1797704,Electronic Labyrinth THX 1138:4EB,1967,['United States of America'],"['Short Film', 'Science Fiction']",1960,7
8770363,Harikrishnans,1998,['India'],"['Romance Film', 'Comedy']",1990,8
30715080,Anarkali,1966,[],['Romance Film'],1960,6
1815970,"The Cook, the Thief, His Wife & Her Lover",1989,"['United Kingdom', 'France']",['Drama'],1980,9
3274071,Come See the Paradise,1990,['United States of America'],"['Period piece', 'Romantic drama', 'Historical drama', 'Romance Film', 'Melodrama', 'War film', 'Drama']",1990,0
36200448,Mathilukal,1989,['India'],['Drama'],1980,9
32353405,Andy Hardy Gets Spring Fever,1939,['United States of America'],"['Coming of age', 'Comedy-drama']",1930,9
2144538,Side Street,1950,['United States of America'],"['Black-and-white', 'Crime Fiction', 'Thriller', 'Film noir', 'Drama']",1950,0
12401202,The Cyclops,1957,['United States of America'],"['Horror', 'Science Fiction']",1950,7
19773013,Tripwire,1990,['United States of America'],['Drama'],1990,0
5499618,My Sexiest Year,2007,['United States of America'],"['Period piece', 'Drama', 'Indie', 'Romantic drama', 'Comedy', 'Romance Film', 'Romantic comedy']",2000,7
7653582,The Death of the Incredible Hulk,1990,['United States of America'],"['Superhero', 'Superhero movie', 'Science Fiction', 'Drama']",1990,0
1278575,See No Evil,2006,['United States of America'],"['Slasher', 'Thriller', 'Horror']",2000,6
17828310,Padayottam,1982,['India'],"['Action', 'Drama', 'Thriller', 'War film']",1980,2
19661965,Acid Factory,2009,['India'],"['Action', 'Action Thrillers']",2000,9
4598013,The Blue Bird,1940,['United States of America'],"['Comedy', 'Adventure', 'Family Film', 'Fantasy']",1940,0
14882264,Charleston & Vendetta,2008,['Serbia'],"['Comedy', 'Drama', 'Fantasy']",2000,8
3146002,Sunday Bloody Sunday,1971,"['United Kingdom', 'England']","['Gay Themed', 'LGBT', 'Gay', 'Romantic drama', 'Gay Interest', 'Romance Film', 'Drama']",1970,1
13539323,Home in Indiana,1944,['United States of America'],['Adventure'],1940,4
24010250,Machine Gun Mama,1944,['United States of America'],"['Black-and-white', 'Action/Adventure', 'Comedy', 'Adventure', 'Romance Film']",1940,4
6969350,Heimkehr,1941,"['Austria', 'Nazi Germany', 'Germany', 'Poland']",['Propaganda film'],1940,1
3644423,Variety Lights,1950,['Italy'],"['Drama', 'World cinema']",1950,0
28865396,Rajkumar,1996,['India'],"['Action/Adventure', 'World cinema']",1990,6
8212697,Rainy Dog,1997,['Japan'],"['Crime Fiction', 'Japanese Movies', 'Action/Adventure', 'World cinema', 'Crime Drama', 'Drama']",1990,7
20189060,Tell-Tale,2009,"['United Kingdom', 'United States of America']","['Psychological thriller', 'Mystery', 'Thriller', 'Crime Thriller']",2000,9
35766264,Golden Girl,1951,['United States of America'],['Musical'],1950,1
6557991,Dushman,1998,['India'],"['Bollywood', 'Drama']",1990,8
7870244,Dr. Pyckle and Mr. Pryde,1925,['United States of America'],"['Black-and-white', 'Indie', 'Short Film', 'Comedy', 'Silent film', 'Science Fiction']",1920,5
29381633,Aaj Ka Ravan,2000,['India'],"['Action', 'Drama']",2000,0
18084708,Girl Trouble,1942,['United States of America'],['Black-and-white'],1940,2
6081623,Le gendarme et les gendarmettes,1982,['France'],['Comedy'],1980,2
9382823,Below,2002,"['United Kingdom', 'United States of America']","['Supernatural', 'Thriller', 'Horror', 'War film', 'Science Fiction']",2000,2
9088886,Queen of the Damned,2002,"['United States of America', 'Australia']","['Music', 'Film adaptation', 'Horror', 'Fantasy']",2000,2
10560346,Dark Reel,2008,['United States of America'],"['Mystery', 'Slasher', 'Thriller', 'Horror', 'Crime Thriller', 'Drama']",2000,8
4122671,The Story of Qiu Ju,1992,"['China', 'Hong Kong']","['Art film', 'Satire', 'Comedy', 'World cinema', 'Comedy-drama', 'Chinese Movies', 'Drama']",1990,2
17862461,A Fractured Leghorn,1950,['United States of America'],['Animation'],1950,0
33773876,A Fever in the Blood,1961,['United States of America'],"['Comedy-drama', 'Political drama']",1960,1
265143,Red Dawn,1984,['United States of America'],"['Cold War', 'Action', 'Action/Adventure', 'Thriller', 'Disaster', 'Drama', 'Coming of age', 'War film']",1980,4
3548398,Spirit Trap,2005,['United Kingdom'],"['Supernatural', 'Haunted House Film', 'Horror']",2000,5
1591858,The High and the Mighty,1954,['United States of America'],"['Action', 'Airplanes and airports', 'Action/Adventure', 'Disaster', 'Adventure', 'Drama']",1950,4
9986161,El Mar de Lucas,1999,['Argentina'],"['Romantic drama', 'Indie', 'World cinema', 'Romance Film', 'Drama']",1990,9
171068,The Madness of King George,1994,['United Kingdom'],"['Biography', 'Comedy', 'Biographical film', 'Costume drama', 'Drama', 'Period piece', 'Political cinema', 'Historical fiction', 'Political drama', 'Comedy of manners']",1990,4
5890466,Double Happiness,1994,['Canada'],"['Drama', 'Indie', 'Comedy', 'Romance Film', 'Romantic comedy', 'Comedy-drama']",1990,4
7985929,Unrest,2006,['United States of America'],"['Supernatural', 'Cult', 'Horror']",2000,6
14408606,The Empty Canvas,1963,"['France', 'Italy']",['Drama'],1960,3
157172,Time Bandits,1981,['United Kingdom'],"['Fantasy Adventure', 'Indie', 'Fantasy Comedy', 'Comedy', 'Costume drama', 'Adventure', 'Time travel', 'Existentialism', 'Science Fiction', 'Family Film', 'Fantasy']",1980,1
7463777,Nagarik,1977,['India'],['Drama'],1970,7
6640066,Poovellam Un Vasam,2001,['India'],['Drama'],2000,1
1047834,Fist of Fury,1972,['Hong Kong'],"['Action', 'Action/Adventure', 'World cinema', 'Romance Film', 'Chinese Movies', 'Martial Arts Film']",1970,2
24227817,Su-ki-da,2005,['Japan'],"['Japanese Movies', 'Drama']",2000,5
2005101,I've Heard the Mermaids Singing,1987,['Canada'],"['LGBT', 'Indie', 'Romantic drama', 'Comedy', 'Romance Film', 'Drama', 'Gay Themed', 'Gay', 'Gay Interest', 'Workplace Comedy']",1980,7
28322355,The Ticket of Leave Man,1937,['United Kingdom'],"['Crime Fiction', 'Mystery', 'Thriller', 'Melodrama', 'Crime Thriller', 'Drama']",1930,7
2808281,The Batman vs. Dracula,2005,['United States of America'],"['Action', 'Animation', 'Action/Adventure', 'Thriller', 'Superhero movie', 'Fantasy']",2000,5
5895363,Little Nikita,1988,['United States of America'],"['Action', 'Suspense', 'Spy', 'Action Thrillers', 'Action/Adventure', 'Thriller', 'Drama']",1980,8
33010153,The Vow,1946,['Soviet Union'],['Drama'],1940,6
4485134,Garbo Talks,1984,['United States of America'],"['Comedy', 'Comedy-drama', 'Tragicomedy', 'Drama']",1980,4
4186478,He Knows You're Alone,1980,['United States of America'],"['Slasher', 'Horror']",1980,0
15088997,Hero,2007,['Japan'],['Japanese Movies'],2000,7
23921560,The Woman in the Hall,1947,['United Kingdom'],['Drama'],1940,7
28066996,Murder at Midnight,1931,['United States of America'],['Mystery'],1930,1
2100438,Scars of Dracula,1970,['United Kingdom'],['Horror'],1970,0
17176729,A Tale of a Naughty Girl,2002,['India'],['Drama'],2000,2
26383573,The Greatest,2009,['United States of America'],"['Romance Film', 'Indie', 'Drama']",2000,9
16972436,The Adams Chronicles,1976,[],"['Historical drama', 'Drama']",1970,6
10051590,MacArthur,1977,['United States of America'],"['Biography', 'Biographical film', 'War film', 'Drama']",1970,7
20813549,Bitter Springs,1950,"['United Kingdom', 'Australia']","['Adventure', 'Drama']",1950,0
61507,Libeled Lady,1936,['United States of America'],"['Black-and-white', 'Screwball comedy', 'Comedy']",1930,6
22607311,Overheard,2009,['Hong Kong'],"['Action', 'Crime Fiction', 'Thriller', 'World cinema', 'Chinese Movies', 'Adventure', 'Drama']",2000,9
8948959,The Beast of the City,1932,['United States of America'],"['Crime Fiction', 'Film noir', 'Melodrama', 'Pre-Code', 'Drama']",1930,2
34191227,143,2004,['India'],"['Action', 'Romance Film', 'Thriller']",2000,4
23909373,Good Luck!,2008,['India'],"['Musical', 'Romantic drama', 'Comedy', 'Bollywood', 'World cinema', 'Romance Film', 'Drama', 'Romantic comedy']",2000,8
4433680,The Big Swindle,2004,['South Korea'],"['Action', 'Crime Fiction']",2000,4
5892193,Loverboy,2005,['United States of America'],"['Film adaptation', 'Drama', 'Indie', 'Comedy', 'Romance Film']",2000,5
17228882,Dog Eat Dog,2007,['Colombia'],"['Action/Adventure', 'Thriller', 'World cinema', 'Crime Thriller']",2000,7
151461,Austin Powers: Goldmember,2002,['United States of America'],"['Action', 'Crime Fiction', 'Comedy']",2000,2
15063943,Aag Hi Aag,1987,['India'],['Action'],1980,7
5980485,Polish Wedding,1998,['United States of America'],"['Family Drama', 'Coming of age', 'Comedy', 'Romance Film', 'Domestic Comedy', 'Comedy-drama', 'Drama']",1990,8
27581436,Ruby Cairo,1993,"['United Kingdom', 'Japan', 'United States of America']","['Psychological thriller', 'Mystery', 'Japanese Movies', 'Thriller']",1990,3
955166,Lemora: A Child's Tale of the Supernatural,1975,['United States of America'],"['Horror', 'Erotic thriller', 'Erotica', 'Supernatural', 'Cult']",1970,5
22977613,I stormens öga,2009,['Sweden'],"['Mystery', 'Crime Fiction']",2000,9
17980087,The Subject Was Roses,1968,['United States of America'],['Drama'],1960,8
5915746,Spirit of '76,1990,['United States of America'],['Time travel'],1990,0
14736880,Uncivil War Birds,1946,['United States of America'],"['Short Film', 'Black-and-white', 'Comedy']",1940,6
1680034,Police Academy 5: Assignment Miami Beach,1988,['United States of America'],"['Action', 'Action/Adventure', 'Comedy', 'Slapstick']",1980,8
25507521,Made for Each Other,2009,['United States of America'],"['Black comedy', 'Indie', 'Comedy']",2000,9
79700,Anchors Aweigh,1945,['United States of America'],"['Musical', 'Comedy', 'Musical comedy', 'Romance Film', 'Romantic comedy']",1940,5
11448113,Friday After Next,2002,['United States of America'],"['Buddy film', 'Comedy']",2000,2
17367576,Ripley Under Ground,2005,['Germany'],"['Romance Film', 'Drama', 'Thriller']",2000,5
15978267,Latitude 55°,1982,['Canada'],"['Adventure', 'Drama']",1980,2
19931072,Dasvidaniya,2008,['India'],"['Drama', 'Comedy']",2000,8
11596102,Posse Cat,1954,['United States of America'],"['Short Film', 'Comedy', ""Children's/Family"", 'Family Film']",1950,4
1128175,A Sound of Thunder,2005,"['United Kingdom', 'Germany', 'Czech Republic', 'United States of America']","['Time travel', 'Thriller', 'Adventure', 'Doomsday film', 'Science Fiction', 'Drama', 'Fantasy']",2000,5
5922179,Scooby-Doo and the Legend of the Vampire,2003,['United States of America'],"['Adventure Comedy', 'Animation', 'Family-Oriented Adventure', ""Children's/Family"", 'Family Film']",2000,3
18596291,In Search of the Castaways,1962,['United States of America'],"['Science Fiction', ""Children's"", 'Fantasy']",1960,2
919546,Exorcist: The Beginning,2004,['United States of America'],"['Period piece', 'Psychological thriller', 'Horror', 'Supernatural', 'Cult']",2000,4
1658777,April Snow,2005,['South Korea'],"['Romantic drama', 'Drama']",2000,5
27418924,Aaron's Party: Live in Concert,2001,[],['Concert film'],2000,1
483727,The Court Jester,1956,['United States of America'],"['Action', 'Adventure Comedy', 'Musical', 'Action/Adventure', 'Comedy', 'Satire', 'Musical comedy', 'Costume drama', 'Adventure', 'Drama', 'Slapstick', 'Parody', 'Family Film']",1950,6
652418,Mr. Nice Guy,1997,['Hong Kong'],"['Action', 'Crime Fiction', 'Action/Adventure', 'Comedy', 'World cinema', 'Chinese Movies', 'Martial Arts Film']",1990,7
288303,X2,2003,"['Canada', 'United States of America']","['Action', 'Superhero', 'Action/Adventure', 'Thriller', 'Superhero movie', 'Science Fiction', 'Fantasy']",2000,3
23999017,The Legacy,2009,['Canada'],"['Indie', 'Drama']",2000,9
3721343,Sadie McKee,1934,['United States of America'],"['Black-and-white', 'Romantic drama', 'Romance Film', 'Melodrama', 'Drama']",1930,4
10802011,Numb,2007,"['Canada', 'United States of America']",['Drama'],2000,7
27996231,Guru Dakshina,1983,['India'],['Drama'],1980,3
25900138,Ennodishtam Koodamo,1992,['India'],"['Romance Film', 'Comedy']",1990,2
3905283,Zarak,1956,['United Kingdom'],"['Action', 'Romance Film', 'Adventure']",1950,6
4673182,Barbie as Rapunzel,2002,['United States of America'],"['Fairy tale', ""Children's Fantasy"", 'Animation', ""Children's/Family"", 'Fantasy', 'Family Film', 'Computer Animation']",2000,2
19127891,A Lost Lady,1934,['United States of America'],"['Black-and-white', 'Pre-Code', 'Drama']",1930,4
30000,Taxi Driver,1976,['United States of America'],"['Psychological thriller', 'Crime Fiction', 'Existentialism', 'Thriller', 'New Hollywood', 'Drama']",1970,6
27445179,Sunes sommar,1993,['Sweden'],"['Comedy', 'Family Film']",1990,3
9162738,Stablemates,1938,['United States of America'],"['Melodrama', 'Drama']",1930,8
6283664,Shortcut to Happiness,2001,['United States of America'],"['Comedy-drama', 'Fantasy']",2000,1
5107779,Poison Ivy: The New Seduction,1997,['United States of America'],"['Adult', 'Indie', 'Thriller', 'Crime Thriller', 'Drama', 'Softcore Porn', 'Erotic thriller', 'Erotica']",1990,7
5276217,La Femme de l'aviateur,1981,['France'],"['Romantic drama', 'Comedy', 'World cinema', 'Romance Film', 'Romantic comedy', 'Drama']",1980,1
3156227,"Honey, I Shrunk the Audience",1994,['United States of America'],"['Science Fiction', 'Short Film', 'Comedy']",1990,4
4993790,Uuno Turhapuro &ndash; This Is My Life,2004,['Finland'],['Comedy'],2000,4
12233995,Screamplay,1985,['United States of America'],"['Indie', 'Horror Comedy', 'Horror', 'Black comedy']",1980,5
8609048,Who Is Killing the Great Chefs of Europe?,1978,"['France', 'West Germany', 'Italy', 'United States of America']","['Crime Fiction', 'Mystery', 'Comedy', 'Thriller', 'Black comedy', 'Whodunit']",1970,8
341538,The Black Hole,1979,['United States of America'],"['Action', 'Adventure', 'Science Fiction', 'Family Film']",1970,9
2993903,Support Your Local Sheriff!,1969,['United States of America'],"['Action', 'Parody', 'Action/Adventure', 'Western', 'Comedy']",1960,9
24931589,Red River,2009,['China'],['Chinese Movies'],2000,9
8848174,Marigold,2006,"['United Kingdom', 'India', 'United States of America']","['Musical', 'Comedy', 'Romance Film', 'Romantic comedy']",2000,6
6770626,The Ladies Man,2000,['United States of America'],['Comedy'],2000,0
12127900,Miracle of the White Stallions,1963,['United States of America'],"['Family Drama', 'Animal Picture', 'War film', 'Adventure', 'Drama', 'Family Film']",1960,3
11383001,EX Machina,2007,['Japan'],"['Action', 'Animation', 'Action Thrillers', 'Action/Adventure', 'Thriller', 'Computer Animation', 'Japanese Movies', 'Anime', 'Science Fiction']",2000,7
5744809,Viva Cuba,2005,"['Cuba', 'France']","['Romantic drama', 'Comedy', 'Comedy film', 'World cinema', 'Romance Film', 'Drama']",2000,5
21580685,Black,2009,['France'],"['Thriller', 'World cinema']",2000,9
36090388,The 3rd Voice,1960,['United States of America'],"['Drama', 'Crime Thriller']",1960,0
642696,Beethoven's 4th,2001,['United States of America'],"['Comedy', 'Animal Picture', ""Children's/Family"", 'Family Film']",2000,1
33100124,Country Gentlemen,1936,['United States of America'],['Comedy'],1930,6
811907,Rouge,1988,['Hong Kong'],"['Romantic fantasy', 'Mystery', 'Romantic drama', 'World cinema', 'Romance Film', 'Chinese Movies', 'Drama', 'Fantasy']",1980,8
573912,Searching for Bobby Fischer,1993,['United States of America'],"['Biographical film', 'Childhood Drama', 'Docudrama', 'Drama']",1990,3
34809799,The Last Mercenary,1968,"['Spain', 'West Germany', 'Italy']","['Action', 'Drama', 'Adventure']",1960,8
3446666,"Tarzoon, Shame of the Jungle",1975,"['France', 'Belgium']","['Comedy', 'Animation']",1970,5
24583490,Anjada Gandu,1988,[],['Drama'],1980,8
33610926,A Chinese Ghost Story II,1990,['Hong Kong'],"['Action', 'Romantic drama', 'Action/Adventure', 'Comedy', 'World cinema', 'Romance Film', 'Chinese Movies', 'Martial Arts Film', 'Drama', 'Horror', 'Fantasy']",1990,0
637870,Only Yesterday,1991,['Japan'],"['Animation', 'Coming-of-age film', 'Romance Film', 'Anime', 'Drama']",1990,1
3990404,Hounddog,2007,['United States of America'],"['Musical', 'Period piece', 'Drama', 'Crime Fiction', 'Coming of age', 'Indie', 'Childhood Drama']",2000,7
31117400,When Hell Broke Loose,1958,['United States of America'],"['War film', 'Drama']",1950,8
4937659,Bombay Talkie,1970,['India'],"['Romantic drama', 'Bollywood', 'World cinema', 'Romance Film', 'Drama']",1970,0
1253851,Cursed,2004,"['Germany', 'United States of America']","['Comedy', 'Thriller', 'Horror']",2000,4
4335073,The Adventures of Sebastian Cole,1998,['United States of America'],"['LGBT', 'Indie', 'Comedy', 'Drama', 'Period piece', 'Coming of age', 'Domestic Comedy', 'Comedy-drama']",1990,8
3032552,Let's Get Skase,2001,['Australia'],['Comedy'],2000,1
5777733,Woman Haters,1934,['United States of America'],"['Black-and-white', 'Short Film', 'Comedy', 'Slapstick']",1930,4
5177364,Hathyar: Face to Face with Reality,2002,['India'],"['Action', 'Drama', 'Crime Fiction', 'Thriller']",2000,2
3148833,Once Bitten,1985,['United States of America'],"['Parody', 'Comedy', 'Teen', 'Horror', 'Romance Film', 'Romantic comedy']",1980,5
370064,Love Actually,2003,"['United Kingdom', 'France', 'United States of America']","['Comedy', 'Romantic comedy', 'Romance Film', 'Comedy-drama', 'Holiday Film', 'Drama', 'Ensemble Film']",2000,3
10760729,The Express,2008,"['Germany', 'United States of America']","['Period piece', 'Biography', 'Biopic [feature]', 'Sports', 'Drama']",2000,8
10640451,Mannan,1992,['India'],"['Romance Film', 'Drama']",1990,2
19398747,Chinna Thambi,1991,['India'],"['Romance Film', 'Drama']",1990,1
142623,Boeing Boeing,1965,['United States of America'],"['Comedy', 'Sex comedy']",1960,5
12336807,Luther,2003,"['Germany', 'United States of America']","['Biography', 'Biographical film', 'World cinema', 'Christian film', 'Costume drama', 'Drama', 'Period piece', 'Political drama']",2000,3
10020058,Destination Gobi,1953,['United States of America'],"['Action', 'War film', 'Adventure']",1950,3
14639639,Somberi,2008,['India'],['Drama'],2000,8
2301060,7 Faces of Dr. Lao,1964,['United States of America'],"['Film adaptation', 'Action/Adventure', 'Western', 'Comedy', 'Stop motion', 'Drama', 'Fantasy']",1960,4
26542029,The Cape Town Affair,1967,['South Africa'],"['Spy', 'Thriller', 'World cinema', 'Glamorized Spy Film']",1960,7
2792417,War and Peace,1968,"['Russia', 'Soviet Union']","['History', 'Romance Film', 'War film', 'Drama']",1960,8
4549179,Loveless in Los Angeles,2007,['United States of America'],"['Indie', 'Comedy', 'Romance Film', 'Romantic comedy']",2000,7
17653561,Cycle,2008,['India'],"['Drama', 'Comedy']",2000,8
16083779,The Challenge,1982,"['Japan', 'United States of America']","['Action', 'Drama']",1980,2
2249951,Deadly Friend,1986,['United States of America'],"['Film adaptation', 'Crime Fiction', 'Slasher', 'Thriller', 'Horror', 'Sci-Fi Horror', 'Science Fiction']",1980,6
4990409,Wild Things: Diamonds in the Rough,2005,['United States of America'],"['Sexploitation', 'Thriller']",2000,5
18555435,I Served the King of England,2007,"['Slovakia', 'Germany', 'Hungary', 'Czech Republic']","['Period piece', 'Comedy', 'World cinema', 'Romance Film', 'War film', 'Drama']",2000,7
4391098,Tarzan's Greatest Adventure,1959,['United Kingdom'],"['Action', 'Drama', 'Jungle Film', 'Adventure']",1950,9
21875520,Shantham,2001,['India'],"['Social problem film', 'Art film', 'Drama']",2000,1
18385147,Gracie's Choice,2004,[],"['Coming of age', 'Family Drama', 'Television movie', 'Drama']",2000,4
10640770,Siva,1989,['India'],"['Action', 'Bollywood']",1980,9
3150498,Baseball Bugs,1946,['United States of America'],['Animation'],1940,6
21906281,Something Evil,1972,['United States of America'],"['Thriller', 'Haunted House Film', 'Horror']",1970,2
2179326,The Wrong Arm of the Law,1963,['United Kingdom'],"['Black-and-white', 'Parody', 'Comedy', 'Crime Comedy']",1960,3
13023499,The April Fools,1969,['United States of America'],"['Romance Film', 'Drama', 'Comedy film']",1960,9
34150988,Der WiXXer,2004,[],['Parody'],2000,4
18658640,Brick Lane,2007,"['United Kingdom', 'India']","['Period piece', 'Film adaptation', 'Indie', 'Drama', 'Feminist Film']",2000,7
11076424,First Sunday,2008,['United States of America'],"['Action', 'Crime Fiction', 'Action/Adventure', 'Comedy', 'Drama', 'Heist', 'Crime Comedy', 'Religious Film']",2000,8
17306691,Anatharu,2007,['India'],"['Musical', 'Crime Fiction', 'Thriller', 'Drama']",2000,7
21015620,Fighting,2009,['United States of America'],"['Action', 'Boxing', 'Crime Fiction', 'Action/Adventure', 'Teen', 'Thriller', 'Martial Arts Film', 'Drama', 'Crime Drama', 'Sports']",2000,9
9803131,Calling Dr. Death,1943,['United States of America'],"['Psychological thriller', 'Black-and-white', 'Mystery', 'Thriller']",1940,3
20460767,10:10,2008,['India'],['Comedy-drama'],2000,8
22422976,To Find a Man,1972,['United States of America'],"['Indie', 'Drama']",1970,2
9924713,Perfect Harmony,1991,['United States of America'],"['Period piece', 'Coming of age', 'Family Drama', 'Teen', 'Television movie', 'Drama', 'Family Film']",1990,1
1885580,My Life as McDull,2001,['Hong Kong'],"['Animation', 'Comedy-drama', 'Chinese Movies', ""Children's"", 'Family Film']",2000,1
27965599,Cocktail,2006,"['China', 'Hong Kong']","['Romantic drama', 'World cinema', 'Romance Film', 'Chinese Movies', 'Drama']",2000,6
11952667,24 Hours in London,2000,['United Kingdom'],"['Action', 'Gangster Film', 'Action/Adventure', 'Thriller', 'Crime Thriller', 'Science Fiction']",2000,0
1068520,The Island,2005,['United States of America'],"['Action', 'Dystopia', 'Action/Adventure', 'Science Fiction', 'Thriller', 'Drama']",2000,5
25860552,First Shot,2002,"['Canada', 'United States of America']","['Action', 'Action/Adventure', 'Thriller', 'Television movie']",2000,2
11260507,Zibahkhana,2007,"['United Kingdom', 'Pakistan']","['Slasher', 'Horror']",2000,7
9886340,The Mystic Masseur,2001,"['United Kingdom', 'India', 'United States of America']","['Period piece', 'Film adaptation', 'Romantic drama', 'Romance Film', 'Political drama', 'Drama']",2000,1
4152250,Band of the Hand,1986,['United States of America'],"['Action', 'Crime Fiction', 'Action Thrillers', 'Action/Adventure', 'Thriller', 'Crime Thriller', 'Drama']",1980,6
1045723,Connie and Carla,2004,['United States of America'],"['LGBT', 'Buddy film', 'Comedy', 'Comedy of Errors']",2000,4
28692419,Dead Lenny,2006,['United States of America'],"['Action', 'Heist', 'Gangster Film', 'Action/Adventure', 'Comedy', 'Crime Comedy']",2000,6
9532900,I Even Met Happy Gypsies,1967,['Yugoslavia'],['Drama'],1960,7
2876564,The Punisher,1989,"['United States of America', 'Australia']","['Action', 'Crime Fiction', 'Action/Adventure', 'Thriller', 'Superhero movie', 'Drama']",1980,9
19601054,Avtaar,1983,['India'],['Bollywood'],1980,3
5334800,The Good German,2006,['United States of America'],"['Black-and-white', 'Crime Fiction', 'Mystery', 'Romantic drama', 'Thriller', 'Romance Film', 'Drama', 'Period piece']",2000,6
26152459,Better Late Than Never,1983,['United Kingdom'],['Comedy film'],1980,3
193847,"Heaven Knows, Mr. Allison",1957,['United States of America'],"['Action', 'Romantic drama', 'Action/Adventure', 'Romance Film', 'Comedy-drama', 'War film', 'Drama']",1950,7
6446061,Live and Let Die,1973,['United Kingdom'],"['Action', 'Blaxploitation', 'Crime Fiction', 'Action Thrillers', 'Action/Adventure', 'Thriller', 'Glamorized Spy Film', 'Adventure']",1970,3
2134506,Slim,1937,['United States of America'],"['Black-and-white', 'Melodrama', 'Drama']",1930,7
17357251,Shool,1999,['India'],"['Drama', 'Crime Thriller', 'Bollywood']",1990,9
5674209,Sugar Hill,1994,['United States of America'],"['Crime Fiction', 'Gangster Film', 'Indie', 'Thriller', 'Drama']",1990,4
2520267,Tart,2001,['United States of America'],"['Drama', 'Crime Fiction', 'Coming of age', 'Indie', 'Teen', 'Melodrama', 'Romance Film']",2000,1
5656393,Manasellam,2002,['India'],"['Romantic drama', 'World cinema', 'Romance Film', 'Drama']",2000,2
3084973,Shock Waves,1977,['United States of America'],"['Zombie Film', 'Cult', 'Horror']",1970,7
22278706,Canadian Pacific,1950,['United States of America'],['Western'],1950,0
16567366,Assembly,2007,"['Hong Kong', 'South Korea', 'China']","['Action/Adventure', 'World cinema', 'Chinese Movies', 'War film', 'Drama']",2000,7
30581507,Ma and Pa Kettle at Home,1954,['United States of America'],"['Slapstick', 'Comedy']",1950,4
35986999,The Kid with the 200 I.Q.,1983,['United States of America'],"['Family Film', 'Comedy film']",1980,3
4815412,Forbidden,1984,"['United Kingdom', 'West Germany', 'United States of America']",['Drama'],1980,4
23233876,48 Angels,2006,['United Kingdom'],['Drama'],2000,6
19747684,Time Out for Lessons,1939,['United States of America'],"['Short Film', 'Black-and-white', 'Comedy']",1930,9
5292154,Hellboy 2: The Golden Army,2008,['United States of America'],"['Action', 'Action/Adventure', 'Comedy', 'Thriller', 'Adventure', 'Superhero movie', 'Supernatural', 'Science Fiction', 'Fantasy']",2000,8
14872132,Shadows in the Palace,2007,['South Korea'],"['Detective fiction', 'Mystery', 'Thriller', 'Detective', 'Horror']",2000,7
14580154,Son of a General II,1991,['South Korea'],"['Action', 'Drama']",1990,1
30351490,When's Your Birthday?,1937,['United States of America'],"['Romance Film', 'Comedy']",1930,7
26308243,Pattalam,2003,['India'],"['Action', 'Drama', 'Comedy']",2000,3
17623115,Dawn of the world,2008,"['France', 'Germany']",['Drama'],2000,8
21382951,Love Takes Wing,2009,['United States of America'],"['Period piece', 'Film adaptation', 'Romantic drama', 'Television movie', 'Drama']",2000,9
1065748,Friday Night Lights,2004,['United States of America'],"['Action', 'Period piece', 'Film adaptation', 'Americana', 'Sports', 'Drama']",2000,4
25052188,"Santa, Jr.",2002,['United States of America'],"['Romance Film', 'Comedy', 'Fantasy']",2000,2
20334134,7-10 Split,2007,['United States of America'],"['Sports', 'Indie', 'Comedy']",2000,7
1201864,Jin-Roh: The Wolf Brigade,1999,['Japan'],"['Action', 'Animation', 'Japanese Movies', 'Anime', 'Fantasy']",1990,9
2164450,Phone,2002,['South Korea'],"['Mystery', 'Horror', 'World cinema', 'Drama']",2000,2
32895970,Rudd's New Selection,1921,[],['Silent film'],1920,1
34962547,"Lila, Lila",2009,['Germany'],['Comedy film'],2000,9
18762329,Soft Shell Man,2001,['Canada'],"['Romantic drama', 'Indie', 'Romance Film', 'Drama']",2000,1
10466367,Close My Eyes,1992,['United Kingdom'],"['Romance Film', 'Romantic drama', 'Drama']",1990,2
18472115,Janky Promoters,2009,['United States of America'],"['Comedy', 'Hip hop movies']",2000,9
5983218,Nutty But Nice,1940,['United States of America'],"['Black-and-white', 'Short Film', 'Comedy', 'Slapstick']",1940,0
10640149,Jeevan Mrityu,1970,['India'],"['Musical', 'Romantic drama', 'Bollywood', 'World cinema', 'Romance Film', 'Drama']",1970,0
26063763,Troublesome Night 17,2002,['Hong Kong'],"['Chinese Movies', 'Horror']",2000,2
181353,Leave Her to Heaven,1945,['United States of America'],"['Crime Fiction', 'Romantic drama', 'Crime Drama', 'Romance Film', 'Melodrama', 'Film noir', 'Drama']",1940,5
11140719,My Dear Marthandan,1990,['India'],['Drama'],1990,0
2560949,The Crimson Pirate,1952,['United States of America'],"['Adventure Comedy', 'Action', 'Costume Adventure', 'Action/Adventure', 'Comedy', 'Swashbuckler films', 'Adventure', 'Drama', 'Epic']",1950,2
1519783,Fantastic Four,2005,"['Germany', 'United States of America']","['Action', 'Action/Adventure', 'Superhero movie', 'Science Fiction', 'Fantasy']",2000,5
31029385,Los que no deben nacer,1953,['Mexico'],['Drama'],1950,3
25458401,The Unforgiven,2005,['South Korea'],['Drama'],2000,5
8870325,Better Than Sex,2000,"['France', 'New Zealand', 'Australia']","['Romantic drama', 'Comedy', 'World cinema', 'Romance Film', 'Drama', 'Romantic comedy', 'Comedy-drama', 'Sex comedy']",2000,0
9351454,The City of Lost Souls,2000,['Japan'],"['Crime Fiction', 'Japanese Movies', 'Gangster Film', 'Thriller', 'World cinema', 'Crime Thriller']",2000,0
963301,Joe Dirt,2001,['United States of America'],"['Action', 'Gross out', 'Gross-out film', 'Mystery', 'Comedy', 'Romance Film', 'Slapstick', 'Adventure']",2000,1
5246514,Pattiyal,2006,['India'],"['Musical', 'Gangster Film', 'Bollywood', 'World cinema', 'Drama']",2000,6
21984286,Angels of the Streets,1943,['France'],['Drama'],1940,3
9084375,She Couldn't Take It,1935,['United States of America'],['Comedy'],1930,5
8934867,Love Is A Fat Woman,1987,"['Argentina', 'Netherlands']",['Drama'],1980,7
32883730,While the Billy Boils,1921,[],"['Romance Film', 'Drama']",1920,1
2610276,Autopsy,2006,['United States of America'],"['Slasher', 'Thriller', 'Horror']",2000,6
728946,When a Man Loves a Woman,1994,['United States of America'],"['Romantic drama', 'Marriage Drama', 'Romance Film', 'Addiction Drama', 'Drama']",1990,4
2292864,Jury Duty,1995,['United States of America'],"['Slapstick', 'Comedy']",1990,5
14329804,The Band's Visit,2007,"['Israel', 'France', 'United States of America']","['Music', 'Comedy', 'World cinema', 'Drama', 'Slice of life story']",2000,7
481605,Batman Begins,2005,"['United Kingdom', 'United States of America']","['Action', 'Crime Fiction', 'Action Thrillers', 'Superhero', 'Action/Adventure', 'Thriller', 'Drama', 'Superhero movie', 'Crime Drama', 'Reboot']",2000,5
22264734,Veerana,1988,['India'],"['Action', 'Musical', 'Bollywood', 'World cinema', 'Horror', 'Drama']",1980,8
16543602,I'm Dancing as Fast as I Can,1982,['United States of America'],"['Biography', 'Biopic [feature]', 'Docudrama', 'Television movie', 'Addiction Drama', 'Drama']",1980,2
3751916,Morning Raga,2005,['India'],"['Art film', 'Drama', 'World cinema']",2000,5
2388346,Firecreek,1968,['United States of America'],"['Action', 'Revisionist Western', 'Western', 'Adventure']",1960,8
35633088,Wadjah Seorang Laki-laki,1971,['Indonesia'],[],1970,1
3610464,Angel and the Badman,1947,['United States of America'],"['Black-and-white', 'Romantic drama', 'Action/Adventure', 'Western', 'Romance Film', 'Drama']",1940,7
9972502,Sweet Kitty Bellairs,1930,['United States of America'],['Pre-Code'],1930,0
30437887,Thiruthalvaadi,1992,[],['Romance Film'],1990,2
4819015,Killer Nun,1978,['Italy'],"['Sexploitation', 'Horror', 'World cinema', 'Supernatural']",1970,8
34414128,The Dream Makers,1975,['United States of America'],"['Music', 'Drama']",1970,5
646009,Alive,1993,['United States of America'],"['Action', 'Film adaptation', 'Action/Adventure', 'Thriller', 'Disaster', 'Adventure', 'Drama', 'Airplanes and airports']",1990,3
26883668,Savage Harvest,1994,['United States of America'],"['Slasher', 'B-movie', 'Horror']",1990,4
33488749,Show,2002,['India'],"['Drama', 'Comedy film']",2000,2
6400083,The Saint in New York,1938,['United States of America'],['Black-and-white'],1930,8
33747875,Wedlock Deadlock,1947,[],['Short Film'],1940,7
6168923,American cowslip,2009,['United States of America'],"['Black comedy', 'Indie', 'Comedy']",2000,9
23283544,Granite Hotel,1940,['United States of America'],"['Animation', 'Short Film', 'Comedy film']",1940,0
3885386,Stuart Little 3: Call of the Wild,2005,['United States of America'],"['Fantasy Adventure', 'Animation', 'Comedy', 'Family-Oriented Adventure', ""Children's/Family"", 'Adventure', 'Computer Animation', 'Family Film', 'Fantasy']",2000,5
23994350,The F Word,2005,['United States of America'],"['Drama', 'Indie', 'Documentary', 'Political drama']",2000,5
3737649,Carry On Doctor,1967,['United Kingdom'],"['Parody', 'Slapstick', 'Comedy']",1960,7
17684652,Men Suddenly in Black,2003,['Hong Kong'],"['Gangster Film', 'Comedy', 'World cinema', 'Black comedy', 'Chinese Movies']",2000,3
1348451,This Rebel Breed,1960,['United States of America'],"['Melodrama', 'Drama']",1960,0
25105240,The Proud and the Damned,1969,['United States of America'],"['Action/Adventure', 'Western']",1960,9
12521963,"My best friend, General Vasili, son of Joseph Stalin",1991,['Russia'],['Drama'],1990,1
4736948,Pyare Mohan,2006,['India'],"['Musical', 'Romantic drama', 'Comedy', 'Bollywood', 'World cinema', 'Romance Film', 'Slapstick', 'Drama', 'Romantic comedy']",2000,6
213170,Totally Minnie,1987,"['Canada', 'United States of America']","['Musical', 'Family Film']",1980,7
241471,American Pie 2,2001,['United States of America'],"['Gross out', 'Gross-out film', 'Ensemble Film', 'Comedy', 'Teen', 'Romance Film', 'Sex comedy']",2000,1
5577964,Kamen Rider Blade: Missing Ace,2004,[],['Science Fiction'],2000,4
4199566,Dark Kingdom: The Dragon King,2004,"['United Kingdom', 'Germany', 'Italy', 'United States of America']","['Fantasy Adventure', 'Action/Adventure', 'Sword and sorcery', 'Sword and sorcery films', 'Fantasy']",2000,4
7088344,The End of Silliness?,1998,[],"['Musical', 'Animation', 'Short Film', ""Children's""]",1990,8
32987124,Son of the Morning Star,1991,['United States of America'],"['Historical fiction', 'Western', 'Biopic [feature]']",1990,1
32456683,Die Fahne von Kriwoj Rog,1967,['German Democratic Republic'],[],1960,7
7393241,Jwar Bhata,1944,['India'],['Drama'],1940,4
8433714,My Tale Is Hot,1964,['United States of America'],"['Sexploitation', 'Comedy', 'Pornographic movie', 'Adult', 'Fantasy']",1960,4
5382611,Unnai Thedi,1999,['India'],['Romance Film'],1990,9
27640601,Rough Cut,2008,['South Korea'],"['Action/Adventure', 'World cinema']",2000,8
334874,Shark Tale,2004,['United States of America'],"['Animation', 'Comedy', ""Children's/Family"", ""Children's"", 'Family Film', 'Computer Animation']",2000,4
18698642,Calvin Marshall,2008,['United States of America'],"['Coming of age', 'Indie', 'Comedy', 'Romantic comedy', 'Sports']",2000,8
314680,The Mask of Dimitrios,1944,['United States of America'],"['Psychological thriller', 'Black-and-white', 'Crime Fiction', 'Mystery', 'Thriller', 'Film noir', 'Drama']",1940,4
7018587,Minor Mishaps,2002,"['Sweden', 'Denmark']","['Drama', 'Comedy']",2000,2
31176526,Shanghai Blues,1984,['Hong Kong'],"['Musical', 'Chinese Movies', 'Comedy']",1980,4
3829646,What Have I Done To Deserve This?,1984,['Spain'],"['Crime Fiction', 'Comedy', 'World cinema', 'Black comedy', 'Domestic Comedy', 'Drama']",1980,4
23749706,Aye Auto,1990,['India'],['Comedy'],1990,0
3104299,Demons,1985,['Italy'],"['Horror', 'Zombie Film', 'Supernatural', 'Cult']",1980,5
28542374,Unrelated,2008,['United Kingdom'],['Drama'],2000,8
5759874,The Aftermath,2006,"['United Kingdom', 'United States of America']","['Drama', 'Television movie']",2000,6
2593578,The Saragossa Manuscript,1965,['Poland'],"['Surrealism', 'Fantasy Adventure', 'Art film', 'World cinema', 'Drama', 'Fantasy']",1960,5
15798260,Danger Signal,1945,['United States of America'],"['Black-and-white', 'Crime Fiction', 'Film noir', 'Drama']",1940,5
9701325,Advise and Consent,1962,['United States of America'],"['LGBT', 'Political drama', 'Drama', 'Courtroom Drama']",1960,2
2703340,National Lampoon's Christmas Vacation 2: Cousin Eddie's Island Adventure,2003,['United States of America'],"['Adventure Comedy', 'Parody', 'Comedy', 'Holiday Film', 'Slapstick', 'Christmas movie']",2000,3
982226,Rover Dangerfield,1991,['United States of America'],"['Animation', 'Comedy', ""Children's/Family"", 'Family Film']",1990,1
384673,Zero Patience,1993,['Canada'],"['Musical', 'LGBT', 'Heavenly Comedy', 'Indie', 'Comedy', 'Drama', 'Gay Themed', 'Gay', 'Gay Interest', 'Fantasy']",1990,3
9162177,El,1953,['Mexico'],['Drama'],1950,3
101813,The Family Man,2000,['United States of America'],"['Romantic drama', 'Comedy', 'Romance Film', 'Christmas movie', 'Drama', 'Time travel', 'Romantic comedy', 'Comedy-drama', 'Fantasy']",2000,0
10690185,Blood on Wolf Mountain,1936,['China'],"['Chinese Movies', 'Black-and-white']",1930,6
9411697,Sakura Wars: The Movie,2001,['Japan'],"['Action', 'Animation', 'World cinema', 'Sci-Fi Adventure', 'Adventure', 'Slice of life story', 'Japanese Movies', 'Anime', 'Science Fiction', 'Fantasy']",2000,1
19498574,"Kunstseidene Mädchen, Das",1960,"['France', 'Germany', 'West Germany', 'Italy']",['Black-and-white'],1960,0
30232900,Escapade,1935,['United States of America'],"['Romance Film', 'Comedy']",1930,5
5566154,Adventure,1925,['United States of America'],"['Silent film', 'Black-and-white', 'Indie']",1920,5
29062573,The Fall of Berlin,1949,['Soviet Union'],"['History', 'War film', 'Drama']",1940,9
1389099,Under the Tuscan Sun,2003,"['Italy', 'United States of America']","['Film adaptation', 'LGBT', 'Romantic drama', 'Comedy', 'Romance Film', 'Drama', 'Romantic comedy', 'Comedy-drama', 'Comedy of manners']",2000,3
23788777,Tehilim,2007,"['Israel', 'France']","['Family Drama', 'World cinema', 'Drama', 'Slice of life story']",2000,7
733213,The Princess Diaries 2: Royal Engagement,2004,['United States of America'],"['Comedy', 'Teen', 'Comedy of manners', 'Romance Film', 'Romantic comedy', 'Drama', 'Family Film']",2000,4
22781881,A Mother's Heart,1965,['Soviet Union'],[],1960,5
23019704,Apartment 1303,2007,['Japan'],"['Japanese Movies', 'Horror', 'World cinema', 'Supernatural']",2000,7
18001963,Akkare Akkare Akkare,1990,['India'],['Comedy'],1990,0
1594067,I Not Stupid,2002,['Singapore'],"['Drama', 'Comedy']",2000,2
23922107,There's Good Boos To-Night,1948,['United States of America'],"['Short Film', 'Animation']",1940,8
1125221,National Lampoon's Christmas Vacation,1989,['United States of America'],"['Slapstick', 'Comedy', 'Holiday Film', 'Christmas movie', 'Family Film']",1980,9
4734333,For One Night,2002,['United States of America'],['Drama'],2000,2
14864488,Galaxy of Terror,1981,['United States of America'],"['Action', 'Horror', 'Sci-Fi Horror', 'Science Fiction']",1980,1
1188399,Corvette K-225,1943,['United States of America'],"['Combat Films', 'Action', 'Black-and-white', 'Adventure', 'War film']",1940,3
26461072,Masquerade in Mexico,1945,['United States of America'],['Comedy film'],1940,5
24185486,The Animals Film,1982,['United Kingdom'],"['Drama', 'Documentary']",1980,2
3044641,The Long Memory,1952,['United Kingdom'],"['Film noir', 'Crime Fiction', 'Thriller']",1950,2
3749096,Fast Track,2007,"['South Korea', 'China', 'United States of America']","['Action', 'Action Thrillers', 'Comedy', 'Comedy film', 'Romance Film', 'Chinese Movies']",2000,7
9102499,Transit,2006,['Russia'],"['Crime Fiction', 'History', 'Comedy', 'War film', 'Drama']",2000,6
17961082,The Gay Falcon,1941,['United States of America'],"['Black-and-white', 'Detective fiction', 'Crime Fiction', 'Mystery', 'Detective', 'Romance Film', 'Crime Thriller']",1940,1
24475500,Women of the Sun,1982,['Australia'],['Drama'],1980,2
9584164,The Man Who Haunted Himself,1970,['United Kingdom'],"['Psychological thriller', 'Drama', 'Indie', 'Thriller', 'Supernatural', 'Fantasy']",1970,0
19454994,An Englishman in New York,2009,"['United Kingdom', 'United States of America']","['LGBT', 'Biography', 'Biographical film', 'Drama', 'Period piece', 'Gay Themed', 'Gay', 'Gay Interest', 'Biopic [feature]', 'Television movie', 'Comedy-drama']",2000,9
31029811,The Belgrade Phantom,2009,"['Serbia', 'Bulgaria', 'Hungary']","['Action', 'Drama', 'Crime Fiction', 'Thriller']",2000,9
2470904,28 Days,2000,['United States of America'],"['Comedy', 'Romantic comedy', 'Comedy-drama', 'Addiction Drama', 'Drama']",2000,0
5777653,Ali Baba Bunny,1957,['United States of America'],"['Comedy', ""Children's/Family""]",1950,7
34674320,The Hound of London,1993,"['Luxembourg', 'Canada']","['Detective fiction', 'Crime Fiction', 'Thriller']",1990,3
18033896,A Wonderful Night in Split,2004,['Croatia'],"['Drama', 'World cinema']",2000,4
4878629,The Lost City,2006,['United States of America'],"['Romantic drama', 'Romance Film', 'Political drama', 'Drama']",2000,6
825828,Endless Love,1981,['United States of America'],"['Coming of age', 'Teen', 'Romance Film', 'Drama', 'Tragedy']",1980,1
9386367,The Family Secret,1924,['United States of America'],"['Black-and-white', 'Drama', 'Indie', 'Silent film']",1920,4
1076789,The Story of G.I. Joe,1945,['United States of America'],"['Combat Films', 'War film', 'Drama']",1940,5
3759292,Please Teach Me English,2003,['South Korea'],"['Romantic drama', 'Comedy', 'World cinema', 'Romance Film', 'Romantic comedy', 'Drama']",2000,3
10572390,Milan,1967,['India'],"['Musical', 'Romantic drama', 'Bollywood', 'World cinema', 'Romance Film', 'Drama']",1960,7
9068066,Ram Lakhan,1989,['India'],"['Action/Adventure', 'Bollywood', 'World cinema', 'Drama']",1980,9
431333,My Big Fat Greek Wedding,2002,"['Canada', 'United States of America']","['Indie', 'Comedy', 'Romance Film', 'Drama', 'Domestic Comedy', 'Romantic comedy', 'Comedy of manners', 'Ensemble Film']",2000,2
26291046,Kannezhuthi Pottum Thottu,1999,['India'],['Drama'],1990,9
2273470,One Eight Seven,1997,['United States of America'],"['Drama', 'Crime Fiction', 'Thriller']",1990,7
19626582,Chinna Mapillai,1993,['India'],"['Romance Film', 'Drama']",1990,3
2175059,A Very Natural Thing,1973,['United States of America'],"['Gay Themed', 'LGBT', 'Gay', 'Gay Interest', 'Romance Film', 'Drama']",1970,3
1614771,Freaked,1993,['United States of America'],"['Indie', 'Parody', 'Comedy', 'Black comedy', 'Science Fiction', 'Absurdism']",1990,3
28417619,The Return of Carol Deane,1938,[],['Crime Fiction'],1930,8
570240,All Monsters Attack,1969,['Japan'],"['Japanese Movies', 'Monster', 'Science Fiction', 'Cult', 'Fantasy']",1960,9
23713094,Man Without a Star,1955,['United States of America'],['Western'],1950,5
12070585,"Texas, Adios",1967,"['Spain', 'Italy']","['Western', 'Action/Adventure', 'World cinema']",1960,7
5734570,Shiner,2004,['United States of America'],"['LGBT', 'Drama', 'Indie']",2000,4
20320591,Rich in Love,1993,['United States of America'],"['Film adaptation', 'Drama', 'Family Drama', 'Indie', 'Coming of age', 'Comedy-drama']",1990,3
15912300,Bharatha Vilas,1973,['India'],['Drama'],1970,3
17625647,Doppelganger,2003,['Japan'],"['Japanese Movies', 'Comedy', 'Thriller', 'World cinema', 'Horror', 'Supernatural']",2000,3
12271677,Toss,2007,['India'],['Action'],2000,7
19107204,Little Boy Boo,1954,['United States of America'],"['Animation', 'Short Film', 'Family Film']",1950,4
14422284,The Working Man,1933,['United States of America'],"['Black-and-white', 'Comedy-drama']",1930,3
5496726,Riff-Raff,1990,['United Kingdom'],"['Social problem film', 'Comedy-drama']",1990,0
28796274,Haunted Mansion,1998,['Hong Kong'],"['Drama', 'Chinese Movies', 'Horror']",1990,8
9975140,D.E.B.S.,2003,['United States of America'],"['Action', 'LGBT', 'Indie', 'Action/Adventure', 'Comedy', 'Romance Film', 'Parody', 'Short Film']",2000,3
7521477,Betty Boop's May Party,1933,['United States of America'],"['Animation', 'Short Film', 'Comedy film', 'Family Film']",1930,3
435412,Hitler: The Last Ten Days,1973,"['United Kingdom', 'Italy']","['Biopic [feature]', 'Political drama', 'Docudrama', 'War film', 'Drama']",1970,3
2161222,Sarkar,2005,['India'],"['Crime Fiction', 'Gangster Film', 'Action/Adventure', 'Thriller', 'Bollywood', 'World cinema', 'Drama', 'Crime Drama']",2000,5
118569,Topkapi,1964,['United States of America'],"['Action', 'Film adaptation', 'Crime Fiction', 'Action/Adventure', 'Comedy', 'Drama', 'Heist', 'Caper story', 'Crime Comedy']",1960,4
23962337,Le Père Noël est une ordure,1982,['France'],"['Comedy', 'Comedy film']",1980,2
3477126,Leviathan,1989,"['Italy', 'United States of America']","['Action', 'Action/Adventure', 'Thriller', 'Horror', 'Science Fiction', 'Natural horror films']",1980,9
168747,"Truly, Madly, Deeply",1991,"['United Kingdom', 'England']","['Music', 'Romantic fantasy', 'Romantic drama', 'Comedy', 'Romance Film', 'Drama', 'Heaven-Can-Wait Fantasies', 'Romantic comedy', 'Fantasy']",1990,1
20579735,Dharti,1970,['India'],"['Action', 'Drama', 'Romantic drama', 'World cinema', 'Romance Film']",1970,0
2294860,The Fortune,1975,['United States of America'],"['Screwball comedy', 'Comedy', 'Crime Comedy', 'Slapstick']",1970,5
16044362,Bienvenue chez les Ch'tis,2008,['France'],"['Comedy', 'Satire']",2000,8
8208854,Out of Time,1988,['United States of America'],['Science Fiction'],1980,8
473273,Jurassic Park III,2001,['United States of America'],"['Action', 'Monster', 'Action/Adventure', 'Thriller', 'Adventure', 'Horror', 'Science Fiction', 'Natural horror films']",2000,1
13771225,Change of Mind,1964,['United States of America'],"['Thriller', 'Social problem film', 'Science Fiction', 'Drama']",1960,4
1179416,First Knight,1995,['United States of America'],"['Costume Adventure', 'Romantic drama', 'Romance Film', 'Costume drama', 'Adventure', 'Drama', 'Period piece', 'Fantasy']",1990,5
2225976,Candleshoe,1977,"['United Kingdom', 'United States of America']","['Comedy', 'Family-Oriented Adventure', ""Children's/Family"", 'Adventure', 'Drama', 'Family Film']",1970,7
30582,The Sixth Sense,1999,['United States of America'],"['Suspense', 'Psychological thriller', 'Thriller', 'Childhood Drama', 'Horror', 'Supernatural', 'Drama']",1990,9
18158404,Dr. Horrible's Sing-Along Blog,2008,['United States of America'],"['Musical', 'Indie', 'Action/Adventure', 'Comedy', 'Superhero movie']",2000,8
14838516,Street Fighter: The Legend of Chun-Li,2009,"['Canada', 'Japan', 'India', 'United States of America']","['Action', 'Crime Fiction', 'Action Thrillers', 'Action/Adventure', 'Thriller', 'Martial Arts Film', 'Japanese Movies', 'Fantasy']",2000,9
17544255,Knowing,2009,"['United Kingdom', 'Australia', 'United States of America']","['Mystery', 'Thriller', 'Science Fiction', 'Drama']",2000,9
26284769,Marry Me,1949,['United Kingdom'],"['Romance Film', 'Comedy']",1940,9
18778120,Crowing Pains,1947,['United States of America'],"['Animation', 'Short Film', 'Family Film']",1940,7
10010424,The Bride of the Regiment,1930,['United States of America'],"['Musical', 'Pre-Code']",1930,0
28183453,Memories of Me,1988,['United States of America'],"['Indie', 'Comedy', 'Drama']",1980,8
6538127,Mata Hari,1931,['United States of America'],"['Spy', 'Black-and-white', 'Thriller', 'Romance Film', 'Pre-Code', 'Drama']",1930,1
5311638,One Last Thing...,2006,['United States of America'],"['Drama', 'Family Drama', 'Indie', 'Coming of age', 'Comedy', 'Comedy-drama', 'Tragicomedy']",2000,6
22491070,Men's Group,2008,['Australia'],['Drama'],2000,8
10871232,Anurodh,1977,['India'],['Bollywood'],1970,7
34016021,Solla Thudikuthu Manasu,1988,[],['Drama'],1980,8
4769447,Mad Love,2001,"['Portugal', 'Spain', 'Italy']","['History', 'Romantic drama', 'Biographical film', 'World cinema', 'Romance Film', 'Drama']",2000,1
14437713,Pigs,2007,['Canada'],['Comedy'],2000,7
5659653,Wilby Wonderful,2004,['Canada'],"['LGBT', 'Drama', 'Indie', 'Comedy', 'Black comedy', 'Ensemble Film']",2000,4
172299,Dumbo,1941,['United States of America'],"['Music', 'Musical', 'Animation', 'Animated Musical', ""Children's/Family"", ""Children's"", 'Drama', ""Children's Fantasy"", 'Family Film', 'Fantasy']",1940,1
26252539,Key to the City,1950,['United States of America'],"['Romance Film', 'Comedy']",1950,0
33335661,The Egg-Cited Rooster,1952,[],"['Animation', 'Short Film', 'Family Film']",1950,2
33321463,Attack of the Helping Hand,1978,[],"['Short Film', 'Comedy film', 'Horror']",1970,8
29013002,Taxi for Two,1929,['United Kingdom'],"['Romance Film', 'Comedy film']",1920,9
33944586,Marumalarchi,1998,['India'],['Drama'],1990,8
28091651,Act of Love,1953,"['France', 'United States of America']","['Romance Film', 'War film', 'Drama']",1950,3
21546442,Between Heaven and Hell,1956,['United States of America'],"['Action', 'Film adaptation', 'Drama', 'Action/Adventure', 'War film']",1950,6
6415841,Meltdown,1995,"['China', 'Hong Kong']","['Action', 'Action/Adventure', 'Comedy', 'World cinema', 'Chinese Movies', 'Martial Arts Film']",1990,5
31640956,Lucky Partners,1940,[],['Romance Film'],1940,0
7681239,Kithakithalu,2006,['India'],"['Comedy', 'Comedy of manners']",2000,6
20518713,Woodpecker from Mars,1956,['United States of America'],"['Animation', 'Short Film', 'Comedy film', 'Science Fiction', 'Family Film']",1950,6
2999460,Jason and the Argonauts,2000,['United States of America'],"['Action/Adventure', 'Television movie', 'Costume drama', 'Adventure', 'Family Film', 'Fantasy']",2000,0
2666942,She Was an Acrobat's Daughter,1937,['United States of America'],"['Animation', 'Short Film', 'Comedy film']",1930,7
546663,A Woman of Paris,1923,['United States of America'],"['Black-and-white', 'Drama', 'Indie', 'Romantic drama', 'Silent film', 'Romance Film', 'Melodrama']",1920,3
12812600,Nazi Agent,1942,['United States of America'],"['Action', 'Spy', 'Black-and-white', 'Drama', 'War film']",1940,2
22884413,The Pursuit of Happiness,1971,['United States of America'],['Drama'],1970,1
1191730,The Wooden Horse,1950,['United Kingdom'],"['Adventure', 'Docudrama', 'War film', 'Escape Film', 'Drama']",1950,0
25913431,Destiny Turns on the Radio,1995,['United States of America'],"['Adventure', 'Fantasy Comedy']",1990,5
8277957,Desideria e l'Anello del Drago,1994,['Italy'],"['Family Film', 'Fantasy']",1990,4
16766524,RoboDoc,2008,['United States of America'],"['Parody', 'Science Fiction', 'Comedy']",2000,8
23450564,Samurai Sentai Shinkenger The Movie: The Fateful War,2009,['Japan'],"['Short Film', 'Japanese Movies']",2000,9
10625975,Avenging Eagle,1978,['Hong Kong'],"['Action', 'Wuxia', 'Chinese Movies', 'Martial Arts Film']",1970,8
11141678,Enakkul Oruvan,1984,['India'],"['Drama', 'Crime Fiction']",1980,4
9633312,Priyamanavale,2000,['India'],['Family Film'],2000,0
9734825,Shark Bait,2006,"['United States of America', 'South Korea']","['Family Film', 'Animation']",2000,6
23482287,Uro,2006,['Norway'],['Crime Fiction'],2000,6
33964976,Aabra Ka Daabra,2004,[],['Fantasy'],2000,4
7509120,The Garden of Allah,1936,['United States of America'],"['Romance Film', 'Romantic drama', 'Drama']",1930,6
29586011,Phantom of the Rue Morgue,1954,['United States of America'],"['Crime Fiction', 'Mystery', 'Horror']",1950,4
10376736,Carnival in Flanders,1935,"['France', 'Germany', 'Nazi Germany']","['Period piece', 'Black-and-white', 'Comedy', 'Comedy of manners', 'Romance Film', 'Romantic comedy', 'Comedy-drama']",1930,5
7286445,The Witches,1966,['United Kingdom'],"['Psycho-biddy', 'Supernatural', 'Horror']",1960,6
2572919,The Good Shepherd,2006,['United States of America'],"['Period piece', 'Spy', 'Thriller', 'Political drama', 'Drama']",2000,6
13917204,Nothing but the Truth,2008,['United States of America'],"['Thriller', 'Political drama', 'Drama', 'Political thriller']",2000,8
15734386,The Night of Counting the Years,1969,['Egypt'],['Drama'],1960,9
9013078,A Time of Destiny,1988,['United States of America'],"['Thriller', 'Melodrama', 'War film', 'Drama']",1980,8
5985595,5 Centimeters Per Second,2007,['Japan'],"['Animation', 'Japanese Movies', 'Romantic drama', 'Anime', 'Drama', 'Slice of life story']",2000,7
8581231,Birdman of Alcatraz,1962,['United States of America'],"['Prison', 'Drama', 'Biopic [feature]']",1960,2
242548,Silkwood,1983,['United States of America'],"['LGBT', 'Biographical film', 'Thriller', 'Biopic [feature]', 'Social problem film', 'Docudrama', 'Drama']",1980,3
4213209,Deceived,1991,['United States of America'],"['Psychological thriller', 'Suspense', 'Mystery', 'Thriller']",1990,1
25718062,The Master and His Servants,1959,['Norway'],['Drama'],1950,9
7816820,Shaolin Mantis,1978,['Hong Kong'],"['Action', 'Spy', 'Chinese Movies', 'Martial Arts Film', 'Adventure', 'Drama']",1970,8
45481,Soylent Green,1973,['United States of America'],"['Mystery', 'Thriller', 'Science Fiction', 'Drama']",1970,3
5526227,Birds Do It,1966,['United States of America'],"['Action', 'Spy', 'Comedy', ""Children's/Family""]",1960,6
1971531,Once Upon a Time in China II,1992,"['China', 'Hong Kong']","['Action', 'Martial Arts Film', 'Action Comedy', 'Action/Adventure', 'Comedy', 'World cinema', 'Chinese Movies']",1990,2
31085054,Appointment in Honduras,1953,['United States of America'],"['Action', 'Thriller', 'Comedy film', 'Romance Film', 'Adventure']",1950,3
27080141,Honeymoon,1947,[],"['Romance Film', 'Comedy']",1940,7
3339851,Athadu,2005,['India'],"['Action', 'Action/Adventure', 'Thriller', 'Tamil cinema', 'World cinema']",2000,5
11100390,Blændværk,1955,['Denmark'],['Crime Fiction'],1950,5
19165852,The Lady Is a Square,1959,['United Kingdom'],"['Musical', 'Comedy', 'Musical comedy', 'Romantic comedy']",1950,9
2467794,Comfort and Joy,1984,"['United Kingdom', 'Scotland']","['Black comedy', 'Comedy']",1980,4
14670375,Nagamandala,1997,['India'],['Drama'],1990,7
2154881,The Eiger Sanction,1975,['United States of America'],"['Action', 'Film adaptation', 'Action Thrillers', 'Action/Adventure', 'Thriller', 'Albino bias', 'Drama']",1970,5
2378034,November,2004,['United States of America'],"['Psychological thriller', 'Drama', 'Crime Fiction', 'Mystery', 'Indie', 'Thriller', 'Crime Thriller']",2000,4
2610454,Zombies,2006,['United States of America'],"['Zombie Film', 'Supernatural', 'Horror']",2000,6
20010929,Aamra,2006,['India'],"['Romantic drama', 'Comedy', 'Documentary']",2000,6
2959718,Bangers,1999,['Australia'],['Short Film'],1990,9
19063258,How to Find the Ideal,2007,['Ukraine'],['Comedy'],2000,7
24097616,The Music of Chance,1993,['United States of America'],['Drama'],1990,3
12009929,Two-Minute Warning,1976,['United States of America'],"['Action', 'Action Thrillers', 'Action/Adventure', 'Thriller', 'Disaster', 'Drama']",1970,6
3298184,Dirty Deeds,2002,"['New Zealand', 'Australia']","['Crime Fiction', 'Gangster Film', 'Thriller', 'World cinema', 'Black comedy', 'Crime Thriller', 'Drama', 'Period piece']",2000,2
32529040,Lament,1997,['South Korea'],"['Romance Film', 'Drama', 'World cinema']",1990,7
23642774,Darklands,1998,['United Kingdom'],['Horror'],1990,8
22501388,Angel Baby,1961,['United States of America'],"['Film adaptation', 'Drama']",1960,1
20226470,Bombay Dreams,2004,['Sweden'],['Comedy'],2000,4
20179415,Halloween,1978,['United States of America'],"['Indie', 'Slasher', 'Thriller', 'Horror', 'Teen', 'Cult']",1970,8
681931,Lady in the Lake,1947,['United States of America'],"['Black-and-white', 'Crime Fiction', 'Mystery', 'Thriller', 'Film noir', 'Point of view shot', 'Crime Thriller', 'Drama']",1940,7
3499096,Patriot Games,1992,['United States of America'],"['Action', 'Film adaptation', 'Crime Fiction', 'Action Thrillers', 'Action/Adventure', 'Thriller', 'Drama', 'War film', 'Political thriller']",1990,2
62687,All This and Heaven Too,1940,['United States of America'],"['Film adaptation', 'Black-and-white', 'Romantic drama', 'Marriage Drama', 'Romance Film', 'Melodrama', 'Drama']",1940,0
1011144,The Farmer's Wife,1928,['United Kingdom'],"['Black-and-white', 'Drama', 'Indie', 'Comedy', 'Silent film', 'Romance Film']",1920,8
11699514,12:01 PM,1993,['United States of America'],"['Psychological thriller', 'Thriller', 'Romance Film', 'Television movie', 'Science Fiction']",1990,3
33035035,Action Man: Robot Atak,2004,[],['Animation'],2000,4
13518788,Deewangee,2002,['India'],['Bollywood'],2000,2
16128109,The Trouble-Makers,2004,['Hong Kong'],"['Romantic drama', 'World cinema', 'Romance Film', 'Chinese Movies', 'Drama']",2000,4
3048149,Le Bateau sur l'herbe,1971,['France'],['Drama'],1970,1
24451216,Dread,2009,['United Kingdom'],"['Psychological thriller', 'Film adaptation', 'Slasher', 'Horror', 'Drama']",2000,9
19131114,Money No Enough 2,2008,['Singapore'],"['Drama', 'Comedy']",2000,8
32802295,The Ballad of G.I. Joe,2009,['United States of America'],"['Musical', 'Short Film', 'Comedy']",2000,9
14459667,Up the Down Staircase,1967,['United States of America'],"['Film adaptation', 'Coming of age', 'Drama']",1960,7
27416625,Vagdanam,1961,['India'],['Drama'],1960,1
32808282,Always Another Dawn,1949,['Australia'],"['War film', 'Drama']",1940,9
1195047,Baywatch: Hawaiian Wedding,2003,['United States of America'],"['Action', 'Television movie', 'Adventure', 'Drama']",2000,3
4278361,The Day the Earth Caught Fire,1961,['United Kingdom'],"['Doomsday film', 'Disaster', 'Science Fiction', 'Drama']",1960,1
2102931,Nice Dreams,1981,['United States of America'],"['Comedy', 'Cult']",1980,1
13295684,100 Proof,1997,['United States of America'],"['Crime Drama', 'Drama']",1990,7
22565456,Spring Fever,2009,"['France', 'Hong Kong', 'China']","['LGBT', 'Crime Fiction', 'Romantic drama', 'World cinema', 'Romance Film', 'Chinese Movies', 'Drama']",2000,9
20045605,Sepia Cinderella,1947,['United States of America'],"['Musical', 'Drama']",1940,7
7200857,I Think I Love My Wife,2007,['United States of America'],"['Comedy', 'Romance Film', 'Romantic comedy', 'Sex comedy']",2000,7
1274420,Ek Aur Ek Gyarah,2003,['India'],"['Musical', 'Action/Adventure', 'Bollywood', 'World cinema']",2000,3
27844598,Artham,1989,['India'],"['Crime Fiction', 'Drama', 'Comedy film']",1980,9
3342049,My Night at Maud's,1969,['France'],"['Romantic drama', 'Comedy of manners', 'World cinema', 'Romance Film', 'Comedy-drama', 'Drama']",1960,9
8993821,Adharm,1992,['India'],"['Musical', 'Bollywood', 'World cinema', 'Drama']",1990,2
16168190,Kuththu,2004,['India'],"['Musical', 'Romantic drama', 'Bollywood', 'World cinema', 'Romance Film', 'Drama']",2000,4
30921183,Tarzan and the Brown Prince,1972,"['Spain', 'Italy']",['Adventure'],1970,2
20712267,Wubbzy's Big Movie,2008,['United States of America'],['Animation'],2000,8
27057795,Goyokin,1969,['Japan'],"['Action', 'Samurai cinema', 'Japanese Movies', 'Action/Adventure', 'World cinema', 'Martial Arts Film']",1960,9
10115335,Relative Strangers,2006,['United States of America'],"['Indie', 'Comedy']",2000,6
18192517,Ramchand Pakistani,2008,"['United States of America', 'Pakistan']","['Social problem film', 'Drama', 'World cinema']",2000,8
24465420,Captured!,1933,['United States of America'],['War film'],1930,3
26709220,Ee Thanutha Veluppan Kalathu,1990,['India'],"['Mystery', 'Thriller']",1990,0
18350867,Humboldt County,2008,['United States of America'],"['Drama', 'Indie', 'Stoner film', 'Comedy', 'Comedy-drama', 'Slice of life story']",2000,8
3427588,April Fool's Day,1986,['United States of America'],"['Mystery', 'Slasher', 'Comedy', 'Teen', 'Horror']",1980,6
13913878,Adiyozhukkukal,1984,['India'],"['Action', 'Drama', 'Bollywood']",1980,4
3409107,By the Light of the Silvery Moon,1953,['United States of America'],"['Musical', 'Period piece', 'Romantic drama', 'Comedy', 'Romance Film', 'Romantic comedy', 'Drama']",1950,3
8747179,The Deviants,2004,['United States of America'],"['Indie', 'Comedy', 'Romance Film', 'Romantic comedy', 'Sex comedy']",2000,4
226519,The 7th Voyage of Sinbad,1958,['United States of America'],"['Action', 'Fantasy Adventure', 'Action/Adventure', 'Costume drama', 'Adventure', 'Mythological Fantasy', 'Stop motion', 'Family Film', 'Fantasy']",1950,8
5064191,Germany Year Zero,1947,"['France', 'Germany', 'Italy']","['Black-and-white', 'Drama', 'World cinema']",1940,7
4532800,The Serpent's Kiss,1997,['United Kingdom'],"['Period piece', 'Drama', 'Indie', 'Romantic drama', 'Romance Film', 'Melodrama', 'Comedy-drama']",1990,7
18471278,Veronika Decides to Die,2009,['United States of America'],"['Film adaptation', 'Indie', 'Drama']",2000,9
961437,Congo,1995,['United States of America'],"['Action', 'Film adaptation', 'Action/Adventure', 'Thriller', 'Jungle Film', 'Horror', 'Adventure']",1990,5
15194448,The Things of Life,1970,"['France', 'Switzerland', 'Italy']","['Romance Film', 'Drama']",1970,0
3711228,ON_LINE,2002,['United States of America'],"['LGBT', 'Indie', 'Romance Film', 'Drama']",2000,2
18220509,Ugly Aur Pagli,2008,['India'],"['Musical', 'Romantic drama', 'Comedy', 'Bollywood', 'World cinema', 'Romance Film', 'Drama', 'Romantic comedy']",2000,8
10575737,Crossroads,1937,['China'],"['Black-and-white', 'Drama', 'Chinese Movies']",1930,7
998111,Bored of Education,1936,['United States of America'],"['Short Film', 'Black-and-white', 'Comedy']",1930,6
8921890,I Was a Teenage Zombie,1987,['United States of America'],"['Comedy', 'Teen', 'Horror', 'Horror Comedy', 'B-movie', 'Zombie Film']",1980,7
23758209,Ever in My Heart,1933,['United States of America'],"['Romance Film', 'War film', 'Drama']",1930,3
3206129,The Court-Martial of Billy Mitchell,1955,['United States of America'],"['Biography', 'Drama', 'Courtroom Drama']",1950,5
4662560,Maniac,1963,['United Kingdom'],"['Thriller', 'Horror']",1960,3
163457,The Last Detail,1973,['United States of America'],"['Buddy film', 'Comedy', 'New Hollywood', 'Black comedy', 'Comedy-drama', 'Road movie', 'Drama']",1970,3
5725629,The Hand,1981,['United States of America'],"['Psychological thriller', 'Film adaptation', 'Horror', 'Supernatural', 'Drama', 'Cult']",1980,1
4636143,Nala Damayanthi,2003,['India'],['Comedy'],2000,3
1988806,Lolita,1997,"['United States of America', 'France']","['Film adaptation', 'Black comedy', 'Romance Film', 'Drama']",1990,7
29491325,The Real Macaw,1998,"['New Zealand', 'Australia']","['Adventure', 'Family Film']",1990,8
5501911,A Fine Mess,1986,['United States of America'],"['Crime Fiction', 'Comedy', 'Romantic comedy', 'Slapstick']",1980,6
29724018,Mickey's Movies,1928,['United States of America'],['Short Film'],1920,8
26007941,Valhalla Rising,2009,"['United Kingdom', 'Denmark']","['Action', 'Period piece', 'History', 'Action/Adventure', 'World cinema', 'Adventure', 'Drama']",2000,9
6917971,Love and Other Disasters,2006,"['United Kingdom', 'France', 'United States of America']","['LGBT', 'Comedy', 'Romance Film', 'Romantic comedy']",2000,6
3651016,The Face,1996,['United States of America'],"['Thriller', 'Drama']",1990,6
28903478,Handsome Harry,2009,['United States of America'],"['LGBT', 'Crime Fiction', 'Indie', 'Drama', 'Gay Themed', 'Gay', 'Gay Interest', 'Road movie']",2000,9
6148095,Red Trousers - The Life of the Hong Kong Stuntmen,2004,"['Hong Kong', 'United States of America']","['Action', 'Chinese Movies', 'World cinema', 'Documentary', 'Sports', 'Martial Arts Film']",2000,4
8492265,Tarzan Finds a Son!,1939,['United States of America'],"['Action', 'Black-and-white', 'Jungle Film', 'Adventure']",1930,9
6876496,The Old Maid,1939,['United States of America'],"['Black-and-white', 'Drama']",1930,9
21380964,Ski School,1991,"['Canada', 'United States of America']","['Sports', 'Comedy']",1990,1
23919719,Dancing with Crime,1947,['United Kingdom'],"['Crime Fiction', 'Mystery', 'Drama']",1940,7
5787607,Alien 51,2004,['United States of America'],"['Science Fiction', 'Natural horror films', 'Horror']",2000,4
591310,Tales from the Darkside: The Movie,1990,['United States of America'],"['Creature Film', 'Monster movie', 'Horror', 'Supernatural']",1990,0
24158745,Steal Big Steal Little,1995,['United States of America'],"['Parody', 'Satire', 'Comedy', 'Comedy-drama', 'Comedy of Errors']",1990,5
26479782,Sudigundalu,1967,['India'],['Drama'],1960,7
7194312,Chocolate,2001,['India'],[],2000,1
7379506,Place Vendôme,1998,['France'],"['Thriller', 'World cinema', 'Crime Thriller', 'Drama']",1990,8
14075290,Zany Adventures of Robin Hood,1984,['United States of America'],"['Political cinema', 'Parody', 'Slapstick', 'Comedy', 'Television movie', 'Costume drama']",1980,4
19388177,I Found Stella Parish,1935,['United States of America'],"['Black-and-white', 'Melodrama', 'Drama']",1930,5
9104281,Casanova Brown,1944,['United States of America'],"['Black-and-white', 'Screwball comedy', 'Comedy', 'Romance Film', 'Romantic comedy']",1940,4
10931357,Lady Assassin,1983,['Hong Kong'],"['Action', 'Adventure']",1980,3
1812196,Manichitrathazhu,1993,['India'],"['Psychological thriller', 'Comedy', 'Bollywood', 'Horror']",1990,3
8945770,The Stolen Jools,1931,['United States of America'],"['Black-and-white', 'Short Film', 'Comedy', 'Crime Comedy']",1930,1
8660233,Al final del espectro,2006,['Colombia'],"['Mystery', 'Thriller', 'Horror', 'Drama']",2000,6
7725707,Deception,1946,['United States of America'],"['Romantic drama', 'Film noir', 'Romance Film', 'Drama']",1940,6
23400698,Maasilamani,2009,['India'],['Action'],2000,9
20931003,Joyride,1996,['United States of America'],"['Suspense', 'Crime Thriller', 'Thriller']",1990,6
25342247,Twelve Men of Christmas,2009,['United States of America'],"['Comedy', 'Romance Film', 'Romantic comedy', 'Television movie']",2000,9
2524772,On the Double,1961,['United States of America'],"['Action', 'Action/Adventure', 'Comedy', 'War film', 'Comedy of Errors']",1960,1
21410691,Boys Over Flowers Final,2008,['Japan'],"['Japanese Movies', 'Comedy', 'World cinema', 'Romance Film', 'Drama']",2000,8
14526402,Phony Express,1943,['United States of America'],"['Short Film', 'Black-and-white', 'Comedy']",1940,3
1251285,Women on the Edge of a Nervous Breakdown,1988,['Spain'],"['Comedy', 'Drama', 'World cinema']",1980,8
2645237,Where the Truth Lies,2005,"['United Kingdom', 'United States of America', 'Canada']","['Film adaptation', 'LGBT', 'Crime Fiction', 'Mystery', 'Indie', 'Drama', 'Thriller']",2000,5
76619,"What's Opera, Doc?",1957,['United States of America'],"['Musical', 'Animation', 'Comedy']",1950,7
9939796,The Happening,2008,"['India', 'France', 'United States of America']","['Suspense', 'Action/Adventure', 'Thriller', 'Horror', 'Doomsday film', 'Disaster', 'Science Fiction']",2000,8
2804704,Gone with the Wind,1939,['United States of America'],"['Film adaptation', 'Romantic drama', 'Romance Film', 'Roadshow theatrical release', 'Costume drama', 'Drama', 'Period piece', 'Epic', 'War film']",1930,9
2282187,The Prophecy,1995,['United States of America'],"['Mystery', 'Thriller', 'Horror', 'Supernatural', 'Cult', 'Fantasy']",1990,5
5209312,One Night Stand,1997,['United States of America'],"['Indie', 'Drama']",1990,7
4586481,Maidstone,1970,['United States of America'],"['Indie', 'Political drama', 'Drama']",1970,0
6738531,Ajnabee,2001,['India'],['Bollywood'],2000,1
26723753,Torture Ship,1939,['United States of America'],"['B-movie', 'Science Fiction', 'Horror']",1930,9
24048171,Marie and Bruce,2005,['United States of America'],"['Indie', 'Comedy', 'Black comedy', 'Drama']",2000,5
23435832,Mahakaal,1993,['India'],"['Musical', 'Bollywood', 'Horror', 'World cinema']",1990,3
8267726,King of the Mounties,1942,['United States of America'],"['Action', 'Black-and-white', 'Northern', 'Adventure']",1940,2
9590609,While She Was Out,2008,"['Germany', 'United States of America', 'Canada']","['Psychological thriller', 'Suspense', 'Indie', 'Thriller', 'Horror', 'Crime Thriller']",2000,8
14384820,Saw V,2008,"['Canada', 'United States of America']","['Psychological thriller', 'Crime Fiction', 'Slasher', 'Thriller', 'Horror', 'Cult']",2000,8
31384964,Kabooliwala,1993,['India'],"['Romance Film', 'Comedy', 'Drama']",1990,3
415018,Bugsy and Mugsy,1957,['United States of America'],"['Animation', 'Short Film', 'Comedy', 'Family Film']",1950,7
4738997,Sailor Moon SuperS movie,1995,['Japan'],"['Action', 'Animation', 'Comedy', 'Romance Film', 'Anime', 'Family Film', 'Fantasy']",1990,5
17225987,Shubho Mahurat,2003,['India'],"['Crime Fiction', 'Mystery', 'Drama']",2000,3
3447732,Dennis the Menace,1993,['United States of America'],"['Comedy', 'Family Film']",1990,3
15927958,Love,2008,['Indonesia'],['Romance Film'],2000,8
6652508,Macbeth,2006,"['New Zealand', 'Australia']","['Film adaptation', 'Drama', 'Crime Fiction', 'Indie', 'Thriller', 'World cinema', 'Crime Thriller']",2000,6
1237529,Anne of Avonlea,1987,"['United Kingdom', 'United States of America', 'Canada']","['Period piece', 'Coming of age', 'Family Film']",1980,7
25333915,The Headless Woman,2008,['Argentina'],"['Psychological thriller', 'Thriller', 'World cinema', 'Drama']",2000,8
24544387,Worth Winning,1989,['United States of America'],"['Romance Film', 'Romantic comedy', 'Comedy']",1980,9
27079,Star Trek: Generations,1994,['United States of America'],"['Action', 'Science Fiction', 'Adventure']",1990,4
342556,They Live,1988,['United States of America'],"['Action', 'Political satire', 'Satire', 'Thriller', 'Black comedy', 'Dystopia', 'Horror', 'Alien invasion', 'Alien Film', 'Science Fiction']",1980,8
28077528,"Hail, Hero!",1969,['United States of America'],['Drama'],1960,9
25253732,King of Bollywood,2004,['India'],"['Musical', 'Comedy', 'Bollywood', 'World cinema']",2000,4
13699003,And the Band Played On,1993,['United States of America'],"['Film adaptation', 'LGBT', 'Television movie', 'Drama']",1990,3
7636003,The Zodiac,2006,['United States of America'],"['Psychological thriller', 'Crime Fiction', 'Mystery', 'Thriller', 'Crime Thriller', 'Docudrama', 'Drama']",2000,6
1070097,The Princess and the Warrior,2001,['Germany'],"['Crime Fiction', 'Mystery', 'Romantic drama', 'World cinema', 'Romance Film', 'Drama']",2000,1
29491798,Mickey's Disguises,1933,['United States of America'],['Short Film'],1930,3
2243921,Gone Nutty,2002,['United States of America'],"['Animation', 'Short Film', 'Comedy film', 'Family-Oriented Adventure', ""Children's/Family"", 'Family Film', 'Computer Animation']",2000,2
3099824,Category 7: The End of the World,2005,['United States of America'],"['Disaster', 'Thriller', 'Political thriller']",2000,5
28195972,The Disappeared,2008,['United Kingdom'],"['Psychological thriller', 'Horror']",2000,8
21733866,Parking,2008,"['China', 'Taiwan']","['World cinema', 'Comedy-drama', 'Chinese Movies', 'Drama']",2000,8
5038050,Hardly Working,1981,['United States of America'],"['Slapstick', 'Comedy']",1980,1
20672329,Chōkoku no Jikū e,2009,"['Japan', 'United States of America']","['Animation', 'Japanese Movies', 'Anime', ""Children's"", 'Family Film']",2000,9
24607416,Get Thrashed,2008,[],"['Music', 'Documentary']",2000,8
1596524,Heartbreak Ridge,1986,['United States of America'],"['Action', 'Drama', 'Action/Adventure', 'Black comedy', 'War film']",1980,6
1774116,The Killers,1946,['United States of America'],"['Black-and-white', 'Crime Fiction', 'Thriller', 'Film noir', 'Drama']",1940,6
2343735,A Lady Without Passport,1950,['United States of America'],"['Black-and-white', 'Crime Fiction', 'Film noir', 'Melodrama', 'Drama']",1950,0
31470445,"Sometime, Somewhere",1987,['India'],"['Drama', 'Comedy']",1980,7
24981250,Red Canyon,2009,['United States of America'],"['Action', 'Thriller', 'Horror']",2000,9
12561874,Boobs in Arms,1940,['United States of America'],"['Black-and-white', 'Screwball comedy', 'Short Film', 'Comedy', 'War film']",1940,0
2059591,Jett Jackson: The Movie,2001,['Canada'],"['Action', 'Comedy', 'Teen', 'Family-Oriented Adventure', 'Adventure', 'Family Film']",2000,1
19471956,Sex Sells: The Making of Touché,2005,['United States of America'],"['Sex comedy', 'Satire', 'Comedy', 'Mockumentary']",2000,5
31226363,Juan Colorado,1966,['Mexico'],"['Western', 'Drama']",1960,6
7324665,Cheech & Chong's The Corsican Brothers,1984,['United States of America'],"['Stoner film', 'Parody', 'Comedy', 'Adventure', 'Cult']",1980,4
31628381,Akashadoothu,1993,[],['Drama'],1990,3
20548913,Slappy and the Stinkers,1998,['United States of America'],"['Comedy', 'Animal Picture', 'Adventure', 'Family Film']",1990,8
21693066,Familles je vous hais,1997,['France'],['Drama'],1990,7
9219971,Battles Without Honor and Humanity: Hiroshima Deathmatch,1973,['Japan'],"['Crime Fiction', 'Japanese Movies', 'Drama']",1970,3
5207053,Ankahee,2006,['India'],"['Romantic drama', 'Bollywood', 'World cinema', 'Romance Film', 'Drama']",2000,6
22106018,City of Damnation,2009,['South Korea'],"['Action', 'Action Comedy', 'Comedy']",2000,9
13949810,Vatel,2000,"['United Kingdom', 'France', 'Belgium']","['Romantic drama', 'Biographical film', 'World cinema', 'Romance Film', 'Costume drama', 'Drama', 'Period piece', 'Historical fiction']",2000,0
31775991,Wives and Lovers,1963,['United States of America'],"['Film adaptation', 'Romantic drama', 'Comedy', 'Romance Film', 'Romantic comedy', 'Drama']",1960,3
24813968,Delta Force 3: The Killing Game,1991,['United States of America'],"['Action', 'Action Thrillers', 'Action/Adventure', 'Thriller']",1990,1
36057877,Sena,2003,['India'],['Crime Fiction'],2000,3
8649132,Compañeros,1970,"['Spain', 'West Germany', 'Italy']","['Action/Adventure', 'Western', 'Buddy film', 'World cinema', 'Spaghetti Western']",1970,0
195246,The Passion of the Christ,2004,['United States of America'],"['Period piece', 'Drama', 'History', 'Indie', 'Epic', 'Hagiography', 'Costume drama']",2000,4
4513177,Benji the Hunted,1987,['United States of America'],"['Animal Picture', 'Family-Oriented Adventure', ""Children's/Family"", 'Adventure', 'Family Film']",1980,7
31805985,Red Rose,1980,[],"['Musical', 'Crime Fiction', 'Thriller', 'Romance Film', 'Adventure']",1980,0
5006049,Ravanaprabhu,2001,['India'],"['Action', 'Bollywood']",2000,1
24196436,Barrister Parvateesam,1940,['India'],['Comedy-drama'],1940,0
27358005,Why Be Good?,1929,['United States of America'],['Comedy'],1920,9
1227317,Silver City,2004,['United States of America'],"['Crime Fiction', 'Mystery', 'Comedy', 'Satire', 'Thriller', 'Crime Thriller', 'Drama', 'Political cinema', 'Parody', 'Political drama', 'Political thriller']",2000,4
29940517,The Christmas Hope,2009,"['Canada', 'United States of America']",['Drama'],2000,9
19922240,Salt in the Wound,1969,['Italy'],"['War film', 'Drama']",1960,9
14076874,Kansas City Trucking Co.,1976,['United States of America'],"['Gay Themed', 'Gay', 'Gay Interest', 'Hardcore pornography', 'Pornographic movie', 'Gay pornography', 'Adult']",1970,6
30091529,Hindsight,2008,['United States of America'],"['Mystery', 'Crime Thriller', 'Thriller']",2000,8
885876,Streets of Fire,1984,['United States of America'],"['Musical', 'Action', 'Action Thrillers', 'Action/Adventure', 'Thriller', 'Adventure', 'Drama']",1980,4
22777559,The Railroad,2007,['South Korea'],"['Romance Film', 'Drama']",2000,7
14489319,Mickey's Delayed Date,1947,['United States of America'],"['Animation', 'Short Film', 'Comedy', 'Romance Film', 'Family Film']",1940,7
16040190,Mister Roberts,1955,['United States of America'],"['War film', 'Comedy', 'Family Film']",1950,5
7165700,Brice de nice,2005,['France'],"['Gross out', 'Gross-out film', 'Comedy', 'Teen']",2000,5
3643169,The General,1998,"['Ireland', 'United Kingdom']","['Crime Fiction', 'Gangster Film', 'Biography', 'Indie', 'Drama']",1990,8
25915620,Parampara,1990,['India'],"['Thriller', 'Drama']",1990,0
22333286,Slaves,1969,['United States of America'],['Drama'],1960,9
23471953,The Trojan Women,1971,"['United Kingdom', 'Greece', 'United States of America']","['Film adaptation', 'Drama']",1970,1
2870618,Boy called Twist,2004,['South Africa'],"['Film adaptation', 'Drama', 'Indie', 'World cinema']",2000,4
34805876,Pusher,1996,['Denmark'],"['Action', 'Crime Fiction', 'Gangster Film', 'Action/Adventure', 'Thriller', 'World cinema', 'Crime Thriller', 'Drama']",1990,6
7158830,Stalk of the Celery,1979,['United States of America'],"['Short Film', 'Animation']",1970,9
23700037,Keep 'Em Slugging,1943,['United States of America'],"['Romantic comedy', 'Melodrama', 'Comedy-drama']",1940,3
23823721,Strange Voices,1987,['United States of America'],"['Thriller', 'Drama']",1980,7
5847229,Firestorm,1998,['United States of America'],"['Action', 'Action/Adventure', 'Thriller', 'Disaster']",1990,8
1299974,Smiles of a Summer Night,1955,['Sweden'],"['Black-and-white', 'Comedy', 'Ensemble Film', 'Comedy of manners', 'World cinema', 'Romance Film', 'Sex comedy']",1950,5
26195967,Crazy Waiting,2008,['South Korea'],"['Romance Film', 'Comedy film']",2000,8
23974943,Bog,1984,['United States of America'],"['Horror', 'B-movie']",1980,4
24140977,Miracle Beach,1992,['United States of America'],"['Comedy', 'Teen', 'Romance Film', 'Romantic comedy', 'Fantasy']",1990,2
19954197,Web of Fear,1963,"['France', 'Spain']","['Thriller', 'Crime Thriller']",1960,3
5274269,Hulchul,2004,['India'],"['Musical', 'Romantic drama', 'Comedy', 'Bollywood', 'World cinema', 'Romance Film', 'Drama', 'Romantic comedy']",2000,4
15186845,Porky & Daffy,1938,['United States of America'],"['Animation', 'Short Film', 'Comedy', 'Sports', 'Family Film']",1930,8
6439718,FernGully 2: The Magical Rescue,1998,['United States of America'],"[""Children's Fantasy"", 'Animation', ""Children's/Family"", 'Family Film', 'Fantasy']",1990,8
1908238,The Da Vinci Code,2006,['United States of America'],"['Mystery', 'Crime Thriller', 'Thriller']",2000,6
11558403,Our Modern Maidens,1929,['United States of America'],"['Black-and-white', 'Drama', 'Indie', 'Romantic drama', 'Comedy', 'Silent film', 'Pre-Code']",1920,9
1120730,Mr. Bean's Holiday,2007,"['United Kingdom', 'France', 'Germany']","['Slapstick', 'Comedy', 'Family Film']",2000,7
13076317,The Pajama Game,1957,['United States of America'],"['Musical', 'Screwball comedy', 'Comedy']",1950,7
27624205,Bugs Bunny's 3rd Movie: 1001 Rabbit Tales,1982,['United States of America'],"['Animation', 'Comedy', 'Family Film']",1980,2
25308603,Dad's Week Off,1997,['United States of America'],['Comedy'],1990,7
13523313,Night Key,1937,['United States of America'],"['Black-and-white', 'Crime Fiction', 'Mystery', 'Thriller', 'Science Fiction']",1930,7
1891471,Another State of Mind,1984,['United States of America'],"['Biographical film', 'Documentary']",1980,4
16013696,Mikey,1992,['United States of America'],"['Crime Fiction', 'Thriller', 'Horror', 'Crime Thriller', 'Juvenile Delinquency Film']",1990,2
454208,The Butterfly Effect,2004,"['Canada', 'United States of America']","['Psychological thriller', 'Time travel', 'Thriller', 'Science Fiction']",2000,4
10990102,The Left Handed Gun,1958,['United States of America'],"['Black-and-white', 'Action/Adventure', 'Western', 'Biographical film', 'Drama']",1950,8
4515631,Zombie Nightmare,1986,['Canada'],"['Horror', 'Zombie Film']",1980,6
5747187,A Mother's Instinct,1996,['United States of America'],"['Mystery', 'Drama']",1990,6
9871185,Landing Stripling,1962,[],"['Animation', 'Short Film', 'Comedy', 'Family Film']",1960,2
2825438,The Goddess of 1967,2000,['Australia'],"['Comedy', 'World cinema', 'Comedy-drama', 'Road movie', 'Drama']",2000,0
11972652,La Cucaracha,1959,['Mexico'],"['Romance Film', 'War film', 'Drama']",1950,9
24665356,The Box,2003,['United States of America'],"['Drama', 'Crime Fiction', 'Thriller']",2000,3
8279688,King of the Rocket Men,1949,['United States of America'],"['Action', 'Black-and-white', 'Adventure', 'Science Fiction']",1940,9
264943,Nikita,1990,"['France', 'Italy']","['Action', 'Spy', 'Action/Adventure', 'Thriller', 'World cinema', 'Crime Thriller', 'Heist', 'Conspiracy fiction']",1990,0
24122155,Fit for a King,1937,['United States of America'],"['Romance Film', 'Black-and-white', 'Comedy']",1930,7
13938920,A Thunder of Drums,1961,['United States of America'],"['Western', 'Cavalry Film']",1960,1
30208772,Iruttinte Athmavu,1967,['India'],['Drama'],1960,7
6012909,Aya Sawan Jhoom Ke,1969,['India'],"['Romantic drama', 'World cinema', 'Romance Film', 'Drama']",1960,9
10142378,Conspiracy of Silence,2003,"['Ireland', 'United Kingdom']","['LGBT', 'Mystery', 'Thriller', 'Drama']",2000,3
18640429,Never Back Down,2008,['United States of America'],"['Action', 'Action/Adventure', 'Thriller', 'Teen', 'Martial Arts Film', 'Drama', 'Coming of age', 'Sports']",2000,8
24346395,Rope Hell,1978,['Japan'],"['Erotica', 'Japanese Movies', 'Pornographic movie']",1970,8
1839694,The Legend of Suriyothai,2001,['Thailand'],"['Action', 'Biographical film', 'World cinema', 'Adventure', 'Drama', 'History', 'Historical Epic', 'Epic', 'War film']",2000,1
18791512,Martial Law 2: Undercover,1991,['United States of America'],"['Action', 'Crime Fiction', 'Martial Arts Film']",1990,1
2996768,Jennifer,1978,['United States of America'],"['Indie', 'Thriller', 'Horror', 'Teen']",1970,8
22292130,Flashback,1969,['Italy'],"['War film', 'Drama']",1960,9
4595569,Roar,1997,['United States of America'],"['Action/Adventure', 'Jungle Film', 'Animal Picture', 'Family-Oriented Adventure', ""Children's/Family"", 'Adventure', 'Drama']",1990,7
401839,"Good bye, Lenin!",2003,['Germany'],"['Political cinema', 'Comedy', 'World cinema', 'Romance Film', 'War film', 'Drama']",2000,3
12560767,Harold,2008,['United States of America'],"['Coming of age', 'Comedy', 'Teen']",2000,8
5374099,Sonhos de Peixe,2006,"['Brazil', 'Russia', 'United States of America']","['Indie', 'Drama']",2000,6
21474496,Neshoba,2008,['Chile'],"['Social issues', 'Law & Crime', 'Crime Fiction', 'History', 'Documentary', 'Culture & Society']",2000,8
3126164,Bombaiyer Bombete,2003,['India'],"['Crime Fiction', 'Adventure', 'Family Film']",2000,3
1321819,The Jackal,1997,"['Japan', 'United Kingdom', 'France', 'Germany', 'United States of America']","['Action', 'Action Thrillers', 'Japanese Movies', 'Chase Movie', 'Action/Adventure', 'Thriller', 'Crime Thriller']",1990,7
28273975,The Night Walker,1964,['United States of America'],"['Mystery', 'Thriller', 'Horror']",1960,4
23801784,The Worst Witch,1986,['United States of America'],"['Adventure', 'Family Film']",1980,6
3729190,Guru,2007,['India'],"['Drama', 'Bollywood', 'World cinema']",2000,7
4930872,Chai Lai,2006,['Thailand'],"['Action', 'Action/Adventure', 'Thriller', 'World cinema', 'Martial Arts Film']",2000,6
1619410,Bushwhacked,1995,['United States of America'],"['Action', 'Action Comedy', 'Action/Adventure', 'Slapstick', 'Comedy']",1990,5
4560,Braveheart,1995,['United States of America'],"['Action', 'Biography', 'Action/Adventure', 'Costume drama', 'Adventure', 'Drama', 'Period piece', 'History', 'War film']",1990,5
24185289,Olangal,1982,['India'],['Drama'],1980,2
8966185,Isabella,2006,"['China', 'Hong Kong']","['Drama', 'Chinese Movies', 'World cinema']",2000,6
8201004,Dick Tracy,1937,['United States of America'],"['Action', 'Black-and-white', 'Crime Fiction', 'Mystery', 'Action/Adventure', 'Thriller', 'Crime Thriller', 'Adventure', 'Detective', 'Movie serial', 'Superhero movie']",1930,7
15411938,Muqabla,1993,['India'],"['Drama', 'World cinema']",1990,3
2069266,Ferry to Hong Kong,1959,['United Kingdom'],['Adventure'],1950,9
1953082,The Wraith,1986,['United States of America'],"['Action', 'Auto racing', 'Action/Adventure', 'Thriller', 'Horror', 'Supernatural', 'Science Fiction']",1980,6
1096485,The Gnome-Mobile,1967,['United States of America'],"['Musical', 'Adventure', 'Family Film', 'Fantasy']",1960,7
26131098,Nagarangalil Chennu Raparkam,1990,['India'],['Comedy'],1990,0
11256773,Mujhe Jeene Do,1963,['India'],"['Black-and-white', 'Crime Fiction', 'Bollywood', 'Drama']",1960,3
4526503,Jhankaar Beats,2003,['India'],"['Musical', 'Comedy', 'Bollywood', 'World cinema', 'Romance Film']",2000,3
985100,Flaming Star,1960,['United States of America'],"['Action/Adventure', 'Western', 'Indian Western', 'Drama']",1960,0
27888842,Queen of the Vampires,1968,['France'],"['World cinema', 'Horror']",1960,8
2122881,Moby Dick,1956,['United States of America'],"['Adventure', 'Drama']",1950,6
7500507,The Great Mom Swap,1995,['United States of America'],"['Domestic Comedy', 'Comedy-drama', 'Comedy']",1990,5
6255681,Anna to the Infinite Power,1983,['United States of America'],"['Film adaptation', 'Thriller', ""Children's/Family"", 'Science Fiction', 'Drama', 'Family Film']",1980,3
14470060,Sappy Bull Fighters,1959,['United States of America'],"['Short Film', 'Black-and-white', 'Comedy']",1950,9
17611179,Bits of Life,1921,['United States of America'],"['Black-and-white', 'Silent film', 'Anthology', 'Drama']",1920,1
4260564,The Second Arrival,1998,['United States of America'],"['Alien Film', 'Science Fiction']",1990,8
27305615,Saptaswaralu,1969,['India'],['Drama'],1960,9
20971048,Tumbleweed,1953,['United States of America'],"['Action/Adventure', 'Western']",1950,3
1235519,Weekend at Bernie's,1989,['United States of America'],"['Screwball comedy', 'Slapstick', 'Buddy film', 'Comedy', 'Black comedy', 'Adventure', 'Comedy of Errors']",1980,9
6612094,The Pursuit of D. B. Cooper,1981,['United States of America'],"['Crime Fiction', 'Comedy', 'Adventure']",1980,1
8303619,Brother Brat,1944,['United States of America'],"['Animation', 'Short Film', 'Comedy', 'Family Film']",1940,4
22773122,Alaska Seas,1954,['United States of America'],"['Period piece', 'Black-and-white', 'Crime Fiction', 'Thriller', 'Adventure', 'Drama']",1950,4
2246413,Ghost Rider,2007,"['United States of America', 'Australia']","['Action', 'Action/Adventure', 'Thriller', 'Adventure', 'Drama', 'Horror', 'Superhero movie', 'Fantasy']",2000,7
9248251,Así es la vida,1939,"['Argentina', 'United States of America']","['Black-and-white', 'Marriage Drama', 'Melodrama', 'Drama']",1930,9
15968947,Broken Angel,2008,['United States of America'],"['Family Drama', 'Melodrama', 'Addiction Drama', 'Drama']",2000,8
16130074,Ang Lihim ni Antonio,2008,['Philippines'],"['Filipino Movies', 'Gay Themed', 'LGBT', 'Gay', 'Gay Interest', 'World cinema', 'Drama']",2000,8
11796155,Zombie Night,2003,['Canada'],"['Creature Film', 'Comedy', 'Horror', 'B-movie', 'Zombie Film', 'Science Fiction']",2000,3
638459,The Conqueror,1956,['United States of America'],"['Costume drama', 'War film']",1950,6
11235388,Besharam,1978,['India'],['Family Drama'],1970,8
8365100,My Tutor,1983,['United States of America'],"['Drama', 'Coming of age', 'Indie', 'Comedy', 'Romantic comedy', 'Romance Film', 'Sex comedy']",1980,3
4405649,The Little Vampire,2000,"['United Kingdom', 'Germany', 'Netherlands', 'United States of America']","[""Children's Fantasy"", 'Comedy', 'Family-Oriented Adventure', ""Children's/Family"", ""Children's"", 'Family Film', 'Fantasy']",2000,0
542094,Cabin Fever,2002,['United States of America'],"['Thriller', 'Teen', 'Horror', 'Cult']",2000,2
22723513,Natalee Holloway,2009,['United States of America'],"['Crime Fiction', 'Mystery', 'Television movie', 'Drama']",2000,9
17865780,The Brøken,2008,"['United Kingdom', 'France']","['Psychological thriller', 'Indie', 'Thriller', 'Horror', 'Supernatural', 'Science Fiction']",2000,8
29829542,Balipeetam,1975,['India'],['Drama'],1970,5
1204925,The Opposite of Sex,1998,['United States of America'],"['LGBT', 'Indie', 'Comedy', 'Romance Film', 'Black comedy', 'Drama', 'Gay Themed', 'Gay', 'Gay Interest', 'Domestic Comedy', 'Romantic comedy']",1990,8
18829067,Homecoming,2005,"['Philippines', 'Canada', 'Japan', 'United States of America']","['Filipino Movies', 'Satire', 'World cinema', 'Zombie Film', 'Drama', 'Japanese Movies', 'Horror', 'Supernatural']",2000,5
5872569,Gudumba Shankar,2004,['India'],"['Tollywood', 'Drama', 'World cinema']",2000,4
26472079,Intimate Enemies,2007,['France'],['War film'],2000,7
3730804,Breaker! Breaker!,1977,['United States of America'],"['Action', 'Chase Movie', 'Action/Adventure', 'Thriller', 'Road movie', 'Martial Arts Film']",1970,7
5009558,Rollin' With The Nines,2006,['United Kingdom'],"['Action', 'Drama', 'Crime Fiction', 'Thriller']",2000,6
19111972,Shooter,2000,['Canada'],['Short Film'],2000,0
27106935,Unconscious,2004,"['Portugal', 'Spain', 'Germany', 'Italy']","['Mystery', 'Romantic drama', 'Comedy film', 'Romance Film', 'Romantic comedy', 'Drama']",2000,4
2099242,I Love You to Death,1990,['United States of America'],"['Action', 'Crime Fiction', 'Comedy', 'Crime Comedy', 'Black comedy']",1990,0
16888879,Sweeney!,1977,['United Kingdom'],"['Drama', 'Crime Fiction']",1970,7
22395193,The Last Frontier,1986,"['New Zealand', 'Australia', 'United States of America']","['Romance Film', 'Drama']",1980,6
7138643,Star Kid,1998,['United States of America'],"[""Children's Fantasy"", 'Indie', 'Adventure', ""Children's/Family"", 'Science Fiction', 'Family Film']",1990,8
14153517,Middlemarch,1994,['United Kingdom'],['Costume drama'],1990,4
23413256,The Secret of the Purple Reef,1960,[],"['Drama', 'Crime Fiction']",1960,0
2396634,House of Dark Shadows,1970,['United States of America'],"['Gothic Film', 'Horror', 'Romance Film', 'Drama']",1970,0
18589854,A Night to Remember,1942,['United States of America'],"['Black-and-white', 'Mystery', 'Comedy']",1940,2
21238681,Encirclement - Neo-Liberalism Ensnares Democracy,2008,['Canada'],"['Documentary', 'World cinema']",2000,8
13949859,Deceiver,1997,['United States of America'],"['Psychological thriller', 'Neo-noir', 'Crime Fiction', 'Mystery', 'Thriller', 'Crime Thriller', 'Drama']",1990,7
6644109,Princesas,2005,['Spain'],"['Drama', 'World cinema']",2000,5
7326436,Milano calibro 9,1972,['Italy'],"['Action', 'Crime Fiction', 'Action Thrillers', 'Action/Adventure', 'Thriller', 'World cinema', 'Crime Thriller', 'Drama']",1970,2
10622036,Pyar Hi Pyar,1969,['India'],"['Drama', 'World cinema']",1960,9
19344277,Devil's Feud Cake,1963,['United States of America'],"['Animation', 'Short Film', 'Comedy', 'Family Film']",1960,3
11994,Destroy All Monsters,1968,['Japan'],"['Action', 'Monster', 'Action/Adventure', 'World cinema', 'Monster movie', 'Japanese Movies', 'Science Fiction', 'Cult', 'Fantasy']",1960,8
8977593,American Flyers,1985,['United States of America'],"['Sports', 'Family Drama', 'Drama']",1980,5
17271180,Three Men on a Horse,1936,['United States of America'],"['Comedy', 'Black-and-white']",1930,6
805354,Ewoks: The Battle for Endor,1985,['United States of America'],"['Action', 'Adventure', ""Children's/Family"", 'Stop motion', 'Science Fiction']",1980,5
958920,Tall Tale,1995,['United States of America'],"['Western', 'Fantasy']",1990,5
1192770,How to Kill Your Neighbor's Dog,2002,"['United Kingdom', 'Germany', 'United States of America']","['Indie', 'Comedy', 'Comedy of manners', 'Black comedy', 'Comedy-drama']",2000,2
3365240,The Town That Dreaded Sundown,1976,['United States of America'],"['Crime Fiction', 'Mystery', 'Slasher', 'Thriller', 'Horror', 'Docudrama', 'Crime Thriller']",1970,6
576208,Hiding Out,1987,['United States of America'],"['Action', 'Crime Fiction', 'Indie', 'Action/Adventure', 'Comedy', 'Thriller', 'Teen', 'Crime Thriller', 'Drama', 'Comedy Thriller']",1980,7
14738921,Self-Made Maids,1950,['United States of America'],"['Short Film', 'Black-and-white', 'Comedy']",1950,0
11465088,Candles in the Dark,1993,['United States of America'],['Drama'],1990,3
35604925,Harischandraa,1999,['India'],['Romance Film'],1990,9
2576917,Evan Almighty,2007,['United States of America'],"['Heavenly Comedy', 'Parody', 'Comedy', 'Religious Film', 'Fantasy Comedy', 'Family Film', 'Fantasy']",2000,7
30049560,The Danish Experience,2003,[],"['Drama', 'Comedy film']",2000,3
20678281,Blood on the Arrow,1964,['United States of America'],"['Action', 'Western']",1960,4
19965135,Dangerous Touch,1994,['United States of America'],"['Erotic thriller', 'Drama', 'Thriller']",1990,4
27326285,The Tenth Circle,2008,['Canada'],"['Film adaptation', 'Mystery', 'Thriller', 'Television movie', 'Crime Thriller', 'Drama']",2000,8
2547388,Trees Lounge,1996,['United States of America'],"['Drama', 'Indie', 'Comedy', 'Comedy-drama', 'Slice of life story']",1990,6
29425225,"I, Justice",1968,[],['Psychological thriller'],1960,8
23658618,Wrong Turn 3: Left for Dead,2009,"['Germany', 'United States of America']","['Crime Fiction', 'Thriller', 'Horror']",2000,9
9770050,Stephanie Daley,2007,['United States of America'],"['Courtroom Drama', 'Crime Fiction', 'Indie', 'Drama', 'Feminist Film']",2000,7
24787384,Hare Trimmed,1953,[],"['Animation', 'Short Film', 'Comedy film', 'Family Film']",1950,3
18037052,Ganeshana Maduve,1990,['India'],"['Romantic comedy', 'Drama']",1990,0
29017970,Reichenbach Falls,2007,['United Kingdom'],"['Drama', 'Crime Thriller']",2000,7
6394318,Simple Men,1992,"['United Kingdom', 'Italy', 'United States of America']","['Crime Fiction', 'Indie', 'Comedy', 'Romance Film', 'Adventure', 'Drama', 'Romantic comedy', 'Comedy-drama']",1990,2
12085775,Eastern Condors,1987,['Hong Kong'],"['Action', 'Action/Adventure', 'World cinema', 'War film', 'Chinese Movies', 'Martial Arts Film']",1980,7
23707320,White Mile,1994,['United States of America'],"['Courtroom Drama', 'Drama']",1990,4
6025960,Pinjar,2003,"['India', 'Pakistan']","['Drama', 'World cinema']",2000,3
21206525,Weather Girl,2009,['United States of America'],['Comedy film'],2000,9
886698,PT 109,1963,['United States of America'],"['Biopic [feature]', 'Docudrama', 'War film', 'Drama']",1960,3
24317883,The Life,2002,['United States of America'],"['Short Film', 'Drama']",2000,2
2206417,Frankenstein Created Woman,1967,['United Kingdom'],"['Horror', 'Science Fiction']",1960,7
250699,Excalibur,1981,"['United Kingdom', 'United States of America']","['Fantasy Adventure', 'Action/Adventure', 'Costume drama', 'Adventure', 'Drama', 'Sword and sorcery films', 'Mythological Fantasy', 'Sword and sorcery', 'Fantasy']",1980,1
2667958,Deep Rising,1998,['United States of America'],"['Creature Film', 'Action', 'Action/Adventure', 'Horror', 'Sci-Fi Horror', 'Science Fiction', 'Natural horror films']",1990,8
13998597,The Burning Plain,2008,"['Argentina', 'United States of America']","['Romantic drama', 'Indie', 'Romance Film', 'Drama', 'Ensemble Film']",2000,8
6049239,Hot Lead and Cold Feet,1978,"['Canada', 'United States of America']","['Comedy Western', 'Action/Adventure', 'Western', 'Comedy', 'Family Film']",1970,8
2325367,Society,1989,['United States of America'],"['Suspense', 'Mystery', 'Indie', 'Comedy', 'Horror']",1980,9
2751452,Gideon,1999,['United States of America'],"['Comedy', 'Romance Film', 'Melodrama', 'Comedy-drama', 'Drama', 'Ensemble Film']",1990,9
8418367,Hair High,2004,['United States of America'],"['Animation', 'Horror Comedy', 'Comedy', 'Horror', 'Black comedy']",2000,4
17192514,Varudu,2009,['India'],"['Action', 'Drama', 'Crime Fiction', 'Thriller']",2000,9
5559264,Kastoori Nivasa,1971,['India'],['Drama'],1970,1
27539366,Ghost Machine,2009,['United Kingdom'],"['Suspense', 'Thriller', 'Supernatural', 'Science Fiction']",2000,9
6156481,Don't Fool Me,1991,['Hong Kong'],['Chinese Movies'],1990,1
9107230,Nenjirukkum Varai,2006,['India'],['Drama'],2000,6
22677923,Rainbow,1944,['Soviet Union'],['War film'],1940,4
29680415,Borrowed Hearts,1997,"['Canada', 'United States of America']","['Romantic drama', 'Family Drama', 'Romance Film', 'Television movie', 'Christmas movie', 'Drama', 'Family Film']",1990,7
2058218,The Legend of Billie Jean,1985,['United States of America'],"['Action', 'Drama', 'Crime Fiction', 'Coming of age', 'Indie', 'Chase Movie', 'Teen']",1980,5
24107943,The Man in the Raincoat,1957,"['France', 'Italy']","['Mystery', 'Comedy']",1950,7
18609739,Broken Embraces,2009,"['Spain', 'Slovak Republic', 'Czech Republic', 'United States of America']","['Biography', 'Romantic drama', 'Thriller', 'World cinema', 'Romance Film', 'Drama', 'Melodrama', 'Comedy-drama', 'Family Film']",2000,9
2806165,Willy the Sparrow,1988,['Hungary'],"[""Children's/Family"", 'Animation', 'Family Film']",1980,8
50957,Star Wars Episode II: Attack of the Clones,2002,['United States of America'],"['Action', 'Romance Film', 'Adventure', 'Fantasy', 'Space opera', 'Science Fiction', 'Family Film', 'Movies About Gladiators']",2000,2
14736271,Twists of Fate,2007,['Poland'],"['Social problem film', 'Drama']",2000,7
5828241,Lyle the Kindly Viking,2001,[],"['Musical', 'Animation', 'Short Film', ""Children's""]",2000,1
16731473,Up Tight!,1968,['United States of America'],"['Blaxploitation', 'Thriller', 'Crime Thriller', 'Political drama', 'Drama', 'Political thriller']",1960,8
4783723,A Lucky Dog,1921,['United States of America'],"['Black-and-white', 'Indie', 'Short Film', 'Comedy', 'Silent film']",1920,1
4048300,Two Cops,1993,['South Korea'],['Comedy'],1990,3
19184257,Hurricane Season,2009,['United States of America'],"['Sports', 'Drama']",2000,9
334865,Attack of the 50 Foot Woman,1958,['United States of America'],"['Creature Film', 'Science Fiction', 'Alien Film', 'Cult']",1950,8
17244774,Jaggubhai,2008,['India'],['Drama'],2000,8
3834305,Love in the Afternoon,1957,['United States of America'],"['Black-and-white', 'Romantic drama', 'Comedy', 'Romance Film', 'Romantic comedy', 'Drama']",1950,7
6045984,Castaway Cowboy,1974,['United States of America'],"['Western', 'Comedy', 'Family-Oriented Adventure', 'Adventure', 'Family Film']",1970,4
15749688,A Very Serious Person,2006,['United States of America'],"['Gay Themed', 'LGBT', 'Drama', 'Indie', 'Coming of age', 'Comedy-drama']",2000,6
11762841,Spy Kids,2001,['United States of America'],"['Action', 'Spy', ""Children's"", 'Comedy', 'Adventure', 'Science Fiction', 'Family Film']",2000,1
20648252,"Jasper, Texas",2003,['United States of America'],"['Crime Fiction', 'Social problem film', 'Television movie', 'Docudrama', 'Drama', 'Courtroom Drama']",2000,3
5589600,Alai,2005,['India'],"['Romantic drama', 'Tamil cinema', 'World cinema', 'Romance Film', 'Drama']",2000,5
19948005,Those Wonderful Years that Sucked,1997,['Czech Republic'],"['Comedy', 'Drama', 'Ensemble Film']",1990,7
7169738,The Clones of Bruce Lee,1981,['Hong Kong'],"['Action', 'Bruceploitation', 'Chinese Movies', 'Martial Arts Film']",1980,1
20547048,The Constant Nymph,1920,['United Kingdom'],['Silent film'],1920,0
5995578,Special,2006,['United States of America'],"['Psychological thriller', 'Indie', 'Satire', 'Science Fiction', 'Drama']",2000,6
705267,In the Cut,2003,"['United Kingdom', 'Australia', 'United States of America']","['Psychological thriller', 'Film adaptation', 'Mystery', 'Thriller', 'Romance Film', 'Crime Thriller', 'Suspense', 'Erotic thriller']",2000,3
24843685,The Missouri Traveller,1958,['United States of America'],"['Western', 'Drama', 'Family Film']",1950,8
5455297,Before and After,1996,['United States of America'],"['Courtroom Drama', 'Film adaptation', 'Crime Fiction', 'Mystery', 'Thriller', 'Crime Thriller', 'Drama']",1990,6
10483931,Wedding Daze,2006,['United States of America'],"['Comedy', 'Romance Film', 'Romantic comedy', 'Slapstick']",2000,6
27375785,The Best Man,2005,"['United Kingdom', 'Germany', 'Hungary', 'United States of America']","['Romance Film', 'Romantic comedy', 'Comedy']",2000,5
19289204,Ashi Hi Banwa Banwi,1988,['India'],['Comedy film'],1980,8
14969658,Angel,2007,"['United Kingdom', 'France', 'Belgium']","['Period piece', 'Film adaptation', 'Parody', 'Romantic drama', 'World cinema', 'Romance Film', 'Drama']",2000,7
22822904,Bindhaast,1999,['India'],"['Mystery', 'Adventure', 'Thriller']",1990,9
26950194,Kindergarten,1989,['Argentina'],['Drama'],1980,9
8847160,Million Dollar Mystery,1987,['United States of America'],"['Comedy', 'Thriller']",1980,7
5242919,Dosti,1964,['India'],['Bollywood'],1960,4
26085852,Marrying God,2006,['United States of America'],"['Short Film', 'Drama']",2000,6
25747636,ZigZag,2002,['United States of America'],"['Crime Fiction', 'Indie', 'Drama']",2000,2
14080718,Croc,2007,['United States of America'],"['Television movie', 'Natural horror films', 'Horror']",2000,7
11584626,Cinderella,2006,['South Korea'],"['World cinema', 'Horror']",2000,6
76325,Salt of the Earth,1954,['United States of America'],"['Indie', 'Political drama', 'Drama']",1950,4
27047737,Suno Sasurjee,2004,['India'],"['Romantic drama', 'Comedy', 'Crime Comedy', 'World cinema', 'Romance Film', 'Drama']",2000,4
1533664,Grosse Pointe Blank,1997,['United States of America'],"['Crime Fiction', 'Comedy Thriller', 'Thriller', 'Comedy', 'Romantic comedy', 'Black comedy', 'Romance Film']",1990,7
15620980,Cottage to Let,1941,['United Kingdom'],"['Spy', 'Black-and-white', 'Mystery', 'Thriller', 'War film', 'Drama']",1940,1
7740758,The Plague,2006,['United States of America'],['Horror'],2000,6
3319336,The Laughing Policeman,1973,['United States of America'],"['Suspense', 'Film adaptation', 'Mystery', 'Thriller', 'Crime Thriller', 'Drama']",1970,3
30138638,Grayeagle,1977,['United States of America'],"['Western', 'Action/Adventure', 'Adventure']",1970,7
24640663,Ice Queen,2005,['United States of America'],"['Monster movie', 'B-movie', 'Horror']",2000,5
6694303,A Corpse Hangs in the Web,1960,"['Germany', 'Yugoslavia', 'West Germany']","['Black-and-white', 'Sexploitation', 'Indie', 'Horror', 'Science Fiction', 'Natural horror films']",1960,0
31660844,Tumi Jodi Aamar Hote Re,2008,['Bangladesh'],"['Romance Film', 'Drama', 'Family Film']",2000,8
18892941,Fuzz,1972,['United States of America'],"['Action', 'Drama', 'Crime Fiction', 'Action/Adventure', 'Comedy']",1970,2
11539841,That's My Pup!,1953,['United States of America'],['Short Film'],1950,3
3562033,Dog Pounded,1954,['United States of America'],"['Animation', 'Short Film', 'Comedy', 'Family Film']",1950,4
14854661,Aashiq,2001,['India'],"['Action', 'Musical', 'Romantic drama', 'Comedy', 'Bollywood', 'World cinema', 'Romance Film', 'Drama']",2000,1
15217751,Out of the Fog,1941,['United States of America'],"['Film noir', 'Black-and-white']",1940,1
10320498,Gubra,2006,['Malaysia'],['Drama'],2000,6
10872127,Aap Ki Khatir,1977,['India'],"['Action', 'Drama', 'Comedy']",1970,7
29082218,Hindle Wakes,1931,[],['Drama'],1930,1
2262145,Sour Grapes,1998,['United States of America'],"['Screwball comedy', 'Buddy film', 'Comedy', 'Comedy of manners', 'Black comedy']",1990,8
27421749,Curse of the Black Widow,1977,['United States of America'],"['Crime Fiction', 'Mystery', 'Horror']",1970,7
6933675,The Cool Surface,1994,['United States of America'],"['Erotic thriller', 'Thriller']",1990,4
24818077,Stealing Candy,2004,['United States of America'],"['Crime Fiction', 'Thriller', 'Erotic thriller', 'Crime Thriller']",2000,4
5977601,Wisdom,1986,['United States of America'],"['Drama', 'Crime Fiction']",1980,6
68245,Bonnie and Clyde,1967,['United States of America'],"['Action', 'Outlaw', 'Crime Fiction', 'Gangster Film', 'Action/Adventure', 'Biographical film', 'Romance Film', 'Drama', 'Heist', 'New Hollywood', 'Crime Drama', 'Road movie']",1960,7
12975947,Thozha,2008,['India'],['Musical'],2000,8
4579172,Yaadon Ki Baraat,1973,['India'],"['Action', 'Musical', 'Bollywood', 'World cinema', 'Romance Film', 'Drama', 'Family Film']",1970,3
1650241,The Even Chance,1998,['United Kingdom'],['Costume drama'],1990,8
1486573,Richie Rich,1994,['United States of America'],"['Adventure Comedy', 'Comedy', 'Family Film']",1990,4
26022496,Tora-san's Salad-Day Memorial,1988,['Japan'],['Japanese Movies'],1980,8
15488775,Jannat,2008,['India'],"['Musical', 'Romantic drama', 'Bollywood', 'World cinema', 'Social problem film', 'Romance Film', 'Drama']",2000,8
76297,Red River,1948,['United States of America'],"['Action/Adventure', 'Western']",1940,8
8835468,Shnei Kuni Leml,1966,['Israel'],"['Musical', 'Comedy', 'World cinema']",1960,6
35987367,The Ryan White Story,1989,['United States of America'],"['Drama', 'Biographical film']",1980,9
20919109,Forty Thousand Horsemen,1941,['Australia'],"['Action', 'War film', 'Adventure']",1940,1
5093828,Sex in Chains,1928,"['Germany', 'German Language', 'Weimar Republic']","['Black-and-white', 'LGBT', 'Indie', 'World cinema', 'Drama', 'Gay Themed', 'Gay', 'Gay Interest', 'Silent film']",1920,8
5099233,The Thief Who Came to Dinner,1973,['United States of America'],"['Caper story', 'Comedy', 'Crime Comedy', 'Romantic comedy']",1970,3
2508699,The Music Room,1958,['India'],"['Music', 'Art film', 'Bengali Cinema', 'World cinema', 'Drama']",1950,8
3740032,Desperate,1947,['United States of America'],['Film noir'],1940,7
15046811,Loss,2008,['Lithuania'],['Drama'],2000,8
14206173,A Sheep in the Deep,1962,['United States of America'],"['Animation', 'Short Film', 'Comedy', 'Family Film']",1960,2
20938164,Peege,1973,['United States of America'],"['Short Film', 'Drama']",1970,3
9962683,Ek Phool Do Mali,1969,['India'],"['Musical', 'Bollywood', 'World cinema', 'Drama']",1960,9
19131684,Sea Wife,1957,['United Kingdom'],"['Film adaptation', 'Romantic drama', 'Romance Film', 'Melodrama', 'Adventure', 'Drama']",1950,7
4118334,Countess Dracula,1971,['United Kingdom'],"['Biographical film', 'Horror', 'Docudrama', 'Costume Horror', 'Cult']",1970,1
12276040,Malaikottai,2007,['India'],"['Romance Film', 'Comedy']",2000,7
2886766,Kickboxer,1989,['United States of America'],"['Action', 'Action/Adventure', 'Thriller', 'Martial Arts Film']",1980,9
26460403,Borrowed Bride,2005,"['Turkey', 'Greece']",['Drama'],2000,5
1023955,Angel's Egg,1985,['Japan'],"['Surrealism', 'Animation', 'Mystery', 'Anime', 'Drama', 'Japanese Movies', 'Horror', 'Science Fiction', 'Fantasy']",1980,5
8373513,A Carol Christmas,2003,['United States of America'],"['Comedy', 'Holiday Film', 'Christmas movie', 'Fantasy Comedy']",2000,3
535532,Prick Up Your Ears,1987,"['United Kingdom', 'England']","['LGBT', 'Biography', 'Indie', 'Comedy', 'Biographical film', 'Tragicomedy', 'Drama', 'Gay Themed', 'Gay', 'Gay Interest', 'Biopic [feature]', 'Comedy-drama']",1980,7
31327502,Uninvited,1988,['United States of America'],['Horror'],1980,8
190416,Baby Doll,1956,['United States of America'],"['Film adaptation', 'Comedy', 'Black comedy', 'Drama']",1950,6
10318873,Last House on Dead End Street,1972,['United States of America'],['Horror'],1970,2
2032436,Seems Like Old Times,1980,['United States of America'],"['Screwball comedy', 'Comedy', 'Romance Film', 'Romantic comedy']",1980,0
4459059,Trial and Error,1997,['United States of America'],"['Indie', 'Comedy', 'Romance Film', 'Romantic comedy', 'Slapstick']",1990,7
535971,Bloodsport,1988,['United States of America'],"['Action', 'Biography', 'Action/Adventure', 'Sports', 'Martial Arts Film']",1980,8
6537640,Ahista Ahista,2006,['India'],"['Romantic drama', 'World cinema', 'Romance Film', 'Drama']",2000,6
18083698,Get Yourself a College Girl,1964,['United States of America'],"['Romance Film', 'Comedy']",1960,4
10053804,Das Fest des Huhnes,1992,['Austria'],"['Parody', 'Comedy']",1990,2
6735527,Finders Keepers,1966,['United Kingdom'],"['Musical', 'Comedy']",1960,6
19570233,Mathru Devo Bhava,1993,['India'],['Drama'],1990,3
11610890,Earth vs. the Spider,2001,['United States of America'],"['Science Fiction', 'Thriller', 'Horror']",2000,1
8901969,Percy's Progress,1974,['United Kingdom'],['Comedy'],1970,4
2884945,Die Bad,2000,['South Korea'],"['Drama', 'Crime Fiction']",2000,0
24059492,The Hide,2008,['United Kingdom'],"['Indie', 'Drama']",2000,8
3051335,The Postcard Bandit,2003,"['New Zealand', 'Australia']","['Action', 'Crime Fiction', 'Action/Adventure', 'Thriller', 'Crime Thriller', 'Drama', 'Heist', 'Television movie']",2000,3
11450530,Demonic Toys,1992,['United States of America'],"['Monster movie', 'Cult', 'Horror']",1990,2
18764211,Buck and the Preacher,1972,['United States of America'],"['Action', 'Revisionist Western', 'Action/Adventure', 'Western', 'Comedy']",1970,2
14433697,The Tiger Blade,2005,['Thailand'],"['Action', 'Crime Fiction', 'Action/Adventure', 'World cinema', 'Martial Arts Film', 'Fantasy']",2000,5
10641044,Nann Adimai Illai,1987,['India'],['Romance Film'],1980,7
6980652,The Gladiators,1969,['Sweden'],"['Action/Adventure', 'World cinema', 'Science Fiction', 'Drama']",1960,9
7503149,A Language All My Own,1935,['United States of America'],"['Animation', 'Short Film', 'Comedy film', 'Family Film']",1930,5
32411625,This Angry Age,1958,"['France', 'Italy', 'United States of America']",['Drama'],1950,8
24038487,Maclovia,1948,['Mexico'],"['Romance Film', 'Drama']",1940,8
6816694,The Night Before Christmas,1941,['United States of America'],"['Animation', 'Short Film', 'Comedy', 'Family Film', 'Fantasy']",1940,1
18295411,Atlantic City,1944,['United States of America'],"['Musical', 'Black-and-white', 'Drama']",1940,4
12788657,The Boston Strangler,1968,['United States of America'],"['Crime Fiction', 'Mystery', 'Thriller', 'Crime Thriller', 'Drama']",1960,8
19355191,Zombie Honeymoon,2004,['United States of America'],"['Comedy', 'Horror Comedy', 'Horror', 'Romance Film', 'Romantic comedy', 'Zombie Film', 'Drama']",2000,4
5202670,Terror Firmer,1999,['United States of America'],"['Comedy', 'Horror Comedy', 'Horror', 'Slasher', 'B-movie']",1990,9
1608822,Prospero's Books,1991,"['Netherlands', 'Japan', 'United Kingdom', 'France', 'Italy']","['Surrealism', 'Japanese Movies', 'Avant-garde', 'Experimental film', 'Drama', 'Fantasy']",1990,1
4564324,Azumi 2: Death or Love,2005,['Japan'],"['Action', 'Japanese Movies', 'Action/Adventure', 'World cinema', 'Martial Arts Film', 'Drama']",2000,5
28922467,White Viking,1991,"['Norway', 'Iceland']","['Adventure', 'Drama']",1990,1
358243,Class,1983,['United States of America'],"['Coming of age', 'Comedy', 'Teen', 'Romance Film', 'Comedy-drama', 'Sex comedy']",1980,3
2999596,False Hare,1964,['United States of America'],"['Animation', 'Short Film', 'Family Film']",1960,4
22152731,Alien Trespass,2009,"['Canada', 'United States of America']","['Creature Film', 'Parody', 'Comedy', 'Science Fiction']",2000,9
2581115,InuYasha the Movie: Swords of an Honorable Ruler,2003,['Japan'],"['Action', 'Animation', 'Japanese Movies', 'World cinema', 'Anime', 'Fantasy']",2000,3
6416597,The Milky Way,1936,['United States of America'],"['Black-and-white', 'Comedy', 'Sports', 'Slapstick']",1930,6
16686440,All in a Night's Work,1961,['United States of America'],"['Screwball comedy', 'Satire', 'Comedy', 'Romance Film', 'Romantic comedy']",1960,1
1670736,Swimming with Sharks,1994,['United States of America'],"['Drama', 'Indie', 'Comedy', 'Black comedy', 'Comedy-drama', 'Workplace Comedy']",1990,4
11043663,The Four Days of Naples,1962,['Italy'],"['Black-and-white', 'War film', 'Drama']",1960,2
6041499,Cat And Mouse,2003,['Hong Kong'],"['Romantic drama', 'Action/Adventure', 'Comedy', 'World cinema', 'Romance Film', 'Chinese Movies', 'Drama', 'Romantic comedy']",2000,3
4029751,The Phantom of the Opera,1962,['United Kingdom'],['Horror'],1960,2
27936611,Virtual Sexuality,1999,"['United Kingdom', 'England', 'United States of America']","['Gay pornography', 'Drama', 'Coming of age', 'Indie', 'Comedy', 'Science Fiction']",1990,9
5873261,Sukran,2005,['India'],['World cinema'],2000,5
13737949,The Counterfeiters,2007,"['Austria', 'Germany']","['Crime Fiction', 'World cinema', 'War film', 'Drama']",2000,7
2157292,The Libertine,2004,['United Kingdom'],"['Period piece', 'Romantic drama', 'Biography', 'Romance Film', 'Drama']",2000,4
11466747,July Rhapsody,2001,"['China', 'Hong Kong']","['Romantic drama', 'Marriage Drama', 'World cinema', 'Romance Film', 'Chinese Movies', 'Drama']",2000,1
21028695,Ayiram Poi,1969,['India'],['Drama'],1960,9
8284674,Nancy Goes to Rio,1950,['United States of America'],"['Musical', 'Comedy', 'Musical comedy', 'Romance Film', 'Romantic comedy']",1950,0
5111565,Down Three Dark Streets,1954,['United States of America'],"['Detective fiction', 'Crime Fiction', 'Mystery', 'Thriller', 'Detective', 'Film noir', 'Crime Thriller']",1950,4
3541643,The Naked Runner,1967,['United Kingdom'],"['Spy', 'Thriller', 'Political thriller']",1960,7
20814141,Engine Sentai Go-onger vs. Gekiranger,2009,['Japan'],"['Action', 'Drama', 'Japanese Movies', 'Science Fiction']",2000,9
8603284,Hell's Kitchen,1998,['United States of America'],"['Drama', 'Crime Fiction']",1990,8
18619636,A Coy Decoy,1941,['United States of America'],"['Animation', 'Short Film', 'Family Film']",1940,1
9273330,Trois 2: Pandora's Box,2002,['United States of America'],"['Psychological thriller', 'Mystery', 'Thriller', 'Erotic thriller']",2000,2
29218227,Linda,1960,['United Kingdom'],['Teen'],1960,0
12706152,Mangiati Vivi,1980,['Italy'],"['Exploitation', 'Splatter film', 'Horror', 'World cinema']",1980,0
10685113,Night of the Scarecrow,1995,['United States of America'],"['Horror', 'Science Fiction']",1990,5
6836675,Thamizh MA,2007,['India'],"['Mystery', 'Drama']",2000,7
12127393,The Bong Connection,2006,['India'],['Drama'],2000,6
28226468,Jungle Gents,1954,['United States of America'],['Comedy film'],1950,4
32207440,Sorority Wars,2009,['United States of America'],"['Drama', 'Television movie']",2000,9
34973432,Everything Is Fine,1937,['Egypt'],"['Comedy', 'Comedy film', 'World cinema']",1930,7
2572733,"You're a Good Sport, Charlie Brown",1975,['United States of America'],"['Animation', 'Short Film', 'Drama', 'Family Film']",1970,5
26007214,Crash!,1977,['United States of America'],['Horror'],1970,7
29546284,Kanmadam,1998,[],['Drama'],1990,8
3077127,Fanaa,2006,['India'],"['Musical', 'Romantic drama', 'Thriller', 'Bollywood', 'Romance Film', 'Drama']",2000,6
6816597,La Notte,1961,"['France', 'Italy']","['Black-and-white', 'Art film', 'Marriage Drama', 'World cinema', 'Drama']",1960,1
19444214,Praan Jaye Par Shaan Na Jaye,2003,['India'],"['Drama', 'Comedy film', 'World cinema']",2000,3
17112241,Green Flash,2008,['United States of America'],"['Sports', 'Drama']",2000,8
17216568,Peasants,1978,['South Korea'],['Drama'],1970,8
13257327,Love Crazy,1941,['United States of America'],"['Black-and-white', 'Screwball comedy', 'Comedy', 'Romance Film', 'Romantic comedy']",1940,1
1988339,Frog Prince,1971,['United States of America'],"['Musical', 'Television movie', 'Family Film', 'Fantasy']",1970,1
16271350,The Echo,2008,['United States of America'],"['Suspense', 'Thriller', 'Horror', 'Supernatural']",2000,8
11544460,The Blue Hour,2007,['United States of America'],"['Indie', 'Drama']",2000,7
3680519,Tarzan Escapes,1936,['United States of America'],"['Black-and-white', 'Adventure', 'Jungle Film']",1930,6
10060183,The Mouse Comes to Dinner,1945,['United States of America'],"['Short Film', 'Comedy']",1940,5
123417,The Matrix Reloaded,2003,"['United States of America', 'Australia']","['Action', 'Action/Adventure', 'Science Fiction', 'Thriller', 'Adventure']",2000,3
14356044,All Things Fair,1995,"['Sweden', 'Denmark']","['Coming of age', 'Romantic drama', 'World cinema', 'Romance Film', 'Erotica', 'Drama']",1990,5
31434603,Twin Rivers,2007,['Australia'],['Drama'],2000,7
24864880,Cutting Moments,1997,['United States of America'],"['Short Film', 'Horror']",1990,7
32024949,Sahhas,1981,[],['Action'],1980,1
23271370,The Graduates of Malibu High,1983,['United States of America'],"['Action', 'Crime Fiction', 'Drama']",1980,3
10215404,Revolutionary Road,2008,"['United Kingdom', 'United States of America']","['Period piece', 'Film adaptation', 'Romantic drama', 'Marriage Drama', 'Romance Film', 'Drama', 'Tragedy']",2000,8
146236,Close Encounters of the Third Kind,1977,['United States of America'],"['New Hollywood', 'Adventure', 'Science Fiction', 'Drama']",1970,7
32131638,The People Next Door,1970,['United States of America'],['Drama'],1970,0
9823573,Death Wish 4: The Crackdown,1987,['United States of America'],"['Action', 'Crime Fiction', 'Action Thrillers', 'Action/Adventure', 'Thriller', 'Crime Thriller', 'Drama']",1980,7
29157670,Dear Wife,1949,['United States of America'],"['Political cinema', 'Comedy']",1940,9
6367539,That Beautiful Somewhere,2006,['Canada'],"['Mystery', 'Indie', 'Thriller', 'Crime Thriller', 'Drama']",2000,6
12752776,The Tale of Despereaux,2008,"['United Kingdom', 'United States of America']","[""Children's Fantasy"", 'Animation', 'Comedy', ""Children's/Family"", 'Adventure', 'Family Film', 'Fantasy']",2000,8
9753495,Black Girl,1966,"['France', 'Senegal']","['Drama', 'World cinema']",1960,6
2525385,Mac and Me,1988,['United States of America'],"['Comedy', 'Family-Oriented Adventure', ""Children's/Family"", 'Adventure', ""Children's Fantasy"", 'Science Fiction', 'Family Film', 'Fantasy']",1980,8
25080990,The Spy in the Green Hat,1967,['United States of America'],"['Action', 'Spy', 'Crime Fiction', 'Comedy', 'Thriller', 'Adventure']",1960,7
21211657,Ladies of the House,2008,['United States of America'],"['Drama', 'Television movie']",2000,8
2345044,The Man Who Knew Too Much,1956,['United States of America'],"['Psychological thriller', 'Gangster Film', 'Mystery', 'Thriller', 'Film noir', 'Crime Thriller', 'Drama', 'Suspense']",1950,6
4415359,Lonely Hearts,2007,['United States of America'],"['Period piece', 'Crime Fiction', 'Thriller', 'Crime Thriller', 'Drama']",2000,7
10158744,Vijeta,1982,['India'],['War film'],1980,2
26283819,Whale,1970,['Bulgaria'],['Drama'],1970,0
12761868,Kuruvi,2008,['India'],"['Action', 'Drama', 'Comedy']",2000,8
24806261,Hold That Kiss,1938,['United States of America'],"['Romantic comedy', 'Comedy', 'Comedy of Errors']",1930,8
981874,Tokyo Godfathers,2003,['Japan'],"['LGBT', 'Animation', 'Family Drama', 'World cinema', 'Holiday Film', 'Christmas movie', 'Drama', 'Japanese Movies', 'Comedy-drama', 'Anime', 'Slice of life story']",2000,3
4871578,Five Fingers of Death,1972,['Hong Kong'],"['Action', 'Action/Adventure', 'World cinema', 'Romance Film', 'Chinese Movies', 'Martial Arts Film', 'Adventure', 'Drama']",1970,2
12414269,Young Black Stallion,2003,['United States of America'],"['Family Drama', 'Adventure', 'Drama', 'Family Film']",2000,3
19931140,Black Ice,2007,"['Finland', 'Germany']",['Drama'],2000,7
3614997,Ju-on: The Grudge 2,2003,['Japan'],"['Japanese Movies', 'Horror']",2000,3
18004913,Naduvazhikal,1989,['India'],"['Action', 'Thriller', 'Drama']",1980,9
10683927,La famiglia,1987,"['France', 'Italy']","['Family Drama', 'Drama']",1980,7
23813724,The Silver Chair,1990,['United Kingdom'],"[""Children's Fantasy"", ""Children's/Family"", 'Adventure', 'Fantasy']",1990,0
2964792,The Blockhouse,1974,['United Kingdom'],"['Melodrama', 'War film', 'Drama']",1970,4
18332911,Five Aces,1999,['United States of America'],"['Action', 'Action/Adventure', 'Comedy', 'Comedy-drama']",1990,9
15269954,The Trap,2007,"['Serbia', 'Germany', 'Hungary']","['Drama', 'Crime Fiction', 'Thriller']",2000,7
8611306,Botched,2006,"['Ireland', 'United States of America']","['Psychological thriller', 'Crime Fiction', 'Comedy', 'Thriller', 'Horror Comedy', 'Horror', 'Black comedy']",2000,6
7073851,Very Silly Songs!,1997,[],"['Musical', 'Animation', 'Short Film', ""Children's""]",1990,7
19854622,Nandu,1981,['India'],['Musical'],1980,1
149433,Rocky II,1979,['United States of America'],"['Boxing', 'New Hollywood', 'Sports', 'Drama']",1970,9
18639038,30 Years to Life,2003,['United States of America'],"['Indie', 'Comedy', 'Romance Film', 'Romantic comedy', 'Ensemble Film']",2000,3
21652388,Lake Mungo,2008,['Australia'],"['Psychological thriller', 'Thriller', 'Horror', 'World cinema', 'Supernatural']",2000,8
13694717,Dayton's Devils,1968,['United States of America'],"['Action', 'Crime Fiction', 'Drama']",1960,8
3564394,The Raven,1935,['United States of America'],"['Black-and-white', 'Horror']",1930,5
1266489,The Pagemaster,1994,['United States of America'],"[""Children's Fantasy"", 'Animation', ""Children's"", ""Children's/Family"", 'Adventure', 'Family Film', 'Fantasy']",1990,4
13948061,Rosy Dreams,1977,"['Czechoslovakia', 'Slovakia']",['Comedy'],1970,7
13312274,Gospel Hill,2008,['United States of America'],"['Mystery', 'Thriller', 'Social problem film', 'Drama']",2000,8
600351,Scream 3,2000,['United States of America'],"['Mystery', 'Indie', 'Comedy', 'Thriller', 'Teen', 'Parody', 'Slasher', 'Horror']",2000,0
8066553,The Tale of Ruby Rose,1987,['Australia'],"['Adventure', 'Drama']",1980,7
25147240,Special Delivery,2000,"['Canada', 'United States of America']","['Comedy', 'Family Film', 'Fantasy']",2000,0
25091705,Phool Aur Angaar,1993,['India'],['Action'],1990,3
4084504,Lord Slug,1991,['Japan'],"['Action', 'Animated cartoon', 'Animation', 'Japanese Movies', ""Children's"", 'Anime', 'Science Fiction']",1990,1
5367128,Santa Fe Trail,1940,['United States of America'],"['Action', 'Black-and-white', 'Action/Adventure', 'Western', 'Historical fiction', 'Drama']",1940,0
2359987,Lucky: No Time for Love,2005,['India'],"['Musical', 'Romantic drama', 'World cinema', 'Romance Film', 'Drama']",2000,5
11956039,Callaway Went Thataway,1951,['United States of America'],"['Parody', 'Western', 'Satire', 'Comedy']",1950,1
27457042,Hard Lesbian: Genuine Tongue Technique,1992,['Japan'],['Japanese Movies'],1990,2
13342147,Charlie Chan in London,1934,['United States of America'],"['Detective fiction', 'Black-and-white', 'Crime Fiction', 'Mystery', 'Thriller', 'Detective', 'Crime Thriller']",1930,4
1103547,Brainstorm,1983,['United States of America'],"['Psychological thriller', 'Science Fiction', 'Thriller']",1980,3
5103545,Children of the Damned,1964,['United Kingdom'],"['Thriller', 'Horror', 'Alien Film', 'Science Fiction', 'Drama']",1960,4
2839084,The Match King,1932,['United States of America'],"['Black-and-white', 'Biographical film', 'Biopic [feature]', 'Drama']",1930,2
15288104,Embryo,1976,['United States of America'],"['Action', 'Action/Adventure', 'Science Fiction', 'Thriller', 'Horror']",1970,6
535453,Quicksilver Highway,1997,['United States of America'],"['Television movie', 'Horror Comedy', 'Horror']",1990,7
11236927,Next of Kin,1985,['Canada'],"['Indie', 'Drama']",1980,5
24160755,Now & Forever,2002,['United States of America'],"['Romance Film', 'Romantic drama', 'Drama']",2000,2
5828901,Le gendarme en balade,1970,"['France', 'Italy']",['Comedy'],1970,0
33894063,Murder Live!,1997,['United States of America'],"['Psychological thriller', 'Crime Fiction', 'Thriller', 'Television movie', 'Crime Thriller', 'Drama']",1990,7
3326435,The Hours,2002,"['United Kingdom', 'United States of America']","['Period piece', 'Gay Themed', 'Film adaptation', 'LGBT', 'Feminist Film', 'Costume drama', 'Drama']",2000,2
15997720,The Love Specialist,1956,"['France', 'Italy']","['Romance Film', 'Comedy', 'Drama']",1950,6
17151705,The Evil That Men Do,1984,"['United Kingdom', 'Mexico', 'United States of America']","['Action', 'Action Thrillers', 'Action/Adventure', 'Thriller', 'Crime Thriller', 'Adventure']",1980,4
12124469,The Strange Door,1951,['United States of America'],"['Psychological thriller', 'Black-and-white', 'Horror']",1950,1
14186169,Oldest Living Confederate Widow Tells All,1994,['United States of America'],"['Period piece', 'Biography', 'Historical Epic', 'Television movie', 'Americana', 'Drama']",1990,4
1385911,Category 6: Day of Destruction,2004,['United States of America'],"['Drama', 'Disaster', 'Thriller']",2000,4
18230,La Jetée,1962,['France'],"['Romantic fantasy', 'Avant-garde', 'World cinema', 'Romance Film', 'Apocalyptic and post-apocalyptic fiction', 'Drama', 'Time travel', 'Short Film', 'Experimental film', 'Science Fiction']",1960,2
24936756,Alegre ma non troppo,1994,['Spain'],"['Music', 'Romance Film', 'Comedy film']",1990,4
8869124,The Great K & A Train Robbery,1926,['United States of America'],"['Detective fiction', 'Black-and-white', 'Indie', 'Western', 'Detective', 'Silent film']",1920,6
13403138,The Warrior's Heart,1992,"['Denmark', 'Sweden', 'Norway', 'Ireland']",['Drama'],1990,2
19389289,Birthday Blues,1932,['United States of America'],"['Black-and-white', 'Short Film', 'Comedy', 'Family Film']",1930,2
12226500,Confessions of a Pit Fighter,2005,['United States of America'],"['Action', 'Crime Fiction', 'Action Thrillers', 'Action/Adventure', 'Thriller', 'Martial Arts Film', 'Drama', 'Sports']",2000,5
1716921,Amazon Women on the Moon,1987,['United States of America'],"['Parody', 'Comedy', 'Science Fiction', 'Cult', 'Absurdism']",1980,7
28756605,Still Waters,2000,['Russia'],['Romance Film'],2000,0
4227273,Elvira: Mistress of the Dark,1988,['United States of America'],"['Indie', 'Comedy', 'Thriller', 'Horror Comedy', 'Parody', 'Horror', 'B-movie', 'Fantasy']",1980,8
27265213,Kind Lady,1935,['United States of America'],"['Thriller', 'Drama']",1930,5
4570449,Shaadi Se Pehle,2006,['India'],"['Musical', 'Romantic drama', 'Comedy', 'Bollywood', 'World cinema', 'Romance Film', 'Drama', 'Comedy of Errors', 'Romantic comedy']",2000,6
6368773,Blue Car,2003,['United States of America'],"['Coming of age', 'Family Drama', 'Indie', 'Drama']",2000,3
10792098,Johnny,1980,['India'],['Romance Film'],1980,0
19920152,The Rebound,2009,['United States of America'],"['Romance Film', 'Romantic comedy', 'Comedy']",2000,9
6102449,Chakram,2005,['India'],"['Tollywood', 'Romantic drama', 'World cinema', 'Romance Film', 'Drama']",2000,5
9149984,Bathing Beauty,1944,['United States of America'],"['Musical', 'Comedy', 'Musical comedy', 'Romantic comedy']",1940,4
1789996,The Amityville Horror,2005,['United States of America'],"['Film adaptation', 'Mystery', 'Thriller', 'Remake', 'Drama', 'Horror', 'Supernatural', 'Cult']",2000,5
24822644,Preah Peay Phat,1971,['Cambodia'],"['Romance Film', 'Drama']",1970,1
9704560,Ek Chotisi Love Story,2002,['India'],"['Art film', 'Romantic drama', 'World cinema', 'Romance Film', 'Drama']",2000,2
4125366,Mr India,1987,['India'],"['Musical', 'Action/Adventure', 'Comedy', 'Bollywood', 'World cinema', 'Superhero movie']",1980,7
3408170,The Proud Valley,1940,['United Kingdom'],"['Black-and-white', 'Musical Drama', 'Drama']",1940,0
23754125,Cries from the Heart,1994,['United States of America'],"['Television movie', 'Drama', 'Courtroom Drama']",1990,4
26065372,Shavukar,1950,['India'],['Drama'],1950,0
3112558,Building Sites Bite,1978,['United Kingdom'],['Short Film'],1970,8
27533783,Starsky and Hutch on Playboy Island,1977,['United States of America'],[],1970,7
74951,Meshes of the Afternoon,1943,['United States of America'],"['Surrealism', 'Black-and-white', 'Short Film', 'Avant-garde', 'Experimental film', 'Film noir']",1940,3
2038132,Hum Aapke Hain Kaun...!,1994,['India'],"['Musical', 'Romantic drama', 'Bollywood', 'World cinema', 'Romance Film', 'Drama']",1990,4
8085358,It Happened to Jane,1959,['United States of America'],"['Romance Film', 'Romantic comedy', 'Comedy']",1950,9
16262444,A Beautiful New World,1998,"['China', 'Taiwan']","['Chinese Movies', 'Comedy']",1990,8
6449273,Who is Cletis Tout?,2001,"['Canada', 'United States of America']","['Action', 'Heist', 'Crime Fiction', 'Action/Adventure', 'Comedy', 'Crime Comedy', 'Black comedy']",2000,1
22232800,Hypnotized and Hysterical,2002,['France'],"['Musical', 'Comedy', 'World cinema', 'Drama']",2000,2
568780,Jersey Girl,2004,['United States of America'],"['Romantic drama', 'Comedy', 'Romance Film', 'Romantic comedy', 'Drama']",2000,4
17752581,Don't Talk to Strangers,1994,['United States of America'],"['Psychological thriller', 'Thriller']",1990,4
10659691,A Difficult Life,1961,['Italy'],"['Black-and-white', 'Comedy', 'Drama']",1960,1
21133839,Scooby-Doo and the Samurai Sword,2009,['United States of America'],"['Animation', 'Family-Oriented Adventure', ""Children's/Family"", 'Adventure', 'Family Film', 'Fantasy']",2000,9
17284460,Chelsea Walls,2001,['United States of America'],"['Indie', 'Drama', 'Ensemble Film']",2000,1
5115147,Shor,1972,['India'],['Bollywood'],1970,2
9665214,Beyond Therapy,1987,['United States of America'],"['LGBT', 'Parody', 'Indie', 'Comedy']",1980,7
6394355,Full Clip,2004,['United States of America'],"['Action', 'Action Thrillers', 'Action/Adventure', 'Thriller']",2000,4
13979345,Don't Knock the Twist,1962,['United States of America'],['Musical'],1960,2
4541104,Moosa Khan,2001,['Pakistan'],['Drama'],2000,1
6387666,Paris Qui Dort,1924,['France'],"['Black-and-white', 'Indie', 'Comedy', 'Chase Movie', 'Short Film', 'Silent film', 'Science Fiction', 'Fantasy']",1920,4
6856839,Joe Gould's Secret,2000,['United States of America'],"['Period piece', 'Biography', 'Buddy film', 'Biopic [feature]', 'Comedy-drama', 'Drama']",2000,0
15796197,Revenge of the Stepford Wives,1980,['United States of America'],"['Mystery', 'Science Fiction', 'Thriller']",1980,0
27671001,Eroica,2003,['United Kingdom'],"['Period piece', 'Drama']",2000,3
2216309,Hush,1998,['United States of America'],"['Mystery', 'Thriller']",1990,8
19601982,Modern Love,2006,"['New Zealand', 'Australia']","['Mystery', 'Thriller', 'World cinema']",2000,6
2557023,Chalti Ka Naam Gaadi,1958,['India'],"['Comedy', 'Bollywood', 'World cinema']",1950,8
20152384,The Deserter,1971,"['Yugoslavia', 'Italy', 'United States of America']",['Drama'],1970,1
27856647,Ponmuttayidunna Tharavu,1988,['India'],"['Drama', 'Comedy']",1980,8
23510042,Time After Time,1985,"['England', 'Australia']","['Drama', 'Comedy']",1980,5
16147568,Villmark,2003,['Norway'],"['Thriller', 'Horror']",2000,3
29489697,Mickey's Covered Wagon,1933,['United States of America'],['Short Film'],1930,3
11471094,Conflict of Interest,1993,['United States of America'],"['Action', 'Crime Fiction', 'Mystery', 'Indie', 'Action/Adventure', 'Thriller', 'Crime Thriller', 'Suspense']",1990,3
1412446,They All Laughed,1981,['United States of America'],"['Mystery', 'Comedy', 'Thriller', 'New Hollywood', 'Romance Film', 'Romantic comedy', 'Crime Thriller']",1980,1
2197909,Sniper 2,2003,['United States of America'],"['Action', 'Action Thrillers', 'Action/Adventure', 'Thriller', 'Television movie', 'War film']",2000,3
3408227,Rize,2005,"['United Kingdom', 'United States of America']","['Music', 'Social issues', 'Documentary', 'Dance', 'Culture & Society']",2000,5
20856259,"Gaily, Gaily",1969,['United States of America'],"['Musical', 'Film adaptation', 'Crime Fiction', 'Comedy', 'Docudrama', 'Slapstick', 'Drama', 'Period piece', 'Biopic [feature]']",1960,9
13720276,Go Naked in the World,1961,['United States of America'],"['Romance Film', 'Melodrama', 'Drama']",1960,1
16357786,Quiet City,2007,['United States of America'],"['Romantic drama', 'Indie', 'Romance Film', 'Drama']",2000,7
1261542,Les Misérables,1995,['France'],"['Drama', 'World cinema']",1990,5
14174534,I Will Always Love You,2006,['Philippines'],"['Filipino Movies', 'Romantic drama', 'World cinema', 'Romance Film', 'Filipino', 'Drama']",2000,6
33431513,Crayon Shin-chan: The Storm Called: The Kasukabe Boys of the Evening Sun,2004,[],"['Family Film', 'Animation']",2000,4
3619322,Smart Alec,1951,['United States of America'],"['Short Film', 'Pornographic movie', 'Pornography', 'Adult']",1950,1
6030385,"Dr. Black, Mr. Hyde",1976,['United States of America'],"['Blaxploitation', 'Horror']",1970,6
2157529,Murder,2004,['India'],"['Crime Fiction', 'Romantic drama', 'Thriller', 'World cinema', 'Romance Film', 'Drama']",2000,4
20028957,Las 13 rosas,2007,['Spain'],"['Period piece', 'Drama', 'Ensemble Film']",2000,7
31034325,Dust of Angels,1992,['Taiwan'],"['Action', 'Crime Fiction', 'Drama']",1990,2
21426799,Pray for Morning,2006,['United States of America'],"['Slasher', 'Horror']",2000,6
1380313,My Blue Heaven,1990,['United States of America'],['Comedy'],1990,0
740989,Boys Town,1938,['United States of America'],"['Drama', 'Biographical film']",1930,8
12343041,Learners,2007,['United Kingdom'],"['Drama', 'Comedy']",2000,7
11745593,The Unknown Woman,2006,"['France', 'Italy']","['Psychological thriller', 'Mystery', 'Thriller', 'World cinema', 'Drama']",2000,6
7612306,School Wars: HERO,2004,['Japan'],['Japanese Movies'],2000,4
1318335,Twilight Zone: The Movie,1983,['United States of America'],"['Psychological thriller', 'Suspense', 'Horror', 'Sci-Fi Horror', 'Science Fiction']",1980,3
6007108,Lockdown,2000,['United States of America'],"['Drama', 'Crime Fiction']",2000,0
3877823,The Invisible Man's Revenge,1944,['United States of America'],"['Black-and-white', 'Thriller', 'Horror', 'Science Fiction']",1940,4
17356137,The Show,1927,['United States of America'],"['Silent film', 'Black-and-white', 'Drama']",1920,7
24104995,Jangan Pandang Belakang Congkak,2009,['Malaysia'],"['Horror', 'Comedy film']",2000,9
11805887,Bell Witch: The Movie,2007,['United States of America'],"['B-movie', 'Drama', 'Horror']",2000,7
29198000,Chandra Mukhi,1993,[],"['Romance Film', 'Drama']",1990,3
4241641,Hell Is a City,1960,['United Kingdom'],"['Black-and-white', 'Crime Fiction', 'Mystery', 'Thriller', 'Crime Thriller', 'Drama', 'Suspense', 'British New Wave']",1960,0
1634280,Baadshah,1999,['India'],"['Musical', 'Bollywood', 'World cinema']",1990,9
164376,Being There,1979,['United States of America'],"['Political satire', 'Satire', 'Comedy', 'Drama', 'Political cinema', 'Parody', 'New Hollywood', 'Comedy-drama']",1970,9
4298222,Madhouse,2004,['United States of America'],"['Psychological thriller', 'Horror']",2000,4
13166374,Mortuary,1983,['United States of America'],"['Supernatural', 'Slasher', 'Horror']",1980,3
13167404,Death Valley,1982,['United States of America'],"['Slasher', 'Horror']",1980,2
883489,Mona Lisa Smile,2003,['United States of America'],"['Period piece', 'Coming of age', 'Romance Film', 'Drama', 'Feminist Film']",2000,3
20361901,The Christmas Card,2006,['United States of America'],"['Romantic drama', 'Romance Film', 'Television movie', 'Drama']",2000,6
23941849,Munchie,1992,['United States of America'],"['Science Fiction', 'Comedy', 'Family Film']",1990,2
19738112,Waking Madison,2009,['United States of America'],"['Psychological thriller', 'Drama', 'Indie', 'Thriller']",2000,9
6701097,Above Us the Waves,1955,['United Kingdom'],['War film'],1950,5
2686345,Rabbit Seasoning,1952,['United States of America'],"['Animation', 'Short Film', 'Comedy', 'Family Film']",1950,2
29397961,Mad Dogs and Englishmen,1995,['United Kingdom'],"['Thriller', 'Crime Thriller']",1990,5
7269467,Naani,2003,['India'],['Romance Film'],2000,3
12366040,Get Lost,1956,[],['Animation'],1950,6
15378807,Ice Planet,2003,[],['Science Fiction'],2000,3
4853679,Everybody Famous!,2000,"['France', 'Netherlands', 'Belgium']","['Comedy', 'Drama', 'World cinema']",2000,0
2236472,Transformers,2007,['United States of America'],"['Action', 'Thriller', 'Doomsday film', 'Disaster', 'Science Fiction', 'Alien Film']",2000,7
8355938,The Night They Saved Christmas,1984,['United States of America'],"[""Children's Fantasy"", 'Comedy', ""Children's/Family"", 'Christmas movie', 'Drama', 'Family Film']",1980,4
29166744,The Donovan Affair,1929,['United States of America'],"['Mystery', 'Comedy']",1920,9
27890625,Rain,2007,['United States of America'],"['Film adaptation', 'Indie', 'Drama']",2000,7
2005133,Nayagan,1987,['India'],"['Musical', 'Gangster Film', 'Thriller', 'Bollywood', 'World cinema', 'Drama']",1980,7
14662019,Mindwarp,1992,['United States of America'],"['Action', 'Thriller', 'Horror', 'Science Fiction']",1990,2
8905485,Tempest,1982,['United States of America'],"['Film adaptation', 'Indie', 'Romantic drama', 'Comedy', 'Romance Film', 'Drama', 'Romantic comedy', 'Comedy-drama']",1980,2
18792012,Martial Outlaw,1993,['United States of America'],"['Action', 'Crime Fiction', 'Martial Arts Film']",1990,3
14326973,The Truce,1997,"['Switzerland', 'France', 'Germany', 'Italy', 'United States of America']","['Period piece', 'Film adaptation', 'Biography', 'Biographical film', 'Drama']",1990,7
14385736,Three Little Sew and Sews,1939,['United States of America'],"['Black-and-white', 'Short Film', 'Comedy', 'Slapstick']",1930,9
30626975,Maya,1966,['United States of America'],"['Family-Oriented Adventure', 'Adventure', 'Family Film']",1960,6
10776597,Invincible Armor,1977,"['Hong Kong', 'Taiwan']","['Action', 'Mystery', 'Action/Adventure', 'Thriller', 'World cinema', 'Chinese Movies', 'Martial Arts Film']",1970,7
6827045,Vasantham,2003,['India'],['Drama'],2000,3
8834970,The Pick-up Artist,1987,['United States of America'],"['Romance Film', 'Romantic comedy', 'Comedy']",1980,7
6236671,Meridian: Kiss Of The Beast,1990,['United States of America'],"['Erotica', 'Horror']",1990,0
4158539,Who's the Man?,1993,['United States of America'],"['Action', 'Action Comedy', 'Action/Adventure', 'Comedy']",1990,3
15165528,The Burglar,1957,['United States of America'],"['Crime Fiction', 'Thriller', 'Film noir', 'Drama']",1950,7
31811425,"Darna, Kuno?",1979,[],['Parody'],1970,9
1917459,Nutty Professor II: The Klumps,2000,['United States of America'],"['Comedy', 'Romance Film', 'Romantic comedy', 'Slapstick', 'Science Fiction']",2000,0
15141609,The Merry Widow,1934,['United States of America'],"['Musical', 'Black-and-white', 'Romantic drama', 'Comedy', 'Romance Film', 'Pre-Code', 'Drama', 'Period piece', 'Romantic comedy']",1930,4
16994537,The Nest,1927,['United States of America'],"['Silent film', 'Black-and-white', 'Drama']",1920,7
15742802,Children of Hiroshima,1952,['Japan'],"['Black-and-white', 'Japanese Movies', 'Horror', 'Docudrama', 'War film', 'Propaganda film', 'Drama']",1950,2
8634248,Tashan,2008,['India'],"['Action', 'Musical', 'Action/Adventure', 'Thriller', 'Bollywood', 'World cinema', 'Romance Film', 'Crime Thriller', 'Road movie']",2000,8
8846464,The Private Navy of Sgt. O'Farrell,1968,['United States of America'],"['Screwball comedy', 'War film', 'Comedy']",1960,8
14238581,Nick and Norah's Infinite Playlist,2008,['United States of America'],"['Music', 'Musical', 'Comedy', 'Teen', 'Romance Film', 'Drama', 'Coming of age', 'Romantic comedy']",2000,8
1388443,If I Were a Rich Man,2002,['France'],"['Music', 'Biography', 'Comedy']",2000,2
318542,Hero,2002,"['China', 'Hong Kong']","['Action/Adventure', 'World cinema', 'Wuxia', 'Chinese Movies', 'Martial Arts Film']",2000,2
3807682,Confessions of a Window Cleaner,1974,['United Kingdom'],"['Slapstick', 'Comedy', 'Sex comedy']",1970,4
13102698,Bonneville,2006,['United States of America'],"['Indie', 'Comedy', 'Comedy-drama', 'Road movie', 'Drama']",2000,6
2310550,The Land Before Time II: The Great Valley Adventure,1994,['United States of America'],"['Music', 'Animation', ""Children's"", 'Family-Oriented Adventure', ""Children's/Family"", 'Adventure', 'Family Film']",1990,4
24089925,Transylmania,2009,['United States of America'],"['Gross out', 'Gross-out film', 'Parody', 'Comedy', 'Horror Comedy', 'Horror']",2000,9
5422935,David Copperfield,2000,"['United Kingdom', 'United States of America']",['Costume drama'],2000,0
9492034,Sultanat,1986,['India'],"['Musical', 'Action/Adventure', 'Bollywood', 'World cinema']",1980,6
21686389,True North,2006,"['United Kingdom', 'Germany', 'Scotland', 'Ireland']","['Thriller', 'Drama']",2000,6
1347325,Puppet Master,1989,['United States of America'],"['Thriller', 'Horror', 'Supernatural', 'Science Fiction', 'Drama', 'Cult']",1980,9
26012602,Anubhavangal Paalichakal,1971,['India'],['Drama'],1970,1
5812737,Fida,2004,['India'],"['Romantic drama', 'Bollywood', 'World cinema', 'Romance Film', 'Drama']",2000,4
30899685,The Lesser Evil,1998,['United States of America'],"['Thriller', 'Drama']",1990,8
8282237,Blaumilch Canal,1969,['Israel'],"['Satire', 'Comedy', 'World cinema']",1960,9
31193551,Nasihat,1986,[],"['Drama', 'Family Film']",1980,6
31494891,Elavamkodu Desam,1998,[],"['Drama', 'Fantasy']",1990,8
14499499,The Girl from 10th Avenue,1935,['United States of America'],"['Black-and-white', 'Drama']",1930,5
445066,RoboCop,1987,['United States of America'],"['Action', 'Crime Fiction', 'Action/Adventure', 'Satire', 'Thriller', 'Superhero movie', 'Stop motion', 'Science Fiction']",1980,7
4885225,The Big Wheel,1949,['United States of America'],"['Action', 'Auto racing', 'Black-and-white', 'Action/Adventure', 'Sports', 'Drama']",1940,9
23257408,Murder C.O.D.,1990,['United States of America'],"['Crime Fiction', 'Thriller', 'Television movie', 'Crime Thriller', 'Drama']",1990,0
17997162,Brüno,2009,['United States of America'],['Comedy'],2000,9
4695168,La Bataille de San Sebastian,1968,"['France', 'Mexico', 'Italy']","['Action', 'Western', 'Action/Adventure', 'World cinema', 'Spaghetti Western', 'Adventure']",1960,8
2251076,Breakin' 2: Electric Boogaloo,1984,['United States of America'],"['Musical', 'Drama', 'Indie', 'Teen', 'Dance', 'Hip hop movies']",1980,4
10026936,Take the High Ground!,1953,['United States of America'],"['War film', 'Comedy']",1950,3
2667691,The Firemen's Ball,1967,"['Czechoslovakia', 'Czech Republic', 'Italy']","['Satire', 'Comedy', 'Comedy film', 'World cinema', 'Black comedy', 'Czechoslovak New Wave', 'Drama']",1960,7
6679879,Jack-Wabbit and the Beanstalk,1943,[],"['Animation', 'Short Film', 'Comedy film', 'Family Film']",1940,3
6976299,Here We Go Round the Mulberry Bush,1968,['United Kingdom'],"['Coming of age', 'Comedy', 'Teen', 'Comedy-drama', 'Sex comedy']",1960,8
2212664,Brian's Song,1971,['United States of America'],"['Biographical film', 'Television movie', 'Sports', 'Drama']",1970,1
2553269,The Plastic Age,1925,['United States of America'],"['Black-and-white', 'Indie', 'Comedy', 'Silent film', 'Romance Film', 'Romantic comedy', 'Comedy-drama']",1920,5
25693212,Decameron: Two Naughty Tales,2005,['Italy'],['Gay pornography'],2000,5
14383677,The Comic,1969,['United States of America'],"['Black comedy', 'Comedy', 'Drama']",1960,9
31707804,Scandalous John,1971,['United States of America'],"['Western', 'Comedy']",1970,1
25079637,Teenage Doll,1957,['United States of America'],"['Film noir', 'Crime Fiction', 'Drama']",1950,7
1912693,HMS Defiant,1962,['United Kingdom'],"['Action/Adventure', 'Adventure', 'Costume drama', 'Drama']",1960,2
1858682,Monkey Business,1952,['United States of America'],"['Black-and-white', 'Screwball comedy', 'Comedy', 'Romance Film', 'Romantic comedy']",1950,2
18599919,Ustedes los ricos,1948,['Mexico'],"['Comedy', 'World cinema', 'Drama', 'Comedy of Errors']",1940,8
3450162,Grand Slam,1978,['United Kingdom'],"['Action', 'Drama', 'Comedy', 'Television movie', 'Sports', 'Adventure']",1970,8
6586251,Sanam Bewafa,1991,['India'],"['Romantic drama', 'Action/Adventure', 'Thriller', 'Bollywood', 'World cinema', 'Romance Film', 'Drama']",1990,1
3461478,Shatter Dead,1994,['United States of America'],"['B-movie', 'Zombie Film', 'Horror']",1990,4
14280823,How to Lose Friends & Alienate People,2008,['United Kingdom'],"['Romance Film', 'Romantic comedy', 'Comedy']",2000,8
20765561,Wild 90,1968,['United States of America'],"['Drama', 'Crime Fiction']",1960,8
22693744,Work Is a Four-Letter Word,1968,['United Kingdom'],['Comedy'],1960,8
52549,Star Wars Episode IV: A New Hope,1977,['United States of America'],"['Action', 'Coming of age', 'Adventure', 'Space western', 'Science Fiction', 'Family Film', 'Fantasy']",1970,7
20964509,Ghost Chase,1987,['Germany'],"['Comedy', 'Teen', 'World cinema', 'Science Fiction', 'Fantasy Comedy', 'Fantasy']",1980,7
338962,Splash,1984,['United States of America'],"['Romance Film', 'Comedy', 'Fantasy']",1980,4
903383,Shrek the Third,2007,['United States of America'],"['Animation', 'Comedy', ""Children's/Family"", 'Adventure', 'Fairy tale', ""Children's Fantasy"", 'Fantasy Comedy', 'Family Film', 'Fantasy']",2000,7
3879783,Is It Fall Yet?,2000,"['United States of America', 'South Korea']","['Comedy', 'Animation']",2000,0
2701261,Marie Antoinette,2006,"['France', 'Japan', 'United States of America']","['History', 'Japanese Movies', 'Biography', 'Drama']",2000,6
2839299,Don't Go In The Woods,1980,['United States of America'],"['Slasher', 'Horror', 'B-movie', 'Road-Horror']",1980,0
21605437,Big City,1937,['United States of America'],"['Black-and-white', 'Drama']",1930,7
2485411,Outskirts,1998,['Russia'],"['Action/Adventure', 'World cinema', 'Political drama', 'Drama']",1990,8
26615617,Meerayude Dukhavum Muthuvinte Swapnavum,2003,['India'],"['Musical', 'Drama']",2000,3
7990852,The Shout,1978,['United Kingdom'],"['Drama', 'Horror']",1970,8
235331,Red Beard,1965,['Japan'],"['Period piece', 'Black-and-white', 'Art film', 'Japanese Movies', 'World cinema', 'Drama', 'Medical fiction']",1960,5
13408866,Youth in Revolt,2009,['United States of America'],"['Comedy', 'Teen', 'Black comedy', 'Romantic comedy', 'Romance Film', 'Drama', 'Sex comedy']",2000,9
25897109,Superfantagenio,1987,"['Spain', 'Italy', 'United States of America']","['Comedy', 'Teen', ""Children's/Family"", 'Adventure', 'Fantasy Comedy', 'Family Film', 'Fantasy']",1980,7
922145,Zulu Dawn,1979,['United Kingdom'],"['British Empire Film', 'Action', 'Action/Adventure', 'Adventure', 'Drama', 'Period piece', 'Historical fiction', 'Epic', 'War film']",1970,9
25382451,Whisper of the Heart,1995,['Japan'],"['Animation', 'Japanese Movies', 'Family Drama', 'Anime', ""Children's"", 'Drama', 'Family Film']",1990,5
5940203,Romy and Michele: In the Beginning,2005,['United States of America'],['Comedy'],2000,5
915147,Chunhyang,2000,"['Korea', 'South Korea']","['Musical', 'Period piece', 'Romantic drama', 'World cinema', 'Romance Film', 'Drama']",2000,0
23922732,Inner Sanctum,1948,['United States of America'],"['Mystery', 'Thriller']",1940,8
23497068,Colpo di luna,1995,"['France', 'Italy', 'Netherlands']",['Drama'],1990,5
5999816,The Quiet American,2002,"['Australia', 'United Kingdom', 'France', 'Germany', 'United States of America']","['Film adaptation', 'Crime Fiction', 'Romantic drama', 'Thriller', 'Romance Film', 'War film', 'Drama', 'Period piece', 'Political drama', 'Political thriller']",2000,2
25079889,Sinners in Paradise,1938,['United States of America'],"['Adventure', 'Drama']",1930,8
7279333,Werewolves on Wheels,1971,['United States of America'],"['Outlaw biker film', 'Biker Film', 'Horror']",1970,1
3069564,Joy Ride,2001,['United States of America'],"['Psychological thriller', 'Suspense', 'Thriller', 'Horror', 'Crime Thriller']",2000,1
31087316,Punch and Jody,1974,['United States of America'],['Drama'],1970,4
2742956,La Chienne,1931,['France'],"['Black-and-white', 'Drama']",1930,1
1849258,House of Wax,2005,"['United States of America', 'Australia']","['Slasher', 'Thriller', 'Horror', 'Teen']",2000,5
2249113,Dark City,1950,['United States of America'],"['Crime Fiction', 'Thriller', 'Film noir', 'Crime Thriller', 'Drama']",1950,0
13503679,Lethal Angels,2006,['Hong Kong'],"['Action', 'Action Thrillers', 'Action/Adventure', 'Thriller', 'World cinema', 'Crime Thriller', 'Chinese Movies', 'Erotic thriller']",2000,6
8710454,Dolls,2006,['United Kingdom'],['Short Film'],2000,6
8548290,Qayamat: City Under Threat,2003,['India'],"['Action', 'Action/Adventure', 'Thriller', 'World cinema']",2000,3
20319204,The Professional,2003,['Serbia'],"['Action Thrillers', 'Coming of age', 'Buddy film', 'Thriller', 'Comedy', 'Drama']",2000,3
4461885,Welcome to L.A.,1976,['United States of America'],"['Romantic drama', 'Drama', 'Ensemble Film']",1970,6
19698524,Centigrade,2007,['Canada'],"['Short Film', 'Thriller', 'Horror']",2000,7
1673588,The Brother from Another Planet,1984,['United States of America'],"['Drama', 'Indie', 'Science Fiction', 'Comedy', 'Romance Film', 'Fantasy Comedy', 'Cult']",1980,4
2408687,Warlock,1989,['United States of America'],"['Supernatural', 'Cult', 'Horror']",1980,9
34637161,I Love Luci,2009,['Scotland'],"['Short Film', 'Comedy', 'Drama']",2000,9
670226,The Chronicles of Riddick,2004,['United States of America'],"['Action', 'Action/Adventure', 'Science Fiction', 'Thriller', 'Adventure']",2000,4
10289905,Anjaneya,2003,['India'],"['Crime Drama', 'Tamil cinema']",2000,3
10820768,Suspicious River,2000,['Canada'],"['Psychological thriller', 'Crime Fiction', 'Erotic Drama', 'Indie', 'Drama']",2000,0
10483327,The Haunting Hour Volume One: Don't Think About It,2007,['United States of America'],"[""Children's"", 'Comedy', 'Horror', 'Adventure', 'Family Film', 'Fantasy']",2000,7
1958896,Empire,2002,['United States of America'],"['Action', 'Drama', 'Crime Fiction', 'Indie', 'Thriller']",2000,2
7280966,Full Moon High,1987,['United States of America'],"['Parody', 'Horror Comedy', 'Comedy', 'Horror', 'Sports']",1980,7
1192473,Robotech: The Shadow Chronicles,2006,['United States of America'],"['Anime', 'Animation', 'Science Fiction']",2000,6
2836801,High Hopes,1988,"['United Kingdom', 'England']","['Indie', 'Comedy', 'Mockumentary', 'Drama']",1980,8
26614192,Kunjikoonan,2002,['India'],['Drama'],2000,2
7940626,Passion in the Desert,1998,['United States of America'],"['Period piece', 'Action/Adventure', 'Costume drama', 'Animal Picture', 'Adventure', 'Drama', 'Fantasy']",1990,8
265975,Sid and Nancy,1986,['United Kingdom'],"['Musical', 'Indie', 'Romantic drama', 'Biographical film', 'Romance Film', 'Punk rock', 'Addiction Drama', 'Drama', 'Tragedy', 'Biopic [feature]', 'Cult']",1980,6
1897463,Wah-Wah,2006,['England'],"['Period piece', 'Drama', 'Indie', 'Family Drama', 'Coming of age', 'Comedy-drama']",2000,6
18015352,The Black Orchid,1958,['United States of America'],"['Romance Film', 'Romantic drama', 'Drama']",1950,8
19082345,The Marrying Man,1991,['United States of America'],"['Crime Fiction', 'Gangster Film', 'Comedy', 'Crime Comedy', 'Romantic comedy', 'Romance Film']",1990,1
6893550,Cadavre Exquis première édition,2006,['Canada'],['Drama'],2000,6
1026994,The Whole Ten Yards,2004,['United States of America'],"['Action', 'Crime Fiction', 'Gangster Film', 'Action/Adventure', 'Comedy', 'Thriller', 'Crime Thriller', 'Crime Comedy']",2000,4
25276910,Return to Macon County,1975,['United States of America'],['Drama'],1970,5
6048468,September Dawn,2007,['Canada'],"['Period piece', 'Revisionist Western', 'Romantic drama', 'Western', 'Action/Adventure', 'Romance Film', 'Drama']",2000,7
13919299,The Devil’s Gift,1984,['United States of America'],"['Thriller', 'Horror']",1980,4
13490096,Timecrimes,2007,['Spain'],"['Mystery', 'Thriller', 'World cinema', 'Crime Thriller', 'Supernatural', 'Science Fiction']",2000,7
11285083,Late One Night,2001,['United States of America'],"['Short Film', 'Christian film', 'Religious Film', 'Drama']",2000,1
1493527,Timecop,1994,"['Japan', 'United States of America']","['Action', 'Time travel', 'Japanese Movies', 'Action/Adventure', 'Thriller', 'Superhero movie', 'Science Fiction']",1990,4
1356971,Sabrina,1954,['United States of America'],"['Black-and-white', 'Comedy', 'Romance Film', 'Romantic comedy', 'Comedy-drama', 'Drama']",1950,4
1808570,Blood Sucking Freaks,1976,['United States of America'],"['B-movie', 'Cult', 'Horror']",1970,6
10374164,"Jenny, Juno",2005,['South Korea'],"['Romance Film', 'Comedy']",2000,5
13308646,One of the Hollywood Ten,2000,"['United Kingdom', 'Spain', 'England']","['Drama', 'Biographical film']",2000,0
7279558,The Werewolf of Washington,1973,['United States of America'],"['Blaxploitation', 'Indie', 'Satire', 'Comedy', 'Horror Comedy', 'Creature Film', 'Horror', 'B-movie']",1970,3
2967223,Morituri,1965,['United States of America'],"['Action', 'Period piece', 'Drama', 'Thriller', 'War film']",1960,5
6961032,"Don't Just Lie There, Say Something!",1973,['United Kingdom'],"['Comedy', 'Sex comedy']",1970,3
9843384,All About You,2001,['United States of America'],"['Drama', 'Indie', 'Romantic drama', 'Comedy', 'Romance Film', 'Romantic comedy']",2000,1
17451938,Tawny Pipit,1944,['United Kingdom'],"['Comedy', 'Black-and-white']",1940,4
6335006,Modesty Blaise,1966,['United Kingdom'],"['Action', 'Spy', 'Parody', 'Action/Adventure', 'Comedy']",1960,6
12632216,The Two Worlds of Jenny Logan,1979,['United States of America'],['Romantic drama'],1970,9
2592877,Love Stinks,1999,['United States of America'],"['Romance Film', 'Romantic comedy', 'Comedy']",1990,9
2421509,Another Woman,1988,['United States of America'],"['Psychological thriller', 'Drama']",1980,8
30372222,Ganga Ki Kasam,1999,[],['Drama'],1990,9
1050541,Guys and Balls,2004,['Germany'],"['LGBT', 'Comedy', 'World cinema', 'Romantic comedy', 'Sports']",2000,4
4859230,Sheerluck Holmes and the Golden Ruler,2006,[],"['Musical', 'Animation', 'Short Film', 'Comedy', ""Children's""]",2000,6
4259091,Dorian Blues,2004,['United States of America'],"['LGBT', 'Comedy', 'Teen', 'Drama', 'Gay Themed', 'Gay', 'Coming of age', 'Gay Interest', 'Comedy-drama']",2000,4
30863819,Taps,1981,['United States of America'],['Drama'],1980,1
26759941,Caravans,1978,"['Iran', 'United States of America']","['Action', 'Film adaptation', 'Action/Adventure', 'Epic', 'Political drama', 'Adventure', 'Drama']",1970,8
18023344,The Rose Tattoo,1955,['United States of America'],"['Black-and-white', 'Family Drama', 'Romantic drama', 'Melodrama', 'Drama']",1950,5
10243437,In a Dark Place,2006,"['Luxembourg', 'United Kingdom']","['Psychological thriller', 'Thriller', 'Horror', 'Supernatural']",2000,6
4762122,Hathi Mere Sathi,1971,['India'],"['Musical', 'Romantic drama', 'Action/Adventure', 'Bollywood', 'World cinema', 'Romance Film', 'Drama']",1970,1
36037575,Jane's House,1994,"['Canada', 'United States of America']",['Drama'],1990,4
34050487,Silver Dollar,1932,['United States of America'],"['Biographical film', 'Biopic [feature]', 'Docudrama', 'Drama']",1930,2
2170376,The Stöned Age,1994,['United States of America'],"['Stoner film', 'Indie', 'Comedy', 'Teen', 'Cult']",1990,4
20407039,Open City,2008,['South Korea'],"['Action', 'Crime Fiction']",2000,8
558336,Garden State,2004,['United States of America'],"['Romantic drama', 'Coming of age', 'Comedy', 'Romantic comedy', 'Romance Film', 'Comedy-drama', 'Drama']",2000,4
10335706,This Time for Keeps,1947,['United States of America'],"['Musical', 'Comedy', 'Romance Film', 'Romantic comedy']",1940,7
24041333,Les Derniers jours du monde,2009,['France'],"['Romantic drama', 'World cinema', 'Romance Film', 'Drama']",2000,9
14716766,Where Were You When the Lights Went Out?,1968,['United States of America'],"['Romantic comedy', 'Comedy', 'Comedy of Errors']",1960,8
156632,The Lavender Hill Mob,1951,['United Kingdom'],"['Ealing Comedies', 'Black-and-white', 'Crime Fiction', 'Satire', 'Comedy', 'Parody', 'Caper story', 'Crime Comedy']",1950,1
3195724,Dynasty: The Making of a Guilty Pleasure,2005,"['United States of America', 'Australia']","['Docudrama', 'Drama']",2000,5
24283167,Swarga Seema,1945,['India'],['Drama'],1940,5
8830252,Case Closed: The Time Bombed Skyscraper,1997,['Japan'],"['Action', 'Animation', 'Japanese Movies', 'Anime']",1990,7
20789060,Sonnal Thaan Kathala,2001,['India'],['Romance Film'],2000,1
31749363,Sandy Claws,1955,[],"['Animation', 'Short Film', 'Family Film']",1950,5
8395348,The Lost Letter,1945,['Soviet Union'],"['Animation', 'Short Film', 'Fantasy']",1940,5
23605276,1-Ichi,2003,['Japan'],"['Japanese Movies', 'Action/Adventure', 'Thriller', 'World cinema', 'Crime Thriller']",2000,3
1848829,Koma,2004,['Hong Kong'],"['Thriller', 'Chinese Movies', 'World cinema']",2000,4
4829422,The Other Side of the Wind,1972,"['France', 'Iran', 'United States of America']","['Short Film', 'Documentary']",1970,2
12112868,Yamaleela,1994,['India'],"['Comedy', 'Drama', 'Family Film', 'Fantasy']",1990,4
22277244,"Je t'aime, je t'aime",1968,['France'],"['Surrealism', 'Heaven-Can-Wait Fantasies', 'Avant-garde', 'Experimental film', 'Science Fiction', 'Fantasy']",1960,8
1040965,Batman Beyond: Return of the Joker,2000,['United States of America'],"['Action', 'Animation', 'Superhero', 'Superhero movie', 'Science Fiction']",2000,0
14073116,The Wandering Swordsman,1970,['Hong Kong'],"['Action', 'Action/Adventure', 'World cinema', 'Wuxia', 'Chinese Movies', 'Martial Arts Film']",1970,0
1260445,The Ref,1994,['United States of America'],"['Crime Fiction', 'Comedy', 'Black comedy', 'Domestic Comedy', 'Comedy-drama']",1990,4
3652373,Anonymous Rex,2004,['United States of America'],"['Television movie', 'Science Fiction', 'Fantasy']",2000,4
22537025,Plaza Suite,1971,['United States of America'],['Comedy'],1970,1
25221701,Lulu and Jimi,2009,['Germany'],"['Romantic drama', 'World cinema', 'Romance Film', 'Drama']",2000,9
13073735,Forest of Death,2007,['Hong Kong'],"['Detective fiction', 'Crime Fiction', 'Thriller', 'Detective', 'Horror', 'World cinema', 'Chinese Movies']",2000,7
4861656,The Blindflyers,2004,['Germany'],"[""Children's""]",2000,4
6030184,Blackenstein,1974,['United States of America'],"['Creature Film', 'Blaxploitation', 'Action/Adventure', 'Horror']",1970,4
2387930,Red Zone Cuba,1966,['United States of America'],"['Action', 'Thriller', 'Drama']",1960,6
2853092,Pallavi Anu Pallavi,1983,['India'],[],1980,3
386476,The Frisco Kid,1979,['United States of America'],"['Comedy Western', 'Action/Adventure', 'Western', 'Buddy film', 'Comedy']",1970,9
12113716,Boulevard,1994,"['Canada', 'United States of America']","['Crime Fiction', 'Thriller', 'Crime Thriller', 'Drama']",1990,4
21082878,Taking a Chance on Love,2009,['Canada'],['Romance Film'],2000,9
26303157,Kept Husbands,1931,['United States of America'],"['Romantic drama', 'Marriage Drama', 'Drama']",1930,1
18734158,Garfield's Fun Fest,2008,"['United States of America', 'South Korea']","['Animation', 'Comedy', 'Family Film', 'Computer Animation']",2000,8
35008916,Licensed to Love and Kill,1979,['United Kingdom'],"['Action', 'Comedy film']",1970,9
8066735,Cosmic Voyage,1996,['United States of America'],"['Short Film', 'Documentary']",1990,6
8013000,"Bah, Humduck! A Looney Tunes Christmas",2006,['United States of America'],"[""Children's/Family"", 'Holiday Film', 'Christmas movie']",2000,6
4980349,Woh Saat Din,1983,['India'],"['Comedy', 'Drama', 'Family Film']",1980,3
31156893,Sheelabathi,2005,['India'],['Drama'],2000,5
17949718,Dark Tower,1987,['United States of America'],"['Supernatural', 'Thriller', 'Horror']",1980,7
36445964,Unforgivable,1996,['United States of America'],['Drama'],1990,6
3990322,The Breaking Point,1950,['United States of America'],"['Film noir', 'Crime Fiction', 'Drama']",1950,0
24159163,Dangerous Game,1987,['Australia'],"['Drama', 'Thriller', 'Horror']",1980,7
6618673,Employee of the Month,2006,['United States of America'],"['Romance Film', 'Romantic comedy', 'Comedy']",2000,6
1586285,Lenin in Paris,1980,['Soviet Union'],['Drama'],1980,0
13550268,Naseem,1995,['India'],"['Family Drama', 'Political drama', 'Drama']",1990,5
3477618,Once Upon a Girl,1976,['United States of America'],"['Animation', 'Comedy', 'Hardcore pornography', 'Pornographic movie', 'Adult']",1970,6
30077600,The Lord Protector,1996,['United States of America'],"['Action', 'Adventure', 'Fantasy']",1990,6
323715,Troy,2004,"['United Kingdom', 'Malta', 'United States of America']","['Action', 'Action/Adventure', 'Documentary', 'Romance Film', 'Sword and Sandal', 'Costume drama', 'Adventure', 'History', 'Historical Epic', 'Historical fiction', 'Epic', 'War film']",2000,4
6410861,The Case Of The Stuttering Pig,1937,['United States of America'],['Black-and-white'],1930,7
5734461,Wrong Turn 2: Dead End,2007,"['Canada', 'United States of America']","['Action', 'Slasher', 'Thriller', 'Horror']",2000,7
19103721,Sorority House,1939,['United States of America'],"['Romance Film', 'Black-and-white', 'Drama']",1930,9
67441,Ticker,2001,['United States of America'],"['Action', 'Action Thrillers', 'Chase Movie', 'Action/Adventure', 'Thriller']",2000,1
26273354,Hot Rod Girl,1956,['United States of America'],"['Action/Adventure', 'Adventure', 'Juvenile Delinquency Film', 'Drama']",1950,6
3194438,A Return to Salem's Lot,1987,['United States of America'],['Horror'],1980,7
5444637,Leprechaun 3,1994,['United States of America'],"['Creature Film', 'Monster movie', 'Slasher', 'Horror', 'Supernatural', 'Cult']",1990,4
164754,Lilo & Stitch,2002,['United States of America'],"['Animation', 'Educational', 'Comedy', 'Adventure', 'Science Fiction', 'Family Film', 'Fantasy']",2000,2
5718787,The Sons of Katie Elder,1965,['United States of America'],"['Western', 'Action/Adventure', 'Drama']",1960,5
1495709,The Company of Wolves,1984,"['United Kingdom', 'England', 'United States of America']","['Creature Film', 'Fairy tale', 'Horror', 'Cult', 'Fantasy']",1980,4
11151407,Baton Baton Mein,1979,['India'],"['Musical', 'Romantic drama', 'Comedy', 'Bollywood', 'World cinema', 'Romance Film', 'Drama', 'Romantic comedy']",1970,9
315035,The Other,1972,['United States of America'],"['Psychological thriller', 'Thriller', 'Horror']",1970,2
81503,Indiana Jones and the Temple of Doom,1984,['United States of America'],"['Action', 'Costume Adventure', 'Action/Adventure', 'Adventure']",1980,4
11257726,Kalapani,1958,['India'],"['Musical', 'Black-and-white', 'Bollywood', 'World cinema']",1950,8
7688046,Sea of Fear,2005,['United States of America'],"['Psychological thriller', 'Slasher', 'Thriller', 'Horror']",2000,5
19098625,Tiramisu,2002,['Hong Kong'],"['Romantic drama', 'World cinema', 'Romance Film', 'Chinese Movies', 'Drama', 'Fantasy']",2000,2
23691085,Lights of Old Santa Fe,1944,['United States of America'],"['Action', 'Musical', 'Action/Adventure', 'Western']",1940,4
2461103,Bitter Rice,1949,['Italy'],"['Black-and-white', 'Drama', 'World cinema']",1940,9
981884,Eden Lake,2008,"['United Kingdom', 'England']","['Slasher', 'Thriller', 'Horror']",2000,8
20929541,In the Loop,2009,['United Kingdom'],"['Political cinema', 'Political satire', 'Comedy', 'Black comedy']",2000,9
3901356,Dreamchild,1985,['United Kingdom'],"['Period piece', 'Biopic [feature]', 'Drama', 'Fantasy']",1980,5
29836849,Cave-In!,1983,['United States of America'],['Drama'],1980,3
29752380,La seconda ombra,2000,[],"['Drama', 'Biographical film']",2000,0
2269465,Jason X,2001,['United States of America'],"['Thriller', 'Teen', 'Adventure', 'Slasher', 'Horror', 'Supernatural', 'Science Fiction', 'Cult']",2000,1
1842500,Spun,2003,['United States of America'],"['Drama', 'Crime Fiction', 'Indie', 'Comedy', 'Black comedy', 'Comedy-drama']",2000,3
14228567,A Snitch in Time,1950,['United States of America'],"['Short Film', 'Black-and-white', 'Comedy']",1950,0
11522190,The Little Thief,1988,['France'],"['Drama', 'Coming of age', 'Teen']",1980,8
1252914,Indiana Jones and the Kingdom of the Crystal Skull,2008,['United States of America'],"['Adventure Comedy', 'Action', 'Costume Adventure', 'Action/Adventure', 'Thriller', 'Adventure', 'Family Film', 'Fantasy']",2000,8
23624549,Escape from Fort Bravo,1953,['United States of America'],"['Action', 'Action/Adventure', 'Western', 'Adventure']",1950,3
28301538,"Love, Bitter",2009,['Turkey'],['Drama'],2000,9
14705670,Why Change Your Wife?,1920,['United States of America'],"['Black-and-white', 'Indie', 'Romantic drama', 'Comedy', 'Romance Film', 'Drama', 'Silent film', 'Romantic comedy']",1920,0
17137344,Time of the Wolf,2002,"['Canada', 'Germany']","['Family Drama', 'Childhood Drama', 'Animal Picture', ""Children's/Family"", 'Drama', 'Family Film']",2000,2
187010,Pinocchio,1940,['United States of America'],"['Music', 'Animation', 'Adventure', 'Drama', 'Family Film', 'Fantasy']",1940,0
13365759,Android Apocalypse,2006,['United States of America'],"['Television movie', 'Science Fiction', 'Thriller']",2000,6
33024214,Saturday's Children,1940,['United States of America'],"['Romance Film', 'Drama']",1940,0
4150178,Hamilton,1998,"['Sweden', 'Norway']","['Action', 'Crime Fiction', 'Adventure']",1990,8
1365630,Pocketful of Miracles,1961,['United States of America'],"['Comedy', 'Comedy of manners', 'Domestic Comedy', 'Comedy-drama']",1960,1
13504835,Ginger and Cinnamon,2003,['Italy'],"['Art film', 'Romantic drama', 'Comedy', 'World cinema', 'Romance Film', 'Drama', 'Comedy of Errors', 'Romantic comedy']",2000,3
13501099,Walk All Over Me,2007,['Canada'],"['Crime Fiction', 'Thriller', 'Erotic thriller', 'Crime Thriller', 'Drama']",2000,7
1338432,Rebirth of Mothra,1996,['Japan'],"['Action', 'Japanese Movies', 'Monster', 'Science Fiction', 'Fantasy']",1990,6
2823668,Missing in America,2005,"['Canada', 'United States of America']","['War film', 'Drama']",2000,5
26970821,Lesbian Harem,1987,['Japan'],"['Japanese Movies', 'Fantasy']",1980,7
12319832,Transformers: Revenge of the Fallen,2009,['United States of America'],"['Action', 'Thriller', 'Adventure', 'Science Fiction']",2000,9
29042331,New Mr. Vampire,1987,['Hong Kong'],"['Comedy horror', 'Chinese Movies', 'Horror']",1980,7
8504201,Le vieux fusil,1975,['France'],"['Thriller', 'Melodrama', 'War film', 'Drama']",1970,5
18569735,Gentlemen Are Born,1934,['United States of America'],"['Black-and-white', 'Drama']",1930,4
12603065,The Nest,1980,"['Argentina', 'Spain']",['Drama'],1980,0
5512355,Tarzan and the Lost City,1998,"['Germany', 'United States of America', 'Australia']","['Action', 'Costume Adventure', 'Action/Adventure', ""Children's/Family"", 'Costume drama', 'Adventure', 'Period piece', 'Jungle Film']",1990,8
10800668,Heroes Two,1974,['Hong Kong'],"['Action', 'History', 'Action/Adventure', 'World cinema', 'Chinese Movies', 'Martial Arts Film', 'Drama']",1970,4
4031078,Dr. Goldfoot and the Bikini Machine,1965,['United States of America'],"['Action', 'Parody', 'Action/Adventure', 'Comedy', 'Teen', 'Science Fiction']",1960,5
27363750,Successive Slidings of Pleasure,1974,['France'],"['Fantasy', 'Thriller', 'Horror']",1970,4
16796753,Havana Widows,1933,['United States of America'],"['Comedy', 'Black-and-white']",1930,3
659378,Snake & Crane Arts of Shaolin,1978,"['Hong Kong', 'South Korea']","['Action', 'Action/Adventure', 'World cinema', 'Chinese Movies', 'Martial Arts Film', 'Drama']",1970,8
6386227,It's In the Water,1997,['United States of America'],"['LGBT', 'Indie', 'Comedy', 'Americana', 'Gay Themed', 'Gay', 'Gay Interest', 'Romantic comedy', 'Comedy-drama']",1990,7
10299953,Made in Heaven,1987,['United States of America'],"['Drama', 'Indie', 'Romantic drama', 'Comedy', 'Romance Film', 'Romantic comedy', 'Fantasy']",1980,7
12883423,Normal Life,1996,['United States of America'],"['Drama', 'Crime Fiction', 'Indie', 'Romantic drama', 'Thriller', 'Crime Drama']",1990,6
9136736,"Toot, Whistle, Plunk and Boom",1953,['United States of America'],"['Animation', 'Family Film', 'Documentary']",1950,3
11654754,The Three Musketeers,1948,['United States of America'],"['Action', 'Film adaptation', 'Action/Adventure', 'Romance Film', 'Costume drama', 'Adventure', 'Drama', 'Swashbuckler films']",1940,8
2421409,Broadway Danny Rose,1984,['United States of America'],"['Comedy', 'Comedy of Errors']",1980,4
22718776,Dead Ahead: The Exxon Valdez Disaster,1992,"['United Kingdom', 'United States of America']","['Docudrama', 'Disaster', 'Drama']",1990,2
9316781,The Jigsaw Man,1983,['United Kingdom'],"['Action', 'Spy', 'Drama', 'Indie', 'Thriller', 'Political thriller']",1980,3
31022942,Fall Guy,1947,[],['Film noir'],1940,7
6077443,Вчера,1988,['Bulgaria'],['Drama'],1980,8
12251711,The Killing of Angel Street,1981,['Australia'],"['Crime Fiction', 'Thriller', 'Melodrama', 'Drama']",1980,1
9015927,Kannum Kannum,2008,['India'],['Drama'],2000,8
24828951,Dicen Que Soy Mujeriego,1949,['Mexico'],['World cinema'],1940,9
17863395,How To Be,2008,['United Kingdom'],"['Coming of age', 'Indie', 'Comedy']",2000,8
23307519,Fimpen,1974,['Sweden'],"['Sports', 'Adventure', 'Drama']",1970,4
3417532,The Dream Machine,1990,['United States of America'],"['Indie', 'Comedy', 'Thriller', 'Teen']",1990,0
5221632,Master with Cracked Fingers,1971,['Hong Kong'],"['Action', 'Action/Adventure', 'Comedy', 'World cinema', 'Chinese Movies', 'Martial Arts Film', 'Drama']",1970,1
22465691,Lovers and Lollipops,1956,['United States of America'],"['Black-and-white', 'Avant-garde', 'Experimental film', ""Children's"", 'Drama', 'Slice of life story']",1950,6
8557673,American Dreamer,1984,['United States of America'],"['Action', 'Crime Fiction', 'Action/Adventure', 'Comedy', 'Thriller', 'Romance Film', 'Adventure', 'Comedy film', 'Romantic comedy']",1980,4
6476067,Hands Over the City,1963,"['France', 'Italy']","['Black-and-white', 'Art film', 'World cinema', 'Drama']",1960,3
2920744,My Favourite Wife,1940,['United States of America'],"['Black-and-white', 'Screwball comedy', 'Comedy', 'Romance Film', 'Romantic comedy']",1940,0
5131440,Halloween Is Grinch Night,1977,['United States of America'],"['Animation', 'Short Film', 'Comedy', 'Family Film', 'Fantasy']",1970,7
11440428,Dil Kya Kare,1999,['India'],"['Drama', 'World cinema']",1990,9
24652963,The Animal Kingdom,1932,['United States of America'],"['Romantic drama', 'Comedy', 'Comedy of manners', 'Romance Film', 'Romantic comedy', 'Comedy-drama', 'Drama']",1930,2
19744710,Alfalfa's Double,1940,['United States of America'],"['Black-and-white', 'Short Film', 'Comedy', 'Family Film']",1940,0
21127928,The Woman Hunter,1972,['United States of America'],['Mystery'],1970,2
1246480,Leonard Part 6,1987,['United States of America'],"['Action', 'Spy', 'Parody', 'Action/Adventure', 'Comedy film']",1980,7
25249826,You're Beautiful,2009,[],['World cinema'],2000,9
20326029,The Wave,2008,['Germany'],"['Thriller', 'Drama']",2000,8
12565531,Watchers 3,1994,['United States of America'],"['Creature Film', 'Horror', 'B-movie', 'Science Fiction']",1990,4
6818007,Cracking Up,1983,['United States of America'],"['Slapstick', 'Comedy']",1980,3
7865056,Murphy's Law,1986,['United States of America'],"['Action', 'Crime Fiction', 'Mystery', 'Action/Adventure', 'Thriller', 'Crime Thriller']",1980,6
24464033,Bitter Victory,1957,[],"['Film adaptation', 'Romantic drama', 'Romance Film', 'War film', 'Drama']",1950,7
26011265,Krishnagudiyil Oru Pranayakalathu,1997,['India'],['Romance Film'],1990,7
9312752,Shadow Run,1998,['United Kingdom'],"['Heist', 'Crime Thriller', 'Thriller']",1990,8
2864939,The Great Silence,1968,"['France', 'Italy']","['Action/Adventure', 'Western', 'World cinema', 'Spaghetti Western']",1960,8
26235035,Rojulu Marayi,1955,['India'],['Drama'],1950,5
1963352,The New York Ripper,1982,"['Italy', 'United States of America']","['Giallo', 'Slasher', 'Splatter film', 'Thriller', 'Horror', 'Cult']",1980,2
10690553,Killing Birds,1988,['Italy'],"['Horror', 'World cinema', 'Zombie Film', 'Natural horror films']",1980,8
22904128,A Winnie the Pooh Thanksgiving,1998,['United States of America'],"['Animation', 'Short Film', 'Family Film']",1990,8
179351,One Hundred and One Dalmatians,1961,['United States of America'],"['Animation', 'Adventure', 'Drama', 'Family Film']",1960,1
497870,The Delinquents,1957,['United States of America'],['Drama'],1950,7
1188061,Born in East L.A.,1987,['United States of America'],"['Parody', 'Satire', 'Comedy', 'Comedy of Errors']",1980,7
35790651,Pandithurai,1992,['India'],['Drama'],1990,2
7150525,Bhoothnath,2008,['India'],"['Musical', 'Comedy', 'Bollywood', 'World cinema', 'Family-Oriented Adventure', ""Children's/Family"", 'Haunted House Film', 'Horror']",2000,8
28150777,Nothing But the Truth,1929,['United States of America'],['Comedy film'],1920,9
1587300,An American in Paris,1951,['United States of America'],"['Musical', 'Romance Film']",1950,1
23734952,Shattered Trust: The Shari Karney Story,1993,['United States of America'],"['Crime Fiction', 'Television movie', 'Drama', 'Courtroom Drama']",1990,3
14899853,So Big!,1932,['United States of America'],['Drama'],1930,2
385299,Aama,1964,"['Nepal', 'United States of America']",[],1960,4
28369046,Handsome Siblings,1992,['Hong Kong'],"['Wuxia', 'Chinese Movies']",1990,2
16796383,Once Upon a Time,2008,['South Korea'],"['Action', 'Crime Fiction', 'Historical drama', 'Comedy', 'Thriller', 'Romance Film', 'Adventure', 'Drama', 'Comedy film']",2000,8
27439224,The Last Hard Men,1976,['United States of America'],"['Action', 'Western']",1970,6
12780242,Three Strangers in Rome,1958,['Italy'],"['Black-and-white', 'Comedy', 'Romantic comedy', 'Drama']",1950,8
1759292,Shabd,2005,['India'],"['Romantic drama', 'World cinema', 'Romance Film', 'Drama']",2000,5
20850141,Man in the Middle,1963,"['United Kingdom', 'United States of America']","['Film adaptation', 'War film', 'Drama']",1960,3
8289010,The Dentist,1932,['United States of America'],"['Short Film', 'Comedy']",1930,2
6168268,Smile,1975,['United States of America'],"['Parody', 'Satire', 'Comedy', 'Drama']",1970,5
5829474,The Tracker,2002,"['New Zealand', 'Australia']","['Crime Fiction', 'History', 'Western', 'World cinema', 'Experimental film', 'Political drama', 'Drama']",2000,2
8069903,The Hitcher,2007,['United States of America'],"['Action', 'Slasher', 'Thriller', 'Horror', 'Teen', 'Drama', 'Cult']",2000,7
570491,The Gallopin' Gaucho,1928,['United States of America'],"['Short Film', 'Black-and-white', 'Comedy']",1920,8
10699774,Chor Machaye Shor,1974,['India'],"['Action', 'Musical', 'Romance Film']",1970,4
4298868,The Complete Truth About De-Evolution,1993,['United States of America'],"['Music', 'Documentary']",1990,3
28646062,Short Order,2005,"['United Kingdom', 'Germany', 'Ireland']","['Indie', 'Comedy', 'World cinema', 'Comedy-drama', 'Adventure', 'Drama']",2000,5
14994077,Sae sang bakuro,1994,['South Korea'],"['Drama', 'Comedy']",1990,4
2918617,The Prince of Pennsylvania,1988,['United States of America'],"['Drama', 'Indie', 'Comedy', 'Romance Film', 'Romantic comedy', 'Comedy-drama']",1980,8
35485633,Sengottai,1996,['India'],['Action'],1990,6
6808679,Manga Latina: Killer on the Loose,2005,"['Canada', 'United Kingdom']","['Animation', 'Indie', 'Comedy']",2000,5
18279599,Gypsy Magic,1997,['Republic of Macedonia'],"['Drama', 'Comedy']",1990,7
6491526,The Passion of Darkly Noon,1995,"['United Kingdom', 'Germany', 'Belgium']","['Psychological thriller', 'Drama', 'Mystery', 'Indie', 'Thriller', 'World cinema']",1990,5
24044707,El Penalti Mas Largo Del Mundo,2005,['Spain'],"['Sports', 'Comedy', 'World cinema']",2000,5
44366,Where the Heart Is,2000,['United States of America'],"['Romantic drama', 'Comedy', 'Romance Film', 'Drama']",2000,0
772823,Dead Again,1991,['United States of America'],"['Mystery', 'Thriller']",1990,1
18080210,The End of Summer,1961,['Japan'],"['Art film', 'Japanese Movies', 'World cinema', 'Drama']",1960,1
1966863,Emperor of the North,1973,['United States of America'],"['Action', 'Period piece', 'Action/Adventure', 'Thriller', 'Road movie', 'Adventure', 'Drama']",1970,3
3296253,The Comfort of Strangers,1990,"['United Kingdom', 'Italy', 'United States of America']","['Psychological thriller', 'Thriller', 'World cinema', 'Erotic thriller', 'Crime Thriller', 'Drama']",1990,0
11492971,Going Home,1944,['United States of America'],"['Animation', 'Short Film', 'Comedy']",1940,4
3623103,Halloween,2007,['United States of America'],"['Cult', 'Slasher', 'Horror']",2000,7
24470088,Sahara,1958,['India'],['Bollywood'],1950,8
16647548,Fixed Bayonets!,1951,['United States of America'],"['Action', 'Film adaptation', 'Drama', 'Action/Adventure', 'War film']",1950,1
22140210,The One Lamb,2009,['United States of America'],"['Christian film', 'Drama']",2000,9
18112571,Tortured,2008,"['Canada', 'United States of America']","['Psychological thriller', 'Gangster Film', 'Thriller', 'Crime Thriller']",2000,8
26057633,Casey's Shadow,1978,['United States of America'],"['Sports', 'Film adaptation', 'Family Drama', 'Animal Picture', 'Horse racing', 'Drama', 'Family Film']",1970,8
29526153,Turning Paige,2001,['Canada'],['Drama'],2000,1
864217,The Care Bears Movie,1985,"['Canada', 'United States of America']","[""Children's Fantasy"", 'Animation', 'Indie', ""Children's/Family"", 'Family Film', 'Fantasy']",1980,5
6777103,The Fastest Gun Alive,1956,['United States of America'],"['Action', 'Black-and-white', 'Western', 'Action/Adventure']",1950,6
5523710,The Devil's Backbone,2001,"['Mexico', 'Spain']","['Mystery', 'Gothic Film', 'Thriller', 'World cinema', 'Haunted House Film', 'Period piece', 'Horror', 'Supernatural', 'Fantasy']",2000,1
18794321,Midnight Man,1994,['United States of America'],"['Action', 'Action Thrillers', 'Indie', 'Thriller', 'Martial Arts Film']",1990,4
33689385,Challenge of a Lifetime,1985,['United States of America'],"['Sports', 'Drama', 'Comedy film']",1980,5
13263490,Saturno contro,2007,"['France', 'Turkey', 'Italy']","['LGBT', 'Romantic drama', 'Comedy', 'Thriller', 'World cinema', 'Romance Film', 'Drama']",2000,7
10815122,The Victim,1980,['Hong Kong'],"['Action', 'Action/Adventure', 'World cinema', 'Chinese Movies', 'Martial Arts Film', 'Drama']",1980,0
22276930,Geetham,1986,[],['Drama'],1980,6
23690966,In Old Caliente,1939,['United States of America'],"['Western', 'Black-and-white', 'Action/Adventure']",1930,9
146908,Scarlet Street,1945,['United States of America'],"['Black-and-white', 'Crime Fiction', 'Mystery', 'Thriller', 'Film noir', 'Romance Film', 'Drama', 'Crime Drama']",1940,5
13996322,Festival,1996,['South Korea'],[],1990,6
2692675,The First Traveling Saleslady,1956,['United States of America'],"['Western', 'Comedy']",1950,6
19741056,Rocky Marciano,1999,['United States of America'],"['Period piece', 'Sports', 'Boxing', 'Biography', 'Television movie', 'Drama']",1990,9
23691191,Twilight in the Sierras,1950,['United States of America'],"['Action', 'Crime Fiction', 'Action/Adventure', 'Western']",1950,0
77647,Wake Island,1942,['United States of America'],"['Action', 'Combat Films', 'Black-and-white', 'Action/Adventure', 'Propaganda film', 'War film', 'Drama']",1940,2
3576873,All Dogs Go to Heaven 2,1996,['United States of America'],"['Music', 'Animation', 'Animated Musical', 'Comedy', 'Buddy film', 'Romance Film', 'Family-Oriented Adventure', ""Children's/Family"", ""Children's"", 'Romantic comedy', 'Family Film', 'Fantasy']",1990,6
24273686,The Frightened Lady,1932,['United Kingdom'],"['Crime Fiction', 'Mystery', 'Thriller', 'Drama']",1930,2
9725560,A Crysanthemum Bursts in Cincoesquinas,1997,"['Brazil', 'Spain', 'Argentina', 'France']","['Indie', 'Drama']",1990,7
1967834,Stop! Or My Mom Will Shoot!,1992,['United States of America'],"['Action', 'Action/Adventure', 'Buddy film', 'Comedy']",1990,2
133622,Howards End,1992,"['United Kingdom', 'Japan']","['Period piece', 'Film adaptation', 'Japanese Movies', 'Romantic drama', 'Romance Film', 'Costume drama', 'Drama']",1990,2
225505,The Story of Adele H.,1975,['France'],"['Period piece', 'Romantic drama', 'Biopic [feature]', 'World cinema', 'Romance Film', 'Drama']",1970,5
21548126,Jannat Ki Talash,1999,['Pakistan'],"['Romance Film', 'Historical fiction', 'Drama']",1990,9
17595645,Mostly Ghostly: Who Let the Ghosts Out?,2008,['United States of America'],"['Comedy', ""Children's"", 'Family Film', 'Fantasy']",2000,8
6690845,The Amazing Transparent Man,1960,['United States of America'],"['Suspense', 'Black-and-white', 'Action Thrillers', 'Indie', 'Thriller', 'Crime Thriller', 'Science Fiction']",1960,0
168958,Friday the 13th,1980,['United States of America'],"['Slasher', 'Teen', 'Horror', 'Cult']",1980,0
19817250,Doin' Their Bit,1942,['United States of America'],"['Black-and-white', 'Short Film', 'Comedy', 'Family Film']",1940,2
32250175,Thillaanaa Mohanambal,1968,['India'],"['Romance Film', 'Drama']",1960,8
18849333,Rathnakumar,1949,['India'],"['Romance Film', 'Drama']",1940,9
3785094,Black and White,2002,"['United Kingdom', 'Australia']","['Crime Fiction', 'World cinema', 'Drama', 'Courtroom Drama']",2000,2
30489874,Hold Back the Night,1956,['United States of America'],['War film'],1950,6
19049168,The Red Meadows,1945,['Denmark'],"['War film', 'Drama']",1940,5
6701484,Thiruda Thirudi,2003,['India'],"['Romance Film', 'Comedy']",2000,3
31772080,Karma Aur Holi,2009,"['India', 'United States of America']","['Romantic drama', 'Indie', 'World cinema', 'Romance Film', 'Drama']",2000,9
901421,AVP: Alien vs. Predator,2004,"['United Kingdom', 'Germany', 'Czech Republic', 'United States of America']","['Action', 'Monster movie', 'Action/Adventure', 'Thriller', 'Horror', 'Science Fiction']",2000,4
3232438,The Candidate,1972,['United States of America'],"['Political cinema', 'Parody', 'Comedy', 'Political drama', 'Drama']",1970,2
153435,Rocky V,1990,['United States of America'],"['Action', 'Boxing', 'Drama', 'Melodrama', 'Sports']",1990,0
10119452,Mere Mehboob,1963,['India'],"['Musical', 'Bollywood', 'World cinema']",1960,3
10638027,Cachorro,2004,['Spain'],"['LGBT', 'Comedy', 'World cinema', 'Drama']",2000,4
4762538,The Adventures of Felix,2000,['France'],"['LGBT', 'Comedy', 'World cinema', 'Drama']",2000,0
7882413,Aurore,2005,['Canada'],"['Drama', 'Biographical film']",2000,5
33617254,Dying God,2008,[],['Horror'],2000,8
11594316,Laughing Sinners,1931,['United States of America'],"['Black-and-white', 'Romantic drama', 'Drama']",1930,1
5467622,A Funny Story About 6 and 9,1999,['Thailand'],"['Crime Fiction', 'Action/Adventure', 'Comedy', 'Thriller', 'World cinema']",1990,9
4822531,To Walk With Lions,1999,['Canada'],"['Period piece', 'Film adaptation', 'Biography', 'Biopic [feature]', 'Animal Picture', 'Drama']",1990,9
31157082,Thakarachenda,2007,[],['Drama'],2000,7
1797028,La Reine Margot,1994,"['France', 'Germany', 'Italy']","['Biography', 'Romantic drama', 'Historical drama', 'Biographical film', 'World cinema', 'Romance Film', 'Drama', 'Period piece', 'History', 'War film']",1990,4
13399638,The Edge of Heaven,2007,"['Germany', 'Turkey', 'Italy']","['LGBT', 'World cinema', 'Drama', 'Slice of life story']",2000,7
17619092,L'ultimo treno della notte,1975,['Italy'],"['Thriller', 'Horror']",1970,5
18983347,Storm Over the Nile,1955,['United Kingdom'],"['Adventure', 'War film']",1950,5
33498195,Stray Cat Rock: Sex Hunter,1970,['Japan'],"['Crime Fiction', 'Japanese Movies', 'Action/Adventure', 'Thriller', 'World cinema', 'Crime Thriller']",1970,0
26723019,Kangaroo,1952,['United States of America'],"['Adventure', 'Drama']",1950,2
14071897,Battle for Haditha,2007,['United Kingdom'],"['Action', 'Drama', 'Indie', 'Docudrama', 'War film', 'Ensemble Film']",2000,7
240371,Private Benjamin,1980,['United States of America'],"['Parody', 'Satire', 'Comedy', 'Comedy-drama', 'Drama', 'Feminist Film']",1980,0
28493001,Witnesses,2003,['Croatia'],"['Crime Fiction', 'Art film', 'World cinema', 'War film', 'Drama']",2000,3
2450188,Flesh,1968,['United States of America'],"['LGBT', 'Indie', 'Comedy', 'Drama']",1960,8
2996966,The Decline of Western Civilization II,1988,['United States of America'],"['Rockumentary', 'Documentary']",1980,8
10650919,Hillbillys in a Haunted House,1967,['United States of America'],"['Musical', 'Comedy', 'Horror Comedy', 'Musical comedy', 'Horror', 'Cult']",1960,7
19699124,Who's Nailin' Paylin?,2008,['United States of America'],['Pornographic movie'],2000,8
6284586,Winnie the Pooh and Christmas Too,1991,['United States of America'],"['Animation', 'Short Film', ""Children's/Family"", ""Children's""]",1990,1
18057739,(500) Days of Summer,2009,['United States of America'],"['Drama', 'Indie', 'Comedy', 'Romance Film', 'Romantic comedy', 'Comedy-drama']",2000,9
3291573,The Monster,1925,['United States of America'],"['Black-and-white', 'Comedy', 'Horror', 'Silent film']",1920,5
376485,Cube,1997,['Canada'],"['Psychological thriller', 'Escape Film', 'Thriller', 'Horror', 'Science Fiction']",1990,7
8523165,Woyzeck,1979,"['Germany', 'West Germany']","['Crime Fiction', 'Art film', 'World cinema', 'Drama']",1970,9
14353418,Maisie,1939,['United States of America'],"['Western', 'Black-and-white', 'Comedy']",1930,9
1199985,Bright Eyes,1934,['United States of America'],"['Musical', 'Black-and-white', 'Family Drama', 'Comedy', 'Drama', 'Family Film']",1930,4
11544346,Below Utopia,1997,['United States of America'],"['Action', 'Drama', 'Action/Adventure', 'Thriller', 'Crime Thriller']",1990,7
13776894,Take It or Leave It,1981,['United Kingdom'],"['Music', 'Comedy', 'Documentary', 'Drama']",1980,1
6841189,Through the Olive Trees,1994,"['France', 'Iran']","['Docudrama', 'Drama']",1990,4
20088468,The Big Man,1990,['United Kingdom'],"['Boxing', 'Crime Fiction', 'Sports', 'Drama']",1990,0
4430454,Gus,1976,['United States of America'],"['Comedy', 'Animal Picture', 'Sports', 'Drama', 'Family Film']",1970,6
9877595,Terry of the Times,1930,['United States of America'],"['Action', 'Black-and-white', 'Indie', 'Silent film', 'Adventure']",1930,0
2711926,The Odyssey,1997,['United States of America'],"['Action/Adventure', 'Adventure', 'Television movie', 'Drama', 'Fantasy']",1990,7
3717069,Memphis Belle,1990,"['United Kingdom', 'Japan', 'United States of America']","['Combat Films', 'Airplanes and airports', 'Japanese Movies', 'War film', 'Drama']",1990,0
5821603,Survive Style 5+,2004,['Japan'],['Japanese Movies'],2000,4
31441464,Son of Darkness: To Die For II,1991,[],['Horror'],1990,1
10593888,Emak-Bakia,1927,['France'],"['Surrealism', 'Short Film']",1920,7
4620459,"The Boys in Company ""C""",1978,"['Hong Kong', 'United States of America']","['Drama', 'Chinese Movies', 'War film']",1970,8
16183078,Whoever Slew Auntie Roo?,1972,['United Kingdom'],"['Psychological thriller', 'Psycho-biddy', 'Slasher', 'Thriller', 'Horror']",1970,2
5676296,Liberty Stands Still,2002,"['Germany', 'United States of America', 'Canada']","['Psychological thriller', 'Suspense', 'Crime Fiction', 'Thriller', 'Crime Thriller', 'Drama']",2000,2
142262,Debbie Does Dallas,1978,['United States of America'],"['Adult', 'Hardcore pornography', 'Pornographic movie']",1970,8
18056742,London Dreams,2007,['India'],"['Musical', 'Musical Drama', 'Bollywood', 'World cinema', 'Drama']",2000,7
304428,The Birds,1963,['United States of America'],"['Suspense', 'Thriller', 'Horror', 'Doomsday film', 'Natural horror films']",1960,3
748858,Violent Cop,1989,['Japan'],"['Action', 'Drama', 'Crime Fiction', 'Japanese Movies', 'Thriller']",1980,9
3080716,Venom,2005,['United States of America'],"['Slasher', 'Thriller', 'Horror', 'Teen', 'Supernatural', 'Cult']",2000,5
32910716,The Arrogant,1987,[],"['Action', 'Crime Fiction', 'Thriller']",1980,7
3030811,Aag,2007,['India'],"['Action', 'Musical', 'Crime Fiction', 'Action/Adventure', 'Comedy', 'Bollywood', 'World cinema', 'Adventure']",2000,7
28442087,Latin Quarter,1945,[],['Thriller'],1940,5
14318573,Jimmy the Gent,1934,['United States of America'],"['Black-and-white', 'Comedy', 'Drama']",1930,4
23266854,The House Next Door,2006,['United States of America'],"['Mystery', 'Thriller', 'Horror']",2000,6
10965647,Love Story 2050,2008,['India'],"['Musical', 'Bollywood', 'World cinema', 'Science Fiction']",2000,8
11341340,Cruise Cat,1952,['United States of America'],"['Comedy', ""Children's/Family""]",1950,2
21055071,Blood Ties,1991,['United States of America'],['Horror'],1990,1
6045916,I Love Lucy,1953,['United States of America'],['Comedy'],1950,3
5892358,Scarecrows,1988,['United States of America'],"['Monster movie', 'Horror', 'Crime Thriller', 'Cult']",1980,8
18895294,Maa Ayana Chanti Pilladu,2008,['India'],['Comedy'],2000,8
22871566,Soundless Wind Chime,2009,"['Hong Kong', 'China', 'Switzerland']","['LGBT', 'World cinema', 'Chinese Movies', 'Drama']",2000,9
525305,Man on Fire,2004,"['United Kingdom', 'United States of America']","['Drama', 'Crime Fiction', 'Thriller']",2000,4
18676578,Dollar for the Dead,1998,"['Spain', 'United States of America']",['Western'],1990,8
159980,Max Keeble's Big Move,2001,['United States of America'],"[""Children's/Family"", 'Comedy', 'Family Film']",2000,1
2387927,The Chumscrubber,2005,['United States of America'],"['Indie', 'Satire', 'Comedy', 'Teen', 'Black comedy', 'Comedy-drama', 'Ensemble Film']",2000,5
2356721,Head Office,1985,['United States of America'],"['Parody', 'Comedy']",1980,5
10746393,No Reservations,2007,"['United States of America', 'Australia']","['Music', 'Comedy', 'Romance Film', 'Romantic comedy', 'Drama']",2000,7
5440306,Beau Geste,1966,['United States of America'],"['Foreign legion', 'War film', 'Adventure', 'Drama']",1960,6
20863875,My Big Love,2008,['Philippines'],"['Filipino Movies', 'Romance Film', 'Drama']",2000,8
24390203,The Good Student,2006,['United States of America'],"['Indie', 'Comedy', 'Black comedy', 'Drama', 'Sex comedy']",2000,6
35281444,Thaali Pudhusu,1997,['India'],[],1990,7
1059280,Superman II,1981,"['United Kingdom', 'United States of America']","['Action', 'Superhero', 'Action/Adventure', 'Adventure', 'Superhero movie', 'Alien Film', 'Science Fiction', 'Family Film']",1980,1
3649527,Los olvidados,1950,['Mexico'],"['Coming of age', 'Childhood Drama', 'Juvenile Delinquency Film', 'Drama']",1950,0
3010124,Unholy Partners,1941,['United States of America'],"['Black-and-white', 'Crime Fiction', 'Crime Drama', 'Romance Film', 'Drama']",1940,1
3133545,Desperate Hours,1990,['United States of America'],"['Psychological thriller', 'Suspense', 'Crime Fiction', 'Mystery', 'Thriller', 'Crime Thriller', 'Drama']",1990,0
5627729,Caterina in the Big City,2005,['Italy'],"['Comedy', 'World cinema', 'Comedy-drama', 'Drama']",2000,5
2581818,Opening Night,1977,['United States of America'],"['Indie', 'Drama']",1970,7
225481,Alice Doesn't Live Here Anymore,1974,['United States of America'],"['Romantic drama', 'Romance Film', 'Drama', 'Feminist Film']",1970,4
13444065,Bangkok Love Story,2007,['Thailand'],"['LGBT', 'Crime Fiction', 'World cinema', 'Romance Film', 'Drama', 'Gay Themed', 'Gay', 'Gay Interest']",2000,7
20710879,Venus and Mars,2007,['South Korea'],"['Action', 'Romance Film', 'Comedy']",2000,7
1267905,Conquest of Space,1955,['United States of America'],"['Science Fiction', 'Adventure', 'Drama']",1950,5
27960819,Sally Swing,1938,['United States of America'],"['Short Film', 'Animation']",1930,8
26475211,Novaya Zemlya,2008,[],"['Action', 'Thriller', 'Drama']",2000,8
7794445,Triloquist,2008,['United States of America'],"['Slasher', 'Horror', 'Road movie', 'Cult']",2000,8
14830123,XIII,2008,"['France', 'United States of America', 'Canada']","['Action', 'Action Thrillers', 'Action/Adventure', 'Thriller', 'Adventure']",2000,8
18601112,Temptation Island,1980,['Philippines'],"['Filipino Movies', 'Comedy', 'World cinema']",1980,0
13578633,Jeete Hain Shaan Se,1988,['India'],['Action'],1980,8
5964302,Flashpoint,1984,['United States of America'],"['Action', 'Crime Fiction', 'Mystery', 'Thriller', 'Detective', 'Crime Thriller', 'Drama']",1980,4
9144986,The Lusty Men,1952,['United States of America'],"['Action', 'Black-and-white', 'Drama', 'Western', 'Film noir']",1950,2
5485644,St. John's Wort,2001,['Japan'],"['Japanese Movies', 'Horror', 'World cinema', 'Science Fiction']",2000,1
2008260,Amen.,2002,"['France', 'Germany', 'Romania', 'United States of America']","['World cinema', 'Christian film', 'War film', 'Political drama', 'Drama']",2000,2
5776001,Mysterious Island,1941,['Soviet Union'],"['Science Fiction', 'Adventure', 'Family Film']",1940,1
26731746,Gulmohar,2008,['India'],['Drama'],2000,8
105972,Death Becomes Her,1992,['United States of America'],"['Comedy', 'Horror', 'Black comedy', 'Slapstick', 'Fantasy Comedy', 'Fantasy']",1990,2
17607081,An Unforgettable Summer,1994,"['Romania', 'France']","['Romance Film', 'War film', 'Drama']",1990,4
2259349,Fallen Angel,1945,['United States of America'],"['Black-and-white', 'Crime Fiction', 'Mystery', 'Thriller', 'Film noir', 'Crime Thriller', 'Drama']",1940,5
9401987,Twist Around the Clock,1961,['United States of America'],"['Musical', 'Dance']",1960,1
23989204,Gundamma Katha,1962,['India'],"['Drama', 'Comedy film']",1960,2
26314659,"Swing It, Sailor!",1938,['United States of America'],"['Comedy', 'Adventure']",1930,8
5960014,Rehguzar,1985,['India'],['Drama'],1980,5
5209755,Sivakasi,2005,['India'],"['Musical', 'Bollywood', 'World cinema', 'Drama']",2000,5
24486141,Eagles Over London,1969,['Italy'],"['Action', 'Action/Adventure', 'World cinema', 'War film']",1960,9
312757,Tron,1982,['United States of America'],"['Action', 'Computer Animation', 'Cyberpunk', 'Thriller', 'Adventure', 'Science Fiction', 'Family Film']",1980,2
11943293,Taxi Driver,1954,['India'],"['Romantic drama', 'World cinema', 'Romance Film', 'Drama']",1950,4
32777123,The Restless and the Damned,1959,[],['Drama'],1950,9
4459597,Sancharram,2004,['India'],"['LGBT', 'World cinema']",2000,4
326982,Calendar Girls,2003,"['United Kingdom', 'United States of America']","['Drama', 'Indie', 'Comedy', 'Ensemble Film']",2000,3
11872722,Monsieur Hire,1989,['France'],"['Crime Fiction', 'Thriller', 'World cinema', 'Crime Drama', 'Crime Thriller', 'Drama']",1980,9
2382272,Imagine,1972,['United States of America'],"['Musical', 'Documentary']",1970,2
6004372,Grace of My Heart,1996,['United States of America'],"['Musical', 'Film à clef', 'Musical Drama', 'Indie', 'Comedy', 'Drama', 'Feminist Film', 'Period piece']",1990,6
31708392,False Identity,1990,[],"['Crime Fiction', 'Mystery', 'Thriller']",1990,0
21917672,Heat,2006,['Russia'],"['Romantic comedy', 'Comedy']",2000,6
2460499,The House Across the Lake,1954,['United Kingdom'],['Film noir'],1950,4
4574509,The Castle of Fu Manchu,1969,"['Spain', 'United Kingdom', 'Germany', 'West Germany', 'Italy']","['Action', 'Spy', 'Crime Fiction', 'Action/Adventure', 'Thriller', 'World cinema', 'Master Criminal Films', 'Adventure', 'Horror', 'Science Fiction']",1960,9
2221417,Unconditional Love,2002,['United States of America'],"['LGBT', 'Crime Fiction', 'Indie', 'Comedy', 'Thriller', 'Crime Thriller', 'Drama']",2000,2
28744945,The Happy Family,1952,['United Kingdom'],['Comedy'],1950,2
6558325,The Hard Corps,2006,"['Romania', 'United States of America']","['Action', 'Action Thrillers', 'Action/Adventure', 'Thriller', 'Martial Arts Film']",2000,6
10814964,Ruthless Tactics,1981,['Taiwan'],"['Action', 'Drama', 'Chinese Movies', 'Martial Arts Film']",1980,1
10378192,Appointment in London,1952,['United Kingdom'],"['Combat Films', 'Black-and-white', 'War film', 'Adventure']",1950,2
8144777,Cicak-Man,2006,['Malaysia'],"['Superhero movie', 'Comedy']",2000,6
4467106,Project A Part II,1987,['Hong Kong'],"['Action', 'Crime Fiction', 'Action/Adventure', 'Comedy', 'World cinema', 'Chinese Movies', 'Martial Arts Film']",1980,7
1420419,Fresh Horses,1988,['United States of America'],"['Romance Film', 'Romantic drama', 'Drama']",1980,8
28712530,Men of Steel,1932,['United Kingdom'],['Drama'],1930,2
31312052,The Piano Lesson,1995,['United States of America'],"['Period piece', 'Family Drama', 'Television movie', 'Family Film', 'Drama']",1990,5
3160128,Frigid Hare,1949,['United States of America'],"['Animation', 'Short Film', 'Comedy film', 'Family Film']",1940,9
18501121,End of the World,1931,['France'],"['Black-and-white', 'Disaster', 'Science Fiction']",1930,1
10891439,Doosra Aadmi,1977,['India'],"['Romantic drama', 'Bollywood', 'World cinema', 'Romance Film', 'Drama']",1970,7
4362616,Mallboy,2001,['Australia'],['Drama'],2000,1
24578244,The Waning Sex,1926,[],"['Silent film', 'Comedy']",1920,6
7418189,Bim,1975,[],"['Drama', 'Political drama']",1970,5
1750723,Minotaur,2006,"['Spain', 'Luxembourg', 'United Kingdom', 'France', 'Germany', 'United States of America']","['Monster movie', 'Teen', 'Horror']",2000,6
6492028,Cassandra's Dream,2008,"['United Kingdom', 'France', 'United States of America']","['Suspense', 'Drama', 'Crime Fiction', 'Indie', 'Thriller', 'Crime Thriller']",2000,8
5746114,A Dangerous Man: Lawrence After Arabia,1990,['United Kingdom'],"['Period piece', 'Biography', 'Biopic [feature]', 'Docudrama', 'Television movie', 'Political drama', 'Drama']",1990,0
23923137,Hitler - Dead or Alive,1942,['United States of America'],"['Action', 'Black-and-white', 'Drama', 'Action/Adventure']",1940,2
11962404,The Tomb,1986,['United States of America'],"['Action', 'Action/Adventure', 'Thriller', 'Horror', 'Supernatural', 'Adventure']",1980,6
1328186,Female Trouble,1974,['United States of America'],"['LGBT', 'Crime Fiction', 'Indie', 'Comedy', 'Black comedy', 'Drama', 'Gay Themed', 'Gay', 'Gay Interest', 'Crime Comedy', 'Cult']",1970,4
23675212,Dog Nail Clipper,2004,['Finland'],['Drama'],2000,4
6608849,Naksha,2006,['India'],"['Action/Adventure', 'Adventure', 'World cinema']",2000,6
4851596,Red,2002,['India'],"['Romantic drama', 'World cinema', 'Romance Film', 'Drama']",2000,2
10910275,Towncraft,2007,['United States of America'],"['Music', 'Rockumentary', 'History', 'Culture & Society', 'Documentary', 'Political drama']",2000,7
10306502,The Deep Below,2007,['United States of America'],"['Action', 'Action/Adventure', 'Thriller', 'Crime Thriller']",2000,7
19931769,Pray to Kill and Return Alive,1971,['Italy'],"['Action/Adventure', 'Western', 'World cinema', 'Spaghetti Western']",1970,1
1075838,The Life Aquatic with Steve Zissou,2004,['United States of America'],"['Indie', 'Comedy', 'Comedy-drama', 'Adventure', 'Drama', 'Cult', 'Ensemble Film']",2000,4
8856020,The Prey,1984,['United States of America'],"['Natural horror films', 'Slasher', 'Horror']",1980,4
3602322,Donald and Pluto,1936,['United States of America'],"['Animation', 'Short Film', 'Comedy', 'Family Film']",1930,6
13445119,The Walking Stick,1970,['United Kingdom'],"['Romance Film', 'Crime Fiction', 'Drama']",1970,0
21875242,Misunderstood,1966,"['France', 'Italy']",['Drama'],1960,6
34169145,Breaking Dawn,2004,['United States of America'],"['Suspense', 'Psychological thriller', 'Mystery', 'Indie', 'Thriller', 'Horror', 'Supernatural']",2000,4
16618557,Prelude to a Kiss,1992,['United States of America'],"['Romantic drama', 'Comedy', 'Romance Film', 'Romantic comedy', 'Drama', 'Fantasy']",1990,2
9313250,Junior Creative,2000,['United States of America'],"['Short Film', 'Drama']",2000,0
61530,One Hundred Men and a Girl,1937,['United States of America'],"['Musical', 'Black-and-white', 'Backstage Musical', 'Comedy', 'Musical comedy']",1930,7
23393578,Revoir Julie,1998,['Canada'],"['Gay Themed', 'LGBT', 'Gay', 'Romantic drama', 'Gay Interest', 'Comedy film', 'Drama']",1990,8
22660896,Machine-Gun Kelly,1958,['United States of America'],"['Action', 'Crime Fiction', 'Biographical film']",1950,8
12595470,On the Beat,1962,['United Kingdom'],['Comedy'],1960,2
4158862,Permanent Record,1988,['United States of America'],"['Coming of age', 'Drama']",1980,8
19753877,Ambikapathy,1937,['India'],"['Historical fiction', 'Drama']",1930,7
7788006,Fighter Squadron,1948,['United States of America'],"['Action', 'War film', 'Adventure', 'Drama']",1940,8
5501312,Masters of Menace,1990,['United States of America'],['Comedy'],1990,0
24229451,Aruba,2006,['Canada'],['Short Film'],2000,6
31200386,Desam,2002,[],"['Action', 'Drama']",2000,2
36093115,Evaraina Eppudaina,2009,['India'],['Romance Film'],2000,9
4704156,Curse of the Sacred Sword,2004,['Japan'],"['Action', 'Animation', 'Comedy', 'Anime', 'Adventure', 'Fantasy']",2000,4
13067866,Baton Bunny,1959,['United States of America'],"['Animation', 'Short Film', 'Comedy']",1950,9
27525185,Innocent Bystanders,1972,['United Kingdom'],"['Action', 'Crime Fiction', 'Adventure']",1970,2
24789658,The Sweet House of Horrors,1989,['Italy'],"['World cinema', 'Horror']",1980,9
7301722,Only Two Can Play,1962,['United Kingdom'],"['Romantic comedy', 'Comedy']",1960,2
5067058,Geumganghan,1931,"['Korea', 'South Korea']","['Action', 'Black-and-white', 'Indie', 'Silent film']",1930,1
6231069,Wilder Napalm,1993,['United States of America'],"['Comedy', 'Romance Film', 'Romantic comedy', 'Fantasy Comedy', 'Fantasy']",1990,3
9633777,Ninaithen Vandhai,1998,['India'],['Romance Film'],1990,8
18340475,Madambi,2008,['India'],"['Musical', 'Bollywood', 'World cinema', 'Drama']",2000,8
5044905,Anbe Aaruyire,2005,['India'],"['Romantic drama', 'Tamil cinema', 'World cinema', 'Romance Film', 'Drama']",2000,5
557036,La Dolce Vita,1960,"['France', 'Italy']","['Black-and-white', 'Satire', 'Comedy', 'World cinema', 'Media Satire', 'Drama', 'Comedy-drama', 'Ensemble Film']",1960,0
693163,Head,1968,['United States of America'],"['Musical', 'Surrealism', 'Satire', 'Musical comedy', 'Comedy', 'Cult', 'Absurdism']",1960,8
897481,Just One of the Guys,1985,['United States of America'],"['Coming of age', 'Comedy', 'Teen', 'Romantic comedy', 'Romance Film', 'Sports', 'Comedy of Errors']",1980,5
23634493,Gotham,1988,['United States of America'],"['Psychological thriller', 'Detective fiction', 'Mystery', 'Thriller', 'Detective', 'Television movie', 'Crime Thriller']",1980,8
4751590,Helpmates,1932,['United States of America'],"['Short Film', 'Black-and-white', 'Comedy']",1930,2
21825241,The Open Doors,2005,['United Kingdom'],"['Short Film', 'Drama']",2000,5
904125,Caveman,1981,['United States of America'],"['Action', 'Action/Adventure', 'Satire', 'Comedy', 'Slapstick', 'Parody', 'Comedy film', 'Stop motion', 'Fantasy']",1980,1
8936009,Good Morning Baby,2005,['United States of America'],['Short Film'],2000,5
4083138,The Sender,1982,['United Kingdom'],"['Psychological thriller', 'Horror']",1980,2
6183117,The Midnight Patrol,1933,['United States of America'],"['Short Film', 'Black-and-white', 'Comedy']",1930,3
10572926,Dangerous Parking,2007,['United Kingdom'],['Drama'],2000,7
28422883,Kitty,1929,['United Kingdom'],['Silent film'],1920,9
3175656,Damage,1992,"['United Kingdom', 'France', 'Germany']","['Film adaptation', 'Indie', 'Romantic drama', 'Romance Film', 'Erotica', 'Drama']",1990,2
1496622,Lean on Me,1989,['United States of America'],"['Action', 'Coming of age', 'Biography', 'Biographical film', 'Biopic [feature]', 'Docudrama', 'Drama']",1980,9
7644867,L.A. Without a Map,1998,"['United Kingdom', 'France', 'Finland']","['Indie', 'Comedy', 'World cinema', 'Romance Film', 'Romantic comedy']",1990,8
33837037,Pupendo,2003,['Czech Republic'],"['Comedy', 'Drama', 'Family Film']",2000,3
3004593,Visitor Q,2001,['Japan'],"['Surrealism', 'Art film', 'Comedy', 'World cinema', 'Black comedy', 'Drama', 'Japanese Movies', 'Horror', 'Domestic Comedy', 'Comedy-drama']",2000,1
4979704,Strip Search,2004,['United States of America'],"['Crime Fiction', 'Television movie', 'Political drama', 'Drama']",2000,4
1342884,Flipper,1996,['United States of America'],"['Adventure', 'Family Film']",1990,6
28776744,The Amateur Gentleman,1920,['United Kingdom'],['Adventure'],1920,0
1468099,Serving Sara,2002,"['Germany', 'United States of America']","['Screwball comedy', 'Comedy', 'Romance Film', 'Romantic comedy', 'Road movie', 'Slapstick']",2000,2
7146876,Madhouse,1974,"['United Kingdom', 'United States of America']","['Crime Fiction', 'Mystery', 'Slasher', 'Thriller', 'Horror', 'Cult']",1970,4
7749729,Oz,1976,['Australia'],"['Musical', 'Comedy', 'Fantasy']",1970,6
22951467,Lunch Box,2004,['Japan'],"['Erotica', 'Japanese Movies', 'Pornographic movie']",2000,4
30366479,The Yin and the Yang of Mr. Go,1970,['United Kingdom'],"['Mystery', 'Thriller']",1970,0
2906780,American Dream,1990,"['United Kingdom', 'United States of America']","['Political cinema', 'Indie', 'Short Film', 'Documentary']",1990,0
9409095,Shooting Gallery,2005,['United States of America'],"['Crime Fiction', 'Thriller', 'Crime Thriller', 'Drama']",2000,5
34420928,Mannin Maindhan,2005,['India'],[],2000,5
13687674,Chocolate: Deep Dark Secrets,2005,['India'],"['Crime Thriller', 'Thriller', 'World cinema']",2000,5
459801,Europa Europa,1990,"['France', 'Germany', 'Poland']","['LGBT', 'History', 'World cinema', 'War film', 'Drama']",1990,0
28443267,In the Line of Duty 4: Witness,1989,['Hong Kong'],"['Action', 'Action Thrillers', 'Action/Adventure', 'World cinema', 'Chinese Movies', 'Martial Arts Film']",1980,9
468326,21 Grams,2003,['United States of America'],"['Crime Fiction', 'Thriller', 'Drama', 'Tragedy', 'Ensemble Film']",2000,3
15479813,Main Madhuri Dixit Banna Chahti Hoon,2003,['India'],"['Musical', 'Bollywood', 'World cinema', 'Drama']",2000,3
2771792,Young at Heart,1954,['United States of America'],"['Musical', 'Romantic drama', 'Romance Film', 'Drama']",1950,4
30854972,Red Sonja,1985,"['Netherlands', 'United States of America']","['Action', 'Action/Adventure', 'Sword and sorcery', 'Costume drama', 'Adventure', 'Fantasy']",1980,5
10812453,Monsters vs. Aliens,2009,['United States of America'],"['Action', 'Animation', 'Monster', 'Comedy', ""Children's/Family"", 'Adventure', 'Computer Animation', 'Creature Film', 'Science Fiction', 'Family Film']",2000,9
584261,Carry On at Your Convenience,1971,['United Kingdom'],"['Parody', 'Satire', 'Comedy', 'Slapstick']",1970,1
9442685,Lady Snowblood,1973,['Japan'],"['Action', 'Crime Fiction', 'Japanese Movies', 'Action/Adventure', 'Thriller', 'World cinema', 'Drama']",1970,3
2861197,Pitfall,1948,['United States of America'],"['Black-and-white', 'Thriller', 'Film noir', 'Drama']",1940,8
11065327,Ma-Mha,2007,['Thailand'],"['Comedy', 'Drama', 'Family Film']",2000,7
14480653,James Blunt: Return to Kosovo,2007,"['United Kingdom', 'United States of America']","['Music', 'Documentary', 'Concert film', 'Culture & Society']",2000,7
492158,Home on the Range,2004,['United States of America'],"['Animation', 'Western', 'Comedy', 'Family Film']",2000,4
12320219,Half Past Dead 2,2007,['United States of America'],"['Action', 'Prison', 'Crime Fiction', 'Action Thrillers', 'Action/Adventure', 'Thriller', 'Drama']",2000,7
22154516,Away We Go,2009,"['United Kingdom', 'United States of America']","['Indie', 'Romantic drama', 'Comedy', 'Romance Film', 'Tragicomedy', 'Drama', 'Road movie', 'Romantic comedy', 'Comedy-drama', 'Comedy of manners', 'Slice of life story']",2000,9
33588763,Isi Ka Naam Zindagi,1992,['India'],"['Comedy film', 'World cinema', 'Drama', 'Family Film']",1990,2
28713362,Platform,1993,[],"['Action', 'Family Film']",1990,3
34149732,The Bugle Call,1927,[],"['Adventure', 'Drama']",1920,7
1380766,The Wendell Baker Story,2005,"['Germany', 'United States of America']","['Drama', 'Indie', 'Comedy', 'Comedy of manners', 'Romance Film', 'Romantic comedy', 'Ensemble Film']",2000,5
22614516,Madrasta,1996,['Philippines'],"['Filipino Movies', 'Drama', 'World cinema']",1990,6
9210138,A Social Celebrity,1926,['United States of America'],"['Black-and-white', 'Drama', 'Indie', 'Romantic drama', 'Comedy', 'Silent film', 'Comedy-drama']",1920,6
13048786,Girls in Prison,1994,['United States of America'],"['Crime Fiction', 'Black comedy', 'Crime Thriller', 'Drama', 'Period piece', 'Sexploitation', 'Erotic thriller', 'Television movie']",1990,4
16486542,Francis of Assisi,1961,['United States of America'],"['Biography', 'Drama']",1960,1
3645005,Revenge of the Pink Panther,1978,"['United Kingdom', 'United States of America']","['Action', 'Action/Adventure', 'Comedy', 'Thriller', 'Crime Thriller', 'Slapstick', 'Parody', 'Family Film']",1970,8
18070657,Libertas,2006,['Croatia'],"['Drama', 'Biographical film']",2000,6
3504856,Gentlemen of Fortune,1972,"['Russia', 'Soviet Union']","['Comedy', 'Crime Comedy', 'World cinema']",1970,2
4717823,Magnificent Obsession,1935,['United States of America'],['Black-and-white'],1930,5
8152402,Sur la trace d'Igor Rizzi,2007,['Canada'],['Drama'],2000,7
9830383,The Story of 1,2005,['United Kingdom'],"['Documentary', 'History', 'World History']",2000,5
9901123,Dear Friends,2007,['Japan'],"['Japanese Movies', 'Drama']",2000,7
2297089,The Ghost and Mrs. Muir,1947,['United States of America'],"['Romantic fantasy', 'Romantic drama', 'Romance Film', 'Costume drama', 'Drama', 'Fantasy']",1940,7
16235196,Three and Out,2008,['United Kingdom'],"['Black comedy', 'Indie', 'Comedy']",2000,8
2278569,BloodRayne,2005,"['Germany', 'United States of America']","['Creature Film', 'Action', 'Gothic Film', 'Horror', 'Costume Horror', 'Adventure', 'Fantasy']",2000,5
2916428,Day of the Dead 2: Contagium,2005,['United States of America'],"['Horror', 'Zombie Film']",2000,5
18580314,The Grand Maneuver,1955,"['France', 'Italy']","['Drama', 'Comedy']",1950,5
1245870,It's Pat,1995,['United States of America'],"['Slapstick', 'Comedy', 'Comedy of Errors']",1990,5
1324910,Dil Maange More,2004,['India'],"['Romantic drama', 'Comedy', 'World cinema', 'Romance Film', 'Romantic comedy', 'Drama']",2000,4
24518077,Cargo,2009,['Switzerland'],"['Mystery', 'Science Fiction', 'Thriller']",2000,9
1001727,The Goose Steps Out,1942,['United Kingdom'],"['Comedy', 'Black-and-white']",1940,2
23410614,Bhramaram,2009,['India'],"['Musical', 'Drama', 'Thriller']",2000,9
26177915,The Deceivers,1988,"['United Kingdom', 'India']","['Period piece', 'Film adaptation', 'Crime Fiction', 'Action/Adventure', 'Political drama', 'Adventure', 'Drama']",1980,8
23949470,Lost in the Stratosphere,1934,['United States of America'],"['Black-and-white', 'Comedy', 'Drama']",1930,4
11293485,Crossroads to Crime,1960,['United Kingdom'],"['Mystery', 'Crime Fiction']",1960,0
33743708,Jeevana Mukthi,1942,['India'],"['Drama', 'Fantasy']",1940,2
12596990,Before the Music Dies,2006,['United States of America'],"['Music', 'Social issues', 'Biography', 'Documentary', 'Culture & Society']",2000,6
30613718,Kranti,2002,['India'],"['Drama', 'World cinema']",2000,2
20920299,The Getting of Wisdom,1977,['Australia'],['Drama'],1970,7
752155,Runaway Jury,2003,['United States of America'],"['Thriller', 'Social problem film', 'Drama', 'Courtroom Drama']",2000,3
7944229,The Hunting Party,2007,"['Bosnia and Herzegovina', 'Croatia', 'United States of America']","['Action', 'Action/Adventure', 'Comedy', 'Thriller', 'Adventure', 'Black comedy', 'Drama']",2000,7
25833783,First Target,2000,"['Canada', 'United States of America']","['Action', 'Thriller']",2000,0
24437207,Breaking the Ice,1938,['United States of America'],['Drama'],1930,8
8461710,The Girl In The Park,2007,['United States of America'],"['Indie', 'Drama']",2000,7
64291,Lenny,1974,['United States of America'],"['Period piece', 'Black-and-white', 'Biography', 'Biographical film', 'Biopic [feature]', 'Drama']",1970,4
16434354,Gunnin' For That,2008,['United States of America'],"['Sports', 'Biography', 'Documentary']",2000,8
18475018,Pontianak Menjerit,2005,['Malaysia'],"['Comedy', 'Horror']",2000,5
14734726,Quiz Whizz,1958,['United States of America'],"['Short Film', 'Black-and-white', 'Comedy']",1950,8
5564328,Neighbors,1920,['United States of America'],"['Black-and-white', 'Indie', 'Short Film', 'Comedy', 'Silent film']",1920,0
18089114,En Swasa Kaatre,2000,['India'],"['Musical', 'Adventure', 'Drama']",2000,0
961937,Fathers' Day,1997,['United States of America'],"['Adventure Comedy', 'Screwball comedy', 'Buddy film', 'Comedy', 'Teen', 'Romance Film', 'Road movie']",1990,7
74979,My Man Godfrey,1936,['United States of America'],"['Screwball comedy', 'Comedy', 'Comedy film', 'Romance Film', 'Romantic comedy']",1930,6
16546354,"Like Mom, Like Me",1978,['United States of America'],['Drama'],1970,8
32565925,I Killed Rasputin,1967,"['France', 'Italy']","['History', 'Biographical film', 'Drama']",1960,7
1371186,The Rebel,1961,['United Kingdom'],"['Comedy', 'Satire']",1960,1
572255,Walking Tall,1973,['United States of America'],"['Action', 'Crime Fiction', 'Biography', 'Action/Adventure', 'Biographical film', 'Thriller', 'Drama']",1970,3
67431,Fire Down Below,1997,['United States of America'],"['Action', 'Action/Adventure', 'Thriller', 'Martial Arts Film']",1990,7
22561914,Holy Matrimony,1994,['United States of America'],"['Comedy film', 'Crime Fiction']",1990,4
29865278,Bol Radha Bol,1992,['India'],"['Bollywood', 'World cinema']",1990,2
14288749,Rock N Roll,2007,['India'],['Musical'],2000,7
31156941,Ekantham,2006,[],['Drama'],2000,6
9031555,The Brain from Planet Arous,1957,['United States of America'],"['Alien Film', 'Science Fiction', 'Horror']",1950,7
917363,Love and Death,1975,['United States of America'],"['Parody', 'Comedy', 'War film', 'Comedy of Errors']",1970,5
6811293,Knights of the City,1986,['United States of America'],"['Action', 'Adventure']",1980,6
15157654,The Sea Hawk,1924,['United States of America'],"['Silent film', 'Black-and-white', 'Swashbuckler films']",1920,4
6690496,She Gods of Shark Reef,1958,['United States of America'],"['Action', 'Action/Adventure', 'Thriller', 'Adventure']",1950,8
6790911,Keroro Gunso the Movie,2006,['Japan'],['Japanese Movies'],2000,6
7362782,Woman on the Beach,2006,['South Korea'],"['Romantic drama', 'Comedy film', 'World cinema', 'Romance Film', 'Comedy-drama', 'Drama']",2000,6
5324002,Ermo,1994,"['China', 'Hong Kong']","['Satire', 'Comedy-drama', 'Tragicomedy', 'Chinese Movies', 'Drama']",1990,4
11132239,Loha,1997,['India'],['Action'],1990,7
1977161,Intersection,1994,['United States of America'],"['Film adaptation', 'Romantic drama', 'Marriage Drama', 'Romance Film', 'Drama']",1990,4
14686017,Downtown,1990,['United States of America'],"['Action', 'Crime Fiction', 'Action/Adventure', 'Buddy film', 'Thriller', 'Comedy', 'Crime Thriller', 'Drama']",1990,0
18692364,Out in Fifty,1999,['United States of America'],"['Psychological thriller', 'Indie', 'Thriller']",1990,9
32240381,Kill the Love,1996,['South Korea'],"['Drama', 'Crime Fiction']",1990,6
6575187,Thimiru,2006,['India'],['Action'],2000,6
26665823,Sasneham Sumithra,2004,['India'],"['Thriller', 'Drama']",2000,4
24858123,Earthly Love,1974,['Soviet Union'],['Romance Film'],1970,4
10531330,Piraty XX veka,1979,"['Russia', 'Soviet Union']","['Action/Adventure', 'Adventure', 'World cinema']",1970,9
12515074,Badmash Gujjar,2001,['Pakistan'],"['Action', 'Crime Fiction', 'Drama']",2000,1
5266051,They Won't Forget,1937,['United States of America'],"['Black-and-white', 'Drama', 'Courtroom Drama']",1930,7
1325571,Wonderful Days,2003,['South Korea'],"['Action', 'Fantasy Adventure', 'Animation', 'World cinema', 'Adventure', 'Drama', 'Anime', 'Science Fiction', 'Fantasy']",2000,3
35168221,Bad Manners,1984,"['Canada', 'United States of America']","['Black comedy', 'Comedy film']",1980,4
924038,Together,2000,"['Sweden', 'Denmark', 'Italy']","['LGBT', 'Comedy', 'World cinema', 'Drama']",2000,0
3493556,Shot through the heart,1998,"['Canada', 'United Kingdom', 'Hungary', 'United States of America']","['Television movie', 'War film', 'Political drama', 'Drama']",1990,8
3367826,A Streetcar Named Desire,1951,['United States of America'],"['Film adaptation', 'Black-and-white', 'Drama']",1950,1
27839884,Shadow Magic,2000,['China'],"['Indie', 'Buddy film', 'Comedy', 'World cinema', 'Chinese Movies', 'Drama', 'Coming of age', 'Comedy-drama']",2000,0
15491650,Return to Lonesome Dove,1993,['United States of America'],"['Period piece', 'Romantic drama', 'Western', 'Melodrama']",1990,3
73425,The Deer Hunter,1978,"['United Kingdom', 'United States of America']","['Anti-war', 'Anti-war film', 'New Hollywood', 'War film', 'Drama', 'Ensemble Film']",1970,8
6309125,Never Weaken,1921,['United States of America'],"['Black-and-white', 'Indie', 'Short Film', 'Comedy', 'Silent film']",1920,1
4207557,Spymate,2006,['Canada'],"['Comedy', 'Animal Picture', 'Adventure', 'Family Film']",2000,6
26177719,Ordeal by Innocence,1985,['United Kingdom'],"['Mystery', 'Thriller']",1980,5
2317139,The Leopard Man,1943,['United States of America'],"['Psychological thriller', 'Black-and-white', 'Thriller', 'Horror']",1940,3
7194623,West,2007,['Australia'],"['Coming of age', 'Drama']",2000,7
3387343,El Muerto,2007,['United States of America'],"['Indie', 'Action/Adventure', 'Thriller', 'Superhero movie', 'Supernatural']",2000,7
1511848,Stratosphere Girl,2004,"['Netherlands', 'Switzerland', 'United Kingdom', 'Germany', 'Italy']","['LGBT', 'Mystery', 'Indie', 'Drama', 'Thriller', 'World cinema']",2000,4
8893746,The Impatient Alchemist,2002,"['Argentina', 'Spain']","['Mystery', 'Thriller', 'World cinema', 'Crime Thriller']",2000,2
12425109,Idol of the Crowds,1937,['United States of America'],"['Romance Film', 'Black-and-white', 'Drama']",1930,7
26139359,Seven Footprints to Satan,1929,['United States of America'],"['Crime Fiction', 'Mystery', 'Drama']",1920,9
14107883,Running Out of Time,1994,['Spain'],"['Drama', 'Thriller', 'World cinema']",1990,4
3151857,Teacher's Pet,2004,['United States of America'],"['Musical', 'Animation', ""Children's"", 'Comedy', 'Adventure', 'Family Film', 'Fantasy']",2000,4
13408805,The Deaths of Ian Stone,2007,"['United Kingdom', 'United States of America']","['Psychological thriller', 'Mystery', 'Slasher', 'Thriller', 'Horror', 'Supernatural', 'Sci-Fi Horror']",2000,7
8160070,Dil Tera Aashiq,1993,['India'],"['Romantic drama', 'World cinema', 'Romance Film', 'Drama']",1990,3
35592739,Return to home Gori,1996,['Italy'],[],1990,6
3985740,Blue Juice,1995,['United Kingdom'],"['Drama', 'Indie', 'Buddy film', 'Comedy', 'Romantic comedy', 'Romance Film', 'Sports']",1990,5
383455,The Devil in Miss Jones,1973,['United States of America'],"['Sexploitation', 'Hardcore pornography', 'Pornographic movie', 'Adult']",1970,3
23666508,Hercules and the Princess of Troy,1965,['Italy'],"['Action', 'Mythological Fantasy', 'Costume Adventure', 'Action/Adventure', 'Sword and Sandal', 'Adventure', 'Fantasy']",1960,5
31213219,Black Snow,1990,['China'],['Chinese Movies'],1990,0
3210646,Breakfast of Champions,1999,['United States of America'],"['Satire', 'Comedy', 'Black comedy', 'Comedy-drama', 'Tragicomedy', 'Drama', 'Absurdism']",1990,9
11875853,Teenage Monster,1957,['United States of America'],"['Black-and-white', 'Western', 'Horror', 'B-movie', 'Sci-Fi Horror', 'Science Fiction']",1950,7
2165639,Bend of the River,1952,['United States of America'],"['Film adaptation', 'Action/Adventure', 'Western', 'Drama']",1950,2
5565338,Stroker Ace,1983,['United States of America'],"['Action', 'Auto racing', 'Screwball comedy', 'Action Comedy', 'Action/Adventure', 'Comedy', 'Sports']",1980,3
1076567,Airport '77,1977,['United States of America'],"['Action', 'Airplanes and airports', 'Action Thrillers', 'Action/Adventure', 'Thriller', 'Disaster', 'Ensemble Film']",1970,7
5379364,Passchendaele,2008,['Canada'],"['Period piece', 'Combat Films', 'Romantic drama', 'Romance Film', 'War film', 'Drama']",2000,8
5606124,Good Luck Chuck,2007,"['Canada', 'United States of America']","['Comedy', 'Romance Film', 'Romantic comedy', 'Fantasy', 'Drama', 'Sex comedy']",2000,7
35942294,Get Married 2,2009,['Indonesia'],['Romantic comedy'],2000,9
18046658,The Great White Hope,1970,['United States of America'],"['Boxing', 'Biography', 'Romance Film', 'Sports', 'Drama']",1970,0
19144344,Bor Asbe Ekhuni,2008,['India'],['Comedy'],2000,8
6061594,Gossip,2000,['United States of America'],"['Psychological thriller', 'Suspense', 'Mystery', 'Thriller', 'Teen', 'Drama']",2000,0
2782527,Karam,2005,['India'],"['Action/Adventure', 'Drama', 'World cinema']",2000,5
3343805,A Little Princess,1939,['United States of America'],"['Family Drama', 'Drama', 'Family Film']",1930,9
5638547,Out of Reach,2004,['United States of America'],"['Action', 'Action Thrillers', 'Action/Adventure', 'Thriller']",2000,4
28374339,The Red Siren,2002,['France'],"['Action', 'Action Thrillers', 'Action/Adventure', 'Thriller', 'World cinema', 'Crime Thriller']",2000,2
4515733,Extreme Prejudice,1987,['United States of America'],"['Action', 'Crime Fiction', 'Action Thrillers', 'Action/Adventure', 'Western', 'Thriller', 'Drama']",1980,7
26025062,Troublesome Night 7,2000,['Hong Kong'],"['Chinese Movies', 'Comedy', 'Horror']",2000,0
7961608,Alphabet City,1984,['United States of America'],"['Crime Fiction', 'Gangster Film', 'Drama']",1980,4
22812968,Up Pompeii,1971,['United Kingdom'],['Comedy'],1970,1
13473149,Singh Is Kinng,2008,"['India', 'Australia']","['Adventure Comedy', 'Musical', 'Action', 'Crime Fiction', 'Comedy', 'Bollywood', 'World cinema', 'Romance Film', 'Road movie']",2000,8
86533,The Craft,1996,['United States of America'],"['Teen', 'Horror', 'Supernatural', 'Fantasy']",1990,6
1285796,Quest for Camelot,1998,['United States of America'],"['Music', 'Musical', 'Animation', 'Animated Musical', ""Children's/Family"", ""Children's"", 'Costume drama', 'Adventure', 'Mythological Fantasy', ""Children's Fantasy"", 'Family Film', 'Fantasy']",1990,8
1031292,Brotherhood of the Wolf,2001,['France'],"['Action', 'Mystery', 'Thriller', 'World cinema', 'Costume Horror', 'Martial Arts Film', 'Costume drama', 'Adventure', 'Creature Film', 'Horror', 'Historical fiction', 'Erotica', 'Steampunk', 'Science Fiction']",2000,1
3874380,Dragnet,1987,['United States of America'],"['Action', 'Parody', 'Action/Adventure', 'Comedy']",1980,7
18296435,Aaah Belinda,1986,['Turkey'],['Comedy'],1980,6
9362866,King of Beggars,1992,['Hong Kong'],"['Action/Adventure', 'Comedy', 'World cinema', 'Chinese Movies', 'Martial Arts Film']",1990,2
27148466,Superman,1997,[],"['Comedy film', 'Thriller']",1990,7
35485636,Pudhu Padagan,1990,['India'],['Drama'],1990,0
203841,Starship Troopers,1997,['United States of America'],"['Action', 'Action Thrillers', 'Political satire', 'Action/Adventure', 'Satire', 'Thriller', 'Adventure', 'Horror', 'War film', 'Science Fiction']",1990,7
2237779,Ernest Goes to Jail,1990,['United States of America'],"['Prison', 'Slapstick', 'Comedy', ""Children's"", 'Family Film']",1990,0
17833519,Alice Upside Down,2008,"['United States of America', 'France']","['Coming of age', 'Family Drama', 'Teen', ""Children's/Family"", 'Adventure', 'Drama', 'Family Film']",2000,8
3766026,Tapas,2005,['Spain'],['Drama'],2000,5
9751939,Shred,2008,['Canada'],"['Sports', 'Comedy', 'Comedy of manners']",2000,8
7258552,Venus Beauty Institute,1999,['France'],"['Romantic drama', 'Buddy film', 'Comedy', 'World cinema', 'Romance Film', 'Drama', 'Romantic comedy', 'Comedy-drama', 'Workplace Comedy']",1990,9
2324795,Somewhere in the Night,1946,['United States of America'],"['Psychological thriller', 'Crime Fiction', 'Mystery', 'Thriller', 'Film noir', 'Crime Thriller', 'Drama', 'Suspense']",1940,6
5470432,Rosenstrasse,2003,"['Germany', 'Netherlands']","['Period piece', 'World cinema', 'War film', 'Political drama', 'Drama']",2000,3
21958806,The Temp,1993,['United States of America'],"['Psychological thriller', 'Suspense', 'Mystery', 'Thriller', 'Crime Thriller']",1990,3
23237090,Journal of a Contract Killer,2008,['United Kingdom'],"['Action', 'Crime Fiction', 'Action Thrillers', 'Gangster Film', 'Action/Adventure', 'Thriller', 'Drama']",2000,8
26681550,De Ingottu Nokkiye,2008,['India'],['Comedy'],2000,8
16193923,Armin,2007,"['Germany', 'Bosnia and Herzegovina', 'Croatia']","['Coming of age', 'Road movie', 'Drama', 'Slice of life story']",2000,7
5959523,La Fuga,2001,['Argentina'],['Drama'],2000,1
12087313,The Flats,2002,['United States of America'],"['Coming of age', 'Indie', 'Comedy', 'Comedy-drama', 'Drama']",2000,2
676660,Night Watch,1973,['United Kingdom'],"['Crime Fiction', 'Mystery', 'Thriller']",1970,3
1395487,Shaft in Africa,1973,['United States of America'],"['Action', 'Blaxploitation', 'Suspense', 'Action Thrillers', 'Mystery', 'Action/Adventure', 'Thriller']",1970,3
20656028,Bridge,1988,"['Soviet Union', 'United States of America']","['Musical', 'Short Film']",1980,8
21651686,Witness for the Prosecution,1982,[],"['Film adaptation', 'Crime Fiction', 'Mystery', 'Thriller', 'Crime Thriller', 'Drama', 'Courtroom Drama', 'Television movie']",1980,2
24962519,Project Shadowchaser III,1995,['United States of America'],"['Action', 'Thriller', 'Horror', 'Science Fiction']",1990,5
2712888,Biwi No.1,1999,['India'],"['Drama', 'Bollywood', 'World cinema']",1990,9
4194975,The Lost World,2001,"['United Kingdom', 'Germany', 'United States of America']","['Adventure', 'Drama', 'Fantasy']",2000,1
5164582,Man with a Million,1953,['United Kingdom'],"['Comedy', 'Satire', 'Comedy of manners', 'Romance Film', 'Drama']",1950,3
28288471,Sticky Fingers,1988,['United States of America'],"['Action', 'Action/Adventure', 'Comedy']",1980,8
11785553,Hans Westmar. Einer von vielen. Ein deutsches Schicksal aus dem Jahre 1929,1933,['Weimar Republic'],"['Black-and-white', 'Biographical film', 'Propaganda film']",1930,3
8777319,Journey from the Fall,2007,"['Vietnam', 'United States of America']","['Indie', 'War film', 'Drama']",2000,7
20529023,The Little Troll Prince: A Christmas Parable,1987,['United States of America'],"['Christian film', 'Animation', 'Fantasy']",1980,7
33410925,Starstruck,1998,['United States of America'],"['Black comedy', 'Comedy', 'Drama']",1990,8
19258217,Splinter,2008,['United States of America'],"['Drama', 'Thriller', 'Horror']",2000,8
2053414,Last Night,1998,['Canada'],"['Drama', 'Indie', 'Comedy', 'Black comedy', 'Doomsday film', 'Disaster', 'Science Fiction']",1990,8
1134154,In the Realm of the Senses,1976,"['France', 'Japan']","['Art film', 'Erotic Drama', 'World cinema', 'Romance Film', 'Drama', 'Japanese Movies', 'Pornographic movie', 'Erotica']",1970,6
21869986,Jai Jagannatha,2007,['India'],['Drama'],2000,7
12848824,Bingo Crosbyana,1936,[],"['Animation', 'Short Film', 'Comedy film', 'Family Film']",1930,6
19654512,"My Love, My Bride",1990,['South Korea'],"['Romance Film', 'Romantic comedy', 'Comedy film']",1990,0
22810764,Bel Ami,1939,['Germany'],['Drama'],1930,9
32364957,Bongja,2000,['South Korea'],"['Drama', 'Comedy']",2000,0
9535585,Real Men,1987,['United States of America'],"['Action', 'Action/Adventure', 'Comedy', 'Science Fiction']",1980,7
23531909,Company Business,1991,['United States of America'],"['Action', 'Action/Adventure', 'Comedy', 'Thriller']",1990,1
3095818,May,2002,['United States of America'],"['Psychological thriller', 'LGBT', 'Thriller', 'Horror', 'Romance Film', 'Drama', 'Cult']",2000,2
18295339,Ambassador Bill,1931,['United States of America'],"['Black-and-white', 'Comedy', 'Satire', 'Comedy of manners']",1930,1
17945020,Simon,1980,['United States of America'],"['Science Fiction', 'Satire', 'Comedy']",1980,0
25848448,Tora-san Loves an Artist,1973,['Japan'],['Japanese Movies'],1970,3
3403010,Whispering Sands,2001,"['Indonesia', 'Japan']","['Japanese Movies', 'Drama']",2000,1
14474214,Mr. Fix It,2006,['United States of America'],"['Romance Film', 'Romantic comedy', 'Comedy']",2000,6
1830431,The Legend of Zorro,2005,['United States of America'],"['Action', 'Costume Adventure', 'Action/Adventure', 'Superhero movie', 'Costume drama', 'Adventure', 'Swashbuckler films']",2000,5
1047463,Romeo Must Die,2000,['United States of America'],"['Action', 'Crime Fiction', 'Action/Adventure', 'Thriller', 'Martial Arts Film']",2000,0
7218888,Adam's Apples,2005,['Denmark'],"['Comedy', 'World cinema', 'Black comedy', 'Drama']",2000,5
5181558,Dead in a Heartbeat,2002,"['Canada', 'United States of America']","['Action', 'Psychological thriller', 'Action Thrillers', 'Action/Adventure', 'Thriller', 'Crime Thriller', 'Drama', 'Suspense', 'Television movie']",2000,2
9302816,Blitz Wolf,1942,['United States of America'],"['Animation', 'Short Film', 'Comedy', 'Propaganda film', 'Family Film']",1940,2
74871,Laura,1944,['United States of America'],"['Psychological thriller', 'Black-and-white', 'Crime Fiction', 'Mystery', 'Thriller', 'Film noir', 'Romance Film', 'Crime Thriller', 'Drama', 'Suspense', 'Detective']",1940,4
24482029,Mustang Country,1976,['United States of America'],['Western'],1970,6
26996202,Devata,1978,['India'],['Bollywood'],1970,8
11522872,Oh Schucks...It's Schuster!,1989,['South Africa'],['Comedy'],1980,9
35986568,Danger Island,1992,[],"['Adventure', 'Horror']",1990,2
3990377,Finding John Christmas,2003,['United States of America'],"['Television movie', 'Drama', 'Fantasy']",2000,3
16385924,The Sting II,1983,['United States of America'],"['Action', 'Crime Fiction', 'Action/Adventure', 'Comedy', 'Drama', 'Period piece', 'Crime Comedy', 'Sports']",1980,3
664402,Kuch Kuck Hota Hai,1998,['India'],"['Musical', 'Comedy', 'Bollywood', 'Romance Film', 'Family Film']",1990,8
7897498,Dream Lover,1994,['United States of America'],"['Psychological thriller', 'Mystery', 'Thriller', 'Drama']",1990,4
31170541,Hello Hemingway,1990,['Cuba'],"['Political drama', 'Drama', 'World cinema']",1990,0
28493182,Where the Penguins Fly,2008,['Croatia'],['Comedy'],2000,8
16201787,Canyon Passage,1946,['United States of America'],"['Action', 'Romance Film', 'Western']",1940,6
12362193,Macedonian Blood Wedding,1967,['Yugoslavia'],['Drama'],1960,7
10577512,Skokie,1981,['United States of America'],"['Docudrama', 'Political drama', 'Drama', 'Courtroom Drama']",1980,1
29082911,Undertow,2009,"['Colombia', 'France', 'Germany', 'Peru']","['LGBT', 'Drama', 'World cinema', 'Romance Film', 'Fictional film']",2000,9
3816108,The Kid Stays in the Picture,2002,['United States of America'],"['Film & Television History', 'History', 'Biography', 'Documentary', 'Film']",2000,2
149815,The Search,1948,"['Switzerland', 'United States of America']","['Black-and-white', 'War film', 'Drama']",1940,8
10619221,Alaap,1977,['India'],['World cinema'],1970,7
10376197,The Little Engine That Could,1991,"['Wales', 'United States of America']","['Animation', 'Short Film', ""Children's"", 'Family Film']",1990,1
27755114,B. Monkey,1998,"['United Kingdom', 'Italy', 'United States of America']","['Heist', 'Crime Thriller', 'Thriller']",1990,8
9079357,Stone Cold,1991,['United States of America'],"['Action', 'Crime Fiction', 'Action/Adventure', 'Thriller']",1990,1
9650057,Nenjinile,1999,['India'],['Action'],1990,9
785210,Spike of Bensonhurst,1988,['United States of America'],"['Comedy-drama', 'Comedy', 'Drama']",1980,8
3823100,Wuthering Heights,1939,['United States of America'],"['Period piece', 'Film adaptation', 'Black-and-white', 'Romantic drama', 'Romance Film', 'Costume drama', 'Drama']",1930,9
3871205,George Lucas in Love,1999,['United States of America'],"['Indie', 'Short Film']",1990,9
7699027,Chattakari,1974,['India'],['Romantic drama'],1970,4
3947408,The Last Man on Earth,1964,"['Italy', 'United States of America']","['Black-and-white', 'Indie', 'Horror', 'Apocalyptic and post-apocalyptic fiction', 'Doomsday film', 'Science Fiction']",1960,4
15210434,Where in the World is Osama Bin Laden?,2008,['United States of America'],"['Political cinema', 'Documentary', 'Travel', 'Culture & Society']",2000,8
672934,The Lawnmower Man,1992,"['United Kingdom', 'Japan', 'United States of America']","['Japanese Movies', 'Horror', 'Sci-Fi Horror', 'Science Fiction']",1990,2
3261501,Bitter & Twisted,2008,['Australia'],"['Melodrama', 'Family Drama', 'Drama']",2000,8
8285987,Juno and the Paycock,1930,['United Kingdom'],"['Period piece', 'Black-and-white', 'Family Drama', 'Melodrama', 'Tragicomedy', 'Drama']",1930,0
19859572,Blindfold: Acts of Obsession,1994,['United States of America'],"['Thriller', 'Pornographic movie', 'Erotic thriller', 'Adult']",1990,4
3888422,Chitchor,1976,['India'],"['Musical', 'Romantic drama', 'Bollywood', 'World cinema', 'Romance Film', 'Drama']",1970,6
2556838,Chisum,1970,['United States of America'],"['Action', 'Action/Adventure', 'Western', 'Biopic [feature]']",1970,0
1714514,Incident at Loch Ness,2004,['United Kingdom'],"['Mockumentary', 'Comedy']",2000,4
931869,Personal Services,1987,"['United Kingdom', 'England']","['Parody', 'Satire', 'Comedy', 'Biopic [feature]', 'Docudrama', 'Drama']",1980,7
4944730,M. Kumaran son of Mahalakshmi,2004,['India'],"['Musical', 'Bollywood', 'World cinema', 'Drama']",2000,4
14174980,The Sky Pilot,1921,['United States of America'],"['Black-and-white', 'Drama', 'Indie', 'Silent film']",1920,1
21673015,The Crew,2008,['United Kingdom'],"['Action', 'Crime Fiction', 'Action/Adventure', 'Thriller', 'Crime Thriller']",2000,8
33770950,"Aloha, Bobby and Rose",1975,['United States of America'],"['Crime Fiction', 'Indie', 'Romantic drama', 'Romance Film', 'Drama', 'Chase Movie', 'Crime Drama', 'Road movie']",1970,5
2019694,Bodysong,2003,['United Kingdom'],"['Indie', 'Avant-garde', 'Documentary', 'Experimental film', 'Instrumental Music']",2000,3
17657295,Macon County Line,1974,['United States of America'],"['Action', 'Drama', 'Crime Fiction', 'Indie', 'Crime Thriller']",1970,4
5852488,"Schöner Gigolo, armer Gigolo",1979,"['Germany', 'West Germany']",['Drama'],1970,9
7299034,Child of Rage,1992,['United States of America'],"['Docudrama', 'Drama']",1990,2
24525848,The Strangler,1964,['United States of America'],"['Crime Fiction', 'Horror']",1960,4
2490812,Tremors 2: Aftershocks,1996,['United States of America'],"['Action', 'Action/Adventure', 'Comedy', 'Thriller', 'Horror Comedy', 'Creature Film', 'Horror', 'Science Fiction']",1990,6
6031488,Cool Money,2005,['United States of America'],"['Drama', 'Crime Fiction']",2000,5
10774223,Warrant,1975,['India'],[],1970,5
1620318,Popeye the Sailor Meets Ali Baba's Forty Thieves,1937,['United States of America'],['Short Film'],1930,7
3710183,Stander,2003,"['Canada', 'United Kingdom', 'Germany', 'South Africa']","['Action', 'Period piece', 'Crime Fiction', 'Biography', 'World cinema', 'Drama']",2000,3
3038038,A Nightmare on Elm Street 4: The Dream Master,1988,['United States of America'],"['Slasher', 'Teen', 'Horror', 'Supernatural']",1980,8
12252072,Lost Empires,1986,[],"['Historical Epic', 'Drama']",1980,6
1072373,Minsaara Kanavu,1997,['India'],"['Musical', 'Romantic drama', 'Bollywood', 'World cinema', 'Romance Film', 'Drama']",1990,7
28877820,Mazha,2000,['India'],['Drama'],2000,0
2235129,Quest of the Delta Knights,1993,['United States of America'],"['Action', 'Sword and sorcery', 'Adventure', 'Fantasy']",1990,3
19999060,Magunira Shagada,2001,['India'],['Drama'],2000,1
19411945,The Bridge to Nowhere,2009,['United States of America'],"['Crime Fiction', 'Adventure', 'Drama']",2000,9
12015098,Livin' Large,1991,['United States of America'],"['Comedy', 'Media Satire', 'Workplace Comedy', 'Drama']",1990,1
4325767,"Deduce, You Say",1956,['United States of America'],"['Animation', 'Mystery', 'Family Film']",1950,6
32015056,Hum Se Badkar Kaun,1981,[],['Action'],1980,1
4986536,Pelikaanimies,2004,"['Finland', 'Sweden']","['Adventure', 'Fantasy']",2000,4
215522,L'Âge d'Or,1930,['France'],"['Surrealism', 'Black-and-white', 'Art film', 'World cinema', 'Drama']",1930,0
6616626,Passage to Marseille,1944,['United States of America'],"['Black-and-white', 'War film', 'Escape Film', 'Drama']",1940,4
142476,Gosford Park,2001,"['United Kingdom', 'Italy', 'United States of America']","['LGBT', 'Crime Fiction', 'Mystery', 'Comedy', 'Thriller', 'Whodunit', 'Crime Thriller', 'Drama', 'Period piece', 'Comedy-drama', 'Comedy of manners', 'Ensemble Film']",2000,1
1526756,Lifeforce,1985,"['United Kingdom', 'United States of America']","['Horror', 'Adventure', 'Zombie Film', 'Alien Film', 'Sci-Fi Horror', 'Science Fiction', 'Cult']",1980,5
9001861,Raakh,1989,['India'],"['Revenge', 'Thriller', 'Bollywood']",1980,9
9468730,Solstice,2008,['United States of America'],"['Thriller', 'Horror', 'Supernatural', 'Drama']",2000,8
511622,Vacation,1983,['United States of America'],"['Romance Film', 'Comedy', 'Adventure']",1980,3
4582680,Naach,2004,['India'],"['Romantic drama', 'World cinema', 'Romance Film', 'Drama']",2000,4
19009754,Jump!,2007,"['Austria', 'United Kingdom']","['Sports', 'Drama', 'Documentary']",2000,7
6664640,Moon in the Gutter,1983,"['France', 'Italy']","['Crime Fiction', 'Thriller', 'World cinema', 'Crime Thriller', 'Drama']",1980,3
19785979,Prix de Beauté,1930,['France'],"['Black-and-white', 'Drama', 'World cinema']",1930,0
1060418,The 10th Kingdom,2000,['United States of America'],"['Fantasy Adventure', 'Comedy', 'Romance Film', 'Family-Oriented Adventure', ""Children's/Family"", 'Costume drama', 'Fairy tale', ""Children's Fantasy"", 'Television movie', 'Fantasy']",2000,0
7690397,Operation Crossbow,1965,['United Kingdom'],"['Action', 'Spy', 'Action/Adventure', 'War film']",1960,5
3608663,Black Rain,1989,['Japan'],"['Japanese Movies', 'World cinema', 'War film', 'Drama']",1980,9
2955789,Brain Blockers,2007,['United States of America'],"['Zombie Film', 'Comedy', 'Horror']",2000,7
12427020,Le Grand Chemin,1987,['France'],['Drama'],1980,7
7153331,Raghavendra,2003,[],"['Action', 'Romance Film', 'Drama']",2000,3
5916229,Chinthamani Kolacase,2006,['India'],['Horror'],2000,6
10770994,Kunwara Baap,1974,['India'],"['Drama', 'Comedy']",1970,4
36027395,Mother,1963,['Japan'],['Drama'],1960,3
2427210,Bad Eggs,2003,['Australia'],['Comedy'],2000,3
2268241,"The Long, Long Trailer",1953,['United States of America'],"['Screwball comedy', 'Comedy', 'Romance Film', 'Romantic comedy']",1950,3
7117584,Bruce Lee: A Dragon Story,1974,['Hong Kong'],"['Chinese Movies', 'Biography', 'Biopic [feature]', 'Martial Arts Film', 'Drama']",1970,4
27415086,Hariharan Pillai Happy Aanu,2003,['India'],"['Drama', 'Comedy']",2000,3
5533243,The Bridges of Madison County,1995,['United States of America'],"['Period piece', 'Film adaptation', 'Romantic drama', 'Romance Film', 'Drama']",1990,5
23694916,Passport to Destiny,1944,['United States of America'],"['Black-and-white', 'Comedy', 'Comedy-drama', 'War film']",1940,4
7420154,Le Roi et l'oiseau,1952,['France'],"['Fairy tale', ""Children's Fantasy"", 'Animation', 'Romance Film', ""Children's/Family"", 'Family Film', 'Fantasy']",1950,2
10370634,The Hoax,2006,['United States of America'],"['Period piece', 'Film adaptation', 'Comedy', 'Biographical film', 'Black comedy', 'Drama']",2000,6
16606105,Gamyam,2008,['India'],"['Romantic drama', 'Drama']",2000,8
32859140,Insadong Scandal,2009,[],"['Drama', 'Crime Fiction', 'Thriller']",2000,9
11684183,Sawaal,1982,['India'],"['Drama', 'Family Film', 'World cinema']",1980,2
23310072,Witchblade,2000,['United States of America'],"['Action', 'Mystery', 'Fantasy']",2000,0
329338,The Boys Next Door,1996,['United States of America'],"['Television movie', 'Comedy', 'Drama']",1990,6
1944643,Duma,2005,['United States of America'],"['Family Drama', 'Family-Oriented Adventure', ""Children's/Family"", ""Children's"", 'Adventure', 'Drama', 'Animal Picture', 'Family Film']",2000,5
13378321,Reform School Girls,1986,['United States of America'],"['Action', 'Prison', 'Crime Fiction', 'Action/Adventure', 'Comedy', 'Thriller', 'Drama', 'Parody']",1980,6
9522233,Kannamoochi Yenada,2007,['India'],"['Romantic comedy', 'Family Film']",2000,7
11699374,Sugarhouse,2007,['United Kingdom'],"['Film adaptation', 'Crime Fiction', 'Thriller', 'Crime Thriller', 'Drama']",2000,7
3050395,Ghajini,2005,['India'],"['Thriller', 'Tamil cinema', 'World cinema', 'Drama']",2000,5
3750194,Life Is a Miracle,2004,"['Serbia', 'France']",['Drama'],2000,4
9334904,The Devil-Doll,1936,['United States of America'],"['Horror', 'Science Fiction']",1930,6
433285,Bullitt,1968,['United States of America'],"['Action', 'Crime Fiction', 'Action Thrillers', 'Chase Movie', 'Mystery', 'Thriller', 'Drama']",1960,8
22211229,San Saba,2008,['United States of America'],"['Mystery', 'Crime Fiction', 'Thriller', 'Crime Thriller', 'Drama']",2000,8
5798540,The Hottie and the Nottie,2008,['United States of America'],"['Comedy', 'Teen', 'Romance Film', 'Romantic comedy']",2000,8
690042,The Long Kiss Goodnight,1996,['United States of America'],"['Action', 'Crime Fiction', 'Mystery', 'Action Thrillers', 'Action/Adventure', 'Thriller', 'Drama', 'Suspense']",1990,6
12987917,Le Carnaval des vérités,1920,['France'],"['Black-and-white', 'Indie', 'Silent film', 'Comedy-drama']",1920,0
8168406,Jungle Girl,1941,['United States of America'],"['Action', 'Black-and-white', 'Action/Adventure', 'Jungle Film', 'Adventure', 'Drama', 'Family Film']",1940,1
12907889,Aurat,1953,['India'],['Drama'],1950,3
12531137,The Dollmaker,1984,['United States of America'],"['Period piece', 'Family Drama', 'Americana', 'Drama']",1980,4
12591488,Torment,1944,['Sweden'],"['Black-and-white', 'Romantic drama', 'World cinema', 'Romance Film', 'Drama']",1940,4
51563,The Luzhin Defence,2000,"['United Kingdom', 'France', 'England']","['Period piece', 'Film adaptation', 'Drama', 'Indie', 'Romantic drama', 'Romance Film']",2000,0
24212105,Stories from the Kronen,1995,['Spain'],['Drama'],1990,5
6410239,The Land Before Time XII: The Day of the Flyers,2006,"['United States of America', 'Australia']","['Animated cartoon', 'Animation', 'Adventure', ""Children's"", 'Family Film']",2000,6
2965435,The Inkwell,1994,['United States of America'],"['Period piece', 'Coming of age', 'Comedy', 'Romantic comedy', 'Comedy-drama', 'Romance Film', 'Drama']",1990,4
703963,Some Kind of Wonderful,1987,['United States of America'],"['Romantic drama', 'Coming of age', 'Teen', 'Romantic comedy', 'Romance Film', 'Comedy-drama', 'Drama']",1980,7
19062950,Keïta! l'Héritage du griot,1995,['Burkina Faso'],"['Drama', ""Children's/Family"", 'Childhood Drama']",1990,5
28164962,Three Naked Sisters: Lewdness,2006,['Japan'],['Japanese Movies'],2000,6
28326873,Teesh and Trude,2002,['Australia'],['Drama'],2000,2
9674290,Taxandria,1994,['Belgium'],"['Fantasy Adventure', 'Romantic fantasy', 'Animation', 'Fantasy']",1990,4
24050808,Always Tomorrow: The Portrait of an American Business,1941,['United States of America'],[],1940,1
7158571,Hare Conditioned,1945,['United States of America'],"['Animated cartoon', 'Short Film', 'Comedy', 'Family Film']",1940,5
8485294,The Amateurs,2005,"['Germany', 'United States of America']","['Parody', 'Comedy', 'Sex comedy']",2000,5
4948256,Remember the Night,1940,['United States of America'],"['Black-and-white', 'Comedy', 'Romance Film', 'Romantic comedy', 'Christmas movie']",1940,0
1853699,Voodoo Woman,1957,['United States of America'],"['Supernatural', 'Horror']",1950,7
20502309,Murder in Greenwich,2002,['United States of America'],"['Film adaptation', 'Crime Fiction', 'Mystery', 'Thriller', 'Crime Thriller', 'Drama', 'Period piece', 'Television movie']",2000,2
11140514,Sathi Leelavathi,1995,['India'],"['Drama', 'Comedy film']",1990,5
35194428,Sawaal Majha Aika!,1964,['India'],[],1960,4
430394,After Life,1999,['Japan'],"['Japanese Movies', 'World cinema', 'Drama', 'Fantasy']",1990,9
23961694,Cattle Call,2006,['United States of America'],"['Comedy', 'Sex comedy']",2000,6
2476119,An American Tail: The Mystery of the Night Monster,2000,['United States of America'],"['Music', 'Animated cartoon', 'Animation', 'Family-Oriented Adventure', ""Children's/Family"", ""Children's"", 'Adventure', ""Children's Fantasy"", 'Family Film', 'Fantasy']",2000,0
6187665,The Ten,2007,['United States of America'],"['Parody', 'Satire', 'Comedy', 'Indie', 'Absurdism']",2000,7
19111251,Yatterman,2009,['Japan'],"['Action', 'Fantasy Adventure', 'Japanese Movies', 'Action/Adventure', 'Comedy', 'World cinema', 'Fantasy']",2000,9
26190838,La herida luminosa,1997,['Spain'],"['Family Drama', 'Drama']",1990,7
3904788,Dot the i,2003,"['Spain', 'United Kingdom', 'England', 'United States of America']","['Psychological thriller', 'Thriller', 'Erotic thriller', 'Drama']",2000,3
6090379,The Golem: How He Came Into the World,1920,"['Weimar Republic', 'Germany']","['Black-and-white', 'Drama', 'Indie', 'Horror', 'World cinema', 'Silent film']",1920,0
2149376,Asteroid,1997,['United States of America'],['Disaster'],1990,7
3966196,Are You Being Served?,1977,['United Kingdom'],['Comedy'],1970,7
2035081,Dracula Has Risen from the Grave,1968,['United Kingdom'],"['Costume Horror', 'Horror']",1960,8
7419883,The Monte Carlo Story,1957,"['Italy', 'United States of America']","['Romantic drama', 'Comedy', 'World cinema', 'Romance Film', 'Romantic comedy', 'Comedy-drama', 'Drama']",1950,7
21888940,Tenderness,2009,['United States of America'],"['Suspense', 'Crime Fiction', 'Thriller', 'Crime Drama', 'Crime Thriller', 'Drama']",2000,9
32951744,Tiger Island,1930,[],['Silent film'],1930,0
9425270,The Dukes of Hazzard: Hazzard in Hollywood!,2000,['United States of America'],"['Action', 'Action/Adventure', 'Comedy', 'Television movie']",2000,0
17538648,The Beach Girls,1982,['United States of America'],"['Musical', 'Softcore Porn', 'Sexploitation', 'Comedy', 'Teen', 'Beach Film', 'Sex comedy']",1980,2
28745539,The Private Eyes,1976,['Hong Kong'],"['Chinese Movies', 'Comedy']",1970,6
8150596,ComDads,1983,['France'],"['Adventure Comedy', 'Crime Fiction', 'Comedy', 'World cinema', 'Road movie']",1980,3
10418730,Suhaag,1979,['India'],"['Action', 'Musical', 'Drama', 'Romance Film']",1970,9
538180,Lorenzo's Oil,1992,['United States of America'],"['Docudrama', 'Drama', 'Medical fiction']",1990,2
22284927,Bionicle: The Legend Reborn,2009,['United States of America'],"['Action', 'Computer Animation', 'Animation', 'Adventure', 'Science Fiction', 'Family Film']",2000,9
4608223,West Side Story,1961,['United States of America'],"['Musical', 'Crime Fiction', 'Musical Drama', 'Romance Film', 'Juvenile Delinquency Film', 'Drama']",1960,1
2759477,Big Momma's House 2,2006,['United States of America'],"['Action', 'Crime Fiction', 'Action/Adventure', 'Comedy', 'Thriller', 'Slapstick']",2000,6
30875295,Boccaccio '70,1962,"['France', 'Italy']","['Comedy', 'Romance Film', 'Fantasy', 'Sex comedy']",1960,2
11143048,Per Sollum Pillai,1987,['India'],['Family Film'],1980,7
7081597,Bloody Tie,2006,['South Korea'],"['Action', 'Crime Fiction', 'Comedy', 'Thriller', 'World cinema', 'Crime Thriller', 'Drama']",2000,6
903776,Death of a President,2006,['United Kingdom'],"['Crime Fiction', 'Mystery', 'Comedy', 'Thriller', 'Mockumentary', 'Drama', 'Political cinema', 'Parody', 'Political drama']",2000,6
9951119,Never Say Die,1988,['New Zealand'],"['Action', 'Spy']",1980,8
2637077,Dying Young,1991,['United States of America'],"['Romantic drama', 'Romance Film', 'Drama', 'Medical fiction']",1990,1
15881207,Ghost Town,2008,['United States of America'],"['Comedy', 'Romance Film', 'Romantic comedy', 'Fantasy']",2000,8
14312128,The Blue Umbrella,2007,['India'],"['Musical', 'Art film', 'Bollywood', 'World cinema', 'Family Film', 'Drama']",2000,7
30244847,Arasu Dharbar,2003,['India'],['World cinema'],2000,3
3359825,A Talking Picture,2003,"['Portugal', 'France', 'Italy']","['Buddy film', 'Comedy', 'World cinema', 'Comedy-drama', 'Road movie', 'Drama']",2000,3
12877907,Saving Sarah Cain,2007,['United States of America'],"['Film adaptation', 'Inspirational Drama', 'Family Drama', 'Christian film', 'Drama']",2000,7
17107836,Welikathara,1971,['Sri Lanka'],['Drama'],1970,1
30862978,Sainik,1993,['India'],"['Action', 'Family Film']",1990,3
7998296,The Ploughman's Lunch,1984,['United Kingdom'],"['Indie', 'Drama']",1980,4
5915777,C.I.D.Moosa,2003,['India'],"['Action', 'Malayalam Cinema', 'Comedy']",2000,3
2399430,At First Sight,1999,['United States of America'],"['Romance Film', 'Romantic drama', 'Drama']",1990,9
14491356,Commotion on the Ocean,1956,['United States of America'],"['Short Film', 'Black-and-white', 'Comedy']",1950,6
4783203,A Summer Place,1959,['United States of America'],"['Romantic drama', 'Teen', 'Romance Film', 'Melodrama', 'Drama']",1950,9
12839024,Ang Cute Ng Ina Mo,2007,['Philippines'],"['Filipino Movies', 'Romantic drama', 'Comedy', 'World cinema', 'Romance Film', 'Romantic comedy', 'Drama']",2000,7
11669338,Grim Reaper,2005,['United States of America'],"['Horror', 'B-movie']",2000,5
17082042,5th Ave Girl,1939,['United States of America'],"['Comedy', 'Black-and-white']",1930,9
10945488,Goat Story,2008,['Czech Republic'],"['Computer Animation', 'Animation', 'Comedy film', 'Family Film', 'Fantasy']",2000,8
21867447,Sexy Battle Girls,1986,['Japan'],['Action'],1980,6
1167186,The Enemy Below,1957,['United States of America'],"['Combat Films', 'Action', 'Drama', 'War film']",1950,7
3306822,The Rosa Parks Story,2002,['United States of America'],"['Political drama', 'Biographical film', 'Drama']",2000,2
2292649,Behind Locked Doors,1948,['United States of America'],"['Black-and-white', 'Crime Fiction', 'Film noir', 'Drama']",1940,8
26695566,Crime File,1999,[],"['Action', 'Crime Fiction', 'Mystery', 'Thriller', 'Bollywood']",1990,9
7612646,First Action Hero,1994,"['Italy', 'United States of America']","['Action', 'Crime Fiction', 'Action/Adventure', 'World cinema']",1990,4
23201517,Permanent Residence,2009,"['China', 'Hong Kong']","['LGBT', 'Romance Film', 'Chinese Movies', 'Drama']",2000,9
25673210,The Keeper,2004,"['Canada', 'United Kingdom']","['Psychological thriller', 'Thriller']",2000,4
16937946,Our Town,2007,['South Korea'],"['Crime Fiction', 'Mystery', 'Thriller']",2000,7
5715746,Prankstar,2009,['United States of America'],"['Indie', 'Comedy', 'Horror', 'Mockumentary']",2000,9
1398485,Crime Story,1993,['Hong Kong'],"['Action', 'Crime Fiction', 'Action/Adventure', 'Thriller', 'World cinema', 'Chinese Movies', 'Martial Arts Film']",1990,3
7954624,Stolen Face,1952,['United Kingdom'],['Drama'],1950,2
7230428,Too Young to Be a Dad,2002,"['Canada', 'United States of America']","['Television movie', 'Family Drama', 'Drama']",2000,2
6085266,Bloodsport 2,1996,['United States of America'],"['Action', 'Action/Adventure', 'Thriller', 'Martial Arts Film']",1990,6
24379388,Sweet Kill,1973,['United States of America'],"['Thriller', 'Horror']",1970,3
28662070,"My Body, My Child",1982,['United States of America'],['Drama'],1980,2
17673063,Confessions of an Opium Eater,1962,['United States of America'],"['Action', 'Crime Drama', 'Adventure', 'Drama']",1960,2
24008579,Diary of a Tired Black Man,2009,['United States of America'],"['Comedy', 'Documentary', 'Romance Film', 'Romantic comedy', 'Drama']",2000,9
18501770,Bujang Lapok,1957,[],['Comedy film'],1950,7
3274109,The Land Before Time IX: Journey to Big Water,2002,['United States of America'],"['Music', 'Animated cartoon', 'Adventure', ""Children's"", 'Family Film']",2000,2
5258501,Dien Bien Phu,1992,"['France', 'Vietnam']",['War film'],1990,2
18941305,Next to No Time,1958,['United Kingdom'],['Comedy'],1950,8
8379662,Ants in the Pantry,1936,['United States of America'],"['Short Film', 'Black-and-white', 'Comedy']",1930,6
17917662,The Notebook,2004,['United States of America'],"['Period piece', 'Film adaptation', 'Coming of age', 'Romantic drama', 'Romance Film', 'Drama']",2000,4
169788,Friday,1995,['United States of America'],"['Coming of age', 'Stoner film', 'Buddy film', 'Comedy', 'Comedy-drama', 'Drama', 'Cult']",1990,5
8357847,The Tripper,2007,['United States of America'],"['Stoner film', 'Slasher', 'Horror Comedy', 'Horror', 'Cult']",2000,7
4056040,Spider-Plant Man,2005,['United Kingdom'],"['Action', 'Short Film', 'Comedy', 'Romance Film']",2000,5
7210701,I'll Be Glad When You're Dead You Rascal You,1932,['United States of America'],"['Musical', 'Animation', 'Short Film', 'Family Film']",1930,2
7677914,Best of the Best 4: Without Warning,1998,['United States of America'],"['Action', 'Action/Adventure', 'Thriller', 'Martial Arts Film']",1990,8
12833694,Ganga Addara,1980,['Sri Lanka'],"['Musical', 'Drama']",1980,0
28148663,Byl jednou jeden polda,1995,['Czech Republic'],['Comedy'],1990,5
264103,Hols: Prince of the Sun,1968,['Japan'],"['Action', 'Animation', 'Family Drama', 'World cinema', 'Anime', 'Adventure', 'Fantasy']",1960,8
24304179,Mix Me a Person,1962,['United Kingdom'],"['Crime Fiction', 'Mystery', 'Melodrama', 'Drama']",1960,2
872912,Devil Girl from Mars,1954,['United Kingdom'],"['Alien Film', 'Science Fiction', 'Cult']",1950,4
2044745,Went the Day Well?,1942,['United Kingdom'],"['Black-and-white', 'Thriller', 'War film', 'Drama']",1940,2
3732839,Jennifer Eight,1992,['United States of America'],"['Psychological thriller', 'Suspense', 'Mystery', 'Thriller', 'Crime Thriller', 'Whodunit']",1990,2
2466810,Zapped!,1982,['United States of America'],"['Parody', 'Indie', 'Comedy', 'Teen', 'Fantasy Comedy', 'Science Fiction', 'Sex comedy']",1980,2
15016005,The Baby Maker,1970,['United States of America'],"['Melodrama', 'Drama']",1970,0
21150037,Little Boy Blue,1998,['United States of America'],"['Thriller', 'Indie', 'Drama']",1990,8
2046252,Le Samouraï,1967,"['France', 'Italy']","['Crime Fiction', 'Mystery', 'Thriller', 'Drama']",1960,7
19979259,"Lula, o filho do Brasil",2009,['Brazil'],"['History', 'Biographical film', 'World cinema', 'Political drama', 'Drama']",2000,9
76040,Rebel Without a Cause,1955,['United States of America'],"['Coming of age', 'Family Drama', 'Short Film', 'Teen', 'Romance Film', 'Juvenile Delinquency Film', 'Drama']",1950,5
12049928,Shankharavam,2005,['India'],"['Drama', 'World cinema']",2000,5
10240061,Lil' Pimp,2004,['United States of America'],"['Animation', 'Indie', 'Comedy', 'Black comedy']",2000,4
34149562,Foreign Devils,1927,['United States of America'],"['Action', 'History', 'Drama']",1920,7
9169267,Amu,2005,"['India', 'United States of America']","['Art film', 'Indie', 'World cinema', 'Political drama', 'Drama']",2000,5
3566967,The Mysterians,1957,['Japan'],"['Japanese Movies', 'Horror', 'World cinema', 'Alien Film', 'Science Fiction']",1950,7
6928503,Take Away,2003,['Australia'],['Comedy'],2000,3
5860129,Poor White Trash,2000,['United States of America'],"['Action', 'Crime Fiction', 'Indie', 'Action/Adventure', 'Comedy']",2000,0
12234690,Deathstalker,1983,['Argentina'],"['Action/Adventure', 'Science Fiction', 'Sword and sorcery', 'Adventure', 'Fantasy']",1980,3
27429846,Confessions of a Cheat,1936,['France'],"['Comedy', 'Drama', 'World cinema']",1930,6
1024792,Police Story 3: Super Cop,1992,['Hong Kong'],"['Action', 'Crime Fiction', 'Action/Adventure', 'Comedy', 'Thriller', 'World cinema', 'Crime Thriller', 'Chinese Movies', 'Martial Arts Film']",1990,2
19923267,Saving Milly,2005,['United States of America'],['Drama'],2000,5
2314982,Looker,1981,['United States of America'],"['Psychological thriller', 'Computer Animation', 'Future noir', 'Thriller', 'Crime Thriller', 'Science Fiction']",1980,1
16656988,The Straw Hat,1974,['Soviet Union'],"['Musical', 'Comedy']",1970,4
1088952,Turkish Delight,1973,['Netherlands'],"['Romantic drama', 'World cinema', 'Romance Film', 'Drama']",1970,3
33082250,Mukhra,1988,['Pakistan'],"['Musical', 'Family Film']",1980,8
8788175,Dracula,2002,"['Germany', 'Italy']",['Horror'],2000,2
24749634,Fast Track: No Limits,2008,"['Germany', 'United States of America']","['Action', 'Crime Fiction', 'Action/Adventure', 'World cinema', 'Sports']",2000,8
1428955,My Beautiful Laundrette,1985,"['United Kingdom', 'England']","['LGBT', 'Indie', 'Comedy', 'Romance Film', 'Drama', 'Gay Themed', 'Gay', 'Gay Interest', 'Comedy-drama']",1980,5
35790647,Azhagesan,2004,['India'],"['Action', 'Drama']",2000,4
27989050,Maqsad,1984,[],"['Action', 'Musical', 'Crime Fiction']",1980,4
770083,Sweet Dreams,1985,['United States of America'],"['Musical', 'Romantic drama', 'Biography', 'Biographical film', 'Romance Film', 'Drama']",1980,5
2465797,300,2006,['United States of America'],"['Action', 'Film adaptation', 'Action/Adventure', 'Costume drama', 'Adventure', 'Superhero movie', 'Historical Epic', 'Historical fiction', 'Epic', 'War film', 'Fantasy']",2000,6
19036209,A Window in London,1940,['United Kingdom'],['Thriller'],1940,0
29831386,Under the Paris Sky,1951,['France'],['Drama'],1950,1
3055575,Can't Help Singing,1944,['United States of America'],"['Musical', 'Western']",1940,4
9204672,Bits and Pieces,1985,['United States of America'],"['Indie', 'Drama', 'Horror']",1980,5
25256434,The Don's Analyst,1997,['United States of America'],['Comedy'],1990,7
21391687,Chaowa Pawa,2009,['India'],"['Romance Film', 'Drama']",2000,9
29083380,Say It with Sables,1928,['United States of America'],['Comedy film'],1920,8
13295537,Reckless Behavior: Caught on Tape,2007,"['Canada', 'United States of America']","['Crime Fiction', 'Mystery', 'Drama']",2000,7
665883,Twin Dragons,1992,['Hong Kong'],"['Action', 'Martial Arts Film', 'Action Comedy', 'Action/Adventure', 'Comedy', 'World cinema', 'Chinese Movies']",1990,2
25121570,Tactical Unit - Comrades in Arms,2009,['Hong Kong'],"['Action', 'Crime Fiction', 'Action/Adventure', 'World cinema', 'Crime Thriller', 'Chinese Movies', 'Drama']",2000,9
205013,Ghostbusters,1984,['United States of America'],"['Action', 'Supernatural', 'Action/Adventure', 'Fantasy Comedy', 'Comedy', 'Stop motion', 'Science Fiction', 'Family Film', 'Fantasy']",1980,4
142482,Cries and Whispers,1972,['Sweden'],"['Family Drama', 'World cinema', 'Romance Film', 'Drama', 'Ensemble Film']",1970,2
24168707,Alice of Wonderland in Paris,1966,['United States of America'],"[""Children's Fantasy"", 'Animation', ""Children's/Family"", 'Fantasy']",1960,6
5134517,Tulsa,1949,['United States of America'],"['Action', 'Drama', 'Western', 'Romance Film']",1940,9
26441004,Extended Play,1982,['United States of America'],"['Short Film', 'Comedy']",1980,2
19248783,Castle Keep,1969,['United States of America'],"['Action', 'Drama', 'War film']",1960,9
18040146,A Boy Called Hate,1994,"['Germany', 'United States of America']","['Crime Drama', 'Drama']",1990,4
18793682,The Base,1999,['United States of America'],"['Action', 'Drama', 'Crime Fiction', 'Action/Adventure', 'Thriller']",1990,9
1086034,The Servant,1963,['United Kingdom'],"['Film adaptation', 'LGBT', 'Romantic drama', 'Romance Film', 'Drama']",1960,3
10931758,Boxer from Shantung,1972,['Hong Kong'],"['Action', 'Crime Fiction', 'Gangster Film', 'Romance Film', 'Chinese Movies', 'Martial Arts Film', 'Drama']",1970,2
9326561,A Taste of Honey,1961,['United Kingdom'],"['LGBT', 'Indie', 'British New Wave', 'Kitchen sink realism', 'Drama']",1960,1
18963921,Little Annie Rooney,1925,['United States of America'],"['Black-and-white', 'Crime Fiction', 'Comedy', 'Silent film', 'Drama']",1920,5
20286230,House,1977,['Japan'],"['Japanese Movies', 'Horror', 'World cinema', 'Cult']",1970,7
320401,Barton Fink,1991,"['United Kingdom', 'United States of America']","['Indie', 'Mystery', 'Comedy', 'Thriller', 'Black comedy', 'Drama', 'Period piece', 'Comedy-drama']",1990,1
36389655,Cet homme est dangereux,1953,['France'],['Adventure'],1950,3
12106162,Squirm,1976,['United States of America'],"['Horror', 'Natural horror films']",1970,6
254991,Passport to Pimlico,1949,"['United Kingdom', 'United States of America']","['Ealing Comedies', 'Political cinema', 'Political satire', 'Comedy']",1940,9
28280207,Penetration Angst,2003,"['United Kingdom', 'Germany']","['Slasher', 'Horror', 'B-movie', 'Cult']",2000,3
18497259,You're the One,2000,['Spain'],['Drama'],2000,0
17016725,Gran Torino,2008,"['Germany', 'United States of America']","['Indie', 'Drama', 'Tragedy']",2000,8
1843114,Where the Buffalo Roam,1980,['United States of America'],"['Film adaptation', 'Political cinema', 'Parody', 'Comedy', 'Biographical film', 'Drama', 'Cult']",1980,0
13901892,The Scapegoat,1959,"['United Kingdom', 'United States of America']","['Black-and-white', 'Crime Fiction', 'Mystery']",1950,9
17455543,Hunger,2008,['United Kingdom'],"['Period piece', 'Historical drama', 'Political drama', 'Drama']",2000,8
10336083,Busy Little Engine,2005,['United States of America'],"['Short Film', ""Children's""]",2000,5
20703482,Living the Dream,2006,['United States of America'],"['Indie', 'Drama']",2000,6
7588268,Betty Boop's Little Pal,1934,['United States of America'],"['Animation', 'Short Film', 'Comedy', 'Family Film']",1930,4
1039871,Enter the Phoenix,2004,['Hong Kong'],"['Action', 'LGBT', 'Action/Adventure', 'Comedy', 'World cinema', 'Chinese Movies', 'Action Comedy', 'Crime Comedy']",2000,4
3058148,Brave Little Tailor,1938,['United States of America'],['Short Film'],1930,8
3574823,Jakob the Liar,1999,"['France', 'Hungary', 'United States of America']","['Period piece', 'Comedy-drama', 'Tragicomedy', 'War film', 'Drama']",1990,9
24507760,"Rabbit, Run",1970,['United States of America'],"['Marriage Drama', 'Drama']",1970,0
10806577,Vigil in the Night,1940,['United States of America'],"['Romance Film', 'Black-and-white', 'Drama']",1940,0
30404907,Richard's Things,1980,['United Kingdom'],['Drama'],1980,0
24723960,A Reason to Live,1985,['United States of America'],['Drama'],1980,5
6641186,Vyapari,2007,['India'],['Drama'],2000,7
13538989,A Blade in the Dark,1983,['Italy'],"['Music', 'Giallo', 'Mystery', 'Slasher', 'Thriller', 'Horror', 'World cinema']",1980,3
23092690,When Romance Meets Destiny,2005,['South Korea'],"['Romance Film', 'Comedy']",2000,5
692661,Carlito's Way,1993,['United States of America'],"['Crime Fiction', 'Gangster Film', 'Thriller', 'Crime Drama', 'Drama']",1990,3
14007128,The Frozen North,1922,['United States of America'],"['Black-and-white', 'Drama', 'Indie', 'Short Film', 'Comedy', 'Silent film']",1920,2
4717779,Magnificent Obsession,1954,['United States of America'],"['Romance Film', 'Romantic drama', 'Drama']",1950,4
15314660,Three Wishes,1995,['United States of America'],"['Period piece', 'Romantic drama', 'Comedy', 'Romance Film', 'Drama', 'Family Film', 'Fantasy']",1990,5
14790659,My Best Friend's Girl,2008,['United States of America'],"['Romance Film', 'Romantic comedy', 'Comedy']",2000,8
73444,Easy Rider,1969,['United States of America'],"['Action', 'Outlaw biker film', 'Crime Fiction', 'Stoner film', 'Indie', 'Action/Adventure', 'Americana', 'Adventure', 'Drama', 'Biker Film', 'Existentialism', 'New Hollywood', 'Road movie']",1960,9
2493274,Ghosts,1997,['United States of America'],['Short Film'],1990,7
5777111,The Lost World,1960,['United States of America'],"['Action', 'Film adaptation', 'Action/Adventure', 'Adventure', 'Science Fiction', 'Fantasy']",1960,0
21960983,Ulsavapittennu,1989,['India'],"['Romance Film', 'Drama']",1980,9
3027693,The Salvation Hunters,1925,['United States of America'],"['Black-and-white', 'Silent film', 'Melodrama', 'Drama']",1920,5
28692590,Mirka,2000,"['France', 'Spain', 'Italy']",['Drama'],2000,0
36590116,High Voltage,1997,['United States of America'],"['Action', 'Crime Fiction', 'Thriller']",1990,7
2843663,Night Eyes,1990,['United States of America'],"['Crime Fiction', 'Thriller', 'Erotic thriller', 'Adult', 'Drama']",1990,0
3924766,Atragon,1963,['Japan'],"['Japanese Movies', 'World cinema', 'Adventure', 'Science Fiction']",1960,3
12896610,American High School,2008,['United States of America'],"['Comedy', 'Teen', 'Romance Film', 'Romantic comedy', 'Sex comedy']",2000,8
6650769,Buccaneer Bunny,1948,[],"['Animation', 'Short Film', 'Comedy', 'Family Film']",1940,8
4094105,After the Truth,1999,['Germany'],"['Drama', 'World cinema']",1990,9
24551069,Loudspeaker,2009,['India'],['Drama'],2000,9
1975043,The Long Ships,1964,"['Yugoslavia', 'United Kingdom']","['Action', 'Film adaptation', 'Costume Adventure', 'Action/Adventure', 'Costume drama', 'Adventure', 'Drama', 'Epic']",1960,4
32708834,Paper Doll,2003,[],['Short Film'],2000,3
946737,Mystery Science Theater 3000: The Movie,1996,['United States of America'],"['Satire', 'Comedy', 'Adventure', 'Parody', 'Horror', 'B-movie', 'Science Fiction', 'Cult']",1990,6
2880326,Human Trafficking,2005,"['Canada', 'United States of America']","['Crime Drama', 'Docudrama', 'Drama']",2000,5
7589186,Boom!,1968,['United Kingdom'],"['Drama', 'Romantic drama', 'Thriller']",1960,8
9689645,Deva,1994,['India'],['Romance Film'],1990,4
2820813,The Land That Time Forgot,1975,['United Kingdom'],"['Adventure', 'Fantasy']",1970,5
10778690,Mehbooba,1976,['India'],"['Romantic drama', 'Bollywood', 'World cinema', 'Romance Film', 'Drama']",1970,6
11003593,Kapò,1959,"['France', 'Yugoslavia', 'Italy']","['Black-and-white', 'World cinema', 'War film', 'Drama']",1950,9
15943379,Prehysteria!,1993,['United States of America'],"['Comedy film', 'Adventure', 'Science Fiction', 'Family Film', 'Fantasy']",1990,3
21722278,Mothers & Daughters,2004,['United Kingdom'],"['Indie', 'Drama']",2000,4
1986237,The Night Watchman,1938,['United States of America'],['Animation'],1930,8
7363831,Abdulla the Great,1955,"['United Kingdom', 'Egypt']","['Romantic drama', 'Drama']",1950,5
12429128,Adieu poulet,1974,['France'],"['Comedy Thriller', 'Thriller']",1970,4
11767370,Sati,1989,['India'],['Drama'],1980,9
10874751,The Secret of Treasure Island,1938,['United States of America'],"['Action', 'Black-and-white', 'Adventure']",1930,8
21652487,Robin Hood,2009,['India'],"['Action', 'Drama', 'Crime Fiction', 'Thriller']",2000,9
24034499,Mr. Wise Guy,1942,['United States of America'],"['Crime Fiction', 'Comedy film', 'Crime Comedy', 'Romance Film', 'Juvenile Delinquency Film', 'Drama']",1940,2
28275468,Thirunakkara Perumal,2009,['India'],[],2000,9
30137103,The Heart Specialist,2006,['United States of America'],"['Drama', 'Comedy film']",2000,6
6852645,Manathodu Mazhaikalam,2006,['India'],['Drama'],2000,6
22304155,Graveyard Shift,1990,"['Japan', 'United States of America']",['Horror'],1990,0
32580351,Vacant Possession,1996,['Australia'],['Drama'],1990,6
21547924,Los Amigos,1972,['Italy'],['Spaghetti Western'],1970,2
30676570,The Right Temptation,2001,['United States of America'],"['Suspense', 'Mystery', 'Thriller', 'Crime Thriller']",2000,1
6471903,The Perfect Weapon,1991,['United States of America'],"['Action', 'Martial Arts Film', 'Drama']",1990,1
5465765,Mouth to Mouth,2006,"['Canada', 'United Kingdom', 'Germany', 'England']","['Indie', 'Drama']",2000,6
11471331,Operation Y and Other Shurik's Adventures,1965,"['Russia', 'Soviet Union']","['Comedy', 'World cinema']",1960,5
4306160,36 Chowringee Lane,1981,['India'],"['Art film', 'Bollywood', 'Romance Film', 'Drama']",1980,1
9881864,All the Young Men,1960,['United States of America'],"['Combat Films', 'Drama']",1960,0
2502447,The Bingo Long Traveling All-Stars & Motor Kings,1976,['United States of America'],"['Sports', 'Comedy']",1970,6
15622632,Management,2009,['United States of America'],"['Comedy', 'Romance Film', 'Romantic comedy', 'Comedy-drama', 'Road movie']",2000,9
8022263,Two Girls and a Guy,1998,['United States of America'],"['LGBT', 'Romantic drama', 'Comedy', 'Romance Film', 'Drama', 'Romantic comedy', 'Comedy-drama', 'Ensemble Film']",1990,8
1482772,The Gorgeous Hussy,1936,['United States of America'],"['Black-and-white', 'Marriage Drama', 'Biopic [feature]', 'Romance Film', 'Historical fiction', 'Political drama', 'Drama']",1930,6
28900800,Man of God,2005,['United States of America'],['Drama'],2000,5
11055898,Apnapan,1977,['India'],"['Romantic drama', 'World cinema', 'Romance Film', 'Drama']",1970,7
3527643,Prayer of the Rollerboys,1991,"['Japan', 'United States of America']","['Action', 'Drama', 'Japanese Movies', 'Teen', 'Science Fiction']",1990,1
28478510,Love That Brute,1950,['United States of America'],"['Comedy', 'Crime Fiction']",1950,0
3575300,Punishment Park,1971,['United States of America'],"['Psychological thriller', 'Prison', 'Thriller', 'Political drama', 'War film', 'Drama']",1970,1
24331848,The Last Hunter,1980,['Italy'],"['Action', 'Action/Adventure', 'Thriller', 'World cinema', 'War film']",1980,0
2424380,Show People,1928,['United States of America'],"['Film à clef', 'Black-and-white', 'Indie', 'Comedy', 'Silent film']",1920,8
14777614,Tales From The Dead,2008,"['Japan', 'United States of America']","['Japanese Movies', 'Thriller', 'Horror', 'World cinema']",2000,8
1769282,Harum Scarum,1965,['United States of America'],"['Musical', 'Romance Film', 'Comedy']",1960,5
6231202,Malta Story,1953,['United Kingdom'],"['Black-and-white', 'Romantic drama', 'Romance Film', 'War film', 'Drama']",1950,3
9514261,Akasa Veedhilo,2001,['India'],"['Drama', 'Family Film']",2000,1
14729728,Lastikman: Unang Banat,2004,['Philippines'],"['Filipino Movies', 'Drama', 'Fantasy']",2000,4
26187835,Deep Waters,1948,['United States of America'],['Drama'],1940,8
16661239,The Girl on a Motorcycle,1968,"['United Kingdom', 'France']","['Action', 'Erotic Drama', 'Indie', 'Action/Adventure', 'Thriller', 'World cinema', 'Drama', 'Sports', 'Biker Film', 'Road movie']",1960,8
1853200,The Fat Spy,1966,['United States of America'],"['Parody', 'Comedy', 'Musical comedy', 'Adventure']",1960,6
16027849,Souli,2004,"['United Kingdom', 'France']",['Drama'],2000,4
31409517,Kids Don't Tell,1985,[],['Drama'],1980,5
2557469,Killing Me Softly,2002,"['United Kingdom', 'United States of America']","['Mystery', 'Thriller', 'Erotic thriller', 'Romance Film', 'Drama']",2000,2
12006795,Little Orphan Airedale,1947,['United States of America'],['Comedy'],1940,7
359005,Dr. Who and the Daleks,1965,['United Kingdom'],"['Science Fiction', 'Adventure', 'Cult']",1960,5
11634528,A Woman's Secret,1949,['United States of America'],"['Film noir', 'Drama']",1940,9
10460270,The Great War,1959,"['France', 'Italy']","['War film', 'Black-and-white']",1950,9
2306908,Slither,2006,"['Canada', 'United States of America']","['Comedy', 'Horror', 'Black comedy', 'Zombie Film', 'Science Fiction']",2000,6
4164156,Night Creatures,1962,['United Kingdom'],"['Adventure', 'Thriller', 'Horror']",1960,2
31243901,Knights,1993,['United States of America'],"['Action', 'Science Fiction', 'Adventure']",1990,3
15464779,Lahu Ke Do Rang,1997,['India'],"['Action', 'Drama']",1990,7
3905441,Detonator Orgun,1991,[],"['Action', 'Drama', 'Animation', 'Science Fiction']",1990,1
202652,Romeo + Juliet,1996,['United States of America'],"['Crime Fiction', 'Thriller', 'Romance Film', 'Drama']",1990,6
31981493,Uuno Turhapuro muuttaa maalle,1986,['Finland'],['Comedy film'],1980,6
2988222,One Night at McCool's,2001,['United States of America'],"['Heist', 'Crime Fiction', 'Comedy', 'Crime Comedy', 'Black comedy']",2000,1
19766878,Dog Gone,2008,['United States of America'],"['Action', 'Comedy', 'Family-Oriented Adventure', ""Children's/Family"", 'Family Film']",2000,8
12075306,Double or Nothing,1937,['United States of America'],"['Musical', 'Black-and-white', 'Comedy']",1930,7
11728170,Shining Through,1992,"['United Kingdom', 'United States of America']","['Action', 'Spy', 'Romantic drama', 'Action/Adventure', 'Thriller', 'Romance Film', 'Drama', 'War film']",1990,2
8119369,The Wistful Widow of Wagon Gap,1947,['United States of America'],"['Black-and-white', 'Comedy Western', 'Western', 'Comedy', 'Slapstick', 'Family Film']",1940,7
26442946,The Red Stallion,1947,['United States of America'],"['Family Drama', 'Action/Adventure', 'Western', 'Drama', 'Family Film']",1940,7
18769044,Zip 'n zoo,2008,['United Kingdom'],"['Short Film', 'Comedy', 'Drama']",2000,8
18185668,Nomads of the North,1920,['United States of America'],"['Black-and-white', 'Silent film', 'Adventure', 'Drama']",1920,0
11958947,Bang the Drum Slowly,1973,['United States of America'],"['Film adaptation', 'Sports', 'Drama']",1970,3
15068907,The Gun Runners,1958,['United States of America'],"['Action', 'Film adaptation', 'Drama', 'Action/Adventure', 'Adventure']",1950,8
9443302,"Bread, Love and Dreams",1953,['Italy'],"['Black-and-white', 'Romantic drama', 'Comedy', 'World cinema', 'Romance Film', 'Romantic comedy', 'Drama']",1950,3
677394,23,1998,['Germany'],"['Psychological thriller', 'Thriller', 'Drama', 'Political thriller']",1990,8
1436343,The Real McCoy,1993,['United States of America'],"['Action', 'Crime Fiction', 'Action/Adventure']",1990,3
20554814,Mettukudi,1996,['India'],['Drama'],1990,6
709391,Around the World in 80 Days,2004,"['United Kingdom', 'Germany', 'Ireland', 'United States of America']","['Action', 'Film adaptation', 'Action/Adventure', 'Comedy', 'Romance Film', ""Children's"", 'Martial Arts Film', 'Adventure', 'Drama', 'Western', 'Steampunk', 'Family Film']",2000,4
15313145,The Fantasticks,1995,['United States of America'],"['Musical', 'Comedy', 'Musical comedy', 'Romance Film', 'Romantic comedy']",1990,5
31087319,Tayaramma Bangarayya,1979,['India'],['Drama'],1970,9
23524959,Iron Road,2009,['Canada'],['Drama'],2000,9
5999053,Joyride,2005,['Netherlands'],"['Crime Fiction', 'Mystery', 'Thriller', 'Adventure', 'Drama']",2000,5
10540961,Goodbye Gemini,1970,['United Kingdom'],"['Crime Fiction', 'Thriller', 'Horror', 'Drama']",1970,0
229047,Enough,2002,['United States of America'],"['Psychological thriller', 'Suspense', 'Crime Fiction', 'Thriller', 'Crime Thriller', 'Drama']",2000,2
3825216,An Affair,1998,['South Korea'],"['Romance Film', 'Drama']",1990,8
32165121,Deep Space,1988,"['France', 'Netherlands', 'United States of America']","['Horror', 'Science Fiction']",1980,8
4224372,Elvira's Haunted Hills,2001,['United States of America'],"['Parody', 'Horror Comedy', 'Comedy', 'Horror', 'Cult', 'Haunted House Film']",2000,1
21012631,Santa Buddies,2009,"['Canada', 'United States of America']","['Christmas movie', ""Children's"", 'Family Film']",2000,9
4472408,Camille,1921,['United States of America'],"['Silent film', 'Black-and-white', 'Indie']",1920,1
3577050,Shinobi: Heart Under Blade,2005,['Japan'],"['Japanese Movies', 'Action/Adventure', 'World cinema', 'Romance Film', 'Martial Arts Film', 'Adventure', 'Drama']",2000,5
17516655,The Machine Girl,2008,"['Japan', 'United States of America']","['Action', 'Japanese Movies', 'Action/Adventure', 'Comedy', 'World cinema', 'Horror']",2000,8
844315,Beauty of the Day,1967,"['France', 'Italy']","['Surrealism', 'Art film', 'Romantic drama', 'World cinema', 'Romance Film', 'Erotica', 'Drama']",1960,7
27662044,Murder in New Hampshire: The Pamela Wojas Smart Story,1991,['United States of America'],"['Suspense', 'Thriller', 'Erotic thriller', 'Television movie']",1990,1
8703922,Paloh,2003,['Malaysia'],"['Action', 'Historical fiction', 'Drama']",2000,3
16395026,The Leading Man,1996,['United Kingdom'],"['Romance Film', 'Romantic comedy', 'Comedy']",1990,6
258732,The American President,1995,['United States of America'],"['Political cinema', 'Romantic drama', 'Comedy', 'Romance Film', 'Romantic comedy', 'Drama']",1990,5
1301663,Maqbool,2004,['India'],"['Crime Fiction', 'Art film']",2000,4
9229395,Regeneration,1997,"['Canada', 'United Kingdom']","['Period piece', 'Film adaptation', 'War film', 'Drama']",1990,7
12592136,Confess,2005,['United States of America'],"['Action', 'Drama', 'Indie', 'Action/Adventure', 'Thriller', 'Political drama', 'Political thriller']",2000,5
15442703,A Snake of June,2002,['Japan'],"['Erotic Drama', 'Mystery', 'Thriller', 'World cinema', 'Romance Film', 'Drama', 'Japanese Movies', 'Erotic thriller', 'Erotica']",2000,2
6103726,Neath Brookyln Bridge,1942,['United States of America'],"['Black-and-white', 'Comedy', 'Romance Film', 'War film', 'Drama']",1940,2
3946762,Apaharan,2005,['India'],"['Musical', 'Thriller', 'Bollywood', 'World cinema', 'Drama']",2000,5
3028394,A Troll in Central Park,1994,['United States of America'],"['Fantasy Adventure', ""Children's Fantasy"", 'Animation', ""Children's/Family"", 'Adventure', 'Family Film', 'Fantasy']",1990,4
8137655,Noble House,1988,['United States of America'],"['Action', 'Drama', 'Adventure']",1980,8
8109596,No Name on the Bullet,1959,['United States of America'],"['Action', 'Crime Fiction', 'Western', 'Action/Adventure', 'Thriller']",1950,9
10597228,Things To Do Before You're 30,2004,['United Kingdom'],"['Gay Themed', 'LGBT', 'Indie', 'Comedy', 'Romantic comedy', 'Romance Film', 'Sports']",2000,4
1392287,Double Vision,2002,"['Hong Kong', 'Taiwan']","['Action', 'Psychological thriller', 'Mystery', 'Action/Adventure', 'Thriller', 'World cinema', 'Crime Thriller', 'Chinese Movies', 'Martial Arts Film', 'Suspense', 'Horror']",2000,2
683428,Kazaam,1996,['United States of America'],"[""Children's Fantasy"", 'Comedy', ""Children's/Family"", 'Fantasy Comedy', 'Family Film', 'Fantasy']",1990,6
24665904,Call of the Wild,2009,['United States of America'],"['Adventure', 'Family Film']",2000,9
28314445,Hold That Hypnotist,1957,['United States of America'],['Comedy film'],1950,7
33155930,Chouans!,1988,['France'],"['Adventure', 'War film']",1980,8
2428862,Take My Eyes,2003,['Spain'],"['Romantic drama', 'World cinema', 'Romance Film', 'Drama']",2000,3
1573570,Nuts in May,1976,['England'],['Drama'],1970,6
18588354,Hot Shots,1956,['United States of America'],['Comedy'],1950,6
9311456,Satyam,2004,['India'],"['Action', 'Thriller']",2000,4
225487,Claudine,1974,['United States of America'],"['Romantic drama', 'Comedy', 'Romance Film', 'Drama']",1970,4
28138586,Touch and Go,1955,['United Kingdom'],['Comedy film'],1950,5
35943142,Captain America II: Death Too Soon,1979,['United States of America'],"['Action', 'Spy', 'Thriller', 'Science Fiction']",1970,9
19837210,Romasanta,2004,"['United Kingdom', 'Spain']","['Period piece', 'Psychological thriller', 'Gothic Film', 'Horror']",2000,4
5743048,How to Rob a Bank,2008,['United States of America'],"['Action', 'Crime Fiction', 'Indie', 'Action/Adventure', 'Comedy', 'Escape Film', 'Heist', 'Caper story', 'Crime Comedy']",2000,8
4696764,The Three Musketeers,1933,['United States of America'],"['Action', 'Black-and-white', 'Adventure']",1930,3
16166150,James Pandu,2000,['India'],['Drama'],2000,0
17461513,Hank and Mike,2007,['Canada'],"['Drama', 'Indie', 'Buddy film', 'Comedy', 'Black comedy', 'Holiday Film', 'Fantasy']",2000,7
29259863,Timbuctoo,1933,['United Kingdom'],['Comedy film'],1930,3
3828072,Boys Will Be Boys,1935,['United Kingdom'],"['Comedy', 'Black-and-white']",1930,5
21028971,Case Closed: The Raven Chaser,2009,['Japan'],['Japanese Movies'],2000,9
6461734,Equus,1977,"['United Kingdom', 'United States of America']","['Psychological thriller', 'Film adaptation', 'Mystery', 'Thriller', 'Horror', 'Drama']",1970,7
8774064,Deewaanapan,2001,['India'],"['Romantic drama', 'World cinema', 'Romance Film', 'Drama']",2000,1
5553187,The Arrangement,1967,['United States of America'],"['Romantic drama', 'Short Film', 'Romance Film', 'Political drama', 'Drama']",1960,7
3528700,Blown Away,1992,['Canada'],"['Action', 'Drama', 'Thriller', 'Erotic thriller', 'Crime Thriller']",1990,2
6584119,Carrie,1952,['United States of America'],"['Romance Film', 'Romantic drama', 'Drama']",1950,2
4622889,Barbie: Mermaidia,2006,['United States of America'],"['Computer Animation', 'Animation', ""Children's"", 'Adventure', 'Family Film', 'Fantasy']",2000,6
24321248,The Garage,2006,['United States of America'],"['Romance Film', 'Indie', 'Drama']",2000,6
20181860,Night and Fog,1955,['France'],"['Short Film', 'World cinema', 'Documentary', 'War film']",1950,5
1530068,Flying Wild,1941,['United States of America'],"['Black-and-white', 'Crime Fiction', 'Comedy', 'Crime Comedy']",1940,1
20842172,A Boyfriend for Christmas,2004,['United States of America'],"['Comedy', 'Romance Film', 'Drama', 'Family Film']",2000,4
11593294,Secret of the Cave,2006,['United States of America'],"['Film adaptation', 'Mystery', 'Family Drama', 'Family-Oriented Adventure', 'Christian film', 'Adventure', 'Drama', 'Coming of age', 'Family Film']",2000,6
2782511,Aitbaar,1985,['India'],"['Action', 'Thriller']",1980,5
9234287,Constellation,2007,['United States of America'],"['Romantic drama', 'Family Drama', 'Romance Film', 'Drama']",2000,7
3035900,Caché,2005,"['Austria', 'France', 'Germany', 'Italy', 'United States of America']","['Psychological thriller', 'Mystery', 'Thriller', 'World cinema', 'Drama']",2000,5
33777630,Wild Texas Wind,1991,['United States of America'],"['Romance Film', 'Crime Fiction', 'Drama']",1990,1
36354703,"For Richer, for Poorer",1992,['United States of America'],['Comedy film'],1990,2
25344779,3 Dancing Slaves,2004,['France'],"['Gay Themed', 'LGBT', 'Gay', 'Family Drama', 'Gay Interest', 'World cinema', 'Drama']",2000,4
9782429,The Sea Beast,1926,['United States of America'],"['Film adaptation', 'Black-and-white', 'Drama', 'Indie', 'Silent film', 'Adventure']",1920,6
1419414,Veronica Guerin,2003,"['United Kingdom', 'Ireland', 'United States of America']","['Crime Fiction', 'Gangster Film', 'Biography', 'Biographical film', 'Biopic [feature]', 'Crime Thriller', 'Drama']",2000,3
3978347,The Monster Club,1980,['United Kingdom'],"['Music', 'Creature Film', 'Comedy', 'Horror', 'Cult']",1980,0
2481282,The Weather Man,2005,"['Germany', 'United States of America']","['Comedy-drama', 'Tragicomedy', 'Drama']",2000,5
174437,Oh! What a Lovely War,1969,['United Kingdom'],"['Musical', 'Satire', 'Comedy', 'Musical comedy', 'Black comedy', 'Anti-war', 'Anti-war film', 'War film']",1960,9
574342,Tezaab,1988,['India'],"['Action', 'Musical', 'Bollywood', 'World cinema', 'Romance Film', 'Drama']",1980,8
14409782,Stuck,2002,['Canada'],['Drama'],2000,2
12555863,Heat,1986,['United States of America'],"['Action', 'Crime Fiction', 'Gangster Film', 'Action/Adventure', 'Thriller', 'Crime Thriller', 'Drama']",1980,6
11202210,Romancing the Bride,2005,['United States of America'],"['Comedy', 'Romance Film', 'Romantic comedy', 'Television movie']",2000,5
20329839,Rosita,1923,['United States of America'],"['Black-and-white', 'Comedy', 'Silent film', 'Romance Film']",1920,3
5644608,The Face of Fu Manchu,1965,['United Kingdom'],"['Mystery', 'Thriller', 'Horror', 'Master Criminal Films']",1960,5
19097116,Spider's Web,1989,"['Germany', 'West Germany']",['Drama'],1980,9
10676879,Bookies,2003,"['Germany', 'United States of America']","['Crime Fiction', 'Indie', 'Comedy', 'Thriller', 'Drama', 'Coming of age', 'Comedy Thriller', 'Crime Comedy', 'Comedy-drama']",2000,3
17435954,Sssshhh...,2003,['India'],"['Drama', 'Thriller', 'World cinema']",2000,3
29058979,Lonely Water,1973,['United Kingdom'],['Short Film'],1970,3
2332290,Free Enterprise,1998,['United States of America'],"['Indie', 'Parody', 'Comedy', 'Romance Film', 'Romantic comedy']",1990,8
799030,Spartan,2004,"['Germany', 'United States of America']","['Action', 'Crime Fiction', 'Mystery', 'Thriller', 'Drama', 'Political thriller']",2000,4
18080137,War of the Worlds 2: The Next Wave,2008,['United States of America'],"['Action', 'Adventure', 'Alien Film', 'Science Fiction']",2000,8
920296,Somewhere in Time,1980,['United States of America'],"['Romantic fantasy', 'Indie', 'Romantic drama', 'Romance Film', 'Drama', 'Tragedy', 'Time travel', 'Science Fiction', 'Fantasy']",1980,0
25829166,My 5 Wives,2000,"['Canada', 'United States of America']",['Comedy'],2000,0
3020199,Dead Heat on a Merry-Go-Round,1966,['United States of America'],"['Heist', 'Crime Fiction', 'Caper story', 'Thriller', 'Crime Comedy', 'Crime Thriller', 'Drama']",1960,6
18206216,Nothin' 2 Lose,2000,['United States of America'],"['Romance Film', 'Romantic comedy', 'Comedy']",2000,0
3868321,The Soul Collector,1999,['United States of America'],['Fantasy'],1990,9
1380903,How to Deal,2003,['United States of America'],"['Family Drama', 'Comedy', 'Teen', 'Romance Film', 'Romantic comedy', 'Comedy-drama', 'Drama']",2000,3
31326696,Wacko,1983,['United States of America'],['Horror'],1980,3
4082935,Jack's Back,1988,['United States of America'],"['Psychological thriller', 'Crime Fiction', 'Mystery', 'Slasher', 'Thriller', 'Horror']",1980,8
4053005,Appointment With Death,1988,"['United Kingdom', 'United States of America']","['Detective fiction', 'Mystery', 'Detective', 'Whodunit']",1980,8
1949083,The Cincinnati Kid,1965,['United States of America'],"['Period piece', 'Film adaptation', 'Drama']",1960,5
24733835,Custom Made 10.30,2005,[],"['Music', 'Drama', 'Comedy']",2000,5
28054698,A Turtle's Tale: Sammy's Adventures,2009,['Belgium'],"['Adventure', 'Family Film']",2000,9
18661417,Xcuse Me,2003,['India'],['Comedy'],2000,3
26834075,Punaradhivasam,2000,['India'],['Drama'],2000,0
25762104,Shubhamangala,1975,['India'],[],1970,5
27768311,The Girl Next Door: Taste of Short Steps,2003,['Japan'],['Japanese Movies'],2000,3
8495088,Christy: Return to Cutter Gap,2000,['Canada'],['Drama'],2000,0
26389782,Devil's Partner,1962,['United States of America'],['Horror'],1960,2
23696558,Ivar Vivahitharayal,2009,['India'],['Comedy film'],2000,9
871130,Raising Helen,2004,['United States of America'],"['Comedy', 'Domestic Comedy', 'Romantic comedy', 'Romance Film', 'Comedy-drama', 'Drama', 'Family Film']",2000,4
11795690,Storyville,1992,['United States of America'],"['Crime Fiction', 'Thriller', 'Political drama', 'Drama', 'Courtroom Drama']",1990,2
1777992,Boom Town,1940,['United States of America'],"['Action', 'Action/Adventure', 'Buddy film', 'Comedy', 'Romance Film', 'Adventure', 'Drama', 'Comedy-drama']",1940,0
29327755,The Kid from Left Field,1953,['United States of America'],"['Sports', 'Comedy film']",1950,3
26551226,The Girl from Maxim's,1933,['United Kingdom'],"['Musical', 'Comedy film']",1930,3
11457270,Rudy: The Rudy Giuliani Story,2003,['United States of America'],"['Biography', 'Biographical film', 'Biopic [feature]', 'Television movie', 'Political drama', 'Drama']",2000,3
31540281,Premer Taj Mahal,2002,['Bangladesh'],[],2000,2
133462,Beauty and the Beast,1991,['United States of America'],"['Music', 'Musical', 'Animation', 'Romance Film', 'Costume drama', ""Children's"", 'Family Film', 'Fantasy']",1990,1
9750356,Crane World,1999,['Argentina'],"['Drama', 'Comedy']",1990,9
36043053,The Grass Is Singing,1981,"['Sweden', 'Zambia', 'Australia']",['Drama'],1980,1
2380254,Shooting Fish,1997,['United Kingdom'],"['Action', 'Action/Adventure', 'Buddy film', 'Comedy', 'Crime Comedy', 'Romance Film', 'Romantic comedy']",1990,7
9072164,After the Wedding,2006,"['Sweden', 'Denmark']","['Family Drama', 'Drama', 'World cinema']",2000,6
3190591,Bulldog Jack,1935,['United Kingdom'],"['Detective fiction', 'Black-and-white', 'Crime Fiction', 'Mystery', 'Comedy', 'Thriller', 'Crime Thriller', 'Detective']",1930,5
32946082,Transe,2006,[],['Drama'],2000,6
3782305,The Turning Point,1952,['United States of America'],"['Crime Fiction', 'Film noir', 'Political drama', 'Drama']",1950,2
15825607,Where Has Love Gone?,1980,['Soviet Union'],"['Musical', 'Drama']",1980,0
33518689,Deadly Messages,1985,['United States of America'],['Thriller'],1980,5
6150970,Robotech: The Movie,1986,"['Japan', 'United States of America']","['Animation', 'Japanese Movies', 'Anime', 'Science Fiction']",1980,6
20094531,Thanksgiving,2004,['United States of America'],"['Indie', 'Short Film', 'Drama']",2000,4
30865251,Tennessee Tuxedo and His Tales,1963,[],[],1960,3
15789679,The Masked Menace,1927,['United States of America'],"['Movie serial', 'Silent film', 'Drama']",1920,7
14552544,Paradise Found,2001,"['Australia', 'United Kingdom', 'France', 'Germany']","['Period piece', 'Biography', 'Biographical film', 'Drama']",2000,1
9985474,The Committee,1968,['United Kingdom'],"['Musical', 'Drama', 'Indie', 'Parody', 'Avant-garde', 'Experimental film']",1960,8
1853942,Black Belt Jones,1974,['United States of America'],"['Action', 'Blaxploitation', 'Action/Adventure', 'Comedy', 'Martial Arts Film']",1970,4
18900694,Jewel Robbery,1932,['United States of America'],"['Black-and-white', 'Crime Fiction', 'Comedy', 'Crime Comedy', 'Romantic comedy']",1930,2
12101601,La vida en un hilo,1945,['Spain'],"['Black-and-white', 'Comedy', 'Drama']",1940,5
34385739,Naan Petra Selvam,1956,['India'],[],1950,6
29899086,Athisayan,2007,[],"['Drama', 'Comedy film', 'Fantasy']",2000,7
17673231,1,2009,['Hungary'],"['Thriller', 'World cinema', 'Science Fiction', 'Fantasy']",2000,9
19925493,Devil Girl,2007,"['Canada', 'United States of America']","['Horror', 'B-movie']",2000,7
12667164,The Boys From County Clare,2003,"['United Kingdom', 'Germany', 'Ireland']","['Music', 'Musical', 'Comedy', 'Comedy film', 'World cinema', 'Romance Film', 'Romantic comedy']",2000,3
2087090,One More Saturday Night,1986,['United States of America'],"['Coming of age', 'Comedy', 'Teen']",1980,6
9383995,La Ciénaga,2001,"['Argentina', 'Spain', 'France']","['Drama', 'Indie', 'Comedy', 'World cinema', 'Black comedy']",2000,1
24779008,The Case of the Whitechapel Vampire,2002,[],"['Crime Fiction', 'Mystery', 'Thriller']",2000,2
339516,The Amazing Colossal Man,1957,['United States of America'],"['Creature Film', 'Science Fiction']",1950,7
25501154,A.R.O.G,2008,['Turkey'],['Parody'],2000,8
32520115,Rise of the Gargoyles,2009,['Canada'],['Horror'],2000,9
19983847,Ek Je Aachhe Kanya,2001,['India'],['Drama'],2000,1
4982200,I'll Be There,2003,['United Kingdom'],"['Musical', 'Comedy', 'Teen', 'Comedy-drama', 'Drama']",2000,3
25734441,House!,2000,['United Kingdom'],"['Romance Film', 'Comedy']",2000,0
16934257,Where Do We Go from Here?,1945,['United States of America'],"['Musical', 'Comedy', 'Fantasy Comedy', 'Fantasy']",1940,5
5694982,To Die For,1989,['United States of America'],"['Romantic drama', 'Indie', 'Horror', 'Romance Film', 'Drama']",1980,9
2814516,The Belle of New York,1952,['United States of America'],"['Musical', 'Romance Film']",1950,2
1863122,Tanner on Tanner,2004,['United States of America'],['Comedy'],2000,4
13921056,Situation Hopeless... But Not Serious,1965,['United States of America'],"['War film', 'Comedy']",1960,5
2279186,The Peanut Butter Solution,1985,['Canada'],"[""Children's Fantasy"", ""Children's/Family"", 'Fantasy']",1980,5
25888327,The Butterfly Lovers,2008,['Hong Kong'],"['Action', 'Wuxia', 'Romance Film', 'Chinese Movies']",2000,8
8906897,Amante para dos,1981,['Argentina'],"['Romance Film', 'Comedy']",1980,1
3622471,Cheyenne Autumn,1964,['United States of America'],"['Action/Adventure', 'Western', 'Epic Western', 'Indian Western']",1960,4
8981929,Blood and Roses,1960,"['France', 'Italy']","['Erotica', 'World cinema', 'Horror']",1960,0
17109428,Accident,2008,['India'],"['Musical', 'Romance Film', 'Thriller']",2000,8
417479,Day for Night,1973,"['France', 'Italy']","['Comedy', 'World cinema', 'Romance Film', 'Comedy-drama', 'Drama']",1970,3
501340,Big Daddy,1999,['United States of America'],"['Family Drama', 'Slapstick', 'Comedy', 'Drama', 'Family Film']",1990,9
14144926,My First Romance,2003,['Philippines'],"['Filipino Movies', 'Romantic drama', 'Comedy', 'World cinema', 'Romance Film', 'Drama']",2000,3
362045,Citizen X,1995,['United States of America'],"['Crime Fiction', 'Mystery', 'Thriller', 'Crime Thriller', 'Docudrama', 'Drama', 'Suspense', 'Crime Drama', 'Television movie']",1990,5
14141946,Tough Guys Don't Dance,1987,['United States of America'],"['Film adaptation', 'Drama', 'Crime Fiction', 'Indie', 'Film noir', 'Comedy-drama']",1980,7
2756990,Sleepstalker,1996,['United States of America'],"['Supernatural', 'Slasher', 'Horror']",1990,6
16280232,Flatland: The Movie,2007,['United States of America'],"['Animation', 'Short Film', 'Satire', 'Science Fiction']",2000,7
25899609,Thooval Sparsam,1990,['India'],['Drama'],1990,0
19134923,The Nightcomers,1971,"['United Kingdom', 'England']","['Film adaptation', 'Crime Fiction', 'Thriller', 'Horror', 'Drama']",1970,1
29397587,Olympiyan Anthony Adam,1999,[],"['Action', 'Crime Fiction', 'Comedy film']",1990,9
3293089,Bulletproof,1988,['United States of America'],"['Action', 'Crime Fiction', 'Action/Adventure', 'Thriller']",1980,8
901563,High School High,1996,['United States of America'],"['Parody', 'Comedy', 'Absurdism']",1990,6
24388527,Of Unknown Origin,1983,"['Canada', 'United States of America']","['Horror Comedy', 'Natural horror films', 'Horror']",1980,3
24759110,Assassin's Creed: Lineage,2009,"['Canada', 'France']",['Short Film'],2000,9
24571663,The Circle,1925,['United States of America'],['Silent film'],1920,5
1172394,The Dawn Patrol,1930,['United States of America'],"['Action', 'Airplanes and airports', 'Black-and-white', 'Action/Adventure', 'War film']",1930,0
2967406,Shag,1989,"['United Kingdom', 'United States of America']","['Indie', 'Romantic drama', 'Comedy', 'Teen', 'Romance Film', 'Drama', 'Period piece', 'Coming of age', 'Romantic comedy']",1980,9
3440608,Creepozoids,1987,['United States of America'],"['Creature Film', 'Sci-Fi Horror', 'Horror', 'Supernatural', 'Science Fiction']",1980,7
19111802,Remembrance,2001,['Canada'],['Short Film'],2000,1
6640035,Jogger's Park,2003,['India'],"['Musical', 'Art film', 'Romantic drama', 'Comedy', 'Bollywood', 'World cinema', 'Romance Film', 'Drama', 'Romantic comedy']",2000,3
6872687,Smashing Time,1967,['United Kingdom'],"['Parody', 'Satire', 'Comedy', 'Slapstick']",1960,7
9987857,The Profession of Arms,2002,['Italy'],"['Action/Adventure', 'Drama', 'World cinema']",2000,2
12024684,Between Love and Hate,2006,['South Korea'],"['Romance Film', 'Comedy', 'Drama']",2000,6
3645284,Under the Roofs of Paris,1930,['France'],"['Musical', 'Black-and-white', 'Romantic drama', 'Comedy', 'World cinema', 'Romance Film', 'Drama', 'Melodrama']",1930,0
8502243,Switched at Birth,1991,['United States of America'],['Drama'],1990,1
4691910,Lust for a Vampire,1971,['United Kingdom'],"['Erotica', 'Thriller', 'Horror']",1970,1
3797781,Kundiman ng Puso,1958,['Philippines'],['Filipino Movies'],1950,8
4996220,The Mistress of Spices,2005,"['United Kingdom', 'United States of America']","['Film adaptation', 'Romantic drama', 'Romance Film', 'Drama']",2000,5
3375247,I Don’t Kiss,1991,"['France', 'Italy']","['Gay Themed', 'Gay', 'Gay Interest', 'Drama']",1990,1
2482322,Hollywood Homicide,2003,['United States of America'],"['Action', 'Crime Fiction', 'Action/Adventure', 'Buddy film', 'Comedy', 'Crime Thriller', 'Buddy cop', 'Action Comedy']",2000,3
11779229,Kalloori,2007,['India'],['Drama'],2000,7
29451676,Guru,1989,['India'],['Crime Fiction'],1980,9
22549171,Promise Her Anything,1965,['United Kingdom'],"['Romance Film', 'Romantic comedy', 'Comedy film']",1960,5
14453901,The Scientific Cardplayer,1972,['Italy'],"['Drama', 'Comedy']",1970,2
2730274,Creature,1985,['United States of America'],"['Horror', 'Science Fiction']",1980,5
16166246,Pennin Manathai Thottu,2000,['India'],['Musical'],2000,0
16851708,Satan's School for Girls,2000,['United States of America'],"['Television movie', 'Drama', 'Horror']",2000,0
22410144,The Witches Hammer,2006,['United Kingdom'],['Horror'],2000,6
6738089,Voyage of the Unicorn,2001,['United States of America'],"['Fantasy Adventure', 'Adventure', 'Fantasy']",2000,1
470943,The Triplets of Belleville,2003,"['Canada', 'Belgium', 'United Kingdom', 'France']","['Animation', 'Comedy', 'World cinema', 'Adventure', 'Family Film']",2000,3
26866490,Lucky Night,1939,['United States of America'],"['Comedy', 'Romance Film', 'Romantic comedy', 'Comedy-drama', 'Slapstick', 'Drama']",1930,9
15662820,Onbadhu Roobai Nottu,2007,['India'],['Drama'],2000,7
3255424,Duchess of Idaho,1950,['United States of America'],['Musical'],1950,0
7208007,The Perfect Crime,2005,['Spain'],"['Crime Fiction', 'Comedy', 'Thriller', 'World cinema', 'Black comedy', 'Drama']",2000,5
5315073,Undersea Kingdom,1936,['United States of America'],"['Action', 'Black-and-white', 'Action/Adventure', 'Adventure', 'Science Fiction', 'Fantasy']",1930,6
1414550,The Quiet Duel,1949,['Japan'],"['Japanese Movies', 'Marriage Drama', 'World cinema', 'Drama', 'Medical fiction']",1940,9
670514,Tom and Huck,1995,['United States of America'],"['Comedy', 'Teen', 'Family-Oriented Adventure', ""Children's/Family"", 'Costume drama', 'Adventure', 'Family Film']",1990,5
14647199,The Prisoner of Shark Island,1936,['United States of America'],"['Prison', 'Black-and-white', 'Biopic [feature]', 'Docudrama', 'Drama']",1930,6
11410269,The Oscar,1966,['United States of America'],['Drama'],1960,6
3151903,Coogan's Bluff,1968,['United States of America'],"['Action', 'Crime Fiction', 'Action Thrillers', 'Action/Adventure', 'Thriller', 'Drama', 'Chase Movie', 'Western']",1960,8
10335449,Cord,2000,['Canada'],"['Psychological thriller', 'Suspense', 'Thriller']",2000,0
5243205,Kismet,1943,['India'],"['Black-and-white', 'Drama']",1940,3
18765170,The Autograph Hound,1939,[],"['Animation', 'Family Film', 'Comedy film']",1930,9
32631391,Homer and Eddie,1989,['United States of America'],"['Screwball comedy', 'Comedy']",1980,9
187635,Lili,1953,['United States of America'],"['Musical', 'Romance Film', 'Drama', 'Family Film']",1950,3
22645206,Ochtendzwemmers,2000,['Netherlands'],"['Music', 'Drama', 'Comedy']",2000,0
2999946,Yankee Dood It,1956,['United States of America'],"['Animation', 'Short Film', 'Comedy film', 'Family Film']",1950,6
12199605,Jonny Quest vs. The Cyber Insects,1995,['United States of America'],"['Action', 'Animation', ""Children's/Family"", 'Adventure']",1990,5
1922658,Gorgo,1961,['United Kingdom'],"['Creature Film', 'Monster', 'Horror', 'Science Fiction', 'Cult']",1960,1
17082868,Good Sam,1948,['United States of America'],"['Black-and-white', 'Comedy', 'Drama']",1940,8
25747140,A Family of Cops,1995,['United States of America'],"['Crime Fiction', 'Mystery', 'Family Drama', 'Thriller', 'Television movie', 'Crime Thriller', 'Drama']",1990,5
24115407,Wild Wild Winter,1966,['United States of America'],"['Musical', 'Comedy film', 'Teen']",1960,6
4490437,Shocker,1989,['United States of America'],"['Indie', 'Satire', 'Thriller', 'Comedy', 'Media Satire', 'Slasher', 'Horror', 'B-movie']",1980,9
12048544,The Tony Blair Witch Project,2000,['United States of America'],['Comedy'],2000,0
30109815,Rogues' Regiment,1948,['United States of America'],"['Action', 'Spy', 'Thriller', 'Adventure']",1940,8
1937414,The Little Prince,1974,"['United Kingdom', 'United States of America', 'Canada']","['Musical', 'Drama', 'Family Film', 'Fantasy']",1970,4
578001,Romancing the Stone,1984,"['Mexico', 'United States of America']","['Adventure Comedy', 'Action', 'Action/Adventure', 'Comedy', 'Adventure', 'Romance Film', 'Romantic comedy']",1980,4
20945069,Bombardier,1943,['United States of America'],"['Combat Films', 'Action', 'Propaganda film', 'War film']",1940,3
9674442,Love Today,1997,['India'],[],1990,7
7185465,Guns & Talks,2001,['South Korea'],"['Action', 'Crime Fiction', 'Action/Adventure', 'Comedy', 'World cinema', 'Crime Thriller', 'Martial Arts Film', 'Action Comedy']",2000,1
13665311,Night Train To Paris,1964,['United Kingdom'],"['Spy', 'Thriller', 'Political thriller']",1960,4
28113610,Sri Shirdi Saibaba Mahathyam,1986,['India'],['Biographical film'],1980,6
33590170,California Conquest,1952,['United States of America'],"['Action', 'Western']",1950,2
32717999,Porky's Romance,1937,['United States of America'],"['Animation', 'Short Film', 'Comedy film', 'Romantic comedy', 'Family Film']",1930,7
30883459,Little Treasure,1985,[],"['Action', 'Drama', 'Comedy film', 'Romance Film']",1980,5
19074986,Cyborg Soldier,2008,['United States of America'],"['Action', 'Action/Adventure', 'Science Fiction', 'Thriller']",2000,8
23814420,World's Greatest Dad,2009,['United States of America'],"['Indie', 'Satire', 'Comedy', 'Black comedy', 'Drama']",2000,9
9685139,Reservation Road,2007,"['Germany', 'United States of America']","['Film adaptation', 'Crime Fiction', 'Thriller', 'Crime Thriller', 'Drama']",2000,7
21488473,Law Abiding Citizen,2009,['United States of America'],"['Psychological thriller', 'Crime Fiction', 'Thriller', 'Crime Thriller', 'Drama']",2000,9
9597495,Auntie Mame,1958,['United States of America'],"['Film adaptation', 'Comedy', 'Drama']",1950,8
35204352,Gandha,2009,['India'],['Drama'],2000,9
1802400,Phantasm,1979,['United States of America'],"['Slasher', 'Horror', 'Zombie Film', 'Supernatural', 'Cult']",1970,9
16740518,The Real World Movie: The Lost Season,2002,"['Canada', 'United States of America']",['Comedy film'],2000,2
6127063,Sugar Town,1999,"['United Kingdom', 'United States of America']","['Indie', 'Comedy', 'Comedy-drama', 'Drama', 'Ensemble Film']",1990,9
5698420,Repentance,1984,"['Russia', 'Soviet Union', 'Georgia', 'Georgian SSR']","['Political drama', 'Drama', 'World cinema']",1980,4
32644906,Love in a Goldfish Bowl,1961,['United States of America'],"['Romantic drama', 'Comedy', 'Romance Film', 'Romantic comedy', 'Comedy-drama', 'Drama']",1960,1
10888233,Balika Badhu,1967,['India'],"['Romance Film', 'Drama', 'Family Film']",1960,7
4290595,Return to Oz,1964,['United States of America'],"['Family Film', 'Animation']",1960,4
7564144,Desert Moon,2001,['Japan'],"['Japanese Movies', 'Drama']",2000,1
4777503,Adam Resurrected,2008,"['Israel', 'Germany', 'United States of America']","['Period piece', 'Film adaptation', 'War film', 'Drama']",2000,8
294520,Serial Mom,1994,['United States of America'],"['LGBT', 'Parody', 'Indie', 'Satire', 'Comedy', 'Media Satire', 'Black comedy']",1990,4
3179185,Mickey,2004,['United States of America'],"['Family Drama', 'Sports', 'Drama', 'Family Film']",2000,4
1862139,Mullet,2001,['Australia'],"['Domestic Comedy', 'Comedy-drama', 'Comedy']",2000,1
11789507,La Paura,1954,"['Germany', 'Italy']","['Black-and-white', 'Drama']",1950,4
12685170,Lars and the Real Girl,2007,"['Canada', 'United States of America']","['Drama', 'Indie', 'Comedy', 'Black comedy', 'Romantic comedy', 'Comedy-drama', 'Romance Film']",2000,7
18575846,Thirteen Hours by Air,1936,['United States of America'],"['Action', 'Disaster', 'Drama']",1930,6
10087485,Rosencrantz & Guildenstern Are Dead,1990,"['United Kingdom', 'United States of America']","['Period piece', 'Parody', 'Existentialism', 'Comedy', 'Comedy-drama', 'Absurdism']",1990,0
2957732,The Trouble with Angels,1966,['United States of America'],"['Comedy', 'Family-Oriented Adventure', 'Religious Film', ""Children's/Family"", 'Drama', 'Family Film']",1960,6
13374572,Don't Go in the House,1980,['United States of America'],"['Slasher', 'Horror']",1980,0
21837152,Days of Darkness,2007,['United States of America'],"['Horror', 'Zombie Film']",2000,7
2073415,Spasms,1983,['Canada'],['Horror'],1980,3
2753408,Trojan War,1997,['United States of America'],"['Coming of age', 'Comedy', 'Teen', 'Romantic comedy']",1990,7
2313158,That Touch of Mink,1962,['United States of America'],"['Comedy', 'Comedy of manners', 'Romance Film', 'Romantic comedy']",1960,2
27871557,Invitation Only,2009,[],"['Crime Fiction', 'Mystery', 'Thriller', 'Horror']",2000,9
10135564,Out of the Darkness,1971,['Thailand'],"['Action', 'Musical']",1970,1
11272068,Tokyo Friends: The Movie,2006,['Japan'],"['Romance Film', 'Japanese Movies', 'Drama']",2000,6
2563837,Femme Fatale,2002,['France'],"['Crime Fiction', 'Mystery', 'Thriller', 'World cinema', 'Erotic thriller', 'Crime Thriller', 'Drama']",2000,2
19583175,Play the Game,2009,['United States of America'],"['Indie', 'Comedy film', 'Romance Film', 'Romantic comedy', 'Comedy-drama']",2000,9
28978049,The Concrete Jungle,1982,['United States of America'],"['Thriller', 'Drama']",1980,2
5895236,Days of Glory,2006,"['Morocco', 'Belgium', 'Algeria', 'France']","['Action', 'Drama', 'War film']",2000,6
2930527,The Distinguished Gentleman,1992,['United States of America'],"['Political cinema', 'Political satire', 'Comedy', 'Comedy of Errors']",1990,2
17728854,Rhythm on the River,1940,['United States of America'],"['Musical', 'Black-and-white', 'Comedy', 'Musical comedy']",1940,0
1795303,Water,1985,['United Kingdom'],"['Political cinema', 'Parody', 'Comedy', 'Adventure', 'Drama']",1980,5
25675846,And I Love You So,2009,['Philippines'],"['Filipino Movies', 'Romantic drama', 'World cinema', 'Romance Film', 'Drama']",2000,9
5389888,Prem Rog,1982,['India'],"['Musical', 'Bollywood', 'World cinema', 'Drama']",1980,2
6745357,Hip Hip Hora!,2004,['Sweden'],['Comedy'],2000,4
3585054,We're No Angels,1955,['United States of America'],"['Religious Film', 'Christmas movie', 'Comedy']",1950,5
71473,The Third Man,1949,"['United Kingdom', 'England']","['Psychological thriller', 'Film adaptation', 'Black-and-white', 'Mystery', 'Thriller', 'Film noir', 'Drama', 'Suspense']",1940,9
14688795,The Love of Siam,2007,['Thailand'],"['LGBT', 'Romantic drama', 'World cinema', 'Romance Film', 'Drama', 'Gay Themed', 'Gay', 'Coming of age', 'Gay Interest']",2000,7
9855336,The Real Howard Spitz,1998,"['Canada', 'United Kingdom']",['Comedy'],1990,8
2651130,Evita,1996,['United States of America'],"['Musical', 'Biography', 'Drama']",1990,6
13865046,Lanka,2007,['India'],"['Action', 'Drama', 'Bollywood']",2000,7
7153704,Puppet Master III: Toulon's Revenge,1991,['United States of America'],"['Supernatural', 'Horror']",1990,1
6181527,Trailer Park Boys: The Movie,2006,['Canada'],"['Action', 'Heist', 'Action/Adventure', 'Comedy', 'Cult']",2000,6
20655988,La Virgen Negra,2008,['Venezuela'],"['Comedy', 'Romance Film', 'Drama', 'Fantasy']",2000,8
1591226,Phantom of the Paradise,1974,['United States of America'],"['Musical', 'Indie', 'Satire', 'Thriller', 'Comedy', 'Black comedy', 'Horror', 'Cult']",1970,4
26763573,The Red Terror,1942,['Germany'],['Action'],1940,2
3863665,Gangster,2006,['India'],"['Crime Fiction', 'Mystery', 'Thriller', 'Bollywood', 'World cinema', 'Romance Film', 'Drama']",2000,6
6312422,Uncommon Women and Others,1978,['United States of America'],['Drama'],1970,8
26949520,Girl Mistress,1980,['Japan'],['Japanese Movies'],1980,0
9136230,Funny Dirty Little War,1983,['Argentina'],"['Drama', 'Indie', 'Comedy', 'World cinema', 'Black comedy', 'War film']",1980,3
6768285,Majunu,2001,['India'],"['Romantic drama', 'World cinema', 'Romance Film', 'Drama']",2000,1
7661570,The Tuskegee Airmen,1995,['United States of America'],"['Action', 'Drama', 'War film']",1990,5
30626695,The Drug Knot,1986,['United States of America'],"['Romance Film', 'Drama', 'Family Film']",1980,6
307789,House of 1000 Corpses,2003,['United States of America'],"['Slasher', 'Horror', 'Albino bias', 'Road-Horror', 'Cult']",2000,3
1114086,Blackrock,1997,"['New Zealand', 'Australia']","['Detective fiction', 'Crime Fiction', 'Indie', 'Thriller', 'World cinema', 'Teen', 'Crime Thriller', 'Drama', 'Detective']",1990,7
19275224,Summer 2007,2008,['India'],"['Musical', 'Crime Fiction', 'Thriller', 'Bollywood', 'World cinema', 'Drama']",2000,8
10708743,Aashirwad,1968,['India'],"['Drama', 'Bollywood', 'World cinema']",1960,8
2423428,U Turn,1997,"['United States of America', 'France']","['Neo-noir', 'Crime Fiction', 'Thriller', 'Black comedy', 'Drama']",1990,7
3044673,High Treason,1952,['United Kingdom'],"['Drama', 'Crime Fiction']",1950,2
365039,Six Days Seven Nights,1998,['United States of America'],"['Action', 'Action/Adventure', 'Comedy', 'Adventure', 'Romance Film', 'Romantic comedy']",1990,8
438547,Blackadder's Christmas Carol,1988,['United Kingdom'],"['Parody', 'Comedy']",1980,8
240962,Amy Stiller's Breast,2000,['United States of America'],['Short Film'],2000,0
18437254,Death Toll,2008,['United States of America'],"['Action', 'Crime Fiction', 'Action/Adventure', 'Thriller', 'Crime Thriller', 'Drama']",2000,8
9669604,Once More,1997,['India'],"['Musical', 'Bollywood', 'World cinema', 'Drama']",1990,7
7092616,Traci Takes Tokyo,1986,"['Japan', 'United States of America']","['Japanese Movies', 'Pornographic movie']",1980,6
18434302,Striporama,1953,['United States of America'],['Comedy'],1950,3
33396742,Hirasat,1987,[],"['Action', 'Crime Fiction', 'Drama']",1980,7
27556114,Hold That Line,1952,['United States of America'],"['Music', 'Action', 'Comedy film', 'Sports']",1950,2
2450375,Painted Lady,1997,"['United Kingdom', 'United States of America']","['Drama', 'Crime Fiction']",1990,7
32960434,Desperate Search,1952,['United States of America'],"['Adventure', 'Drama']",1950,2
28657324,Crayon Shin-chan: Action Kamen vs Leotard Devil,1993,['Japan'],"['Animation', 'Japanese Movies', 'Comedy']",1990,3
20518441,Bunco Busters,1955,['United States of America'],"['Animation', 'Short Film', 'Comedy film', 'Family Film']",1950,5
18165825,Kabluey,2008,['United States of America'],"['Indie', 'Comedy', 'Domestic Comedy', 'Drama']",2000,8
7266768,Meet Wally Sparks,1997,['United States of America'],"['Media Satire', 'Satire', 'Comedy']",1990,7
983044,Mortal Kombat,1995,['United States of America'],"['Action', 'Fantasy Adventure', 'Action/Adventure', 'Thriller', 'Martial Arts Film', 'Adventure', 'Science Fiction', 'Fantasy']",1990,5
15890076,Oriana,1985,"['France', 'Venezuela']","['Family Drama', 'Mystery', 'Thriller', 'World cinema', 'Melodrama', 'Drama']",1980,5
3748152,"Lovers, Liars & Lunatics",2006,['United States of America'],['Indie'],2000,6
10331405,Africa Express,1975,['Italy'],"['Action', 'Adventure']",1970,5
9690865,Fire Serpent,2007,"['Canada', 'United States of America']","['Horror', 'Science Fiction']",2000,7
26839237,Napoleon Blown-Aparte,1966,['United States of America'],"['Short Film', 'Animation']",1960,6
24569945,Cruel Restaurant,2008,['Japan'],"['Japanese Movies', 'Comedy', 'Horror', 'World cinema']",2000,8
23593226,Teree Sang: A Kidult Love Story,2009,['India'],"['Romance Film', 'Drama']",2000,9
20157657,Accidental Friendship,2008,['Canada'],"['Drama', 'Television movie']",2000,8
2906058,Black Dog,1998,"['Japan', 'United Kingdom', 'France', 'Germany', 'United States of America']","['Action', 'Crime Fiction', 'Japanese Movies', 'Action Thrillers', 'Action/Adventure', 'Thriller', 'Drama']",1990,8
3003637,My Boyfriend is Type B,2005,['South Korea'],['Comedy'],2000,5
3190252,Public Enemy,2002,['South Korea'],"['Action', 'Drama', 'Crime Fiction', 'Action/Adventure', 'World cinema']",2000,2
18225554,It's Alive,2008,['United States of America'],"['Monster movie', 'Horror']",2000,8
3214698,Warlords of Atlantis,1978,['United Kingdom'],"['Adventure', 'Alien Film', 'Science Fiction', 'Fantasy']",1970,8
617063,Murder by Numbers,2002,['United States of America'],"['Psychological thriller', 'Suspense', 'Crime Fiction', 'Thriller', 'Crime Thriller', 'Drama']",2000,2
2533907,8½ Women,1999,"['Luxembourg', 'United Kingdom', 'Germany', 'Netherlands']","['Drama', 'Comedy']",1990,9
29950047,Waiting for Caroline,1967,['Canada'],"['Romance Film', 'Romantic drama', 'Drama']",1960,7
24738759,Prem Amar,2009,[],['Romance Film'],2000,9
7971186,Laughing Gravy,1931,['United States of America'],"['Black-and-white', 'Short Film', 'Comedy', 'Slapstick']",1930,1
639629,Fame,1980,['United States of America'],"['Musical', 'LGBT', 'Teen', 'Drama']",1980,0
6795132,Kadhal Kottai,1996,['India'],['Romance Film'],1990,6
1453549,Normal,2003,['United States of America'],"['LGBT', 'Television movie', 'Drama']",2000,3
9939440,Happy Land,1943,['United States of America'],"['Black-and-white', 'Drama']",1940,3
921301,The Notorious Bettie Page,2006,['United States of America'],"['Period piece', 'Biography', 'Biographical film', 'Biopic [feature]', 'Docudrama', 'Drama']",2000,6
1321163,Made,2001,['United States of America'],"['Crime Fiction', 'Comedy', 'Thriller', 'Drama']",2000,1
3264582,Evil,2003,"['Sweden', 'Denmark']","['Drama', 'World cinema']",2000,3
17470133,Hannah Takes the Stairs,2007,['United States of America'],"['Drama', 'Indie', 'Romantic drama', 'Romance Film', 'Romantic comedy', 'Comedy-drama']",2000,7
10639481,Ishq Par Zor Nahin,1970,['India'],['Romance Film'],1970,0
106328,Black Hawk Down,2001,['United States of America'],"['Action', 'Combat Films', 'History', 'Action/Adventure', 'War film', 'Drama']",2000,1
8961830,Fair Game,1985,"['New Zealand', 'Australia']","['Action', 'Psychological thriller', 'Suspense', 'Action/Adventure', 'Thriller', 'World cinema']",1980,5
27611961,The Private Files of J. Edgar Hoover,1977,['United States of America'],"['Drama', 'Biographical film']",1970,7
104643,Things to Come,1936,['United Kingdom'],"['Black-and-white', 'Apocalyptic and post-apocalyptic fiction', 'Doomsday film', 'Steampunk', 'Science Fiction', 'Drama']",1930,6
21093009,Exorcism: The Possession of Gail Bowers,2006,['United States of America'],['Horror'],2000,6
23219806,Tokyo: The Last War,1989,['Japan'],"['Japanese Movies', 'Horror', 'Adventure', 'Fantasy']",1980,9
25515610,Decalogue III,1988,['Poland'],['Drama'],1980,8
3557571,The Debut,2001,['United States of America'],"['Drama', 'Family Drama', 'Indie', 'Coming of age', 'Comedy', 'Teen', 'Comedy-drama']",2000,1
9176509,Passage to Zarahemla,2007,['United States of America'],"['Action/Adventure', 'Adventure', 'Drama']",2000,7
12001093,El Lute: Run for Your Life,1987,['Spain'],"['Drama', 'Biographical film']",1980,7
9321677,Alone with Her,2007,['United States of America'],"['Psychological thriller', 'Drama', 'Crime Fiction', 'Mystery', 'Indie', 'Thriller']",2000,7
2029406,Inseminoid,1981,['United Kingdom'],"['Indie', 'Science Fiction', 'Horror', 'B-movie', 'Sci-Fi Horror']",1980,1
31322561,Alarm in the Circus,1954,['German Democratic Republic'],"['Drama', 'Crime Fiction']",1950,4
2056428,A Yank in the RAF,1941,['United States of America'],"['Action', 'Black-and-white', 'Romantic drama', 'Action/Adventure', 'Romance Film', 'War film', 'Drama']",1940,1
10100536,The Missing Gun,2002,['China'],"['Crime Fiction', 'Mystery', 'Action/Adventure', 'Comedy', 'Thriller', 'World cinema', 'Black comedy', 'Chinese Movies', 'Drama']",2000,2
29398338,Fehérlófia,1981,['Hungary'],"['Animation', 'Adventure', 'Fantasy']",1980,1
23609070,Siri Siri Muvva,1978,['India'],"['Musical', 'Family Film']",1970,8
21172552,Zouzou,1934,['France'],"['Musical', 'Black-and-white', 'Crime Fiction', 'Romance Film']",1930,4
2618462,You'll Never Get Rich,1941,['United States of America'],"['Musical', 'Black-and-white', 'Comedy', 'Romance Film', 'Romantic comedy']",1940,1
7482786,Sa-kwa,2005,['South Korea'],"['Romantic drama', 'World cinema', 'Romance Film', 'Drama']",2000,5
18878308,A Girl Cut in Two,2007,['France'],"['Art film', 'Comedy', 'Thriller', 'World cinema', 'Black comedy', 'Drama']",2000,7
2301370,1 Night in China,2004,['United States of America'],"['Adult', 'Pornographic movie']",2000,4
27283528,Downstairs,1932,['United States of America'],['Drama'],1930,2
26396356,The Killing Time,1987,['United States of America'],"['Action', 'Mystery', 'Action/Adventure', 'Thriller', 'Crime Thriller']",1980,7
23102665,Romance with a Double Bass,1974,['United Kingdom'],"['Short Film', 'Comedy', 'Comedy of manners', 'Romance Film', 'Romantic comedy']",1970,4
4866746,Comrades: Almost a Love Story,1996,['Hong Kong'],"['Romantic drama', 'World cinema', 'Romance Film', 'Chinese Movies', 'Drama']",1990,6
9793561,A Slipping-Down Life,1999,['United States of America'],"['Film adaptation', 'Drama', 'Indie', 'Romantic drama', 'Comedy of manners', 'Romance Film', 'Comedy-drama']",1990,9
11506353,The Friendly Ghost,1945,['United States of America'],"['Animation', 'Short Film', 'Comedy', 'Family Film']",1940,5
11416034,Pleasure Factory,2007,"['Thailand', 'Singapore']","['Romantic drama', 'World cinema', 'Documentary', 'Romance Film', 'Docudrama', 'Drama']",2000,7
26693888,Shalabam,2008,['India'],"['Family Drama', 'Social problem film', 'Romance Film', 'Drama']",2000,8
32332049,Scentimental Romeo,1951,[],"['Animation', 'Short Film', 'Comedy film', 'Family Film']",1950,1
3603641,The Day the Pig Fell Into the Well,1996,['South Korea'],['Drama'],1990,6
16964519,Smouldering Fires,1925,['United States of America'],"['Black-and-white', 'Silent film', 'Romance Film', 'Melodrama', 'Drama']",1920,5
5055956,Tweety's High Flying Adventure,2000,['United States of America'],"['Family Film', 'Animation']",2000,0
24513554,Safar,1970,['India'],"['Bollywood', 'World cinema']",1970,0
5321761,Stardust,1974,['United Kingdom'],"['Musical', 'Indie', 'Drama']",1970,4
10582531,Night Zoo,1987,['Canada'],"['Drama', 'Crime Fiction', 'Thriller']",1980,7
3927698,Il Cuore nel Pozzo,2005,['Italy'],['Drama'],2000,5
5565988,Gone Baby Gone,2007,['United States of America'],"['Psychological thriller', 'Film adaptation', 'Detective fiction', 'Mystery', 'Thriller', 'Crime Thriller', 'Drama', 'Detective']",2000,7
11452198,The Canterville Ghost,1986,"['United Kingdom', 'United States of America']","['Comedy', 'Costume drama', 'Family Film', 'Fantasy']",1980,6
7269514,Vamsi,2000,['India'],['Action'],2000,0
21511956,The Case of the Scorpion's Tail,1971,"['Spain', 'Italy']","['Psychological thriller', 'Giallo', 'Crime Fiction', 'Thriller', 'World cinema', 'Crime Thriller', 'Drama']",1970,1
12139238,Tooth And Nail,2007,['United States of America'],"['Slasher', 'Thriller', 'Horror', 'Doomsday film', 'Science Fiction', 'Drama']",2000,7
15805451,Isle of Sunken Gold,1927,[],"['Silent film', 'Black-and-white', 'Adventure']",1920,7
6099449,Moksha,2001,['India'],"['Thriller', 'Drama']",2000,1
13822777,The Other End of the Line,2008,['United States of America'],"['Comedy', 'Romance Film', 'Romantic comedy', 'Drama']",2000,8
9551038,Black Sunday,1977,['United States of America'],"['Action', 'Mystery', 'Action/Adventure', 'Thriller', 'Disaster']",1970,7
24644162,Albert Pinto Ko Gussa Kyon Aata Hai,1980,['India'],"['Romantic comedy', 'Drama']",1980,0
2797150,A Low Down Dirty Shame,1994,['United States of America'],"['Action', 'Detective fiction', 'LGBT', 'Crime Fiction', 'Action/Adventure', 'Comedy', 'Action Comedy', 'Detective']",1990,4
2973523,Hollywood Shuffle,1987,['United States of America'],"['Indie', 'Parody', 'Comedy', 'Media Satire', 'Cult']",1980,7
16703978,Breath,2007,['South Korea'],['Drama'],2000,7
2910440,Storytelling,2001,['United States of America'],"['Satire', 'Comedy', 'Black comedy', 'Comedy-drama', 'Drama', 'Ensemble Film']",2000,1
19615593,Voltron: Fleet of Doom,1986,['United States of America'],"['Action', 'Animation', 'Anime', 'Science Fiction']",1980,6
10394806,The Bride Comes Home,1935,['United States of America'],"['Romance Film', 'Black-and-white', 'Comedy']",1930,5
12607294,Prey,2008,['Australia'],"['Supernatural', 'Thriller', 'Horror']",2000,8
7203413,Angst,2000,['Australia'],"['Black comedy', 'Comedy', 'Drama']",2000,0
3565057,The Road Home,2003,['United States of America'],"['Romantic drama', 'Comedy', 'Romantic comedy', 'Romance Film', 'Sports', 'Drama']",2000,3
2845380,My Date with the President's Daughter,1998,['United States of America'],"['Comedy', 'Teen', 'Romantic comedy', 'Family Film']",1990,8
20768445,Lost Indulgence,2008,['China'],"['Chinese Movies', 'Drama']",2000,8
11037366,Whisper,2007,['United States of America'],"['Psychological thriller', 'Thriller', 'Horror', 'Crime Thriller', 'Supernatural']",2000,7
5577177,Devil In The Flesh 2,2000,"['Canada', 'United States of America']","['Psychological thriller', 'Indie', 'Slasher', 'Thriller', 'Erotic thriller', 'Crime Thriller']",2000,0
745100,James and the Giant Peach,1996,"['United Kingdom', 'United States of America']","['Musical', 'Animation', 'Comedy', 'Stop motion', ""Children's/Family"", 'Adventure', ""Children's Fantasy"", 'Fantasy Comedy', 'Family Film', 'Fantasy']",1990,6
12331162,Thomas & Friends: The Great Discovery,2008,['United States of America'],"['Family Film', 'Animation']",2000,8
4431129,Butterfly on a Wheel,2007,"['United Kingdom', 'United States of America', 'Canada']","['Psychological thriller', 'Crime Fiction', 'Thriller', 'Crime Thriller', 'Drama']",2000,7
19768754,The Snake King's Wife Part 2,1973,['Thailand'],['Horror'],1970,3
31279604,Vicky the Viking,2009,['Germany'],"['Family-Oriented Adventure', ""Children's/Family""]",2000,9
4091931,You Can't Cheat an Honest Man,1939,['United States of America'],"['Black-and-white', 'Comedy', 'Romance Film', 'Slapstick']",1930,9
7333656,Forever,1922,['United States of America'],"['Black-and-white', 'Indie', 'Silent film', 'Romance Film', 'Drama']",1920,2
9108427,By The People,2005,['India'],"['Action', 'Bollywood']",2000,5
7332704,Automatons,2006,['United States of America'],"['Science Fiction', 'Drama', 'Horror']",2000,6
8636983,Lump Sugar,2006,['South Korea'],"['Romance Film', 'Drama']",2000,6
3824576,The Parole Officer,2001,['United Kingdom'],"['Action', 'Crime Fiction', 'Action/Adventure', 'Comedy', 'Crime Comedy']",2000,1
23606613,Sweet Hearts Dance,1988,['United States of America'],"['Romantic drama', 'Romance Film', 'Drama', 'Ensemble Film']",1980,8
9567718,We've Never Been Licked,1943,['United States of America'],"['War film', 'Propaganda film', 'Drama']",1940,3
2598262,Murmur of the Heart,1971,"['France', 'Germany', 'West Germany', 'Italy']","['Romantic drama', 'Comedy', 'World cinema', 'Romance Film', 'Drama', 'Period piece', 'Coming of age', 'Romantic comedy', 'Sex comedy']",1970,1
7119804,Blonde Crazy,1931,['United States of America'],"['Black-and-white', 'Crime Fiction', 'Gangster Film', 'Pre-Code', 'Drama']",1930,1
3534336,La Moustache,2005,['France'],"['Drama', 'World cinema']",2000,5
5115542,Zapped Again!,1993,['United States of America'],"['Indie', 'Comedy', 'Teen', 'Fantasy', 'Fantasy Comedy', 'Sex comedy']",1990,3
19979352,Mann Vasanai,1983,['India'],"['Romance Film', 'Drama']",1980,3
4380331,Shoot to Kill,1988,['United States of America'],"['Action', 'Action/Adventure', 'Thriller', 'Crime Thriller', 'Adventure']",1980,8
13457871,Father Came Too!,1964,['United Kingdom'],['Comedy'],1960,4
9566099,The Scoundrel,1935,['United States of America'],"['Film noir', 'Black-and-white', 'Drama']",1930,5
9179416,The Mighty McGurk,1947,['United States of America'],"['Melodrama', 'Drama']",1940,7
4807001,8 Ball Bunny,1950,['United States of America'],['Comedy'],1950,0
304725,Problem Child,1990,['United States of America'],"['Slapstick', 'Comedy', 'Black comedy', ""Children's/Family"", 'Family Film']",1990,0
19461317,Doña Perfecta,1951,['Mexico'],['Black-and-white'],1950,1
31197541,Loafer,1973,['India'],['Drama'],1970,3
31653564,Ikigami,2008,['Japan'],['Japanese Movies'],2000,8
798426,Cobb,1994,['United States of America'],"['Period piece', 'Sports', 'Biography', 'Biographical film', 'Biopic [feature]', 'Drama']",1990,4
3944660,Sivaji: The Boss,2007,['India'],"['Action', 'Drama', 'Thriller', 'Romance Film', 'Adventure']",2000,7
163437,Sleuth,1972,"['United Kingdom', 'United States of America']","['Psychological thriller', 'Suspense', 'Mystery', 'Thriller', 'Crime Thriller']",1970,2
2164332,The Adventures of Ford Fairlane,1990,['United States of America'],"['Detective fiction', 'Mystery', 'Parody', 'Comedy', 'Thriller', 'Detective']",1990,0
1482874,Saratoga Trunk,1945,['United States of America'],"['Black-and-white', 'Romantic drama', 'Romance Film', 'Melodrama', 'Drama']",1940,5
458890,Hercules in New York,1970,['United States of America'],"['Action', 'Fantasy Adventure', 'Action/Adventure', 'Comedy', 'Adventure', 'Mythological Fantasy', 'Time travel', 'Fantasy']",1970,0
1586160,Dear Frankie,2004,"['United Kingdom', 'Scotland']","['Coming of age', 'Family Drama', 'Indie', 'Drama']",2000,4
9812356,25 Watts,2001,"['Uruguay', 'Argentina']","['Drama', 'Indie', 'Comedy', 'Teen', 'World cinema', 'Black comedy']",2000,1
18549245,Fifty Dead Men Walking,2008,"['Ireland', 'United Kingdom', 'Canada']","['Crime Fiction', 'Thriller', 'Crime Thriller', 'Docudrama', 'Drama', 'Political thriller']",2000,8
704406,Species II,1998,['United States of America'],"['Science Fiction', 'Sci-Fi Horror', 'Horror']",1990,8
14930873,I am Twenty,1966,['Soviet Union'],['Drama'],1960,6
3277789,The Death of Mr. Lazarescu,2005,['Romania'],"['Medical fiction', 'Drama', 'World cinema']",2000,5
2387940,The Big Picture,1989,['United States of America'],"['Black comedy', 'Comedy', 'Drama']",1980,9
963052,To Live and Die in L.A.,1985,['United States of America'],"['Action', 'Crime Fiction', 'Action Thrillers', 'Indie', 'Action/Adventure', 'Thriller', 'Crime Thriller', 'Drama']",1980,5
21369620,Chadi Jawani Budhe Nu,1976,['India'],['Comedy'],1970,6
5162128,Okkadu,2003,['India'],"['Action', 'Romance Film']",2000,3
5409760,Warm Water Under a Red Bridge,2001,"['France', 'Japan']","['Erotic Drama', 'Romantic drama', 'Comedy', 'World cinema', 'Romance Film', 'Drama', 'Japanese Movies', 'Erotica', 'Fantasy']",2000,1
15879495,Balwaan,1992,['India'],['Action'],1990,2
32697511,My Little Pony Crystal Princess: The Runaway Rainbow,2006,[],['Animation'],2000,6
924179,Playing by Heart,1998,"['United Kingdom', 'United States of America']","['LGBT', 'Romantic drama', 'Comedy', 'Romance Film', 'Drama', 'Comedy-drama', 'Slice of life story', 'Ensemble Film']",1990,8
6114445,Cash and Carry,1937,['United States of America'],"['Black-and-white', 'Short Film', 'Comedy', 'Slapstick']",1930,7
24690281,5 Card Stud,2005,['United States of America'],"['Romantic drama', 'Comedy', 'Romance Film', 'Romantic comedy', 'Drama']",2000,5
15103522,Nine Days in One Year,1962,['Soviet Union'],"['Black-and-white', 'Drama']",1960,2
26304157,Vellithira,2003,['India'],"['Action', 'Comedy-drama']",2000,3
4957483,True Blue,1996,"['United Kingdom', 'United States of America']","['Sports', 'Drama']",1990,6
11051391,Nikaah,1982,['India'],"['Musical', 'Romantic drama', 'Musical Drama', 'Bollywood', 'World cinema', 'Romance Film', 'Drama', 'Marriage Drama', 'Melodrama']",1980,2
6019915,Dad's Dead,2003,"['United Kingdom', 'England', 'United States of America']","['Short Film', 'Drama', 'Animation']",2000,3
33206310,Island of Lost Men,1939,['United States of America'],['Mystery'],1930,9
11467488,Feast of Love,2007,['United States of America'],"['Film adaptation', 'Romantic drama', 'Romance Film', 'Drama', 'Ensemble Film']",2000,7
33364606,Hank Williams: The Show He Never Gave,1980,['Canada'],"['Music', 'Drama']",1980,0
931121,Bat*21,1988,['United States of America'],"['Action', 'Drama', 'Action/Adventure', 'War film']",1980,8
23627704,Quake,1992,"['United Kingdom', 'Germany', 'Poland', 'Hungary', 'Italy', 'United States of America']","['Action', 'Disaster']",1990,2
1166548,Julien Donkey-Boy,1999,['United States of America'],"['Dogme 95', 'Drama', 'Indie', 'Family Drama', 'Avant-garde', 'Experimental film']",1990,9
8972250,"Kiss Me, Kate",1953,['United States of America'],"['Musical', 'Filmed Play', 'Comedy', 'Romance Film', 'Romantic comedy']",1950,3
10845420,Saved by the Bell: Hawaiian Style,1992,['United States of America'],"['Beach Film', 'Comedy', 'Teen']",1990,2
6059070,Berth Marks,1929,['United States of America'],"['Black-and-white', 'Short Film', 'Comedy', 'Silent film', 'Slapstick']",1920,9
16260144,Violent Saturday,1955,['United States of America'],"['Action', 'Drama', 'Crime Fiction', 'Crime Drama']",1950,5
9951441,Once Upon a Time in China,1991,"['China', 'Hong Kong']","['Chinese Movies', 'Martial Arts Film', 'Adventure']",1990,1
10644740,The Bravados,1958,['United States of America'],"['Western', 'Action/Adventure', 'Drama']",1950,8
3368887,Rebirth of Mothra II,1997,['Japan'],"['Monster', 'Japanese Movies']",1990,7
499810,A Mighty Wind,2003,['United States of America'],"['Musical', 'Parody', 'Comedy', 'Musical comedy', 'Mockumentary']",2000,3
16366907,Aanaval mothiram,1990,['India'],"['Action', 'Comedy', 'Thriller', 'Bollywood']",1990,0
5747105,Rocío de La Mancha,1963,['Spain'],"['Musical', 'Comedy']",1960,3
27758747,A Circle of Deception,1960,['United Kingdom'],"['War film', 'Drama']",1960,0
2341972,Surrender,1987,['United States of America'],['Comedy'],1980,7
17183861,Mad About Music,1938,['United States of America'],"['Musical', 'Black-and-white', 'Comedy', 'Musical comedy', 'Drama']",1930,8
11069453,It Always Rains on Sunday,1947,['United Kingdom'],"['Crime Fiction', 'Crime Drama', 'Kitchen sink realism', 'Drama']",1940,7
3591801,Joe Butterfly,1957,['United States of America'],['Comedy'],1950,7
1027251,I Yabba-Dabba Do!,1993,['United States of America'],"['Animation', 'Comedy', 'Family Film']",1990,3
10141296,Avalanche Express,1979,"['Ireland', 'United States of America']","['Action', 'Spy', 'Action Thrillers', 'Thriller', 'Disaster']",1970,9
3644964,Loves of a Blonde,1966,"['Czech Republic', 'Czechoslovakia']","['Art film', 'Romantic drama', 'Satire', 'Comedy', 'World cinema', 'Romance Film', 'Black comedy', 'Drama', 'Comedy-drama', 'Czechoslovak New Wave', 'Comedy of manners']",1960,6
10286355,Primary Colors,1998,"['Japan', 'United Kingdom', 'France', 'Germany', 'United States of America']","['Film à clef', 'Film adaptation', 'Political satire', 'Comedy', 'Media Satire', 'Drama', 'Political cinema', 'Japanese Movies', 'Comedy-drama', 'Political drama']",1990,8
4139977,Pterodactyl,2005,['United States of America'],"['Action', 'Thriller', 'Horror', 'Adventure', 'Television movie', 'Science Fiction', 'Fantasy']",2000,5
24051154,Behind Green Lights,1946,['United States of America'],"['Crime Fiction', 'Mystery', 'Drama']",1940,6
12094338,In Between Days,2006,"['South Korea', 'United States of America', 'Canada']","['Coming of age', 'Romantic drama', 'World cinema', 'Romance Film', 'Drama']",2000,6
31920775,Vallavanukku Vallavan,1965,['India'],['Thriller'],1960,5
3736986,Carry On Spying,1964,['United Kingdom'],"['Parody', 'Comedy']",1960,4
22842262,Superman/Batman: Public Enemies,2009,['United States of America'],"['Action', 'Animation', 'Superhero', 'Superhero movie']",2000,9
8714647,New Port South,2001,['United States of America'],"['Drama', 'Coming of age', 'Teen']",2000,1
1470989,Meatballs,1979,['Canada'],"['Screwball comedy', 'Comedy', 'Teen']",1970,9
6817957,Mutual Appreciation,2006,['United States of America'],"['Mumblecore', 'Black-and-white', 'Drama', 'Indie', 'Comedy']",2000,6
3037944,The Guardian,2006,['United States of America'],"['Action', 'Drama', 'Adventure']",2000,6
20903214,Mere Sajna,1975,['India'],['Romance Film'],1970,5
1290021,Untold Scandal,2003,['South Korea'],"['Period piece', 'Erotic Drama', 'Romantic drama', 'World cinema', 'Romance Film', 'Drama']",2000,3
21038957,Haber,2008,['United States of America'],['Drama'],2000,8
25446285,Chattaniki Kallu Levu,1981,['India'],"['Action', 'Crime Thriller', 'Drama']",1980,1
26165610,Night Without Sleep,1952,['United States of America'],"['Film noir', 'Mystery', 'Drama']",1950,2
8485902,Pinocchio,2002,"['France', 'Germany', 'Italy', 'United States of America']","['Comedy', 'Family Film', 'Fantasy']",2000,2
30000482,Joker,2000,[],"['Musical', 'Drama', 'Comedy film']",2000,0
7856117,Mimic 2,2001,['United States of America'],"['Creature Film', 'Thriller', 'Horror', 'Science Fiction', 'Natural horror films']",2000,1
1160958,Mrityudata,1997,['India'],"['Musical', 'Bollywood', 'World cinema', 'Drama']",1990,7
13007706,Razor Blade Smile,1998,['United Kingdom'],"['Indie', 'Horror', 'B-movie', 'Crime Thriller']",1990,8
32138141,Malajanha,1965,['India'],['Drama'],1960,5
26404640,Kaana Kanmani,2009,['India'],"['Drama', 'Family Film', 'Horror']",2000,9
26150671,The Mark of the Whistler,1944,['United States of America'],"['Film noir', 'Mystery', 'Drama']",1940,4
7180621,Jayam Manade Raa,2000,['India'],['Drama'],2000,0
17955901,The Richest Cat in the World,1986,['United States of America'],"['Crime Fiction', 'Comedy', 'Animal Picture', ""Children's/Family"", 'Fantasy']",1980,6
4340576,Thomasine & Bushrod,1974,['United States of America'],"['Action', 'Blaxploitation', 'Heist', 'Crime Fiction', 'Western', 'Action/Adventure']",1970,4
24552132,Dear J,2008,['United States of America'],['Drama'],2000,8
1273494,The Spy in Black,1939,['United Kingdom'],"['Action', 'Spy', 'Black-and-white', 'Melodrama', 'War film', 'Drama']",1930,9
11041911,Shaadi Ka Laddoo,2004,['India'],['Comedy'],2000,4
14652733,The Man in the Net,1959,['United States of America'],"['Black-and-white', 'Mystery', 'Thriller', 'Film noir', 'Crime Thriller', 'Whodunit', 'Drama']",1950,9
15048077,Komisario Palmun erehdys,1960,['Finland'],['Crime Fiction'],1960,0
7197477,Windy City Heat,2003,['United States of America'],"['Television movie', 'Mockumentary', 'Comedy']",2000,3
25104691,Corsair,1931,['United States of America'],"['Action', 'Drama', 'Crime Fiction', 'Action/Adventure', 'Crime Thriller']",1930,1
32998352,A Daughter of Australia,1922,[],['Silent film'],1920,2
9612611,The Shadow of the Eagle,1932,['United States of America'],"['Action', 'Black-and-white', 'Crime Fiction', 'Action/Adventure', 'Western', 'Detective', 'Adventure']",1930,2
2160467,Broken Arrows,2007,['United States of America'],['Drama'],2000,7
4517361,Larry the Cable Guy: Health Inspector,2006,['United States of America'],"['Gross out', 'Gross-out film', 'Comedy', 'Slapstick']",2000,6
6794558,Savannah Smiles,1982,['United States of America'],"['Comedy', 'Crime Comedy', 'Childhood Drama', ""Children's/Family"", ""Children's""]",1980,2
2002403,Halloween 6,1995,['United States of America'],"['Slasher', 'Teen', 'Horror', 'Cult']",1990,5
7039813,Instant Justice,1986,['United States of America'],"['Action', 'Drama', 'Crime Fiction', 'Action/Adventure', 'Thriller']",1980,6
11241120,Sweethearts,1938,['United States of America'],['Musical'],1930,8
2460824,The Challenge,2003,['United States of America'],"['Comedy', 'Teen', 'Adventure', ""Children's"", 'Family Film']",2000,3
14054382,Milana,2007,['India'],['Romance Film'],2000,7
31574184,Dui Duari,2000,['Bangladesh'],"['Television movie', 'Mystery', 'Drama']",2000,0
10915044,House of Traps,1981,"['China', 'Hong Kong']","['Action', 'Action/Adventure', 'World cinema', 'Chinese Movies', 'Martial Arts Film']",1980,1
24166341,Rapture,1965,"['United States of America', 'France']","['Black-and-white', 'Drama']",1960,5
10061978,Body of Lies,2008,['United States of America'],"['Action', 'Suspense', 'Film adaptation', 'Spy', 'Thriller', 'War film', 'Drama']",2000,8
3920340,Taxi Number 9211,2006,['India'],"['Musical', 'Comedy', 'Bollywood', 'Thriller', 'World cinema']",2000,6
7238980,Kasthuri Maan,2005,['India'],[],2000,5
11544091,To Brave Alaska,1996,['United States of America'],"['Action/Adventure', 'Adventure', 'Television movie', 'Drama']",1990,6
8863640,Justice League of America,1997,['United States of America'],"['Action', 'Adventure', 'Fantasy']",1990,7
12063351,The Trap,1959,['United States of America'],"['Film noir', 'Crime Fiction', 'Drama']",1950,9
8753259,Sitt al-Bayt,1949,['Egypt'],['Comedy'],1940,9
63310,Day of the Dead,1985,['United States of America'],"['Indie', 'Horror', 'Zombie Film', 'Cult']",1980,5
18812751,Desert of Blood,2008,['United States of America'],"['Indie', 'Thriller', 'Horror', 'B-movie']",2000,8
1189767,Intermission,2003,"['Ireland', 'United Kingdom']","['Heist', 'Indie', 'Comedy', 'World cinema', 'Black comedy']",2000,3
27970899,Be Up to Date,1938,[],"['Musical', 'Animation', 'Short Film']",1930,8
31105293,Nightmare in Badham County,1976,['United States of America'],"['Thriller', 'Drama']",1970,6
24855971,Sovann Pancha,1970,['Cambodia'],"['Romance Film', 'Adventure']",1970,0
21462052,Four Last Songs,2006,"['United Kingdom', 'Spain']","['Music', 'Drama', 'Indie', 'Comedy', 'World cinema']",2000,6
695023,Meet the Parents,2000,['United States of America'],"['Screwball comedy', 'Comedy', 'Romance Film', 'Romantic comedy']",2000,0
475496,The Life of Oharu,1952,['Japan'],"['Period piece', 'Black-and-white', 'Japanese Movies', 'Melodrama', 'Drama']",1950,2
314775,Mr. Baseball,1992,['United States of America'],"['Comedy', 'Romantic comedy', 'Romance Film', 'Sports']",1990,2
11440096,The Beautiful Ordinary,2007,['United States of America'],"['Stoner film', 'Indie', 'Comedy', 'Drama']",2000,7
16855103,Easy Virtue,2008,"['Canada', 'United Kingdom']","['Romance Film', 'Romantic comedy', 'Comedy']",2000,8
16673963,Jeevana Chaitra,1991,['India'],"['Musical', 'Bollywood', 'World cinema', 'Drama']",1990,1
8011558,Legionnaire,1998,['United States of America'],"['Action', 'Boxing', 'Crime Fiction', 'Action Thrillers', 'Action/Adventure', 'Thriller', 'Adventure', 'Drama', 'Foreign legion', 'Period piece', 'War film']",1990,8
2050474,Sepet,2005,['Malaysia'],"['Romantic comedy', 'Drama']",2000,5
3208481,Attack of the 60 Foot Centerfold,1995,['United States of America'],"['Parody', 'Indie', 'Comedy', 'Z movie', 'Alien Film', 'Science Fiction', 'Cult']",1990,5
25649246,The Girl on the Train,2009,['France'],"['Docudrama', 'Drama', 'World cinema']",2000,9
528780,Diamond Head,1963,['United States of America'],"['Film adaptation', 'Romantic drama', 'Drama']",1960,3
28090023,Sticky Fingers,2009,['Canada'],"['Crime Fiction', 'Adventure', 'Comedy film']",2000,9
2482603,La ragazza che sapeva troppo,1963,['Italy'],"['Psychological thriller', 'Giallo', 'Black-and-white', 'Mystery', 'Thriller']",1960,3
26163627,True Women For Sale,2008,['Hong Kong'],['Chinese Movies'],2000,8
28261033,Uncensored,1942,['United Kingdom'],"['War film', 'Drama']",1940,2
217784,The Adventures of Elmo in Grouchland,1999,['United States of America'],"['Musical', 'Comedy', 'Family-Oriented Adventure', ""Children's/Family"", ""Children's"", 'Adventure', ""Children's Fantasy"", 'Family Film', 'Fantasy']",1990,9
33163676,Black Moon,1934,[],"['Crime Fiction', 'Horror']",1930,4
1959464,Enron: The Smartest Guys in the Room,2005,['United States of America'],"['Crime Fiction', 'Biography', 'Indie', 'Documentary', 'Business', 'Culture & Society', 'Finance & Investing', 'Law & Crime']",2000,5
35790646,Andipatti Arasampatti,2002,['India'],['Comedy film'],2000,2
30483652,Aryamala,1941,[],[],1940,1
23400589,Big Fan,2009,['United States of America'],"['Comedy', 'Black comedy', 'Sports', 'Drama']",2000,9
22187067,The Fabulous Baron Munchausen,1962,['Czechoslovakia'],"['Animation', 'Adventure', 'Romance Film', 'War film', 'Science Fiction', 'Fantasy']",1960,2
26513341,Inspector Balram,1991,['India'],"['Action', 'Thriller', 'Drama']",1990,1
466340,A Cinderella Story,2004,"['Canada', 'United States of America']","['Comedy', 'Teen', 'Romance Film', 'Romantic comedy', ""Children's"", 'Family Film']",2000,4
10675370,The Domino Principle,1977,"['United Kingdom', 'United States of America']","['Mystery', 'Thriller']",1970,7
962502,55 Days at Peking,1963,['United States of America'],"['Action', 'Costume Adventure', 'War film', 'Adventure', 'Drama', 'Period piece', 'Historical Epic', 'Epic', 'Historical fiction', 'Political drama']",1960,3
11458741,Spring in Park Lane,1948,['United Kingdom'],"['Black-and-white', 'Comedy', 'Romance Film', 'Romantic comedy']",1940,8
16973860,Bent,1997,['United Kingdom'],"['LGBT', 'War film', 'Drama']",1990,7
172577,Kangaroo Jack,2003,"['United States of America', 'Australia']","['Adventure Comedy', 'Crime Fiction', 'Comedy', 'Animal Picture', 'Adventure']",2000,3
3058162,Gulliver Mickey,1934,['United States of America'],['Black-and-white'],1930,4
10633440,The Magic of Ordinary Days,2005,['United States of America'],"['Period piece', 'Romantic drama', 'Romance Film', 'Drama']",2000,5
25573920,Hell in Normandy,1968,['Italy'],"['Action', 'Historical fiction', 'War film', 'Adventure']",1960,8
37067980,The Lady from Peking,1975,"['United States of America', 'Australia']","['Drama', 'Crime Fiction']",1970,5
28289940,Land of the Minotaur,1976,"['United Kingdom', 'Greece', 'United States of America']",['Horror'],1970,6
15924135,Chandu the Magician,1932,['United States of America'],"['Action', 'Black-and-white', 'Mystery', 'Thriller', 'Adventure', 'Science Fiction', 'Fantasy']",1930,2
1531941,She's Having a Baby,1988,['United States of America'],"['Comedy', 'Romance Film', 'Romantic comedy', 'Domestic Comedy', 'Comedy-drama', 'Drama']",1980,8
22297581,Gas,1981,['Canada'],['Comedy'],1980,1
309070,The Dirty Dozen,1967,"['United Kingdom', 'United States of America']","['Action', 'War film', 'Ensemble Film']",1960,7
4305033,Scorched,2003,['United States of America'],"['Action', 'Heist', 'Crime Fiction', 'Indie', 'Action/Adventure', 'Comedy']",2000,3
3327237,Two Thousand Maniacs!,1964,['United States of America'],"['Slasher', 'Splatter film', 'Horror', 'B-movie', 'Cult']",1960,4
3936686,Dragon Boys,2006,['Canada'],"['Crime Drama', 'Drama', 'Ensemble Film']",2000,6
23200481,Dr Dolittle Million Dollar Mutts,2009,"['Canada', 'United States of America']","['Family Film', 'Comedy film']",2000,9
21534991,Aila Re Oriya Pua,2009,['India'],['Drama'],2000,9
26839366,Plastered in Paris,1966,['United States of America'],"['Short Film', 'Animation']",1960,6
5441734,Delta Farce,2007,['United States of America'],"['Action', 'Parody', 'Action/Adventure', 'Comedy', 'Comedy of Errors']",2000,7
623623,The House on Chelouche Street,1973,['Israel'],"['Period piece', 'Coming of age', 'World cinema', 'Historical fiction', 'Political drama', 'Drama']",1970,3
14740242,Three Dark Horses,1952,['United States of America'],"['Short Film', 'Black-and-white', 'Comedy']",1950,2
13269570,Cleopatra,2003,"['Argentina', 'Spain']","['Comedy', 'Drama', 'World cinema']",2000,3
4343543,The Funhouse,1981,['United States of America'],"['Slasher', 'Horror Comedy', 'Teen', 'Horror', 'Cult', 'Natural horror films']",1980,1
5262180,Strawberry Shortcake Meets the Berrykins,1985,['Canada'],"[""Children's/Family"", 'Animation', ""Children's Entertainment""]",1980,5
1562284,Forever Young,1992,['United States of America'],"['Romantic drama', 'Adventure', 'Romance Film', 'Science Fiction', 'Drama', 'Fantasy']",1990,2
20131442,Invitation,1952,['United States of America'],"['Black-and-white', 'Drama']",1950,2
22863237,Police Story,1979,['South Korea'],"['Action', 'Romance Film']",1970,9
20010433,Nater Guru,2003,['India'],"['Romance Film', 'Comedy', 'Drama']",2000,3
21983784,Miss Annie Rooney,1942,['United States of America'],"['Romance Film', 'Drama']",1940,2
6299001,Takedown,2000,['United States of America'],"['Action', 'Chase Movie', 'Action/Adventure', 'Thriller', 'Crime Thriller', 'Drama']",2000,0
2542546,He Who Gets Slapped,1924,['United States of America'],"['Black-and-white', 'Drama', 'Indie', 'Silent film']",1920,4
36241694,Dhanam,2008,['India'],['Drama'],2000,8
14544711,Female Prisoner Scorpion: Beast Stable,1973,['Japan'],"['Prison', 'Crime Fiction', 'Action/Adventure', 'Thriller', 'World cinema', 'Crime Thriller', 'Martial Arts Film', 'Women in prison films', 'Drama', 'Japanese Movies', 'Erotica']",1970,3
1971256,Sylvia Scarlett,1935,['United States of America'],"['LGBT', 'Black-and-white', 'Comedy', 'Crime Comedy', 'Romance Film', 'Romantic comedy', 'Comedy-drama']",1930,5
19094868,Dead Space: Downfall,2008,['United States of America'],"['Animation', 'Horror', 'Anime', 'Sci-Fi Horror', 'Science Fiction']",2000,8
30862810,Celeste in the City,2004,['United States of America'],"['Romance Film', 'Romantic comedy', 'Comedy film']",2000,4
1205027,A Very Long Engagement,2004,"['France', 'United States of America']","['Period piece', 'Romantic drama', 'World cinema', 'Romance Film', 'War film', 'Drama']",2000,4
21680978,Doc,1971,['United States of America'],['Western'],1970,1
33205804,Lucky Me,1954,['United States of America'],"['Musical', 'Comedy', 'Comedy film', 'Romance Film']",1950,4
13135348,Ben X,2008,"['Netherlands', 'Belgium']","['Psychological thriller', 'Thriller', 'World cinema', 'Drama']",2000,8
1128651,Not One Less,1999,['China'],"['Coming of age', 'Comedy', 'World cinema', 'Comedy-drama', 'Chinese Movies', 'Drama']",1990,9
32764613,Bad Day to Go Fishing,2009,"['Uruguay', 'Spain']","['Western', 'Comedy film', 'World cinema', 'Drama']",2000,9
7213392,Diane,1956,['United States of America'],"['Costume drama', 'Biographical film', 'Drama']",1950,6
30042062,The Newcomers,2000,['United States of America'],"['Family Drama', 'Drama', 'Family Film']",2000,0
6544856,Signs & Wonders,2000,['France'],"['Drama', 'Romantic drama', 'Indie', 'World cinema']",2000,0
49696,Metropolis,1927,"['Weimar Republic', 'Germany']","['Action', 'Black-and-white', 'Indie', 'Thriller', 'World cinema', 'Romance Film', 'Adventure', 'Drama', 'Dystopia', 'Silent film', 'Science Fiction', 'Fantasy']",1920,7
28794651,The Smashing Bird I Used to Know,1969,['United Kingdom'],['Drama'],1960,9
10140471,The Big Blockade,1940,['United Kingdom'],"['Black-and-white', 'Comedy', 'War film', 'Propaganda film', 'Drama']",1940,0
4207567,Nancy Drew,2007,['United States of America'],"['Crime Fiction', 'Mystery', 'Comedy', 'Teen', 'Thriller', 'Crime Thriller', 'Adventure', 'Drama', 'Detective', 'Family Film']",2000,7
18139812,Mehbooba,2008,['India'],"['Musical', 'Romantic drama', 'Bollywood', 'World cinema', 'Romance Film', 'Drama']",2000,8
6787192,Deportee,1976,['United States of America'],"['Indie', 'Short Film', 'Drama']",1970,6
1983969,Knight Rider 2000,1991,['United States of America'],"['Science Fiction', 'Adventure', 'Drama']",1990,1
10376295,Hababam sinifi,1975,['Turkey'],['Comedy'],1970,5
9239665,Sharpe's Revenge,1997,['United Kingdom'],"['Historical fiction', 'Adventure']",1990,7
2018546,Krrish,2006,['India'],"['Action', 'Musical', 'Superhero', 'Action/Adventure', 'World cinema', 'Romance Film', 'Adventure', 'Superhero movie', 'Science Fiction']",2000,6
2917185,The Young Girls of Rochefort,1967,['France'],"['Musical', 'Romantic drama', 'Musical comedy', 'World cinema', 'Romance Film', 'Drama']",1960,7
5648156,Tokio Jokio,1943,['United States of America'],['Propaganda film'],1940,3
4084608,Tristana,1970,"['France', 'Spain', 'Italy']","['Satire', 'Marriage Drama', 'Drama']",1970,0
839705,The Big Hit,1998,['United States of America'],"['Action', 'Crime Fiction', 'Action Comedy', 'Caper story', 'Action/Adventure', 'Comedy', 'Crime Thriller']",1990,8
24777060,Number One with a Bullet,1987,['United States of America'],"['Action', 'Action/Adventure', 'Thriller', 'Crime Thriller']",1980,7
1940057,Gamera,1965,['Japan'],"['Black-and-white', 'Japanese Movies', 'World cinema', 'Science Fiction', 'Cult']",1960,5
14037732,Madame X,1920,['United States of America'],"['Black-and-white', 'Drama', 'Indie', 'Silent film']",1920,0
2872393,Uptown Saturday Night,1974,['United States of America'],"['Blaxploitation', 'Crime Fiction', 'Parody', 'Indie', 'Buddy film', 'Comedy']",1970,4
2406029,The Private Eyes,1980,['United States of America'],"['Mystery', 'Crime Fiction', 'Comedy', 'Thriller', 'Crime Thriller']",1980,0
21188019,También de Dolor se Canta,1950,['Mexico'],"['Drama', 'Comedy']",1950,0
8619888,Next Avengers: Heroes of Tomorrow,2008,['United States of America'],"['Action', 'Animated cartoon', 'Animation', 'Superhero', ""Children's"", 'Superhero movie', 'Family Film', 'Fantasy']",2000,8
13927565,Dead Men Walking,2005,['United States of America'],"['Creature Film', 'Indie', 'Horror', 'B-movie', 'Zombie Film']",2000,5
6228904,The Last Movie,1971,['United States of America'],"['Satire', 'New Hollywood', 'Adventure', 'Drama']",1970,1
31563699,Nanjundi Kalyana,1989,[],['Romantic comedy'],1980,9
3969430,Unaru,1984,['India'],[],1980,4
9121918,No Smoking...!,2007,['India'],"['Drama', 'Thriller', 'Horror']",2000,7
18230450,Shock,1977,"['Italy', 'United States of America']","['Horror', 'Supernatural', 'World cinema']",1970,7
25138426,Seven Keys,1961,['United Kingdom'],['Crime Fiction'],1960,1
12498208,Wanted,2009,['India'],"['Action', 'Musical', 'Action Thrillers', 'Action/Adventure', 'Thriller', 'Bollywood', 'World cinema', 'Crime Thriller']",2000,9
13461710,Goya in Bordeaux,1999,"['Spain', 'Italy']","['Biography', 'Biographical film', 'War film', 'Drama']",1990,9
8595545,Showdown At The Cotton Mill,1978,"['Hong Kong', 'Taiwan']","['Action', 'Action/Adventure', 'World cinema', 'Chinese Movies', 'Martial Arts Film']",1970,8
30606122,The Girl with the Hungry Eyes,1995,['United States of America'],"['Erotic thriller', 'Horror']",1990,5
18681545,Lilla Jönssonligan och cornflakeskuppen,1996,['Sweden'],"['Comedy', 'Family Film']",1990,6
24211904,Mutants,2008,['United States of America'],"['Horror', 'Zombie Film']",2000,8
4527590,Rock School,2005,['United States of America'],"['Music', 'Rockumentary', 'Indie', 'Biography', 'Documentary', 'Instrumental Music']",2000,5
1760098,The Touch,1971,['Sweden'],"['Action', 'Drama', 'Romance Film', 'Adventure']",1970,1
1595532,The Hollywood Knights,1980,['United States of America'],"['Comedy', 'Teen', 'Cult', 'Sex comedy']",1980,0
12091375,I-See-You.Com,2006,['United States of America'],"['Indie', 'Comedy']",2000,6
2812023,Love & Basketball,2000,['United States of America'],"['Drama', 'Coming of age', 'Indie', 'Romantic drama', 'Romance Film', 'Sports']",2000,0
19729385,Blinded by the Light,1980,['United States of America'],['Drama'],1980,0
8343583,Son of Flubber,1963,['United States of America'],"['Black-and-white', 'Comedy', ""Children's"", 'Drama', 'Family Film']",1960,3
6158544,Mother of Tears,2007,"['Italy', 'United States of America']","['Supernatural', 'Cult', 'Horror']",2000,7
13179844,The Amazing Mr Blunden,1972,['United Kingdom'],['Drama'],1970,2
2550322,Gamera vs. Jiger/Jaiga or Gamera vs. Monster X,1970,['Japan'],['Japanese Movies'],1970,0
31686022,I'm Losing You,1998,['United States of America'],"['Film adaptation', 'Family Drama', 'Indie', 'Drama', 'Ensemble Film']",1990,8
2168542,Breakin',1984,['United States of America'],"['Musical', 'Indie', 'Romance Film', 'Hip hop movies', 'Drama', 'Coming of age', 'Comedy film', 'Dance']",1980,4
7794617,Classmates,2007,['India'],"['Romance Film', 'Mystery', 'Drama']",2000,7
600194,Cool World,1992,['United States of America'],"['Action', 'Animation', 'Action/Adventure', 'Comedy', 'Erotic thriller', 'Superhero movie', 'Fantasy Comedy', 'Fantasy']",1990,2
13649283,Hamara Dil Aapke Paas Hai,2000,['India'],"['Musical', 'Bollywood', 'World cinema', 'Drama']",2000,0
25815879,Arabian Love,1922,['United States of America'],"['Silent film', 'Adventure']",1920,2
10603679,Masked Avengers,1981,['Hong Kong'],"['Action', 'Drama', 'Martial Arts Film', 'Adventure']",1980,1
23461433,Starlift,1951,['United States of America'],"['Musical', 'Romance Film']",1950,1
28828023,"Hurrah, the School Is Burning",1969,['West Germany'],['Comedy'],1960,9
11613765,Here on Earth,2000,['United States of America'],"['Romantic drama', 'Teen', 'Romance Film', 'Drama']",2000,0
25464794,Rakshasudu,1986,['India'],"['Action', 'Drama', 'Family Film']",1980,6
2371977,Garfield Gets a Life,1991,['United States of America'],['Short Film'],1990,1
885274,Breakin' All the Rules,2004,['United States of America'],"['Comedy', 'Romance Film', 'Romantic comedy', 'Comedy of Errors']",2000,4
17145739,The Restless Sex,1920,['United States of America'],"['Silent film', 'Black-and-white', 'Drama']",1920,0
2506380,Maachis,1996,['India'],"['Musical', 'Art film', 'Bollywood', 'World cinema', 'Political drama', 'Drama']",1990,6
20431829,Kandan Karunai,1967,['India'],['Drama'],1960,7
5506183,The Return Of Captain Invincible,1983,['Australia'],"['Action', 'Musical', 'Superhero', 'Action/Adventure', 'Satire', 'Comedy', 'World cinema', 'Parody', 'Superhero movie', 'Fantasy']",1980,3
4179782,Ricochet,1991,['United States of America'],"['Action', 'Psychological thriller', 'Crime Fiction', 'Action/Adventure', 'Thriller', 'Crime Thriller', 'Drama']",1990,1
6058393,Manmadhudu,2002,['India'],['Romantic comedy'],2000,2
7660945,Kanto Wanderer,1963,['Japan'],"['Crime Fiction', 'Action/Adventure', 'Thriller', 'World cinema', 'Crime Thriller', 'Drama', 'Japanese Movies', 'Crime Drama']",1960,3
4610882,"Ima, Ai ni Yukimasu",2004,['Japan'],"['Romance Film', 'Japanese Movies', 'Fantasy']",2000,4
4962400,Sin-Jin Smyth,2006,['United States of America'],['Horror'],2000,6
5608738,Them Thar Hills,1934,['United States of America'],"['Short Film', 'Black-and-white', 'Comedy']",1930,4
19889791,A Taste of Blood,1967,['United States of America'],"['B-movie', 'Cult', 'Horror']",1960,7
6584379,Osaka Elegy,1936,['Japan'],"['Black-and-white', 'Art film', 'Japanese Movies', 'Family Drama', 'World cinema', 'Drama']",1930,6
164401,Arthur,1981,['United States of America'],"['Comedy', 'Romance Film', 'Romantic comedy', 'Drama']",1980,1
583012,Rambo: First Blood Part II,1985,['United States of America'],"['Action', 'Action Thrillers', 'Action/Adventure', 'Thriller', 'War film']",1980,5
64657,The Big Blue,1988,"['France', 'Italy', 'United States of America']","['Romantic drama', 'Action/Adventure', 'World cinema', 'Romance Film', 'Adventure', 'Drama']",1980,8
21965295,Dark Mirror,2009,['United States of America'],"['Psychological thriller', 'Indie', 'Thriller', 'Horror', 'Crime Thriller', 'Supernatural']",2000,9
29942,The Graduate,1967,['United States of America'],"['Romance Film', 'Comedy', 'Drama']",1960,7
6181075,Waxworks,1924,"['Weimar Republic', 'Germany']","['Black-and-white', 'Indie', 'World cinema', 'Costume Horror', 'Drama', 'Horror', 'Silent film', 'Fantasy']",1920,4
27280443,The Riverside Murder,1935,['United Kingdom'],"['Mystery', 'Crime Fiction']",1930,5
3145613,Masked and Anonymous,2003,"['United Kingdom', 'United States of America']","['Music', 'Musical', 'Musical Drama', 'Political satire', 'Indie', 'Comedy', 'Drama', 'Comedy-drama', 'Political drama', 'Ensemble Film']",2000,3
7451262,Baby Be Good,1935,['United States of America'],"['Animation', 'Short Film', 'Comedy film', 'Family Film']",1930,5
30865811,La Terra trema,1948,['Italy'],"['Black-and-white', 'Art film', 'Drama', 'Indie', 'World cinema', 'Documentary', 'Docudrama']",1940,8
3227389,Hockey Homicide,1945,[],['Short Film'],1940,5
21265450,Teresa's Tattoo,1994,['United States of America'],"['Action', 'Drama', 'Crime Fiction', 'Comedy']",1990,4
15543608,Gutterballs,2008,['Canada'],"['Slasher', 'Teen', 'Horror', 'Horror Comedy', 'B-movie']",2000,8
30217722,Newspaper Boy,1955,['India'],['Drama'],1950,5
31572501,Tharle Nan Maga,1992,[],['Comedy film'],1990,2
5377233,Aalvar,2007,['India'],"['Action', 'Tamil cinema']",2000,7
20354657,The Constant Husband,1955,['United Kingdom'],['Comedy'],1950,5
2506836,Lloyd's of London,1936,['United States of America'],"['Black-and-white', 'Drama']",1930,6
21690482,Radio Cape Cod,2008,['United States of America'],"['Romance Film', 'Romantic drama', 'Drama']",2000,8
691156,Marked Woman,1937,['United States of America'],"['Film à clef', 'Black-and-white', 'Crime Fiction', 'Crime Drama', 'Drama']",1930,7
3342309,Nazarín,1959,['Mexico'],"['Satire', 'Drama']",1950,9
15667039,Sundarakanda,2008,['India'],['Drama'],2000,8
33391353,FC Venus,2005,['Finland'],"['Romance Film', 'Sports', 'Comedy film']",2000,5
1743074,Black Knight,2001,['United States of America'],"['Adventure Comedy', 'Comedy', 'Costume drama', 'Adventure', 'Time travel', 'Science Fiction', 'Fantasy Comedy', 'Fantasy']",2000,1
10619699,2 Champions of Shaolin,1982,['Hong Kong'],"['Chinese Movies', 'Martial Arts Film']",1980,2
2006189,Nightmare Alley,1947,['United States of America'],"['Black-and-white', 'Crime Fiction', 'Film noir', 'Crime Drama', 'Drama']",1940,7
5207578,House Arrest,1996,['United States of America'],"['Comedy', 'Family Film']",1990,6
12606487,When Magoo Flew,1954,['United States of America'],"['Animation', 'Short Film', 'Comedy', ""Children's/Family"", 'Family Film']",1950,4
25106279,Sons of Mistletoe,2001,"['Canada', 'United States of America']",['Drama'],2000,1
28899929,Teesra Kaun,1994,['India'],"['Drama', 'Thriller', 'World cinema']",1990,4
1996350,The Adventures of Sharkboy and Lavagirl,2005,['United States of America'],"['Animation', ""Children's"", 'Action/Adventure', 'Superhero movie', 'Adventure', 'Family Film', 'Fantasy']",2000,5
801722,The Navigators,2002,"['United Kingdom', 'Spain', 'Germany']","['Drama', 'Comedy']",2000,2
75933,Dangerous Liaisons,1988,"['United Kingdom', 'United States of America']","['Period piece', 'Film adaptation', 'Romantic drama', 'Comedy', 'Romance Film', 'Costume drama', 'Drama']",1980,8
11614763,The Bride Wore Red,1937,['United States of America'],"['Black-and-white', 'Comedy', 'Romance Film', 'Romantic comedy', 'Drama']",1930,7
29832052,Brigands,1999,['Italy'],['Drama'],1990,9
21552822,Wise Quacks,1939,['United States of America'],"['Animation', 'Short Film', 'Family Film']",1930,9
30653897,Manasariyathe,1984,[],"['Crime Fiction', 'Drama', 'Horror']",1980,4
7670195,Khushi,2003,['India'],"['Action', 'Family Drama', 'Bollywood', 'Romance Film', 'Drama', 'Family Film']",2000,3
3599979,100 Days With Mr. Arrogant,2004,['South Korea'],"['Comedy', 'Romance Film', 'Romantic comedy', 'Drama']",2000,4
11374661,Music in Darkness,1948,['Sweden'],"['Black-and-white', 'Drama']",1940,8
2982688,X-Men Origins: Wolverine,2009,['United States of America'],"['Action', 'Action Thrillers', 'Superhero', 'Action/Adventure', 'Thriller', 'Superhero movie', 'Science Fiction', 'Fantasy']",2000,9
2208485,Ådalen 31,1969,['Sweden'],"['History', 'World cinema', 'Romance Film', 'Melodrama', 'Political drama', 'Drama']",1960,9
17991745,Scattered Dreams,1993,['United States of America'],"['Period piece', 'Television movie', 'Drama']",1990,3
26050726,Loha,1987,['India'],"['Action', 'Crime Fiction', 'Drama']",1980,7
33820539,Yasmin,1955,['India'],"['Musical', 'Bollywood', 'World cinema', 'Drama']",1950,5
12679350,Pehchaan: The Face of Truth,2005,['India'],"['Bollywood', 'Drama']",2000,5
2392280,Syriana,2005,['United States of America'],"['Thriller', 'Docudrama', 'Drama', 'Political thriller']",2000,5
4410999,Lick the Star,1998,['United States of America'],"['Coming of age', 'Short Film', 'Teen', 'Drama']",1990,8
2763214,She's the Man,2006,"['Canada', 'United States of America']","['Romance Film', 'Romantic comedy', 'Comedy']",2000,6
26943847,Reaching for the Moon,1930,['United States of America'],"['Musical', 'Comedy', 'Romance Film', 'Romantic comedy']",1930,0
20837986,Mother,1985,['South Korea'],"['Thriller', 'Drama']",1980,5
21585746,Closed for Winter,2009,"['New Zealand', 'Australia']","['Film adaptation', 'Drama', 'World cinema']",2000,9
346569,The Discreet Charm of the Bourgeoisie,1972,"['France', 'Spain', 'Italy']","['Surrealism', 'Satire', 'Comedy', 'Avant-garde', 'World cinema', 'Black comedy', 'Drama', 'Experimental film', 'Fantasy']",1970,2
18279593,The Cap,1985,['Canada'],"['Short Film', 'Sports', 'Drama', 'Family Film']",1980,5
7567194,Jatt Jeona Morh,1991,['India'],"['Action', 'Crime Fiction', 'Drama']",1990,1
15065852,Pretty Polly,1967,['United Kingdom'],"['Romance Film', 'Comedy', 'Drama']",1960,7
24385521,Sri Sri Sri Maryada Ramanna,1967,['India'],"['History', 'Drama', 'Comedy film']",1960,7
15530723,Krishnarjuna,2008,['India'],"['Romance Film', 'Comedy', 'Drama']",2000,8
17648915,Linha de Passe,2008,['Brazil'],"['World cinema', 'Juvenile Delinquency Film', 'Drama', 'Ensemble Film']",2000,8
24884909,The Desert Within,2008,['Mexico'],"['Political drama', 'Drama', 'World cinema']",2000,8
3887451,Mothra,1961,['Japan'],"['Japanese Movies', 'Monster', 'Horror', 'World cinema', 'Fantasy']",1960,1
6701433,Iyarkai,2003,['India'],['Romance Film'],2000,3
8172107,ArAf,2006,['Turkey'],"['World cinema', 'Thriller', 'Horror']",2000,6
2428193,The Vampire Lovers,1970,"['United Kingdom', 'United States of America']","['Erotica', 'Horror']",1970,0
9974948,Kanashimi no Belladonna,1973,['Japan'],"['Animation', 'Japanese Movies', 'Anime']",1970,3
26950913,Samsaram,1950,['India'],"['Musical', 'Drama']",1950,0
1940449,RoboCop 3,1993,['United States of America'],"['Action', 'Crime Fiction', 'Action/Adventure', 'Thriller', 'Superhero movie', 'Science Fiction']",1990,3
3627002,Home Sweet Home,1973,['Belgium'],"['Drama', 'Comedy']",1970,3
4191487,Imagine Me & You,2005,"['United Kingdom', 'Germany', 'United States of America']","['LGBT', 'Comedy', 'Romance Film', 'Drama', 'Gay Themed', 'Gay', 'Gay Interest', 'Romantic comedy', 'Comedy-drama']",2000,5
3782892,Pack Up Your Troubles,1932,['United States of America'],"['Black-and-white', 'War film', 'Comedy']",1930,2
18629144,Phat Beach,1996,['United States of America'],['Comedy'],1990,6
28319740,Detective,2007,['India'],"['Musical', 'Thriller', 'Bollywood', 'World cinema']",2000,7
18906899,Escape by Night,1953,['United Kingdom'],"['Drama', 'Crime Fiction']",1950,3
633052,Inglourious Basterds,2009,"['France', 'Germany', 'United States of America']","['Action/Adventure', 'Thriller', 'Black comedy', 'War film', 'Drama']",2000,9
26174601,Holiday for Lovers,1959,['United States of America'],['Comedy'],1950,9
22353049,Little Beau Porky,1936,['United States of America'],"['Animation', 'Short Film', 'Family Film']",1930,6
3755302,Man of the West,1958,['United States of America'],"['Action', 'Western', 'Action/Adventure']",1950,8
17595071,Company Man,2000,"['United Kingdom', 'France', 'United States of America']","['Action', 'Screwball comedy', 'Political satire', 'Action/Adventure', 'Comedy', 'Black comedy', 'Political cinema', 'Parody']",2000,0
21022163,Sibling Rivalry,1990,['United States of America'],"['Screwball comedy', 'Comedy', 'Black comedy', 'Comedy of Errors']",1990,0
26256737,Papam Pasivadu,1972,['India'],['Drama'],1970,2
7548058,Best of the Best 2,1993,['United States of America'],"['Action', 'Crime Fiction', 'Action/Adventure', 'Thriller', 'Crime Thriller', 'Martial Arts Film', 'Drama']",1990,3
25202209,Life Begins for Andy Hardy,1941,['United States of America'],"['Coming of age', 'Comedy', 'Workplace Comedy', 'Drama']",1940,1
6501479,Jagadeka Veerudu Athiloka Sundari,1990,['India'],"['Action', 'Comedy', 'Romance Film', 'Drama', 'Fantasy']",1990,0
3521780,The Curve,1998,['United States of America'],"['Psychological thriller', 'Comedy', 'Thriller', 'Erotic thriller', 'Black comedy', 'Crime Thriller']",1990,8
3220999,The Mole People,1956,['United States of America'],"['Black-and-white', 'Horror', 'Sci-Fi Horror', 'Science Fiction', 'Fantasy']",1950,6
6028806,Compromising Positions,1985,['United States of America'],"['Mystery', 'Comedy', 'Comedy Thriller', 'Whodunit', 'Drama']",1980,5
26743188,Hit Man,1972,['United States of America'],"['Drama', 'Crime Fiction']",1970,2
940565,Monsoon Wedding,2001,"['India', 'France', 'Germany', 'Italy', 'United States of America']","['Art film', 'Indie', 'Family Drama', 'Comedy', 'Romantic drama', 'World cinema', 'Romance Film', 'Drama', 'Domestic Comedy', 'Romantic comedy', 'Comedy-drama']",2000,1
19200935,Escapade in Japan,1957,['United States of America'],"['Drama', ""Children's/Family"", 'Childhood Drama']",1950,7
31788915,Freaky Chakra,2003,['India'],"['Romantic drama', 'World cinema', 'Romance Film', 'Drama']",2000,3
15543592,Blacktop,2000,['Canada'],"['Psychological thriller', 'Slasher', 'Thriller', 'Horror', 'Television movie', 'Drama']",2000,0
11639895,Zack and Miri Make a Porno,2008,['United States of America'],"['Drama', 'Indie', 'Comedy', 'Romance Film', 'Romantic comedy', 'Slapstick', 'Sex comedy']",2000,8
7865977,Bridge to Terabithia,2007,"['New Zealand', 'Australia', 'United States of America']","['Film adaptation', 'Family Drama', ""Children's"", 'Adventure', 'Drama', 'Family Film', 'Fantasy']",2000,7
6649737,The Toy that Saved Christmas,1996,['United States of America'],"['Musical', 'Animation', 'Short Film', ""Children's""]",1990,6
16166681,Thulluvadho Ilamai,2001,['India'],['Drama'],2000,1
24064110,Kabhi na Kabhi,1998,['India'],"['Action', 'Romance Film', 'Crime Fiction']",1990,8
142412,Quiz Show,1994,['United States of America'],"['Docudrama', 'Historical fiction', 'Drama']",1990,4
961542,The Incredibly Strange Creatures Who Stopped Living and Became Mixed-Up Zombies,1964,['United States of America'],"['Musical', 'Parody', 'Horror', 'Zombie Film']",1960,4
8657797,Flying Saucer Rock'n'Roll,1998,['United Kingdom'],"['Short Film', 'Black-and-white', 'Comedy']",1990,8
3602324,The French Lieutenant's Woman,1981,['United Kingdom'],"['Period piece', 'Romantic drama', 'Romance Film', 'Drama']",1980,1
3294706,Ah! My Goddess: The Movie,2000,['Japan'],"['Fantasy Adventure', 'Animation', 'Comedy', 'World cinema', 'Drama', 'Japanese Movies', 'Anime', 'Fantasy']",2000,0
5165272,Angel's Dance,1999,"['Germany', 'United States of America']","['Action', 'Gangster Film', 'Action/Adventure', 'Indie', 'Comedy', 'Thriller', 'Black comedy', 'Crime Comedy', 'Romantic comedy', 'Comedy-drama']",1990,9
1721414,Le Notti di Cabiria,1957,"['France', 'Italy']","['Black-and-white', 'Art film', 'World cinema', 'Romance Film', 'Drama']",1950,7
1947226,The Monster Squad,1987,['United States of America'],"['Creature Film', 'Monster movie', ""Children's Fantasy"", 'Parody', 'Horror Comedy', 'Comedy', 'Horror']",1980,7
14690165,The Phantom Planet,1961,['United States of America'],"['Science Fiction', 'Adventure']",1960,1
31165005,Hazard,1948,['United States of America'],['Comedy film'],1940,8
15148870,Our Gang,1922,['United States of America'],"['Black-and-white', 'Indie', 'Short Film', 'Comedy', 'Silent film', 'Family Film']",1920,2
4568016,Jodi No.1,2001,['India'],"['Romantic drama', 'Comedy', 'World cinema', 'Romance Film', 'Romantic comedy', 'Drama']",2000,1
3779715,State of the Union,1948,['United States of America'],"['Black-and-white', 'Short Film', 'Romance Film', 'Political drama', 'Drama']",1940,8
4290149,The Letter,2004,['Thailand'],"['Romance Film', 'Drama']",2000,4
22545977,Queen of Hearts,1936,['United Kingdom'],['Comedy film'],1930,6
33537324,Encounters of the Spooky Kind II,1990,[],['Martial Arts Film'],1990,0
25654231,Annapurna,1960,['India'],['Drama'],1960,0
1803595,The Changeling,1980,['Canada'],"['Suspense', 'Mystery', 'Thriller', 'Horror', 'Supernatural']",1980,0
19972307,The Sovereign's Servant,2007,['Russia'],"['Action', 'History', 'War film', 'Adventure']",2000,7
10638975,Prem Pujari,1970,['India'],['War film'],1970,0
4443534,Mr. Magorium's Wonder Emporium,2007,['United States of America'],"['Comedy', 'Comedy-drama', ""Children's/Family"", ""Children's"", 'Fantasy Comedy', 'Family Film', 'Fantasy']",2000,7
15293938,Bloody Beach,2000,['South Korea'],"['Slasher', 'World cinema', 'Horror']",2000,0
8294092,Eternal Summer,2006,"['China', 'Taiwan']","['LGBT', 'World cinema', 'Chinese Movies', 'Drama']",2000,6
23613543,Jane White Is Sick & Twisted,2002,['United States of America'],"['Indie', 'Comedy', 'Cult']",2000,2
9556492,Danton,1983,"['France', 'Poland', 'West Germany']","['Art film', 'Biographical film', 'World cinema', 'Political drama', 'Drama', 'Courtroom Drama']",1980,3
2573688,Genesis II,1973,['United States of America'],"['Dystopia', 'Television movie', 'Apocalyptic and post-apocalyptic fiction', 'Science Fiction']",1970,3
3754368,My Wife is a Gangster,2001,['South Korea'],"['Action', 'Romance Film', 'Comedy']",2000,1
4106202,Dark Harvest,2004,['United States of America'],"['Slasher', 'Horror']",2000,4
2772250,Idle Hands,1999,['United States of America'],"['Comedy', 'Thriller', 'Horror']",1990,9
23843742,Eddelu Manjunatha,2009,['India'],"['Drama', 'Comedy']",2000,9
2705562,Abbott and Costello Meet the Invisible Man,1951,['United States of America'],"['Detective fiction', 'Black-and-white', 'Comedy', 'Remake', 'Slapstick', 'Parody', 'Detective', 'Horror', 'Family Film']",1950,1
19035463,Vishwavidhaata,1997,['India'],"['Musical', 'Bollywood', 'World cinema', 'Drama']",1990,7
25011263,The Hook,1963,['United States of America'],"['War film', 'Drama']",1960,3
444169,Stella,1955,['Greece'],"['Romantic drama', 'World cinema', 'Romance Film', 'Drama']",1950,5
25206110,A.F.R.I.K.A.,2002,['South Korea'],"['Action/Adventure', 'Drama', 'World cinema']",2000,2
20669314,Plump Fiction,1996,['United States of America'],"['Parody', 'Comedy', 'Cult']",1990,6
11671400,"Just You and Me, Kid",1979,['United States of America'],['Comedy'],1970,9
31460305,Lung Fung Restaurant,1990,[],['Romantic comedy'],1990,0
3577764,Pride and Glory,2008,"['Germany', 'United States of America']","['Crime Fiction', 'Family Drama', 'Thriller', 'Crime Thriller', 'Drama']",2000,8
6414765,Valentino,1977,"['United Kingdom', 'United States of America']","['Drama', 'Biographical film']",1970,7
3377778,Another Day in Paradise,1998,['United States of America'],"['Drama', 'Crime Fiction']",1990,8
9175716,Once,2006,['Ireland'],"['Musical', 'Drama', 'Indie', 'Romantic drama', 'World cinema', 'Romance Film']",2000,6
13581120,The Amazing Panda Adventure,1995,['United States of America'],"[""Children's"", 'Animal Picture', 'Family-Oriented Adventure', ""Children's/Family"", 'Adventure', 'Drama', 'Family Film']",1990,5
23423291,Cheaper to Marry,1925,['United States of America'],"['Silent film', 'Black-and-white', 'Drama']",1920,5
168491,"Reuben, Reuben",1983,['United States of America'],"['Romantic comedy', 'Comedy-drama', 'Comedy']",1980,3
13972163,Sunflower,2005,"['China', 'Hong Kong']","['Drama', 'Chinese Movies', 'World cinema']",2000,5
1588102,An Ideal Husband,1999,"['United Kingdom', 'United States of America']","['Film adaptation', 'Romantic drama', 'Comedy', 'Romance Film', 'Costume drama', 'Drama', 'Period piece', 'Romantic comedy']",1990,9
26727790,Sisters of Death,1977,['United States of America'],"['Mystery', 'Slasher', 'Thriller', 'Horror']",1970,7
1720492,The Squid and the Whale,2005,['United States of America'],"['Coming of age', 'Family Drama', 'Comedy', 'Drama']",2000,5
22876558,Blindfolded Eyes,1978,"['France', 'Spain']",['Drama'],1970,8
7394356,Mankillers,1987,['United States of America'],"['Action', 'Crime Fiction']",1980,7
3188624,The Empty Mirror,1996,['United States of America'],"['Psychological thriller', 'Indie', 'Political drama', 'Drama']",1990,6
9490193,Häpy Endkö? Eli kuinka Uuno Turhapuro sai niin kauniin ja rikkaan vaimon,1977,['Finland'],['Comedy'],1970,7
6117410,Hello Brother,1994,['India'],"['Action', 'Comedy', 'Tollywood', 'Drama']",1990,4
6043036,The Adventures of the American Rabbit,1986,['United States of America'],"['Animation', 'Indie', 'Superhero movie', 'Family Film', 'Fantasy']",1980,6
7518441,Taking the Blame,1935,['United States of America'],['Comedy'],1930,5
10988542,Sentimental Swordsman,1977,['Hong Kong'],"['Wuxia', 'Chinese Movies', 'Martial Arts Film']",1970,7
11593789,Flight to Mars,1951,['United States of America'],"['Science Fiction', 'Adventure', 'Thriller']",1950,1
6474370,Eat a Bowl of Tea,1989,['United States of America'],"['Film adaptation', 'Indie', 'Comedy', 'Romance Film', 'Drama', 'Romantic comedy', 'Comedy-drama', 'Comedy of manners']",1980,9
2219138,The Playhouse,1921,['United States of America'],"['Black-and-white', 'Indie', 'Short Film', 'Comedy', 'Silent film', 'Fantasy Comedy']",1920,1
4306647,The Road to Guantanamo,2006,['United Kingdom'],"['Drama', 'Indie', 'Documentary', 'Political drama', 'Docudrama', 'War film']",2000,6
17942252,The Librarian: Curse of the Judas Chalice,2008,['United States of America'],"['Action', 'Fantasy Adventure', 'Action/Adventure', 'Television movie', 'Adventure', 'Fantasy']",2000,8
25974376,The Rosebud Beach Hotel,1984,['United States of America'],"['Comedy', 'Sex comedy']",1980,4
2571423,Tyler Perry's Madea's Family Reunion,2006,['United States of America'],"['Family Drama', 'Comedy', 'Romance Film', 'Melodrama', 'Comedy-drama', 'Drama']",2000,6
32895934,On Our Selection,1920,[],['Silent film'],1920,0
30352981,Flight,2009,['South Korea'],"['Action', 'Melodrama', 'Drama']",2000,9
12814569,Two Seconds,1932,['United States of America'],"['Crime Drama', 'Crime Fiction', 'Drama']",1930,2
652539,Rush Hour 2,2001,"['Hong Kong', 'United States of America']","['Action', 'Crime Fiction', 'Action/Adventure', 'Buddy film', 'Thriller', 'Comedy', 'Chinese Movies', 'Martial Arts Film', 'Action Comedy']",2000,1
6954616,Prema Tarangalu,1980,['India'],"['Action', 'Drama', 'Family Film']",1980,0
840506,Sebastian,1995,['Sweden'],"['LGBT', 'Drama', 'World cinema']",1990,5
20238864,Aunt Fanny's Tour of Booty,2005,['United States of America'],"['Animation', 'Short Film', 'Comedy']",2000,5
21812059,A Night At The Adonis,1983,['United States of America'],"['Gay pornography', 'Pornographic movie']",1980,3
8775505,The Cat and the Canary,1939,['United States of America'],"['Black-and-white', 'Mystery', 'Comedy', 'Horror']",1930,9
3926453,Franklin's Magic Christmas,2001,['Canada'],"['Animation', ""Children's"", 'Family Film']",2000,1
13439704,American Venus,2007,['Canada'],"['Family Drama', 'Indie', 'Sports', 'Drama']",2000,7
22442724,The Visitors,1972,['United States of America'],"['Drama', 'Crime Fiction', 'Thriller']",1970,2
31332647,Nazrana,1961,[],"['Romance Film', 'Drama', 'Comedy film']",1960,1
4211699,The Light at the Edge of the World,1971,"['Spain', 'United States of America']","['Action', 'Adventure']",1970,1
12952368,The Ghoul,1975,['United Kingdom'],['Horror'],1970,5
21911033,Frauds,1993,"['New Zealand', 'Australia']","['Comedy Thriller', 'Thriller', 'Comedy film', 'World cinema', 'Black comedy', 'Crime Thriller']",1990,3
12744854,Meet Nero Wolfe,1936,['United States of America'],"['Detective fiction', 'Crime Fiction', 'Mystery', 'Detective']",1930,6
32679329,Mahathma,1996,['India'],['Action'],1990,6
12989103,Crainquebille,1922,"['France', 'Belgium']","['Black-and-white', 'Indie', 'World cinema', 'Silent film', 'Drama']",1920,2
2301374,Champagne for Caesar,1950,['United States of America'],"['Parody', 'Satire', 'Comedy']",1950,0
15332933,Ghostboat,2006,['United Kingdom'],"['Supernatural', 'Thriller']",2000,6
5558615,Jindabyne,2006,"['New Zealand', 'Australia']","['Film adaptation', 'Crime Fiction', 'Mystery', 'Thriller', 'World cinema', 'Crime Thriller', 'Drama', 'Melodrama']",2000,6
7454401,Alraune,1928,['Germany'],"['Black-and-white', 'Indie', 'Horror', 'Silent film', 'Science Fiction']",1920,8
17705805,In Pursuit of Honor,1995,['United States of America'],"['Period piece', 'Western', 'Action/Adventure', 'Cavalry Film', 'Historical fiction', 'Television movie', 'Drama']",1990,5
3680813,101 Reykjavík,2000,"['Denmark', 'Iceland', 'Norway', 'France']","['LGBT', 'Comedy', 'World cinema', 'Romantic comedy']",2000,0
22729553,The Blind Side,2009,['United States of America'],"['Sports', 'Film adaptation', 'Inspirational Drama', 'Biography', 'Family Drama', 'Docudrama', 'Drama']",2000,9
22539578,Cross Connection,2009,['India'],"['Drama', 'Comedy']",2000,9
1228330,Tacones lejanos,1991,"['France', 'Spain']","['Drama', 'Erotica']",1990,1
7040349,In The Navy,1941,['United States of America'],"['Black-and-white', 'Slapstick', 'Comedy']",1940,1
23570643,There Ain't No Justice,1939,['United Kingdom'],['Drama'],1930,9
10736919,Death Note,2006,['Japan'],"['Crime Fiction', 'Mystery', 'Thriller', 'World cinema', 'Crime Thriller', 'Adventure', 'Drama', 'Japanese Movies', 'Crime Drama', 'Supernatural', 'Fantasy']",2000,6
12807520,The Stone Killer,1973,['United States of America'],"['Action', 'Crime Fiction']",1970,3
2177984,Tin Men,1987,['United States of America'],"['Period piece', 'Comedy-drama', 'Comedy']",1980,7
6058130,The Fan,1981,['United States of America'],"['Suspense', 'Crime Fiction', 'Mystery', 'Thriller', 'Horror', 'Drama']",1980,1
10349441,Dance with Me,1998,['United States of America'],"['Romantic drama', 'Comedy', 'Romance Film', 'Drama']",1990,8
3600424,A Passage to India,1984,"['United Kingdom', 'United States of America']","['British Empire Film', 'Period piece', 'Courtroom Drama', 'Film adaptation', 'Crime Fiction', 'Political drama', 'Drama']",1980,4
11777954,Breaking and Entering,2006,"['United Kingdom', 'United States of America']","['Romantic drama', 'Thriller', 'Romance Film', 'Parkour in popular culture', 'Drama']",2000,6
14958744,El bolero de Raquel,1957,['Mexico'],"['Slapstick', 'Comedy', 'World cinema', 'Comedy of Errors']",1950,7
3624149,My Name is Julia Ross,1945,['United States of America'],"['Psychological thriller', 'Black-and-white', 'Thriller', 'Film noir', 'Drama']",1940,5
18683533,The Perfect Age of Rock 'n' Roll,2009,['United States of America'],"['Music', 'Musical Drama', 'Road movie', 'Drama']",2000,9
27789583,Jaguar Lives!,1979,"['Spain', 'United States of America']","['Action', 'Crime Fiction', 'Parody', 'Action/Adventure', 'Sports', 'Martial Arts Film']",1970,9
12253172,A Day with My Son,2007,['South Korea'],['Drama'],2000,7
11467890,Sabata,1969,['Italy'],"['Action', 'Action/Adventure', 'Western', 'World cinema', 'Spaghetti Western']",1960,9
8928586,Superman: Doomsday,2007,['United States of America'],"['Animation', 'Superhero', 'Action/Adventure', 'Adventure', 'Superhero movie']",2000,7
24549940,Aparichithan,2004,['India'],"['Mystery', 'Thriller', 'Horror', 'Adventure']",2000,4
32331157,Los Amantes del Señor de la Noche,1986,['Mexico'],['Horror'],1980,6
29952131,Kohra,1964,[],"['Musical', 'Mystery', 'Thriller', 'Drama']",1960,4
5248155,Hands Across the Table,1935,['United States of America'],"['Screwball comedy', 'Comedy film', 'Romance Film', 'Romantic comedy']",1930,5
1483207,The Train,1964,"['France', 'Italy', 'United States of America']","['Action', 'War film', 'Thriller']",1960,4
2238387,Rhinestone,1984,['United States of America'],['Comedy'],1980,4
31351,The Straight Story,1999,"['United Kingdom', 'France', 'United States of America']","['Biography', 'Existentialism', 'Road movie', 'Americana', 'Adventure', 'Drama']",1990,9
18250933,"Time, Forward!",1965,['Soviet Union'],"['Black-and-white', 'Drama']",1960,5
4053827,The Strange World of Planet X,1957,['United Kingdom'],"['Monster', 'Science Fiction', 'Horror']",1950,7
23719971,Shadow Fury,2001,['Japan'],"['Action', 'Japanese Movies', 'Action/Adventure', 'Thriller', 'Martial Arts Film']",2000,1
3654399,Le notti bianche,1957,"['France', 'Italy']","['Black-and-white', 'Art film', 'Romantic drama', 'World cinema', 'Romance Film', 'Melodrama', 'Drama']",1950,7
15447596,Would Be Kings,2008,[],"['Crime Fiction', 'Crime Drama', 'Television movie', 'Drama']",2000,8
21133178,Yogi,2009,['India'],['Drama'],2000,9
2210733,Bhumika: The Role,1977,['India'],"['Musical', 'Art film', 'Bollywood', 'World cinema', 'Drama']",1970,7
156625,Viva Zapata!,1952,['United States of America'],"['Black-and-white', 'Biographical film', 'Biopic [feature]', 'War film', 'Drama']",1950,2
16674680,(Wes Craven Presents) Carnival of Souls,1998,['United States of America'],"['Psychological thriller', 'Slasher', 'Thriller', 'Horror', 'Supernatural']",1990,8
30456367,A Season of Good Rain,2009,[],"['Romance Film', 'Drama']",2000,9
5170742,Satyakam,1969,['India'],"['Drama', 'Family Film']",1960,9
4244198,Balto II: Wolf Quest,2002,['United States of America'],"['Animation', 'Family-Oriented Adventure', ""Children's/Family"", 'Adventure', 'Family Film']",2000,2
101907,A Touch of Class,1973,['United Kingdom'],"['Romance Film', 'Romantic comedy', 'Comedy']",1970,3
21696582,Zone of the Dead,2009,"['Serbia', 'Spain', 'Italy']","['Zombie Film', 'Indie', 'Horror']",2000,9
15107268,Silver Stallion,1991,['South Korea'],"['Western', 'Adventure', 'Drama']",1990,1
4338749,I Spy,2002,['United States of America'],"['Action', 'Spy', 'Action/Adventure', 'Comedy', 'Thriller', 'Adventure']",2000,2
1011439,Screamers,1996,"['United States of America', 'Canada', 'Japan']","['Action', 'Japanese Movies', 'Action/Adventure', 'Thriller', 'Horror', 'Adventure', 'Science Fiction']",1990,6
1854000,The Bourne Ultimatum,2007,"['Germany', 'United States of America']","['Action', 'Spy', 'Film adaptation', 'Crime Fiction', 'Action Thrillers', 'Mystery', 'Action/Adventure', 'Thriller', 'Martial Arts Film', 'Drama']",2000,7
27171772,Sri Krishnarjuna Yudham,1962,['India'],"['Drama', 'World cinema']",1960,2
5499151,Crazy in Alabama,1999,['United States of America'],"['Crime Fiction', 'Comedy', 'Social problem film', 'Drama', 'Courtroom Drama', 'Period piece', 'Coming of age', 'Comedy-drama']",1990,9
5281750,Tumbleweeds,1925,['United States of America'],"['Black-and-white', 'Drama', 'Indie', 'Action/Adventure', 'Western', 'Silent film']",1920,5
21374558,Alas de Mariposa,1991,['Spain'],"['Melodrama', 'Family Drama', 'Drama']",1990,1
6422613,Chained for Life,1951,['United States of America'],"['Melodrama', 'Drama']",1950,1
25517880,Maneater,2009,[],['Horror'],2000,9
23750517,Gandhada Gudi,1973,['India'],['Action'],1970,3
369682,Lost in Translation,2003,"['Japan', 'United States of America']","['Indie', 'Romantic drama', 'Comedy', 'Romance Film', 'Drama', 'Japanese Movies', 'Romantic comedy', 'Comedy-drama', 'Comedy of manners']",2000,3
34224279,Mr. Right,2009,['United Kingdom'],"['LGBT', 'Indie', 'Comedy', 'Romance Film']",2000,9
1892349,Atomic Train,1999,['United States of America'],"['Action', 'Action/Adventure', 'Thriller', 'Television movie', 'Disaster']",1990,9
24615866,Thiramala,1953,['India'],['Romance Film'],1950,3
19186546,London Derriere,1966,[],"['Short Film', 'Animation']",1960,6
15662770,Puli Varudhu,2007,['India'],"['Action', 'Drama']",2000,7
4305023,Global Heresy,2002,['United States of America'],['Comedy'],2000,2
11137864,Vanishing Point,1997,['United States of America'],"['Action', 'Action/Adventure', 'Thriller', 'Remake', 'Romance Film', 'Road movie', 'Adventure']",1990,7
1611072,A Scanner Darkly,2006,['United States of America'],"['Film adaptation', 'Animation', 'Dystopia', 'Future noir', 'Thriller', 'Science Fiction', 'Drama']",2000,6
14281865,Room for One More,1952,['United States of America'],"['Black-and-white', 'Comedy-drama']",1950,2
18531768,Vicious Circle,2009,['United States of America'],['Drama'],2000,9
29070003,Eternal Love,1929,['United States of America'],"['Film adaptation', 'Silent film', 'Romance Film', 'Drama']",1920,9
22113638,Maging sino ka man,1991,['Philippines'],"['Filipino Movies', 'Drama', 'World cinema']",1990,1
25899808,Dhruvam,1993,['India'],"['Action', 'Thriller', 'Drama']",1990,3
26570761,Solos en la madrugada,1978,['Spain'],['Drama'],1970,8
6717319,Evil Roy Slade,1972,['United States of America'],"['Comedy Western', 'Parody', 'Action/Adventure', 'Western', 'Comedy', 'Romance Film', 'Television movie']",1970,2
28697022,The Three Weird Sisters,1948,['United Kingdom'],"['Drama', 'Crime Fiction']",1940,8
21888630,Baana Kaathadi,2009,['India'],['Romance Film'],2000,9
1779335,Biker Boyz,2003,['United States of America'],"['Action', 'Crime Fiction', 'Coming of age', 'Chase Movie', 'Family Drama', 'Drama']",2000,3
27691376,The Smell of Success,2009,['United States of America'],"['Period piece', 'Comedy']",2000,9
12336545,Nujum Pak Belalang,1959,"['Singapore', 'Malaysia']","['Musical', 'Comedy']",1950,9
4432750,Cyrano de Bergerac,1950,['France'],"['Film adaptation', 'Black-and-white', 'Romantic drama', 'Romance Film', 'Costume drama', 'Drama', 'Swashbuckler films', 'Period piece', 'Epic']",1950,0
971217,Twisted,2004,"['Germany', 'United States of America']","['Psychological thriller', 'Crime Fiction', 'Mystery', 'Thriller', 'Crime Thriller']",2000,4
4276475,The Dark Knight,2008,"['United Kingdom', 'United States of America']","['Action', 'Crime Fiction', 'Superhero', 'Action/Adventure', 'Thriller', 'Drama', 'Superhero movie', 'Crime Drama']",2000,8
2951841,Thunderheart,1992,['United States of America'],"['Detective fiction', 'Crime Fiction', 'Mystery', 'Western', 'Thriller', 'Detective', 'Crime Thriller']",1990,2
2043130,Moving Malcolm,2003,['Canada'],"['Drama', 'Indie', 'Comedy', 'Romance Film', 'Romantic comedy', 'Comedy-drama', 'Slice of life story']",2000,3
19299838,Cape No. 7,2007,"['China', 'Taiwan']","['Romantic drama', 'Comedy', 'World cinema', 'Musical comedy', 'Romance Film', 'Chinese Movies', 'Drama', 'Romantic comedy']",2000,7
25320302,Welcome,2009,['France'],"['Romantic drama', 'World cinema', 'Romance Film', 'Drama']",2000,9
9490126,Scissors,1991,['United States of America'],"['Psychological thriller', 'Suspense', 'Mystery', 'Thriller']",1990,1
3361542,The Hiding Place,1975,['United States of America'],"['Drama', 'Indie', 'Christian film', 'War film']",1970,5
23543821,The Last White Dishwasher,2008,['United States of America'],"['Mockumentary', 'Short Film', 'Comedy']",2000,8
4007440,Beach Blanket Bingo,1965,['United States of America'],"['Musical', 'Comedy', 'Teen', 'Musical comedy', 'Beach Film']",1960,5
4682853,Muthal Mariyathai,1985,['India'],[],1980,5
1501259,The Muppets' Wizard of Oz,2005,['United States of America'],"['Music', 'Musical', 'Comedy', ""Children's/Family"", 'Adventure', ""Children's Fantasy"", 'Television movie', 'Family Film', 'Fantasy']",2000,5
16349395,Dog Altogether,2007,[],['Short Film'],2000,7
3120202,The BFG,1989,['United Kingdom'],[],1980,9
1102360,Enduring Love,2004,['United Kingdom'],"['Psychological thriller', 'Film adaptation', 'Drama', 'Mystery', 'Indie', 'Thriller', 'Romance Film']",2000,4
12588031,InAlienable,2008,['United States of America'],"['Science Fiction', 'Thriller', 'Horror']",2000,8
860103,In the Time of the Butterflies,2001,"['Mexico', 'United States of America']","['Crime Fiction', 'Romantic drama', 'Romance Film', 'Political drama', 'Drama']",2000,1
17048091,Boat People,1982,['Hong Kong'],"['Chinese Movies', 'Docudrama', 'Political drama', 'Drama']",1980,2
25983329,Uncle Silas,1947,['United Kingdom'],"['Crime Fiction', 'Mystery', 'Horror', 'Melodrama', 'Crime Thriller', 'Drama']",1940,7
1795394,The Solid Gold Cadillac,1956,['United States of America'],"['Black-and-white', 'Screwball comedy', 'Satire', 'Comedy', 'Romance Film', 'Romantic comedy']",1950,6
3606815,The Star Packer,1934,['United States of America'],"['Action', 'Black-and-white', 'Western', 'Action/Adventure']",1930,4
277667,Scary Movie,2000,['United States of America'],"['Gross out', 'Gross-out film', 'Parody', 'Slasher', 'Comedy', 'Teen']",2000,0
844337,Spanking Love,1995,['Japan'],"['Softcore Porn', 'Japanese Movies', 'Erotic Drama', 'Adult', 'Drama']",1990,5
22945742,Honky Tonk,1929,['United States of America'],['Musical'],1920,9
2817162,White Christmas,1954,['United States of America'],"['Musical', 'Musical comedy', 'Romantic comedy', 'Holiday Film', 'Christmas movie']",1950,4
1724708,After the Rehearsal,1984,['Sweden'],['Drama'],1980,4
14739673,Pest Man Wins,1951,['United States of America'],"['Short Film', 'Black-and-white', 'Comedy']",1950,1
8022646,The Girl from Monday,2005,['United States of America'],"['Political cinema', 'Drama', 'Parody', 'Indie', 'Comedy', 'Science Fiction']",2000,5
5369620,Dharkan,1972,['India'],"['Musical', 'Bollywood', 'World cinema', 'Drama']",1970,2
9187162,My Best Enemy,2005,"['Chile', 'Spain', 'Argentina']","['Comedy', 'Drama', 'World cinema']",2000,5
780889,Green Fire,1954,['United States of America'],"['Adventure', 'Drama']",1950,4
20546140,The Marine 2,2009,['United States of America'],"['Action', 'Action Thrillers', 'Action/Adventure', 'Thriller']",2000,9
10931554,Angry Guest,1972,"['Hong Kong', 'South Korea']","['Chinese Movies', 'Martial Arts Film']",1970,2
25194677,First Lady,1937,['United States of America'],"['Satire', 'Political satire', 'Comedy']",1930,7
76301,Ride the High Country,1962,['United States of America'],"['Action', 'Revisionist Western', 'Action/Adventure', 'Western']",1960,2
8982671,Who's Got the Action?,1962,['United States of America'],['Comedy'],1960,2
14640620,Shivering Sherlocks,1948,['United States of America'],"['Short Film', 'Black-and-white', 'Comedy']",1940,8
14560791,The Fast Sword,1971,['Hong Kong'],"['Action', 'Action/Adventure', 'World cinema', 'Chinese Movies', 'Martial Arts Film']",1970,1
21133929,Here and There,2009,"['Serbia', 'Germany', 'United States of America']","['Drama', 'Indie', 'Comedy film', 'World cinema']",2000,9
26551706,Blues Busters,1950,['United States of America'],"['Comedy', 'Musical comedy']",1950,0
26523796,Piano Girl,2009,['Turkey'],['Drama'],2000,9
5736805,Diary of June,2005,['South Korea'],"['Crime Fiction', 'Mystery', 'Horror', 'Drama']",2000,5
201553,Romy and Michele's High School Reunion,1997,['United States of America'],"['Screwball comedy', 'Buddy film', 'Comedy']",1990,7
8120239,Heyy Babyy,2007,['India'],"['Musical', 'Romantic drama', 'Comedy', 'Bollywood', 'World cinema', 'Romance Film', 'Drama', 'Romantic comedy', 'Comedy-drama']",2000,7
6006929,Cop,1988,['United States of America'],"['Psychological thriller', 'Mystery', 'Thriller', 'Crime Thriller', 'Drama']",1980,8
22073629,Firaaq,2009,['India'],"['Art film', 'Drama', 'World cinema']",2000,9
18545627,Tweety's Circus,1955,['United States of America'],"['Short Film', 'Animation']",1950,5
10616523,Des Pardes,1978,['India'],"['Thriller', 'World cinema']",1970,8
24002929,High Noon,2009,"['Germany', 'United States of America', 'Canada']","['Film adaptation', 'Romantic drama', 'Romance Film', 'Television movie', 'Drama']",2000,9
30431126,Antique,2008,['South Korea'],"['Comedy', 'World cinema']",2000,8
3476773,Universal Soldier,1971,['United Kingdom'],"['Action', 'Drama', 'War film']",1970,1
156694,Urusei Yatsura,1981,[],[],1980,1
2223709,The Turning Point,1977,['United States of America'],"['Romantic drama', 'New Hollywood', 'Dance', 'Romance Film', 'Drama']",1970,7
23429308,Winged Victory,1944,['United States of America'],"['Patriotic film', 'War film', 'Propaganda film', 'Drama']",1940,4
12554600,The Best Way to Walk,1976,['France'],"['Comedy', 'Drama', 'World cinema']",1970,6
15113148,Doctor in Clover,1966,['United Kingdom'],['Comedy'],1960,6
4951286,Fail-Safe,2000,['United States of America'],"['Psychological thriller', 'Film adaptation', 'Black-and-white', 'Thriller', 'Drama', 'Suspense', 'Television movie', 'Political drama', 'Science Fiction']",2000,0
3894895,Gorilla My Dreams,1948,['United States of America'],"['Short Film', 'Comedy']",1940,8
2034659,The Man with My Face,1951,['United States of America'],"['Psychological thriller', 'Crime Fiction', 'Mystery', 'Thriller', 'Film noir', 'Crime Thriller']",1950,1
9539254,Qeysar,1969,['Iran'],['Drama'],1960,9
5191715,Khel Khel Mein,1975,['India'],"['Romance Film', 'Comedy', 'Drama']",1970,5
181601,The Edge,1997,['United States of America'],"['Action', 'Drama', 'Thriller', 'Adventure']",1990,7
12902178,Devil's Diary,2007,['Canada'],"['Television movie', 'Teen', 'Horror']",2000,7
28997526,The Return of the Rat,1929,['United Kingdom'],['Silent film'],1920,9
62117,Mr. Smith Goes to Washington,1939,['United States of America'],"['Black-and-white', 'Comedy-drama', 'Americana', 'Political drama', 'Drama']",1930,9
6193020,Mermaid Chronicles Part 1: She Creature,2001,['United States of America'],"['Creature Film', 'Monster movie', 'Horror', 'B-movie', 'Science Fiction']",2000,1
4685563,Pierrepoint,2005,['United Kingdom'],"['Biography', 'Biographical film', 'Biopic [feature]', 'Political drama', 'Drama']",2000,5
5034138,Feet First,1930,['United States of America'],"['Romance Film', 'Black-and-white', 'Comedy']",1930,0
19687396,Clown Princes,1939,['United States of America'],"['Black-and-white', 'Short Film', 'Comedy', 'Family Film']",1930,9
13650555,Umer Marvi,1956,['Pakistan'],['Romance Film'],1950,6
7826014,Wildflowers,2000,['United States of America'],"['Coming of age', 'Erotic Drama', 'Drama']",2000,0
15198225,Hollywood Daffy,1946,['United States of America'],"['Animation', 'Short Film', 'Comedy', 'Family Film']",1940,6
2950304,Flags of Our Fathers,2006,['United States of America'],"['Action', 'Film adaptation', 'Drama', 'History', 'War film']",2000,6
16846172,Blondie Goes to College,1942,['United States of America'],"['Black-and-white', 'Comedy', 'Domestic Comedy', 'Comedy of Errors']",1940,2
6714601,Deadly Intentions,1985,['United States of America'],"['Psychological thriller', 'Drama', 'Thriller']",1980,5
9585054,Appointment with Venus,1951,['United Kingdom'],"['War film', 'Comedy', 'Drama']",1950,1
3028396,Erotic Ghost Story,1987,['Hong Kong'],"['Softcore Porn', 'Fantasy Comedy', 'Erotica', 'Chinese Movies', 'Fantasy', 'Adult', 'Sex comedy']",1980,7
1503907,The Way of the Gun,2000,['United States of America'],"['Action', 'Crime Fiction', 'Action/Adventure', 'Thriller', 'Crime Thriller', 'Drama', 'Cult']",2000,0
5501853,The Carey Treatment,1972,['United States of America'],"['Detective fiction', 'Crime Fiction', 'Mystery', 'Detective', 'Crime Thriller']",1970,2
34420878,Inaindha Kaigal,1990,['India'],"['Action', 'Romance Film']",1990,0
15767303,Pachamarathanalil,2008,['India'],['Drama'],2000,8
509987,Heaven,2002,"['United Kingdom', 'France', 'Germany', 'Italy', 'United States of America']","['Action', 'Crime Fiction', 'Indie', 'Romantic drama', 'Thriller', 'World cinema', 'Romance Film', 'Crime Thriller', 'Drama']",2000,2
7299297,Gauravam,1973,['India'],[],1970,3
9383737,On Dress Parade,1939,['United States of America'],['Black-and-white'],1930,9
3635024,In Harihar Nagar,1990,['India'],"['Action', 'Drama', 'Comedy', 'Malayalam Cinema']",1990,0
156628,The Bad and the Beautiful,1952,['United States of America'],"['Film à clef', 'Black-and-white', 'Comedy', 'Romance Film', 'Drama']",1950,2
12565687,Watchers Reborn,1998,['United States of America'],"['Action', 'Crime Fiction', 'Horror', 'Science Fiction']",1990,8
15088404,Kingdom of Crooked Mirrors,1963,"['Russia', 'Soviet Union']","['Fantasy', 'Family Film', 'World cinema']",1960,3
5388746,Nightmare,2000,['South Korea'],"['Slasher', 'World cinema', 'Horror']",2000,0
2854839,Onibaba,1964,['Japan'],"['Crime Fiction', 'Art film', 'World cinema', 'Costume Horror', 'Drama', 'Japanese Movies', 'Horror', 'Supernatural']",1960,4
17289439,The Pirates of Penzance,1983,"['United Kingdom', 'United States of America']","['Musical', 'Romance Film', 'Comedy']",1980,3
2723037,Nightmare,1964,['United Kingdom'],"['Psychological thriller', 'Mystery', 'Thriller', 'Horror']",1960,4
26803725,Bhai,1997,['India'],['Action'],1990,7
8962212,Tholi Valapu,2001,['India'],['Drama'],2000,1
2207640,The Astronaut's Wife,1999,['United States of America'],"['Psychological thriller', 'Indie', 'Thriller', 'Horror', 'Sci-Fi Horror', 'Science Fiction']",1990,9
4338909,Countdown,1968,['United States of America'],"['Science Fiction', 'Adventure', 'Thriller']",1960,8
9128822,Chura Liyaa Hai Tumne,2003,['India'],"['Action', 'Mystery', 'Romantic drama', 'Action/Adventure', 'Thriller', 'World cinema', 'Romance Film', 'Drama']",2000,3
18673551,Taking Woodstock,2009,['United States of America'],"['Music', 'Indie', 'Comedy', 'Drama', 'Slice of life story', 'Period piece', 'Biopic [feature]', 'Comedy-drama']",2000,9
4403560,Clockers,1995,['United States of America'],"['Film adaptation', 'Crime Fiction', 'Coming of age', 'Thriller', 'Crime Drama', 'Crime Thriller', 'Drama']",1990,5
378439,Arrowsmith,1931,['United States of America'],"['Black-and-white', 'Melodrama', 'Drama', 'Medical fiction']",1930,1
68084,Adam's Rib,1949,['United States of America'],"['Romance Film', 'Romantic comedy', 'Comedy']",1940,9
10125507,Wichita,1955,['United States of America'],"['Action', 'Romance Film', 'Western']",1950,5
6300597,The Verdict,1946,['United States of America'],"['Film noir', 'Drama']",1940,6
1314961,"The 5,000 Fingers of Dr. T",1953,['United States of America'],"['Musical', ""Children's Fantasy"", 'Comedy', ""Children's/Family"", 'Drama', 'Family Film', 'Fantasy']",1950,3
6816104,Parinda,1989,['India'],"['Musical', 'Family Drama', 'Romantic drama', 'Musical Drama', 'Thriller', 'Bollywood', 'World cinema', 'Drama', 'Crime Drama']",1980,9
11142347,Unarchigal,1976,['India'],['Drama'],1970,6
32359190,Waltz of the Toreadors,1962,['United Kingdom'],['Comedy'],1960,2
19325619,Midnight Movie,2008,['United States of America'],"['Slasher', 'Thriller', 'Horror']",2000,8
1640736,Saw II,2005,"['Canada', 'United States of America']","['Psychological thriller', 'Mystery', 'Slasher', 'Thriller', 'Horror']",2000,5
26628860,Cancel My Reservation,1972,['United States of America'],"['Crime Fiction', 'Mystery', 'Comedy']",1970,2
2251890,Maine Pyaar Kyun Kiya?,2005,['India'],"['Musical', 'Romantic drama', 'Comedy', 'Bollywood', 'World cinema', 'Romance Film', 'Drama']",2000,5
1367501,Married to the Mob,1988,['United States of America'],"['Crime Fiction', 'Gangster Film', 'Satire', 'Comedy', 'Romantic comedy', 'Romance Film']",1980,8
29386520,The Terror,1928,['United States of America'],"['Mystery', 'Horror']",1920,8
12624367,Sweet Liberty,1986,['United States of America'],"['Romance Film', 'Romantic comedy', 'Comedy']",1980,6
24168980,Vampire Girl vs. Frankenstein Girl,2009,['Japan'],"['Action', 'Japanese Movies', 'Thriller', 'World cinema', 'Horror', 'Science Fiction']",2000,9
10858701,Cronaca di un amore,1950,['Italy'],"['Black-and-white', 'Crime Fiction', 'World cinema', 'Crime Drama', 'Romance Film', 'Drama']",1950,0
2487170,Troops,1997,['United States of America'],"['Fan film', 'Indie', 'Short Film']",1990,7
27150879,Aayiram Naavulla Ananthan,1996,['India'],['Drama'],1990,6
26084701,Infestation,2009,['United States of America'],"['Comedy', 'Horror']",2000,9
26282276,Prem Nazirine Kanmanilla,1983,['India'],['Drama'],1980,3
8973880,A Gunfight,1971,['United States of America'],['Western'],1970,1
3257956,Faithful,1996,['United States of America'],"['Crime Fiction', 'Comedy', 'Black comedy', 'Drama']",1990,6
11569227,Satan's Cheerleaders,2002,['United States of America'],"['Horror Comedy', 'Teen', 'Horror', 'Comedy', 'B-movie', 'Supernatural']",2000,2
2451146,Midnight,1939,['United States of America'],"['Black-and-white', 'Screwball comedy', 'Comedy', 'Romance Film', 'Romantic comedy']",1930,9
3762624,Navajo Joe,1966,"['Spain', 'Italy']","['Action', 'Action/Adventure', 'Western', 'Spaghetti Western']",1960,6
8984132,Perfect Game,2000,['United States of America'],"['Comedy', 'Comedy-drama', ""Children's/Family"", 'Sports', 'Family Film']",2000,0
2768141,Free Jimmy,2006,"['Norway', 'United Kingdom']","['Animation', 'Stoner film', 'Satire', 'Comedy', 'World cinema', 'Black comedy', 'Computer Animation', 'Anime']",2000,6
1306645,Edward II,1991,['United Kingdom'],"['LGBT', 'Crime Fiction', 'Indie', 'Romantic drama', 'Drama', 'Romance Film', 'Costume drama']",1990,1
5080406,Down in the Valley,2005,['United States of America'],"['Psychological thriller', 'Drama', 'Family Drama', 'Romantic drama', 'Indie', 'Romance Film']",2000,5
24631099,Micro Men,2009,['United Kingdom'],['Docudrama'],2000,9
19999286,Casino Raiders,1989,['Hong Kong'],"['Crime Fiction', 'Crime Thriller', 'Chinese Movies']",1980,9
3143908,Main Prem Ki Diwani Hoon,2003,['India'],"['Musical', 'Romantic drama', 'Bollywood', 'World cinema', 'Romance Film', 'Drama']",2000,3
3504167,Winners and Sinners,1983,['Hong Kong'],"['Action/Adventure', 'Comedy', 'Crime Comedy', 'World cinema', 'Chinese Movies', 'Martial Arts Film']",1980,3
5997937,Ghayal,1990,['India'],"['Musical', 'Bollywood', 'World cinema']",1990,0
3244159,Indra,2002,['India'],"['Drama', 'World cinema']",2000,2
1014419,Jönssonligan spelar högt,2000,['Sweden'],"['Comedy', 'Crime Fiction']",2000,0
23836989,Kismat,2004,['India'],"['Romantic drama', 'Action/Adventure', 'World cinema', 'Romance Film', 'Drama']",2000,4
24158862,Dudes,1987,['United States of America'],"['Indie', 'Comedy film']",1980,7
9678161,Maanbumigu Maanavan,1996,['India'],['Action'],1990,6
3693840,The Great Rupert,1950,['United States of America'],"['Animal Picture', 'Comedy', 'Family Film']",1950,0
12360068,Babes in Toyland,1999,['United States of America'],"['Musical', 'Animation', 'Comedy', 'Adventure', 'Family Film']",1990,9
1608743,Two or Three Things I Know About Her,1967,['France'],"['Essay Film', 'Drama', 'Ensemble Film']",1960,7
35327215,Akuto,1965,['Japan'],[],1960,5
27593061,The Square Peg,1959,['United Kingdom'],"['Slapstick', 'Comedy']",1950,9
10131383,"Whoa, Be-Gone!",1958,[],"['Animation', 'Short Film', 'Family Film']",1950,8
9085417,Hello Again,1987,['United States of America'],"['Romantic fantasy', 'Heaven-Can-Wait Fantasies', 'Comedy', 'Romance Film', 'Romantic comedy', 'Fantasy Comedy', 'Fantasy']",1980,7
19108576,Au Pair Girls,1972,['United Kingdom'],['Romance Film'],1970,2
6181138,The Ambushers,1967,['United States of America'],"['Action', 'Spy', 'Parody', 'Action/Adventure', 'Comedy', 'Glamorized Spy Film', 'Science Fiction']",1960,7
25413122,Drums in the Deep South,1951,['United States of America'],"['Western', 'Action/Adventure', 'War film']",1950,1
5521767,Friends,1971,['United Kingdom'],"['Romance Film', 'Romantic drama', 'Drama']",1970,1
17379289,Without Warning,1980,['United States of America'],"['Horror', 'Science Fiction']",1980,0
27160663,Phantom,2002,['India'],['Action'],2000,2
26488721,Paris 36,2008,"['France', 'Germany']","['Period piece', 'Musical Drama', 'World cinema', 'Historical fiction', 'Political drama', 'Drama', 'Ensemble Film']",2000,8
4668216,Alakazam the Great,1960,['Japan'],"['Action', 'Animation', 'Japanese Movies', 'Anime', 'Fantasy']",1960,0
385742,The Fall of the Roman Empire,1964,['United States of America'],"['Period piece', 'Sword and Sandal', 'Historical fiction', 'Historical Epic', 'Epic', 'War film', 'Drama']",1960,4
10367181,Munimji,1955,['India'],['Bollywood'],1950,5
14373082,Back from Eternity,1956,['United States of America'],"['Action', 'Black-and-white', 'Drama', 'Disaster']",1950,6
2265651,Shikoku,1999,['Japan'],"['Romantic fantasy', 'Japanese Movies', 'Thriller', 'Horror', 'World cinema']",1990,9
6970711,Are You My Neighbor?,1995,['United States of America'],"['Musical', 'Animation', 'Short Film', ""Children's""]",1990,5
25430565,The Other Man,2008,"['United Kingdom', 'United States of America']","['Drama', 'Mystery', 'Thriller']",2000,8
10241319,Walang Kapalit,2007,[],['Drama'],2000,7
1767648,The Worlds Strongest Guy,1990,['Japan'],"['Action', 'Animation', 'World cinema', ""Children's"", 'Japanese Movies', 'Anime', 'Science Fiction', 'Fantasy']",1990,0
618856,The Mighty,1998,['United States of America'],"['Comedy-drama', 'Drama', 'Comedy film']",1990,8
22098183,Pedro,2008,['United States of America'],"['Period piece', 'LGBT', 'Biography', 'Drama']",2000,8
26198798,The Chosen,1981,['United States of America'],"['Period piece', 'Film adaptation', 'Drama']",1980,1
16826347,Reversible Errors,2004,[],"['Psychological thriller', 'Thriller', 'Courtroom Drama']",2000,4
250012,Pale Rider,1985,['United States of America'],"['Action', 'Crime Fiction', 'Action/Adventure', 'Western', 'Existentialism', 'Thriller', 'Drama']",1980,5
2460704,Pokémon: The First Movie,1998,"['Japan', 'United States of America']","['Fantasy Adventure', 'Animated cartoon', 'Animation', 'Action/Adventure', 'Fantasy Comedy', 'Comedy', ""Children's/Family"", 'Adventure', ""Children's Fantasy"", 'Japanese Movies', 'Anime', 'Science Fiction', 'Family Film', 'Fantasy']",1990,8
10741125,Assault on a Queen,1966,['United States of America'],"['Action', 'Drama', 'Crime Fiction', 'Thriller', 'Adventure']",1960,6
5324114,Wagons East,1994,['United States of America'],"['Action', 'Screwball comedy', 'Action/Adventure', 'Western', 'Comedy']",1990,4
3296570,Derailed,2002,['United States of America'],"['Action', 'Action/Adventure', 'Thriller', 'Disaster', 'Martial Arts Film']",2000,2
11257210,Peppermint Frappé,1967,['Spain'],"['Romantic drama', 'Drama']",1960,7
2995062,The Last Days of Disco,1998,['United States of America'],"['Indie', 'Comedy', 'Drama', 'Coming of age', 'Parody', 'Comedy-drama', 'Comedy of manners', 'Ensemble Film']",1990,8
26652253,Tropical Fish,1995,['Taiwan'],"['Drama', 'Comedy']",1990,5
36057886,Vanaja Girija,1994,['India'],['Comedy film'],1990,4
13824842,Bowery Bugs,1949,[],"['Animation', 'Short Film', 'Comedy', 'Family Film']",1940,9
3451250,Fearless Hyena,1979,['Hong Kong'],"['Action/Adventure', 'World cinema', 'Chinese Movies', 'Martial Arts Film']",1970,9
3943470,Two Much,1996,"['Spain', 'United States of America']","['Screwball comedy', 'Comedy', 'Romance Film', 'Romantic comedy']",1990,6
616786,Kiss of Death,1995,['United States of America'],"['Neo-noir', 'Heist', 'Gangster Film', 'Thriller', 'Crime Thriller', 'Drama']",1990,5
4971356,Dumm Dumm Dumm,2001,['India'],"['Comedy', 'Tamil cinema', 'Romance Film', 'Drama']",2000,1
2894603,Bruiser,2000,"['Canada', 'United States of America']","['Psychological thriller', 'Slasher', 'Thriller', 'Horror']",2000,0
6268341,Footy Legends,2006,['Australia'],"['Family Drama', 'Indie', 'Comedy-drama', 'Drama']",2000,6
20320460,Black Dynamite,2009,"['United Kingdom', 'United States of America']","['Action', 'Blaxploitation', 'Action/Adventure', 'Comedy', 'Martial Arts Film', 'Adventure', 'Parody', 'Action Comedy']",2000,9
11539737,Tennessee Johnson,1942,['United States of America'],"['Black-and-white', 'Biographical film', 'Biopic [feature]', 'Drama']",1940,2
20753502,REC 2,2009,['Spain'],"['World cinema', 'Thriller', 'Horror']",2000,9
25565186,My Baby Is Missing,2007,[],"['Drama', 'Crime Fiction', 'Thriller']",2000,7
3284664,The Sentinel,2006,['United States of America'],"['Action', 'Crime Fiction', 'Mystery', 'Thriller', 'Political drama', 'Drama', 'Political thriller']",2000,6
16039140,The Amazing Truth About Queen Raquela,2007,"['Philippines', 'United States of America', 'Iceland', 'France', 'Thailand']","['Filipino Movies', 'LGBT', 'Biography', 'Biographical film', 'World cinema', 'Documentary', 'Drama', 'Gay Themed', 'Gay', 'Gay Interest', 'Comedy-drama', 'Road movie']",2000,7
19842551,A Time to Love and a Time to Die,1958,['United States of America'],"['Anti-war', 'Anti-war film', 'Melodrama', 'War film', 'Drama']",1950,8
18970935,Riot,1969,['United States of America'],"['Action', 'Film adaptation', 'Drama', 'Crime Fiction', 'Action/Adventure']",1960,9
932424,A Christmas Story,1983,"['Canada', 'United States of America']","['Christmas movie', 'Comedy', 'Family Film']",1980,3
22942925,Too Beautiful to Lie,2004,['South Korea'],['Romantic comedy'],2000,4
33577424,Spy Kids 2: Island of Lost Dreams,2002,['United States of America'],"['Action', 'Spy', 'Comedy', 'Adventure', 'Science Fiction', 'Family Film']",2000,2
13439264,Mad Money,2008,['United States of America'],"['Action', 'Heist', 'Crime Fiction', 'Caper story', 'Action/Adventure', 'Comedy', 'Crime Comedy']",2000,8
1553031,Fight Back to School III,1993,['Hong Kong'],"['Chinese Movies', 'Comedy']",1990,3
2266239,Midnight Madness,1980,['United States of America'],"['Comedy', 'Teen']",1980,0
1535983,Eight Men Out,1988,['United States of America'],"['Period piece', 'Indie', 'Americana', 'Sports', 'Drama']",1980,8
35825940,Maa,1992,['India'],[],1990,2
1745296,XXX: State of the Union / XXX: The Next Level,2005,['United States of America'],"['Action', 'Spy', 'Action/Adventure', 'Thriller', 'Adventure', 'Crime Thriller']",2000,5
26776502,Follow Me!,1972,['United Kingdom'],"['Comedy', 'Thriller', 'Romance Film', 'Romantic comedy']",1970,2
6337456,Love 101,2000,['United States of America'],"['Romance Film', 'Romantic comedy', 'Comedy']",2000,0
3672697,Carandiru,2003,"['Brazil', 'Argentina', 'Italy']","['Prison', 'LGBT', 'Crime Fiction', 'Indie', 'Drama', 'World cinema']",2000,3
17519548,Take Me Out to the Ball Game,1949,['United States of America'],"['Musical', 'Comedy', 'Romantic comedy', 'Romance Film', 'Sports']",1940,9
16266637,Sherlock Holmes in New York,1976,['United States of America'],"['Detective fiction', 'Crime Fiction', 'Mystery', 'Detective', 'Whodunit']",1970,6
18934864,Skyscraper Souls,1932,['United States of America'],"['Black-and-white', 'Romance Film', 'Comedy-drama', 'Workplace Comedy', 'Drama', 'Ensemble Film']",1930,2
15721024,Moonlight and Valentino,1995,"['United Kingdom', 'United States of America']","['Romantic drama', 'Comedy', 'Romance Film', 'Comedy-drama', 'Drama']",1990,5
73451,El Norte,1983,"['United Kingdom', 'United States of America']","['Indie', 'Thriller', 'Adventure', 'Drama', 'Tragedy']",1980,3
3473059,The Stand,1994,['United States of America'],"['Apocalyptic and post-apocalyptic fiction', 'Adventure', 'Drama', 'Horror', 'Television movie', 'Doomsday film', 'Science Fiction', 'Fantasy']",1990,4
4503438,Scamper the Penguin,1988,"['Soviet Union', 'Japan']","['Japanese Movies', 'Adventure', 'Drama', 'Fantasy']",1980,8
4837681,Pehla Pehla Pyaar,2006,['Pakistan'],['Drama'],2000,6
25060238,Eternity,1990,['United States of America'],['Drama'],1990,0
3950291,Live Flesh,1997,"['France', 'Spain']","['Erotic Drama', 'Romantic drama', 'Thriller', 'World cinema', 'Romance Film', 'Drama', 'Melodrama', 'Erotica']",1990,7
5735559,Tai Chi Master,1993,['Hong Kong'],"['Action', 'Action/Adventure', 'World cinema', 'Chinese Movies', 'Martial Arts Film']",1990,3
4498589,Raiders of the Living Dead,1986,['United States of America'],"['Zombie Film', 'Indie', 'Horror']",1980,6
12781333,Il bell'Antonio,1960,"['France', 'Italy']","['Black-and-white', 'Drama']",1960,0
2100379,I Married a Witch,1942,['United States of America'],"['Black-and-white', 'Comedy', 'Romantic comedy', 'Costume drama', 'Fantasy']",1940,2
7008420,Kill The Moonlight,1994,['United States of America'],"['Indie', 'Comedy', 'Parody']",1990,4
8092271,Rescue Heroes: The Movie,2003,['Canada'],"['Adventure Comedy', 'Action', 'Animation', ""Children's/Family"", ""Children's"", 'Adventure', 'Computer Animation', ""Children's Entertainment"", 'Family Film']",2000,3
5715101,The Mating Habits of the Earthbound Human,1999,['United States of America'],"['Sex comedy', 'Parody', 'Indie', 'Comedy', 'Romance Film', 'Romantic comedy', 'Mockumentary']",1990,9
15290864,Good,2008,"['United Kingdom', 'Germany', 'Hungary']","['Period piece', 'War film', 'Political drama', 'Drama']",2000,8
2696740,Curious George,2006,['United States of America'],"['Animation', ""Children's"", 'Comedy', 'Adventure', 'Family Film']",2000,6
16457387,Evergreen,1934,['United Kingdom'],"['Musical', 'Black-and-white']",1930,4
15271121,The Foreman Went to France,1942,['United Kingdom'],"['Black-and-white', 'War film', 'Drama']",1940,2
5766690,He Loves Me... He Loves Me Not,2003,['France'],"['Psychological thriller', 'Romantic drama', 'Comedy', 'World cinema', 'Black comedy', 'Romance Film', 'Drama']",2000,3
9468198,Thomas l'imposteur,1965,['France'],['Drama'],1960,5
7019460,Perarasu,2006,['India'],"['Action', 'Science Fiction', 'Thriller']",2000,6
26738833,All-American Co-Ed,1941,['United States of America'],"['Musical', 'Comedy']",1940,1
9199781,This Is England,2006,['United Kingdom'],"['Period piece', 'Drama', 'Crime Fiction', 'Coming of age', 'Indie', 'War film']",2000,6
1981790,The Naked City,1948,['United States of America'],"['Black-and-white', 'Crime Fiction', 'Mystery', 'Thriller', 'Film noir', 'Crime Thriller', 'Drama']",1940,8
19270593,I Can Jump Puddles,1981,['Australia'],['Drama'],1980,1
12433713,The Big Town,1987,['United States of America'],"['Period piece', 'Film adaptation', 'Romantic drama', 'Thriller', 'Romance Film', 'Drama']",1980,7
51906,Breakfast at Tiffany's,1961,['United States of America'],"['Comedy', 'Comedy of manners', 'Romance Film', 'Romantic comedy', 'Comedy-drama', 'Drama']",1960,1
33002630,Aatank,1996,['India'],"['Thriller', 'Horror']",1990,6
1205729,Amar Akbar Anthony,1977,['India'],"['Musical', 'Action/Adventure', 'Comedy', 'Bollywood', 'World cinema']",1970,7
11143067,Punnagai Mannan,1986,['India'],"['Romance Film', 'Drama']",1980,6
2410175,Score,1972,"['Yugoslavia', 'United States of America']","['Pornographic movie', 'Erotica']",1970,2
4878174,"Don't Raise the Bridge, Lower the River",1968,['United Kingdom'],"['Adventure Comedy', 'Slapstick', 'Comedy']",1960,8
7517898,Mr. Wrong,1996,['United States of America'],"['Comedy', 'Black comedy', 'Romantic comedy', 'Romance Film', 'Slapstick']",1990,6
24127897,Zor Lagaa Ke...Haiya!,2009,['India'],"['Comedy-drama', 'Family Film']",2000,9
1377427,Coach Carter,2005,"['Germany', 'United States of America']","['Coming of age', 'Biography', 'Docudrama', 'Sports', 'Drama']",2000,5
1381479,Blue Murder at St Trinian's,1957,['United Kingdom'],['Comedy'],1950,7
20051217,Mahakaal,2008,['India'],['Action'],2000,8
9798318,Kaliyuga Ramudu,1982,['India'],['Drama'],1980,2
2560030,DinoCroc,2004,"['Canada', 'United States of America']","['Action', 'Monster', 'Action/Adventure', 'Thriller', 'Creature Film', 'Horror', 'Science Fiction', 'Natural horror films', 'Fantasy']",2000,4
442300,For a Few Dollars More,1965,"['Spain', 'Germany', 'Italy']","['Action', 'Crime Fiction', 'Western', 'Action/Adventure', 'World cinema', 'Spaghetti Western', 'Adventure']",1960,5
19587474,Padamati Sandhya Ragam,1986,['India'],[],1980,6
26497244,Junior Mandrake,1997,['India'],['Comedy film'],1990,7
34255201,Keshu,2009,['India'],"[""Children's"", 'Drama']",2000,9
5656208,Media Whore,2002,['United States of America'],"['Musical', 'Short Film', 'Comedy', 'Media Satire']",2000,2
2360074,Aaptamitra,2004,['India'],"['World cinema', 'Thriller', 'Horror']",2000,4
26839154,"Reaux, Reaux, Reaux Your Boat",1966,['United States of America'],"['Short Film', 'Animation']",1960,6
6554925,The Front Page,1931,['United States of America'],"['Comedy', 'Black-and-white']",1930,1
18612965,Doraemon: Nobita and the Legend of the Sun King,2000,['Japan'],['Japanese Movies'],2000,0
11014779,8 Mile,2002,"['Germany', 'United States of America']","['Musical', 'Coming of age', 'Musical Drama', 'Hip hop movies', 'Drama']",2000,2
4743308,The Story of Us,1999,['United States of America'],"['Romantic drama', 'Marriage Drama', 'Comedy', 'Romance Film', 'Romantic comedy', 'Comedy-drama', 'Drama']",1990,9
8619442,Broken English,2007,"['France', 'Japan', 'United States of America']","['Drama', 'Japanese Movies', 'Indie', 'Comedy', 'Romance Film', 'Romantic comedy']",2000,7
16953189,Basant Bahar,1956,['India'],"['Melodrama', 'Romantic drama', 'Drama']",1950,6
5148040,InuYasha the Movie: Affections Touching Across Time,2001,['Japan'],"['Action', 'Animation', 'Japanese Movies', 'World cinema', 'Anime', 'Fantasy']",2000,1
26723415,Deadtime Stories,1986,['United States of America'],"['Slasher', 'Thriller', 'Horror', 'B-movie']",1980,6
5497021,The Call of Cthulhu,2005,['United States of America'],"['Creature Film', 'Monster movie', 'Black-and-white', 'Horror', 'Silent film', 'B-movie']",2000,5
9363483,White Of The Eye,1987,['United Kingdom'],"['Erotic thriller', 'Psychological thriller', 'Thriller']",1980,7
6574313,Hospital Massacre,1982,['United States of America'],"['Slasher', 'Horror']",1980,2
32568615,Natakala Rayudu,1969,['India'],['Drama'],1960,9
23692886,Naam Iruvar Nammaku Iruvar,1998,['India'],['Crime Fiction'],1990,8
76313,Safety Last!,1923,['United States of America'],"['Black-and-white', 'Indie', 'Comedy', 'Thriller', 'Romance Film', 'Slapstick', 'Adventure', 'Silent film', 'Family Film']",1920,3
246559,Peggy Sue Got Married,1986,['United States of America'],"['Romantic fantasy', 'Comedy', 'Romance Film', 'Americana', 'Time travel', 'Romantic comedy', 'Fantasy Comedy', 'Fantasy']",1980,6
21200382,Dick,1999,"['France', 'United States of America', 'Canada']","['Political cinema', 'Female buddy film', 'Political satire', 'Parody', 'Buddy film', 'Comedy', 'Teen']",1990,9
21260972,Sujatha,1953,['Sri Lanka'],"['Musical', 'Romance Film']",1950,3
32260,U-571,2000,"['United States of America', 'France']","['Action', 'Combat Films', 'Action/Adventure', 'Thriller', 'Adventure', 'War film']",2000,0
5579823,The Nature of the Beast,1995,['United States of America'],"['Action', 'Psychological thriller', 'Spy', 'Mystery', 'Thriller', 'Crime Thriller', 'Drama', 'Horror', 'War film']",1990,5
19517244,New Brooklyn,2009,['United States of America'],"['Indie', 'Drama']",2000,9
3591767,Terror by Night,1946,['United States of America'],"['Film adaptation', 'Detective fiction', 'Black-and-white', 'Crime Fiction', 'Mystery', 'Thriller', 'Crime Thriller', 'Drama', 'Detective']",1940,6
3902593,Dopamine,2003,['United States of America'],"['Drama', 'Indie', 'Comedy', 'Romance Film', 'Romantic comedy', 'Comedy-drama']",2000,3
3370462,The Addiction,1995,['United States of America'],"['Black-and-white', 'Drama', 'Horror']",1990,5
7460258,Edith et Marcel,1983,['France'],"['Romantic drama', 'Biopic [feature]', 'Romance Film', 'Melodrama', 'Drama']",1980,3
3477283,Love Don't Cost a Thing,2003,['United States of America'],"['Comedy', 'Teen', 'Romance Film', 'Romantic comedy', 'Drama']",2000,3
12231217,Les Témoins,2007,['France'],"['Period piece', 'LGBT', 'Romantic drama', 'World cinema', 'Romance Film', 'Drama']",2000,7
2549113,Virginia City,1940,['United States of America'],"['Action', 'Black-and-white', 'Western', 'Action/Adventure']",1940,0
11254628,Morons from Outer Space,1985,['United Kingdom'],"['Indie', 'Parody', 'Comedy', 'Science Fiction']",1980,5
11141762,Neeya,1979,['India'],"['Drama', 'Horror']",1970,9
27214582,Chakram,2003,['India'],"['Action', 'Comedy', 'Bollywood', 'Drama']",2000,3
11179699,Devil Dog: The Hound of Hell,1978,['United States of America'],"['Television movie', 'Horror']",1970,8
1278961,The New World,2005,"['United Kingdom', 'United States of America']","['Biography', 'Romantic drama', 'Romance Film', 'Costume drama', 'Adventure', 'Drama', 'Period piece', 'History']",2000,5
10271998,Spite Marriage,1929,['United States of America'],"['Black-and-white', 'Comedy', 'Silent film', 'Romance Film']",1920,9
2827852,Amateur,1994,"['United Kingdom', 'France', 'United States of America']","['Crime Fiction', 'Mystery', 'Indie', 'Comedy', 'Thriller', 'Crime Thriller', 'Drama', 'Comedy Thriller']",1990,4
61529,Lost Horizon,1937,['United States of America'],"['Film adaptation', 'Black-and-white', 'Action/Adventure', 'Adventure', 'Romance Film', 'Drama', 'Fantasy']",1930,7
5573413,The Civilization of Maxwell Bright,2005,['United States of America'],"['Indie', 'Romantic drama', 'Comedy', 'Black comedy', 'Romance Film', 'Drama', 'Romantic comedy', 'Comedy-drama']",2000,5
14820263,"Sakal, Sakali, Saklolo",2007,['Philippines'],"['Filipino Movies', 'Romantic drama', 'World cinema', 'Romance Film', 'Drama']",2000,7
6020371,Hare Force,1944,[],"['Animated cartoon', 'Animation', 'Short Film', 'Family Film']",1940,4
78425,Raise the Red Lantern,1991,"['Hong Kong', 'Taiwan', 'China']","['Period piece', 'Marriage Drama', 'World cinema', 'Chinese Movies', 'Drama', 'Feminist Film']",1990,1
13164574,Elisita,1980,['Spain'],['Drama'],1980,0
14269859,Amar te duele,2004,['Mexico'],"['Romantic drama', 'World cinema', 'Romance Film', 'Drama']",2000,4
7874801,Rogue Trader,1999,['United Kingdom'],"['Film adaptation', 'Crime Fiction', 'Biography', 'Drama']",1990,9
10619849,Mahaan,1983,['India'],"['Musical', 'Thriller', 'Bollywood', 'World cinema', 'Drama']",1980,3
22291276,More Than a Game,2009,['United States of America'],"['Short Film', 'Sports', 'Documentary']",2000,9
18627809,Patayin Mo Sa Sindak Si Barbara,1974,['Philippines'],"['Filipino Movies', 'Horror']",1970,4
1209812,The Big Bus,1976,['United States of America'],"['Action', 'Parody', 'Action/Adventure', 'Comedy', 'Disaster', 'Ensemble Film']",1970,6
15682219,In Her Skin,2009,['Australia'],"['Drama', 'Indie', 'Family Drama', 'Thriller', 'World cinema', 'Docudrama']",2000,9
4916187,Fake,2003,['Thailand'],['Romance Film'],2000,3
3572176,Grandma's Boy,2006,['United States of America'],"['Stoner film', 'Comedy']",2000,6
31085554,Dear Heart,1964,['United States of America'],"['Comedy', 'Comedy film']",1960,4
2863646,Everyone's Hero,2006,"['Canada', 'United States of America']","['Computer Animation', 'Animation', 'Family-Oriented Adventure', ""Children's/Family"", 'Sports', 'Adventure', 'Family Film']",2000,6
19092669,Yasemin,1988,"['Germany', 'West Germany']","['Romance Film', 'Drama']",1980,8
10948566,"Orochi, the Eight-Headed Dragon",1994,['Japan'],"['Japanese Movies', 'Action/Adventure', 'World cinema', 'Fantasy']",1990,4
12228807,The Duke,1999,['United Kingdom'],['Short Film'],1990,9
3748536,Rang De Basanti,2006,['India'],"['Musical', 'History', 'Musical Drama', 'Comedy', 'Bollywood', 'World cinema', 'Drama']",2000,6
10468036,She Cried No,1996,['United States of America'],"['Drama', 'Television movie']",1990,6
10686800,Late Autumn,1960,['Japan'],"['Japanese Movies', 'Drama']",1960,0
10249841,Aishwarya,2006,['India'],['Romance Film'],2000,6
9034707,Auzaar,1997,['India'],"['Action', 'Drama', 'Thriller', 'World cinema']",1990,7
883432,Gone in Sixty Seconds,2000,['United States of America'],"['Action', 'Heist', 'Crime Fiction', 'Action/Adventure', 'Thriller', 'Crime Thriller']",2000,0
779774,The Private Lives of Elizabeth and Essex,1939,['United States of America'],"['Biography', 'Romantic drama', 'Biographical film', 'Romance Film', 'Costume drama', 'Drama', 'Period piece', 'Biopic [feature]', 'Historical fiction']",1930,9
2583628,The Night Before,1988,['United States of America'],"['Comedy', 'Teen']",1980,8
15904586,Fighting Tommy Riley,2005,['United States of America'],"['Boxing', 'LGBT', 'Indie', 'Sports', 'Drama']",2000,5
11684047,Police Force: An Inside Story,2004,['India'],"['Action', 'Drama', 'Crime Fiction', 'Action/Adventure', 'World cinema']",2000,4
19146018,Gelegenheitsarbeit einer Sklavin,1974,"['Germany', 'West Germany']","['Feminist Film', 'Drama', 'World cinema']",1970,4
9168916,Conversations with Other Women,2006,"['United Kingdom', 'United States of America']","['Drama', 'Indie', 'Romantic drama', 'Comedy', 'Romance Film', 'Comedy-drama', 'Sex comedy']",2000,6
23270755,Sea Beast,2009,['United States of America'],"['Television movie', 'Horror']",2000,9
24542564,Om,1995,[],"['Action', 'Drama']",1990,5
19256291,90 Ghanta,2008,['India'],"['Action', 'Crime', 'Thriller']",2000,8
28132190,Musical Justice,1931,['United States of America'],['Short Film'],1930,1
2284155,The New Guy,2002,['United States of America'],"['Prison', 'Comedy', 'Teen', 'Romantic comedy']",2000,2
1780940,Tintorera,1977,"['Mexico', 'United Kingdom']","['Softcore Porn', 'Thriller', 'Horror', 'World cinema', 'Natural horror films']",1970,7
255049,I Know What You Did Last Summer,1997,['United States of America'],"['Mystery', 'Slasher', 'Thriller', 'Horror', 'Teen']",1990,7
4266637,Go Tell the Spartans,1978,['United States of America'],"['Action', 'Combat Films', 'Film adaptation', 'Drama', 'Indie', 'Action/Adventure', 'War film']",1970,8
5491467,"L'Arbre, le maire et la médiathèque",1993,['France'],"['Comedy-drama', 'Satire', 'Comedy of manners']",1990,3
13142845,Dragon Fist,1979,['Hong Kong'],"['Action', 'Action/Adventure', 'World cinema', 'Chinese Movies', 'Martial Arts Film']",1970,9
28135973,Such a Pretty Little Beach,1949,['France'],"['Film noir', 'Crime Drama', 'Drama']",1940,9
15477338,Grand Canyonscope,1954,['United States of America'],"['Animation', 'Short Film', 'Comedy']",1950,4
3346956,Private Hell 36,1954,['United States of America'],"['Black-and-white', 'Crime Fiction', 'Thriller', 'Crime Drama', 'Film noir', 'Crime Thriller', 'Drama']",1950,4
8887199,The Angels Wash Their Faces,1939,['United States of America'],"['Black-and-white', 'Crime Fiction', 'Crime Drama', 'Juvenile Delinquency Film', 'Drama']",1930,9
18002177,Abhimanyu,1991,['India'],"['Musical', 'Crime Fiction', 'Bollywood', 'Drama']",1990,1
5482341,A Kind of Loving,1962,['United Kingdom'],"['Romantic drama', 'Romance Film', 'British New Wave', 'Kitchen sink realism', 'Drama']",1960,2
10735921,Parenni Maya Jalaima,2004,"['Nepal', 'Hong Kong']","['Chinese Movies', 'Romance Film']",2000,4
706878,The Last Boy Scout,1991,['United States of America'],"['Action', 'Crime Fiction', 'Action/Adventure', 'Buddy film', 'Thriller', 'Comedy', 'Crime Thriller']",1990,1
4556874,Kabul Express,2006,['India'],"['Action/Adventure', 'Comedy', 'World cinema', 'Road movie', 'Drama']",2000,6
2165430,"Davy Crockett, King of the Wild Frontier",1955,['United States of America'],"['Action', 'Western', 'Biopic [feature]', 'Adventure', 'Family Film']",1950,5
207680,Nell,1994,['United States of America'],['Drama'],1990,4
1072033,Journey to the Far Side of the Sun,1969,['United Kingdom'],"['Science Fiction', 'Adventure', 'Thriller']",1960,9
7856247,Cyborg 3: The Recycler,1994,['United States of America'],"['Action', 'Action Thrillers', 'Indie', 'Action/Adventure', 'Thriller', 'Science Fiction']",1990,4
8554522,Mi Vida Loca,1993,"['United Kingdom', 'United States of America']","['Crime Fiction', 'Indie', 'Drama']",1990,3
98508,The Sand Pebbles,1966,['United States of America'],"['Action', 'Film adaptation', 'Romantic drama', 'Romance Film', 'Drama', 'Adventure', 'Historical Epic', 'Historical fiction', 'Epic', 'War film']",1960,6
638349,The Hindenburg,1975,['United States of America'],"['Period piece', 'Suspense', 'Action/Adventure', 'Thriller', 'Disaster', 'Drama']",1970,5
9204125,Vellitherai,2008,['India'],['Action'],2000,8
1689394,Pirates of the Caribbean: At World's End,2007,['United States of America'],"['Adventure Comedy', 'Fantasy Adventure', 'Action', 'Action/Adventure', 'Comedy', 'Swashbuckler films', 'Adventure', 'Fantasy']",2000,7
9951615,Last Hero in China,1993,['Hong Kong'],"['Action', 'Action/Adventure', 'World cinema', 'Chinese Movies', 'Martial Arts Film']",1990,3
19931021,Kaal,2007,['India'],['Drama'],2000,7
15286558,The Soloist,2009,"['United Kingdom', 'France', 'United States of America']","['Musical', 'Film adaptation', 'Biographical film', 'Docudrama', 'Drama']",2000,9
4348820,Down and Derby,2005,['United States of America'],"['Sports', 'Comedy', 'Family Film']",2000,5
7963945,Just Another Girl on the I.R.T.,1992,['United States of America'],"['Coming of age', 'Indie', 'Drama']",1990,2
1172173,Sink the Bismarck!,1960,['United Kingdom'],"['Combat Films', 'Action', 'Drama', 'Action/Adventure', 'War film']",1960,0
14739040,Slaphappy Sleuths,1950,['United States of America'],"['Short Film', 'Black-and-white', 'Comedy']",1950,0
3329115,She Hate Me,2004,['United States of America'],"['LGBT', 'Indie', 'Satire', 'Comedy', 'Comedy-drama', 'Drama', 'Sex comedy']",2000,4
186501,Revolution OS,2001,['United States of America'],"['Inventions & Innovations', 'Computers', 'Indie', 'Documentary', 'Business']",2000,1
3739855,Tom Sawyer,1973,"['United Kingdom', 'United States of America']","['Musical', 'Adventure', 'Drama', 'Family Film']",1970,3
2012192,Umberto D,1952,['Italy'],"['Black-and-white', 'Drama', 'World cinema']",1950,2
24477995,Vettaikkaaran,2009,['India'],['Action'],2000,9
2608983,Ratcatcher,1999,"['United Kingdom', 'France', 'Scotland']","['Period piece', 'Coming of age', 'Family Drama', 'Drama']",1990,9
1193390,The Order,2001,"['Aruba', 'United States of America']","['Action', 'Crime Fiction', 'Action/Adventure', 'Comedy', 'Thriller', 'Martial Arts Film', 'Adventure', 'Drama']",2000,1
24653,Princess Mononoke,1997,['Japan'],"['Fantasy Adventure', 'Japanese Movies', 'Anime', 'Adventure', 'Fantasy']",1990,7
24396026,The Quiet Room,1996,"['France', 'Italy', 'Australia']","['Drama', 'World cinema']",1990,6
553272,A Matter of Life and Death,1946,"['United Kingdom', 'England']","['Romance Film', 'War film', 'Drama', 'Fantasy']",1940,6
11972180,Gundamma Gaari Manavadu,2007,['India'],"['Drama', 'Comedy']",2000,7
15143185,Unnatural & Accidental,2006,['Canada'],"['Psychological thriller', 'Drama', 'Crime Fiction', 'Mystery', 'Indie', 'Thriller']",2000,6
28214293,Mickey's Medicine Man,1934,['United States of America'],['Short Film'],1930,4
4837038,How Green Was My Valley,1941,['United States of America'],"['Black-and-white', 'Western', 'Epic', 'Drama', 'Family Film']",1940,1
8602034,The Carnival Night,1956,['Soviet Union'],"['Musical', 'Romance Film', 'Comedy film']",1950,6
3172900,The Mask of Diijon,1946,['United States of America'],"['Psychological thriller', 'Suspense', 'Thriller', 'Horror', 'Film noir']",1940,6
5700623,Superman II: The Richard Donner Cut,2006,"['United Kingdom', 'United States of America']","['Action', 'Superhero', 'Action/Adventure', 'Romance Film', 'Superhero movie', 'Alien Film', 'Science Fiction', 'Family Film']",2000,6
1556135,Torn Curtain,1966,['United States of America'],"['Spy', 'Suspense', 'Thriller', 'Political thriller']",1960,6
3374727,Blue Collar,1978,['United States of America'],"['Drama', 'Crime Fiction']",1970,8
4018810,All About Anna,2005,['Denmark'],"['Drama', 'Erotic Drama', 'Comedy', 'Romance Film', 'Erotica', 'Adult']",2000,5
26876540,The East is Red,1993,['Hong Kong'],"['Action/Adventure', 'World cinema', 'Wuxia', 'Chinese Movies', 'Martial Arts Film']",1990,3
10579768,Emporte-moi,1999,"['Canada', 'Switzerland', 'France', 'Germany']","['LGBT', 'Coming of age', 'Teen', 'Drama']",1990,9
15470546,Stage Fright,1923,['United States of America'],"['Black-and-white', 'Indie', 'Short Film', 'Comedy', 'Silent film']",1920,3
4639948,The House on Sorority Row,1983,['United States of America'],"['Slasher', 'Thriller', 'Horror', 'Teen', 'B-movie']",1980,3
5994199,Leprechaun In the Hood,2000,['United States of America'],"['Monster movie', 'Horror', 'Supernatural', 'Cult']",2000,0
7235995,Swayamkrushi,1987,['India'],"['Musical', 'Family Film']",1980,7
4168811,Zorro's Fighting Legion,1939,['United States of America'],"['Action', 'Black-and-white', 'Action/Adventure', 'Epic', 'Superhero movie', 'Swashbuckler films', 'Adventure']",1930,9
25757145,Count the Hours,1953,['United States of America'],"['Drama', 'Crime Fiction']",1950,3
239589,The Birdcage,1996,['United States of America'],"['Comedy', 'LGBT']",1990,6
2390149,Corky Romano,2001,['United States of America'],"['Crime Fiction', 'Gangster Film', 'Comedy', 'Crime Comedy', 'Slapstick']",2000,1
21701320,Aage se right,2009,['India'],"['Crime Fiction', 'Comedy', 'Drama']",2000,9
11463940,California Dreamin',2007,['Romania'],"['Art film', 'Comedy', 'World cinema', 'Political drama', 'War film', 'Drama']",2000,7
27218965,Aaj Ka M.L.A. Ram Avtar,1984,['India'],"['Action', 'Drama']",1980,4
2056635,Lila Says,2005,['France'],"['Art film', 'Erotic Drama', 'Coming of age', 'Romantic drama', 'World cinema', 'Romance Film', 'Drama']",2000,5
16355046,Siva Manasula Sakthi,2009,['India'],['Romantic comedy'],2000,9
7976705,A Hobo's Christmas,1987,['United States of America'],"['Holiday Film', 'Christmas movie', 'Drama']",1980,7
5943254,Burglar,1987,"['Canada', 'United States of America']","['Action', 'Mystery', 'Action/Adventure', 'Comedy']",1980,7
2312853,The Captain's Paradise,1953,['United Kingdom'],"['Comedy', 'Comedy of manners', 'Romance Film', 'Romantic comedy']",1950,3
21467628,Asoo Billa,2001,['Pakistan'],['Action'],2000,1
8771437,Tap,1989,['United States of America'],"['Musical', 'Heist', 'Crime Fiction', 'Dance', 'Drama']",1980,9
9310559,Ten,2002,"['France', 'Iran']","['Documentary', 'Drama', 'World cinema']",2000,2
24918362,Sarah's Choice,2009,['United States of America'],['Drama'],2000,9
6352213,Hare Remover,1946,['United States of America'],"['Animation', 'Short Film', 'Comedy', 'Family Film']",1940,6
3643482,Drake & Josh Go Hollywood,2006,['United States of America'],"['Comedy', 'Television movie', 'Adventure', 'Family Film']",2000,6
2614503,The Great Yokai War,2005,['Japan'],"['Fantasy Adventure', 'Action/Adventure', 'World cinema', ""Children's"", 'Adventure', ""Children's Fantasy"", 'Japanese Movies', 'Fantasy']",2000,5
23718554,The Great Love,1931,['Austria'],['Drama'],1930,1
18575659,Masquerade,1988,['United States of America'],"['Psychological thriller', 'Mystery', 'Romantic drama', 'Thriller', 'Romance Film', 'Crime Thriller', 'Drama']",1980,8
11248834,The Magnetic Telescope,1942,['United States of America'],['Short Film'],1940,2
2261684,One Magic Christmas,1985,"['Canada', 'United States of America']","['Heavenly Comedy', 'Christmas movie', 'Fantasy Comedy', 'Family Film', 'Fantasy']",1980,5
14325914,Killer Darts,1968,['Hong Kong'],"['Wuxia', 'Chinese Movies', 'Martial Arts Film']",1960,8
19344346,Stoic,2008,"['Canada', 'United States of America']","['Psychological thriller', 'Prison', 'Mystery', 'Thriller', 'Crime Thriller', 'Drama']",2000,8
7347415,The Admirable Crichton,1957,['United Kingdom'],['Comedy'],1950,7
8958592,Hanna K.,1983,"['Israel', 'France']","['Drama', 'Political drama']",1980,3
9523485,Pallikoodam,2007,['India'],['Drama'],2000,7
23976591,The Murderer Lives at Number 21,1942,['France'],"['Mystery', 'Thriller', 'Comedy film']",1940,2
846820,Look Who's Talking,1989,['United States of America'],"['Comedy', 'Romance Film', 'Romantic comedy', 'Domestic Comedy', 'Family Film']",1980,9
15197178,The Naked Man,1998,['United States of America'],"['Screwball comedy', 'Comedy']",1990,8
10815153,Congorama,2006,"['France', 'Canada', 'Belgium']","['Comedy', 'World cinema', 'Road movie', 'Drama']",2000,6
26600911,Macabre,2009,['Indonesia'],"['Slasher', 'World cinema', 'Horror']",2000,9
24528769,In Pursuit,2001,['United States of America'],"['Action', 'Thriller', 'Drama']",2000,1
14656708,Strangers,2007,['India'],"['Musical', 'Thriller', 'Bollywood', 'World cinema', 'Crime Thriller']",2000,7
10505379,The Hunt for Eagle One,2006,['United States of America'],"['Action', 'Action Thrillers', 'Action/Adventure', 'Thriller', 'War film']",2000,6
18973554,From Beyond the Grave,1973,['United Kingdom'],"['Film adaptation', 'Horror', 'Drama', 'Natural horror films']",1970,3
161882,Cat Ballou,1965,['United States of America'],"['Musical', 'Film adaptation', 'Action/Adventure', 'Comedy', 'Musical comedy', 'Drama', 'Comedy Western', 'Parody', 'Western']",1960,5
21272393,Whistle and I'll Come to You,1968,[],['Television movie'],1960,8
21874997,"Wife, Husband and Friend",1939,['United States of America'],"['Musical', 'Slapstick', 'Comedy film']",1930,9
1487312,Chain Reaction,1996,['United States of America'],"['Action', 'Drama', 'Action/Adventure', 'Thriller']",1990,6
23904795,Twenty Four Seven,1997,"['Kingdom of Great Britain', 'United Kingdom', 'England']","['Boxing', 'Comedy', 'Romance Film', 'Sports', 'Drama']",1990,7
985537,Allan Quatermain and the Lost City of Gold,1987,"['Zimbabwe', 'United States of America']","['Action', 'Action/Adventure', 'Comedy', 'Jungle Film', 'Adventure']",1980,7
22123302,The Bounty Hunter,1954,['United States of America'],"['Action', 'Western']",1950,4
21236624,Cool Cat,1967,['United States of America'],"['Animation', 'Short Film', 'Comedy']",1960,7
16660805,Inside,2007,['France'],"['Psychological thriller', 'Slasher', 'Horror']",2000,7
23749531,Tetsuo: The Bullet Man,2009,['Japan'],"['Action', 'Cyberpunk', 'Thriller', 'World cinema', 'Creature Film', 'Japanese Movies', 'Horror', 'Science Fiction']",2000,9
6795062,Raja,2002,['India'],['Romance Film'],2000,2
76366,Some Like It Hot,1959,['United States of America'],"['Black-and-white', 'Screwball comedy', 'Comedy', 'Romance Film', 'Romantic comedy', 'Sex comedy']",1950,9
8576918,Blood and Sand,1941,['United States of America'],"['Action', 'Drama', 'Romantic drama', 'Action/Adventure', 'Romance Film']",1940,1
6332086,That Riviera Touch,1966,['United Kingdom'],"['Crime Fiction', 'Slapstick', 'Crime Comedy']",1960,6
2175661,Little Women,1933,['United States of America'],"['Film adaptation', 'Black-and-white', 'Family Drama', 'Romance Film', 'Costume drama', 'Drama', 'Family Film']",1930,3
24449337,Les Longs Manteaux,1986,"['Argentina', 'France']","['Action', 'Adventure']",1980,6
12802045,The Man with the Perfect Swing,1995,['United States of America'],"['Comedy-drama', 'Comedy', 'Drama']",1990,5
2243157,Street Trash,1987,['United States of America'],"['Black comedy', 'Comedy', 'Horror']",1980,7
313002,The Last Unicorn,1982,"['Japan', 'United Kingdom', 'West Germany', 'United States of America']","['Fantasy Adventure', 'Animation', 'Animated Musical', ""Children's/Family"", 'Costume drama', 'Adventure', 'Drama', ""Children's Fantasy"", 'Japanese Movies', 'Family Film', 'Fantasy']",1980,2
3383198,Reefer Madness,1936,['United States of America'],"['Exploitation', 'Stoner film', 'Comedy', 'Drama', 'Cult']",1930,6
2011605,Falcons,2002,['Iceland'],['Drama'],2000,2
975913,Vampires,1998,['United States of America'],"['Action', 'Film adaptation', 'Action/Adventure', 'Thriller', 'Drama', 'Western', 'Horror', 'Cult']",1990,8
3998226,Full Fathom Five,1990,"['Peru', 'United States of America']",['Action'],1990,0
2097338,Psycho III,1986,['United States of America'],"['Psychological thriller', 'Crime Fiction', 'Mystery', 'Slasher', 'Thriller', 'Horror']",1980,6
27635803,Dead Air,2007,[],['Horror'],2000,7
9246552,Ard al-Salam,1957,['Egypt'],"['Romance Film', 'War film', 'Drama']",1950,7
19920276,Up from the Beach,1965,"['France', 'United States of America']","['War film', 'Drama']",1960,5
5657263,Free Radicals,2003,['Austria'],"['Art film', 'Romantic drama', 'World cinema', 'Romance Film', 'Drama']",2000,3
11341007,The Eagle Has Landed,1976,['United Kingdom'],"['Spy', 'Suspense', 'Mystery', 'Action/Adventure', 'Thriller', 'War film']",1970,6
34630626,Makkal En Pakkam,1987,['India'],[],1980,7
9861323,Transit,2005,['United Kingdom'],['Drama'],2000,5
3831894,Making Love,1982,['United States of America'],"['Romance Film', 'LGBT', 'Drama']",1980,2
30806084,Possums,1998,['United States of America'],"['Family Drama', 'Sports', 'Drama', 'Family Film']",1990,8
7895523,Memories of Matsuko,2006,['Japan'],"['Musical', 'Japanese Movies', 'Mystery', 'Comedy film', 'Drama']",2000,6
686066,New Jack City,1991,['United States of America'],"['Action', 'Blaxploitation', 'Crime Fiction', 'Gangster Film', 'Indie', 'Thriller', 'Drama', 'Crime Drama']",1990,1
31287257,Giovanna's Father,2008,['Italy'],"['Period piece', 'Juvenile Delinquency Film', 'Drama']",2000,8
2240278,The Frogmen,1951,['United States of America'],"['Action', 'Action/Adventure', 'Epic', 'War film', 'Adventure', 'Drama']",1950,1
18182495,What a Mess!,1995,['Russia'],['Comedy'],1990,5
11611427,Invaders from Mars,1986,['United States of America'],"['Horror', 'Science Fiction']",1980,6
28342228,Paanch,2003,['India'],"['Thriller', 'Crime Fiction']",2000,3
7176929,Santa Claus,1959,['Mexico'],"['World cinema', 'Science Fiction', 'Drama', 'Family Film', 'Fantasy']",1950,9
2372989,In Country,1989,['United States of America'],"['Period piece', 'Coming of age', 'Family Drama', 'Romance Film', 'War film', 'Drama']",1980,9
2339741,Ghosts Can't Do It,1990,['United States of America'],"['Action', 'Action/Adventure', 'Comedy', 'Romance Film', 'Adventure', 'Horror', 'Romantic comedy', 'Fantasy']",1990,0
1583755,Poor Little Rich Girl,1965,['United States of America'],[],1960,5
1001506,The Legend of the Lone Ranger,1981,"['United Kingdom', 'United States of America']","['Action/Adventure', 'Western']",1980,1
4852676,One Day in Europe,2005,"['Germany', 'Spain']",['Comedy'],2000,5
8160176,Ek Ladka Ek Ladki,1992,['India'],"['Romance Film', 'Comedy']",1990,2
29104772,Escort Girl,1941,['United States of America'],"['Drama', 'Crime Fiction']",1940,1
151807,Film,1965,['United States of America'],"['Silent film', 'Indie', 'Short Film']",1960,5
2711663,Satan Met a Lady,1936,['United States of America'],"['Black-and-white', 'Detective fiction', 'Crime Fiction', 'Mystery', 'Comedy', 'Detective', 'Pre-Code']",1930,6
3595362,The Maid,2005,['Singapore'],"['Filipino', 'World cinema', 'Horror']",2000,5
201534,Chicago,2002,"['Germany', 'United States of America', 'Canada']","['Musical', 'Crime Fiction', 'Comedy', 'Drama']",2000,2
24449669,Cairo Time,2009,"['Ireland', 'Canada', 'Egypt']","['Romantic drama', 'Indie', 'Marriage Drama', 'Romance Film', 'Drama']",2000,9
3954948,Strait-Jacket,1964,['United States of America'],"['Psychological thriller', 'Black-and-white', 'Psycho-biddy', 'Thriller', 'Horror', 'Crime Thriller', 'Drama']",1960,4
14177705,The Shopworn Angel,1938,['United States of America'],"['Black-and-white', 'Drama']",1930,8
846828,The Piano Teacher,2001,"['France', 'Germany', 'Austria']","['Music', 'Erotic Drama', 'Drama']",2000,1
3772538,Deck Dogz,2005,"['New Zealand', 'Australia']","['Drama', 'Coming of age', 'Indie', 'Comedy', 'Teen', 'World cinema', 'Sports']",2000,5
23393940,Madame Aema 4,1990,['South Korea'],['Drama'],1990,0
9602389,Love That Boy,2003,['Canada'],['Romantic comedy'],2000,3
5682615,Malibu Express,1985,['United States of America'],"['Action', 'Spy', 'Detective fiction', 'Crime Fiction', 'Mystery', 'Indie', 'Comedy', 'Thriller', 'Parody', 'Detective']",1980,5
3646864,The 14 Amazons,1972,"['China', 'Hong Kong']","['Action', 'Action/Adventure', 'World cinema', 'Martial Arts Film', 'Adventure', 'Drama', 'Wuxia', 'Historical fiction', 'War film']",1970,2
27346771,All I Desire,1953,['United States of America'],"['Family Drama', 'Drama']",1950,3
1046910,The Goddess,1958,['United States of America'],['Drama'],1950,8
23639531,The Dress Code,2000,['United States of America'],"['Drama', 'Comedy']",2000,0
2062208,Toofan,1989,['India'],['Superhero movie'],1980,9
15386228,WΔZ,2008,"['United Kingdom', 'United States of America']","['Psychological thriller', 'Crime Thriller', 'Thriller']",2000,8
18432405,The Story of a Crime,1962,['Soviet Union'],"['Short Film', 'Animation']",1960,2
9162935,Halla Bol,2008,['India'],"['Musical', 'Bollywood', 'World cinema', 'Drama']",2000,8
24571525,The Auction Block,1926,['United States of America'],['Silent film'],1920,6
17873069,I'd Rather Be Rich,1964,['United States of America'],"['Romance Film', 'Romantic comedy', 'Comedy']",1960,4
24954740,The Terror Within II,1991,['United States of America'],"['Horror', 'Science Fiction']",1990,1
32644359,The Sword With No Name,2009,['South Korea'],"['Action', 'Drama']",2000,9
3673030,Live Nude Girls,1995,['United States of America'],"['LGBT', 'Indie', 'Drama', 'Buddy film', 'Comedy', 'Comedy-drama', 'Ensemble Film']",1990,5
14311655,New Jersey Drive,1995,['United States of America'],"['Crime Fiction', 'Action/Adventure', 'Crime Drama', 'Juvenile Delinquency Film', 'Drama']",1990,5
6055524,The Fortune Code,1990,['Hong Kong'],['Chinese Movies'],1990,0
26615611,Abodh,1984,['India'],['Bollywood'],1980,4
31917050,Shredder,2003,['United States of America'],"['Slasher', 'Teen', 'Horror', 'Extreme Sports']",2000,3
845738,Frantic,1988,"['France', 'United States of America']","['Action', 'Psychological thriller', 'Mystery', 'Action/Adventure', 'Thriller']",1980,8
5207131,Homeward Bound II: Lost in San Francisco,1996,['United States of America'],"['Comedy', 'Family-Oriented Adventure', ""Children's/Family"", ""Children's"", 'Adventure', 'Drama', 'Animal Picture', 'Family Film']",1990,6
1178726,Just Imagine,1930,['United States of America'],"['Musical', 'Black-and-white', 'Comedy', 'Science Fiction', 'Fantasy']",1930,0
607673,St. Elmo's Fire,1985,['United States of America'],"['Coming of age', 'Romantic drama', 'Romance Film', 'Drama', 'Ensemble Film']",1980,5
23435357,Do Knot Disturb,2009,['India'],"['Musical', 'Comedy', 'Bollywood', 'Musical comedy', 'World cinema', 'Comedy of Errors']",2000,9
25143753,Ju-on: Shiroi Rōjo / Kuroi Shōjo,2009,[],['Horror'],2000,9
21472776,Les liaisons dangereuses,2003,"['United Kingdom', 'France', 'Canada']",['Romantic drama'],2000,3
3019993,"No Retreat, No Surrender 2",1988,"['Hong Kong', 'United States of America']","['Action', 'Chinese Movies', 'Martial Arts Film']",1980,8
1460724,Maine Pyar Kiya,1989,['India'],"['Musical', 'Romantic drama', 'Bollywood', 'World cinema', 'Romance Film', 'Drama']",1980,9
19410753,Canned Fishing,1938,['United States of America'],"['Black-and-white', 'Short Film', 'Comedy', 'Family Film']",1930,8
2648507,North Dallas Forty,1979,['United States of America'],"['Film adaptation', 'Comedy', 'Sports', 'Drama']",1970,9
24389140,Idhayam,1991,['India'],['Romance Film'],1990,1
1591722,Small Change,1976,['France'],"['Comedy', 'Drama', 'World cinema']",1970,6
6178996,Atom Man vs. Superman,1950,['United States of America'],"['Superhero movie', 'Black-and-white', 'Adventure']",1950,0
19612409,Ernesto,1979,"['Spain', 'West Germany', 'Italy']","['Musical', 'Romance Film', 'Drama']",1970,9
2182638,Head Above Water,1996,['United States of America'],"['Comedy', 'Thriller', 'Comedy Thriller', 'Black comedy']",1990,6
4830569,Lights of New York,1928,['United States of America'],"['Musical', 'Black-and-white']",1920,8
32877031,Noroît,1976,[],"['Adventure', 'Drama', 'Fantasy']",1970,6
20116785,"Kill, Baby, Kill",1968,['Italy'],"['Mystery', 'Gothic Film', 'Thriller', 'World cinema', 'Crime Thriller', 'Costume Horror', 'Horror', 'Supernatural']",1960,8
6824330,Kummeli Kultakuume,1997,['Finland'],['Comedy'],1990,7
5838040,Fun,1994,"['Canada', 'United States of America']","['Drama', 'Crime Fiction', 'Thriller']",1990,4
2796566,The Firm,1988,"['United Kingdom', 'England']",['Drama'],1980,8
2003300,It's a Wonderful World,1939,['United States of America'],"['Black-and-white', 'Crime Fiction', 'Comedy']",1930,9
5960519,The Curiosity of Chance,2006,"['Belgium', 'United States of America']","['LGBT', 'Indie', 'Comedy', 'Teen', 'World cinema', 'Gay Themed', 'Gay', 'Gay Interest', 'Comedy-drama']",2000,6
33951497,How I Killed My Father,2001,"['France', 'Spain']","['Drama', 'World cinema']",2000,1
3137903,In Too Deep,1999,['United States of America'],"['Suspense', 'Crime Fiction', 'Buddy film', 'Thriller', 'Crime Thriller', 'Drama']",1990,9
3326883,Chattahoochee,1989,"['United Kingdom', 'United States of America']","['Period piece', 'Prison', 'Drama', 'Crime Fiction', 'Biography', 'Indie']",1980,9
26523292,Ammayane Sathyam,1993,['India'],"['Romance Film', 'Comedy', 'Drama']",1990,3
7177569,The Gay Deceivers,1969,['United States of America'],"['Gay Themed', 'LGBT', 'Gay', 'Gay Interest', 'Comedy']",1960,9
5189701,Treasure Island,1972,"['Spain', 'United Kingdom', 'France', 'West Germany', 'Italy']","['Adventure', 'Family Film']",1970,2
707151,Wing Commander,1999,"['Luxembourg', 'United States of America']","['Science Fiction', 'Adventure']",1990,9
2510608,Nayak,1966,['India'],"['Art film', 'Satire', 'World cinema', 'Drama']",1960,6
8916073,Mr Ya Miss,2005,['India'],"['Comedy', 'World cinema']",2000,5
29642489,Operation C.I.A.,1965,['United States of America'],"['Spy', 'Black-and-white', 'Thriller', 'Drama']",1960,5
14328634,Curtain Up,1952,['United Kingdom'],"['Comedy', 'Satire']",1950,2
26042283,Gülen Gözler,1977,['Turkey'],"['Drama', 'Comedy']",1970,7
25053516,Hannah Free,2009,['United States of America'],"['Romance Film', 'LGBT', 'Drama']",2000,9
8532390,The Wounds,1998,"['Yugoslavia', 'Serbia', 'France', 'Germany']","['Crime Fiction', 'Comedy', 'Thriller', 'World cinema', 'Teen', 'Crime Thriller', 'Drama', 'Coming of age', 'War film']",1990,8
17527920,Ninja Assassin,2009,"['Germany', 'United States of America']","['Action', 'Crime Fiction', 'Action Thrillers', 'Action/Adventure', 'Thriller', 'Martial Arts Film', 'Ninja movie', 'Drama']",2000,9
316540,Macross Plus,1995,['Japan'],"['Animation', 'Short Film', 'Anime', 'Science Fiction']",1990,5
27617747,"The 3,000 Mile Chase",1977,['United States of America'],"['Action', 'Drama']",1970,7
1964896,Best of the Best,1989,['United States of America'],"['Sports', 'Action/Adventure', 'Martial Arts Film']",1980,9
1808380,Not Without My Daughter,1991,['United States of America'],"['Thriller', 'Docudrama', 'Political drama', 'Escape Film', 'Drama']",1990,1
1276915,The Big Store,1941,['United States of America'],"['Musical', 'Black-and-white', 'Comedy']",1940,1
20240796,Wedding in Galilee,1988,"['Israel', 'France', 'Belgium']","['Romantic drama', 'World cinema', 'Romance Film', 'Political drama', 'Drama']",1980,8
4055736,Strangeland,1998,['United States of America'],"['Psychological thriller', 'Slasher', 'Thriller', 'Horror', 'Teen']",1990,8
925951,Call Me Bwana,1963,['United Kingdom'],"['Action', 'Spy', 'Adventure Comedy', 'Comedy']",1960,3
1519350,Not Another Teen Movie,2001,['United States of America'],"['Gross out', 'Gross-out film', 'Parody', 'Comedy', 'Teen', 'Sex comedy']",2000,1
23937456,The Way of War,2009,['United States of America'],"['Action', 'Action/Adventure', 'Thriller', 'Crime Thriller', 'War film']",2000,9
17836327,Tarzan's Fight for Life,1958,['United States of America'],"['Adventure', 'Jungle Film']",1950,8
2311212,Double Impact,1991,['United States of America'],"['Action', 'Crime Fiction', 'Action/Adventure', 'Thriller', 'Martial Arts Film']",1990,1
10628838,Veera,1994,['India'],['Romantic comedy'],1990,4
8267180,King of the Royal Mounted,1940,['United States of America'],"['Action', 'Spy', 'Black-and-white', 'Action/Adventure', 'Northern', 'Adventure']",1940,0
16797102,I've Got Your Number,1934,['United States of America'],"['Black-and-white', 'Crime Fiction', 'Comedy', 'Crime Comedy', 'Romantic comedy']",1930,4
21621385,Jag Jeondeyan De Mele,2009,"['Canada', 'India']","['Romance Film', 'Drama']",2000,9
26588532,Ustaad,1999,['India'],"['Action', 'Thriller', 'Drama']",1990,9
7408024,Iga no Kabamaru,1983,['Japan'],"['Comedy', 'Animation']",1980,3
9264215,Walk Hard: The Dewey Cox Story,2007,['United States of America'],"['Musical', 'Parody', 'Comedy', 'Musical comedy', 'Drama']",2000,7
10167385,Beauty and the Bastard,2005,['Finland'],['Drama'],2000,5
14553911,Injun Trouble,1969,[],"['Animation', 'Short Film', 'Comedy']",1960,9
26147498,The Jimmy Show,2001,['United States of America'],"['Psychological thriller', 'Indie', 'Comedy', 'Black comedy']",2000,1
15837920,Dream Girl,1977,['India'],"['Romance Film', 'Thriller']",1970,7
5499955,Half Human,1955,['Japan'],"['Creature Film', 'Japanese Movies', 'Horror', 'Science Fiction']",1950,5
14160954,The Story of Gilbert and Sullivan,1953,['United Kingdom'],"['Biography', 'Drama']",1950,3
3520833,Horse Sense,1999,['United States of America'],"['Drama', 'Family Film']",1990,9
2018921,The First Wives Club,1996,['United States of America'],"['Screwball comedy', 'Buddy film', 'Comedy', 'Comedy of manners', 'Romance Film', 'Romantic comedy', 'Feminist Film']",1990,6
26195831,Footlight Serenade,1942,['United States of America'],"['Musical', 'Romance Film', 'Comedy']",1940,2
983849,Top Secret!,1984,"['United Kingdom', 'United States of America']","['Action', 'Parody', 'Comedy', 'Romance Film', 'Absurdism']",1980,4
4066047,Hollywoodland,2006,['United States of America'],"['Detective fiction', 'Crime Fiction', 'Mystery', 'Biography', 'Thriller', 'Romance Film', 'Drama', 'Period piece', 'History', 'Detective']",2000,6
8823243,The Vulture,1981,['Israel'],['Drama'],1980,1
3529964,Black Rain,1989,['United States of America'],"['Action', 'Suspense', 'Crime Fiction', 'Action/Adventure', 'Thriller', 'Drama']",1980,9
14285052,Mad Detective,2007,['Hong Kong'],"['Action', 'Action/Adventure', 'Thriller', 'World cinema', 'Crime Thriller', 'Chinese Movies']",2000,7
5603842,From Soup to Nuts,1928,['United States of America'],"['Black-and-white', 'Indie', 'Short Film', 'Comedy', 'Silent film', 'Slapstick']",1920,8
23825607,Meatball Machine,2005,['Japan'],"['Japanese Movies', 'Avant-garde', 'Horror', 'World cinema', 'Experimental film', 'Science Fiction']",2000,5
13964642,The Hideous Sun Demon,1959,['United States of America'],"['Creature Film', 'Monster movie', 'Horror', 'B-movie', 'Sci-Fi Horror', 'Science Fiction']",1950,9
17595302,Tom Horn,1980,['United States of America'],"['Revisionist Western', 'Action/Adventure', 'Western', 'Biographical film', 'Biopic [feature]']",1980,0
1261599,Ossessione,1943,['Italy'],"['Black-and-white', 'Mystery', 'World cinema', 'Crime Drama', 'Film noir', 'Drama']",1940,3
24236496,Queen of Cactus Cove,2005,['United States of America'],"['Short Film', 'Comedy film']",2000,5
12315045,Dead Air,2008,['United States of America'],"['Suspense', 'Thriller', 'Horror', 'Zombie Film', 'Science Fiction']",2000,8
2703088,Double Whoopee,1929,['United States of America'],"['Black-and-white', 'Indie', 'Short Film', 'Comedy', 'Silent film', 'Slapstick']",1920,9
9408711,The Minder,2006,"['Argentina', 'France', 'Germany', 'Uruguay']","['Indie', 'Drama']",2000,6
3347962,Condorman,1981,['United States of America'],"['Action', 'Spy', 'Superhero', 'Action Thrillers', 'Comedy', 'Superhero movie', 'Adventure']",1980,1
26030961,Grounds for Marriage,1951,['United States of America'],"['Musical', 'Romance Film', 'Comedy']",1950,1
35271106,Why Girls Leave Home,1921,['United States of America'],"['Silent film', 'Drama']",1920,1
4429452,Anguish,1988,['Spain'],"['Psychological thriller', 'Slasher', 'Horror', 'World cinema']",1980,8
6274712,The Black Swan,1942,['United States of America'],"['Action', 'Costume Adventure', 'Action/Adventure', 'Adventure', 'Swashbuckler films']",1940,2
33512455,"Gone, But Not Forgotten",2003,['United States of America'],"['LGBT', 'Indie', 'Romance Film', 'Drama']",2000,3
3341234,Blues in the Night,1941,['United States of America'],"['Musical', 'Black-and-white', 'Film noir', 'Melodrama', 'Road movie', 'Drama']",1940,1
6534040,The Mad Monster,1942,['United States of America'],"['Creature Film', 'Black-and-white', 'Horror', 'Science Fiction']",1940,2
4946682,Backdancers!,2006,['Japan'],['Japanese Movies'],2000,6
2199348,So Long at the Fair,1950,['United Kingdom'],"['Mystery', 'Drama']",1950,0
289890,Piglet's Big Movie,2003,['United States of America'],"['Music', 'Musical', 'Animation', 'Animated Musical', ""Children's/Family"", ""Children's"", 'Family Film']",2000,3
1250208,Jungle 2 Jungle,1997,"['United States of America', 'France']","['Slapstick', 'Comedy', 'Jungle Film', ""Children's/Family"", 'Adventure', 'Family Film']",1990,7
27583067,The Little Moscow,2008,['Poland'],"['Romance Film', 'History', 'Drama']",2000,8
9819018,Strawberry Shortcake: Berry Blossom Festival,2006,['United States of America'],"[""Children's"", 'Animation']",2000,6
4240215,The Battle of Shaker Heights,2003,['United States of America'],"['Indie', 'Romantic drama', 'Comedy', 'Teen', 'Romance Film', 'Drama', 'Coming of age', 'Comedy-drama']",2000,3
11164932,The Sea of Grass,1947,['United States of America'],"['Period piece', 'Film adaptation', 'Black-and-white', 'Action/Adventure', 'Western', 'Marriage Drama', 'Drama']",1940,7
6369028,All About Ah Long,1989,['Hong Kong'],"['Family Drama', 'World cinema', 'Melodrama', 'Chinese Movies', 'Drama']",1980,9
23837735,French Provincial,1975,['France'],"['Drama', 'Comedy']",1970,5
34269989,The Hoodlum Saint,1946,['United States of America'],"['Musical', 'Drama']",1940,6
27045661,Navarathri,1966,['India'],"['Musical', 'Romantic drama', 'Bollywood', 'World cinema', 'Romance Film', 'Drama']",1960,6
21051852,The Thrill Killers,1964,['United States of America'],"['Action', 'Crime Fiction', 'Thriller', 'Horror']",1960,4
8802809,The Enchanted Boy,1955,['Russia'],"['Animation', 'Short Film', 'Family Film']",1950,5
8612307,The Well,1951,['United States of America'],"['Film noir', 'Drama']",1950,1
5118135,Land of the Blind,2006,"['United Kingdom', 'United States of America']","['Political drama', 'Satire', 'Drama']",2000,6
905530,Pickup on South Street,1953,['United States of America'],"['Spy', 'Black-and-white', 'Thriller', 'Film noir', 'Political drama', 'Drama', 'Political thriller']",1950,3
1662223,Odds Against Tomorrow,1959,['United States of America'],"['Black-and-white', 'Crime Fiction', 'Thriller', 'Film noir', 'Drama', 'Heist', 'Caper story', 'Crime Drama']",1950,9
9222167,The Moon's Our Home,1936,['United States of America'],"['Romance Film', 'Black-and-white', 'Comedy']",1930,6
35759185,Chakravarthy,1995,['India'],['Crime Fiction'],1990,5
15713038,Jennifer's Body,2009,['United States of America'],"['Satire', 'Comedy', 'Teen', 'Horror Comedy', 'Black comedy', 'Parody', 'Horror', 'Supernatural']",2000,9
4122840,Urban Legends: Bloody Mary,2005,['United States of America'],"['Slasher', 'Teen', 'Horror', 'Supernatural']",2000,5
7490147,Making Stars,1935,['United States of America'],"['Animation', 'Short Film', 'Comedy', 'Family Film']",1930,5
15826744,Hills of Home,1948,['United States of America'],['Drama'],1940,8
23024134,Saskatchewan,1954,['United States of America'],"['Action', 'Western', 'Northern']",1950,4
24587806,The Single Standard,1929,['United States of America'],"['Silent film', 'Melodrama', 'Drama']",1920,9
2342514,My Summer of Love,2004,['United Kingdom'],"['Film adaptation', 'LGBT', 'Coming of age', 'Romantic drama', 'Romance Film', 'Drama']",2000,4
1412632,Head-On,2004,"['Germany', 'Turkey', 'Canada']","['Romantic drama', 'World cinema', 'Romance Film', 'Drama']",2000,4
190393,Summertime,1955,"['United Kingdom', 'United States of America']","['Romance Film', 'Drama']",1950,5
406339,The Crow,1994,['United States of America'],"['Action', 'Indie', 'Action/Adventure', 'Thriller', 'Superhero movie', 'Fantasy']",1990,4
1677642,Five Corners,1987,"['United Kingdom', 'United States of America']","['Period piece', 'Drama', 'Indie', 'Comedy', 'Romance Film', 'Comedy-drama', 'Ensemble Film']",1980,7
30172991,Dancing Co Ed,1939,['United States of America'],"['Romance Film', 'Comedy']",1930,9
4265319,The Handmaid's Tale,1990,"['Germany', 'United States of America']","['Film adaptation', 'Drama', 'Dystopia', 'Feminist Film', 'Indie', 'Science Fiction']",1990,0
22324733,The Last Days of Pompeii,1935,['United States of America'],"['Action', 'Action/Adventure', 'Disaster', 'Adventure', 'Drama', 'Period piece', 'History', 'Epic']",1930,5
4226034,ID,1995,['United Kingdom'],['Horror'],1990,5
8494445,The Legend of the Sky Kingdom,2003,['Zimbabwe'],"['Animation', 'Stop motion', ""Children's/Family"", 'Adventure', 'Family Film']",2000,3
22915257,The Wooden Man's Bride,1994,['China'],"['Romantic drama', 'World cinema', 'Romance Film', 'Chinese Movies', 'Drama']",1990,4
21487047,Manhattan Tower,1932,['United States of America'],['Drama'],1930,2
22492025,Story of Wine,2008,['South Korea'],"['Drama', 'World cinema']",2000,8
32456591,Ach du fröhliche...,1962,['German Democratic Republic'],"['Drama', 'Comedy']",1960,2
1776465,Clambake,1967,['United States of America'],"['Musical', 'Romance Film', 'Beach Film']",1960,7
6531454,Revolt of the Zombies,1936,['United States of America'],"['Creature Film', 'Black-and-white', 'Indie', 'Horror', 'B-movie', 'Zombie Film']",1930,6
10511781,Tornado!,1996,['United States of America'],"['Action', 'Natural horror films', 'Action/Adventure', 'Television movie', 'Disaster']",1990,6
4572965,Hostel 2,2007,['United States of America'],"['Slasher', 'Thriller', 'Horror', 'Cult']",2000,7
21219881,The Da Vinci Treasure,2006,['United States of America'],"['Action', 'Drama', 'Mystery', 'Indie', 'Action/Adventure', 'Thriller']",2000,6
25078889,Jerky Turkey,1945,[],"['Animation', 'Short Film', 'Comedy film']",1940,5
161912,True Grit,1969,['United States of America'],"['Film adaptation', 'Action/Adventure', 'Western', 'Costume drama', 'Adventure', 'Drama']",1960,9
4538840,Hard Candy,2005,['United States of America'],"['Psychological thriller', 'Suspense', 'Drama', 'Indie', 'Thriller', 'Erotic thriller']",2000,5
474085,Bad News Bears,2005,['United States of America'],"['Sports', 'Comedy', 'Family Film']",2000,5
15493185,Hooked on You,2007,['Hong Kong'],"['Romantic drama', 'Comedy', 'World cinema', 'Romance Film', 'Chinese Movies', 'Drama', 'Romantic comedy', 'Comedy-drama']",2000,7
20639858,Cyrano Fernandez,2007,['Venezuela'],['Drama'],2000,7
12618963,The Young Mr Pitt,1942,"['United Kingdom', 'United States of America']",['Biographical film'],1940,2
4557715,Road to Utopia,1946,['United States of America'],"['Adventure Comedy', 'Musical', 'Screwball comedy', 'Buddy film', 'Comedy']",1940,6
13705136,Phagun,1973,['India'],"['Romance Film', 'Drama', 'Family Film']",1970,3
11861651,Powwow highway,1989,"['United Kingdom', 'United States of America']","['Film adaptation', 'Drama', 'Indie', 'Comedy', 'Comedy-drama', 'Road movie']",1980,9
26615804,Hareendran Oru Nishkalankan,2007,[],['Drama'],2000,7
17645321,The Entrance,2006,['Canada'],"['Thriller', 'Horror', 'Crime Thriller', 'Supernatural']",2000,6
17672269,The Stupor Salesman,1948,[],"['Animation', 'Short Film', 'Family Film']",1940,8
31155997,Maybe,1999,['France'],"['Science Fiction', 'Drama']",1990,9
10909042,Chandrolsavam,2005,['India'],"['Action', 'Drama', 'Thriller', 'Romance Film']",2000,5
11996582,The Hare-Brained Hypnotist,1942,[],"['Animated cartoon', 'Short Film', 'Family Film']",1940,2
5317549,Hood of Horror,2006,['United States of America'],"['Action', 'Indie', 'Slasher', 'Comedy', 'Horror', 'Cult']",2000,6
23308812,Maid's Night Out,1938,['United States of America'],"['Romantic comedy', 'Black-and-white', 'Comedy']",1930,8
20533915,Panhandle Scandal,1959,['United States of America'],"['Animation', 'Western', 'Short Film', 'Comedy', 'Family Film']",1950,9
26254041,April Love,1957,['United States of America'],"['Musical', 'Film adaptation', 'Romantic drama', 'Animal Picture', 'Romance Film', 'Drama']",1950,7
8056834,Chehraa,2005,['India'],"['Romantic drama', 'Thriller', 'World cinema', 'Romance Film', 'Drama']",2000,5
28714062,Orpheus Descending,1990,['United States of America'],"['Romance Film', 'Drama']",1990,0
2068983,Zero Day,2003,['United States of America'],"['Drama', 'Crime Fiction', 'Indie', 'Juvenile Delinquency Film']",2000,3
22600484,Team Picture,2007,['United States of America'],"['Drama', 'Indie', 'Comedy', 'Avant-garde', 'Experimental film', 'Slice of life story']",2000,7
205512,Monty Python's The Meaning of Life,1983,['United Kingdom'],"['Parody', 'Satire', 'Comedy', 'Black comedy', 'Cult']",1980,3
20669,My Neighbor Totoro,1988,['Japan'],"['Animation', 'World cinema', 'Family-Oriented Adventure', ""Children's/Family"", ""Children's"", 'Adventure', ""Children's Fantasy"", 'Japanese Movies', 'Anime', 'Family Film', 'Fantasy']",1980,8
1832735,The Deluge,1974,['Poland'],['War film'],1970,4
6047844,Bad Medicine,1985,['United States of America'],['Comedy'],1980,5
23993252,Appointment with Crime,1946,['United Kingdom'],"['Drama', 'Crime Thriller', 'Thriller']",1940,6
893808,Robots,2005,['United States of America'],"['Animation', 'Comedy', 'Adventure', 'Romance Film', 'Science Fiction', 'Family Film']",2000,5
6724790,3 Ring Circus,1954,['United States of America'],['Comedy'],1950,4
20904222,Tyaag,1977,['India'],"['Crime Fiction', 'Romance Film', 'Drama', 'Family Film']",1970,7
2010693,The Mighty Peking Man,1977,['Hong Kong'],"['Action', 'Action/Adventure', 'Thriller', 'World cinema', 'Chinese Movies', 'Adventure', 'Creature Film', 'Jungle Film']",1970,7
25817040,Quincy Adams Sawyer,1922,['United States of America'],['Silent film'],1920,2
13359663,Blue Puppy,1976,['Soviet Union'],['Short Film'],1970,6
13343266,Wicked,1998,['United States of America'],"['Black comedy', 'Indie', 'Thriller']",1990,8
8201824,Tiger Shark,1932,['United States of America'],"['Action', 'Black-and-white', 'Drama', 'Romance Film', 'Adventure']",1930,2
4977595,The Brotherhood,2001,['United States of America'],['Horror'],2000,1
14335277,It's Love I'm After,1937,['United States of America'],"['Black-and-white', 'Screwball comedy', 'Comedy', 'Romance Film', 'Romantic comedy']",1930,7
23457800,The Case of the Black Cat,1936,['United States of America'],"['Crime Fiction', 'Mystery', 'Drama']",1930,6
9145129,Thunder in the Sun,1959,['United States of America'],"['Western', 'Action/Adventure', 'Adventure']",1950,9
542964,Tintin and the Golden Fleece,1961,"['France', 'Belgium']","['Adventure', 'Drama']",1960,1
1539559,Inferno,1953,['United States of America'],"['Film noir', 'Drama', 'Thriller']",1950,3
552592,The Mighty Ducks,1992,['United States of America'],"['Comedy', ""Children's/Family"", 'Sports', 'Family Film']",1990,2
23795113,Love for Sale,2008,['United States of America'],"['Comedy', 'Romance Film', 'Romantic comedy', 'Drama']",2000,8
9336287,The Kiss Before the Mirror,1933,['United States of America'],"['Suspense', 'Melodrama', 'Pre-Code', 'Drama', 'Courtroom Drama']",1930,3
293524,Beetlejuice,1988,['United States of America'],"['Heaven-Can-Wait Fantasies', 'Comedy', 'Horror', 'Black comedy', 'Fantasy Comedy', 'Haunted House Film', 'Fantasy']",1980,8
3827592,"Beware, My Lovely",1952,['United States of America'],"['Crime Fiction', 'Thriller', 'Film noir', 'Crime Thriller', 'Drama']",1950,2
6395094,Once Upon a Time in the Midlands,2002,"['United Kingdom', 'Germany', 'England', 'Netherlands']","['Action', 'Indie', 'Action/Adventure', 'Comedy', 'Romance Film', 'Drama', 'Romantic comedy', 'Comedy-drama', 'Comedy of manners']",2000,2
394792,Jackie Brown,1997,['United States of America'],"['Action', 'Blaxploitation', 'Crime Fiction', 'Indie', 'Action/Adventure', 'Comedy', 'Thriller', 'Crime Thriller', 'Drama']",1990,7
32643398,Last Song in Paris,1986,[],['Romance Film'],1980,6
4056928,Trust,1990,"['United Kingdom', 'United States of America']","['Drama', 'Indie', 'Comedy', 'Black comedy', 'Romantic comedy', 'Romance Film']",1990,0
25263706,The Dog Who Saved Christmas,2009,['United States of America'],"['Comedy', 'Television movie', ""Children's/Family"", 'Holiday Film', 'Family Film']",2000,9
10706032,Pooja Ke Phool,1964,['India'],"['Musical', 'Drama', 'Family Film']",1960,4
3837141,Elevator to the Gallows,1958,['France'],"['Psychological thriller', 'Black-and-white', 'Crime Fiction', 'Thriller', 'World cinema', 'Film noir', 'Drama']",1950,8
19708587,Habit,1995,['United States of America'],"['Psychological thriller', 'Horror', 'Romance Film', 'Drama']",1990,5
2298412,Gentleman,1993,['India'],"['Musical', 'Crime Fiction', 'Tamil cinema', 'World cinema', 'Drama']",1990,3
26431171,For Sale by Owner,2009,"['Austria', 'United States of America']","['Indie', 'Short Film', 'Thriller', 'Horror', 'Drama']",2000,9
1521540,Trinity,2001,['United Kingdom'],['Science Fiction'],2000,1
6238376,Soigne ta droite,1987,"['Switzerland', 'France']","['Media Satire', 'Comedy', 'World cinema']",1980,7
7873210,Lord of the Flies,1990,['United States of America'],"['Psychological thriller', 'Film adaptation', 'Thriller', 'Adventure', 'Drama']",1990,0
3526088,A Christmas Carol,1999,"['United Kingdom', 'United States of America']","['Film adaptation', 'Family Drama', 'Costume drama', 'Christmas movie', 'Drama', 'Period piece', 'Television movie', 'Family Film']",1990,9
9039938,Las Aventuras de Dios,2000,['Argentina'],"['Surrealism', 'Drama', 'Fantasy']",2000,0
7601962,The Heyde/Sawade Affair,1963,['Germany'],['Crime Fiction'],1960,3
158052,"Aguirre, the Wrath of God",1972,"['Mexico', 'Germany', 'West Germany', 'Peru']","['Art film', 'World cinema', 'Costume drama', 'Adventure', 'Drama', 'Existentialism', 'Jungle Film', 'Historical fiction', 'Historical Epic']",1970,2
20001210,Souryam,2008,['India'],"['Romance Film', 'Drama']",2000,8
22870525,Qurbaan,2009,['India'],"['Action', 'Crime Fiction', 'Thriller', 'Bollywood', 'Romance Film', 'Drama']",2000,9
965988,Barbarians at the Gate,1993,['United States of America'],"['Comedy', 'Satire', 'Television movie', 'Comedy-drama']",1990,3
9157507,Charlie & Louise - Das doppelte Lottchen,1994,['Germany'],"['Family Film', ""Children's"", 'Comedy film']",1990,4
2210017,Something Wicked This Way Comes,1983,['United States of America'],"['Psychological thriller', 'Film adaptation', 'Thriller', 'Drama', 'Coming of age', 'Horror', 'Supernatural', 'Science Fiction', 'Family Film', 'Fantasy']",1980,3
22091537,Speed,1936,['United States of America'],['Auto racing'],1930,6
14268823,"Westward Ho, The Wagons!",1956,['United States of America'],['Western'],1950,6
1195560,2010: The Year We Make Contact,1984,['United States of America'],"['Psychological thriller', 'Film adaptation', 'Thriller', 'Adventure', 'Science Fiction', 'Drama']",1980,4
13226815,Stop Violence,2002,['India'],"['Action', 'Drama', 'Crime Fiction', 'Thriller']",2000,2
35993713,The Fear Inside,1992,['United States of America'],"['Thriller', 'Drama']",1990,2
10348583,Undisputed II: Last Man Standing,2005,['United States of America'],"['Action', 'Boxing', 'Crime Fiction', 'Action/Adventure', 'Thriller', 'Sports', 'Martial Arts Film']",2000,5
24336780,My Boy Jack,2007,['United Kingdom'],"['Period piece', 'War film', 'Drama']",2000,7
11517671,Damaged Lives,1933,"['Canada', 'United States of America']","['Melodrama', 'Drama', 'Medical fiction']",1930,3
74830,Jaws,1975,['United States of America'],['Thriller'],1970,5
528464,Ed Wood,1994,['United States of America'],"['Black-and-white', 'LGBT', 'Comedy', 'Biographical film', 'Black comedy', 'Drama', 'Biopic [feature]', 'Comedy-drama', 'Cult']",1990,4
30013045,The Sinful Dwarf,1973,"['Denmark', 'United States of America']","['Monster movie', 'Crime Fiction', 'Slasher', 'Horror', 'B-movie', 'Adult']",1970,3
2506296,Fat Choi Spirit,2002,['Hong Kong'],"['Chinese Movies', 'Comedy']",2000,2
5713867,Man of a Thousand Faces,1957,['United States of America'],"['Biography', 'Biographical film', 'Biopic [feature]', 'Drama']",1950,7
18203744,The Pumpkin Karver,2006,['United States of America'],"['Indie', 'Slasher', 'Horror', 'B-movie']",2000,6
18672950,Hero,1985,['Pakistan'],['Musical'],1980,5
27875695,An Ideal Husband,2000,['United Kingdom'],['Comedy film'],2000,0
19286426,Aayirathil Oruvan,1965,['India'],"['Action', 'Adventure']",1960,5
24469993,Ladies of Leisure,1930,['United States of America'],"['Romance Film', 'Drama']",1930,0
945029,Analyze This,1999,"['United States of America', 'Australia']","['Comedy', 'Crime Fiction']",1990,9
14262340,Jane and the Lost City,1987,"['United Kingdom', 'United States of America']","['Adventure Comedy', 'Action', 'Superhero', 'Action/Adventure', 'Comedy', 'Superhero movie', 'Adventure']",1980,7
7690276,Reinas,2006,['Spain'],"['LGBT', 'Comedy', 'World cinema', 'Romance Film', 'Romantic comedy']",2000,6
3388805,No Man's Land,1987,['United States of America'],"['Action', 'Drama', 'Crime Fiction', 'Crime Thriller']",1980,7
226842,Ken Park,2002,"['France', 'Netherlands', 'United States of America']","['Indie', 'Teen', 'Erotica', 'Drama']",2000,2
66841,Fly Away Home,1996,['United States of America'],"['Coming of age', 'Family Drama', 'Adventure', 'Drama', 'Family Film']",1990,6
6651585,Frogs,1972,['United States of America'],"['B-movie', 'Natural horror films', 'Horror']",1970,2
28067279,You're My Everything,1949,['United States of America'],"['Musical', 'Comedy']",1940,9
3093681,Across the Wide Missouri,1951,['United States of America'],"['Action/Adventure', 'Western', 'Epic Western', 'Indian Western']",1950,1
8336887,Alien Nation: Dark Horizon,1994,['United States of America'],"['Buddy film', 'Television movie', 'Science Fiction', 'Drama']",1990,4
23323263,Dot Goes to Hollywood,1987,['Australia'],"['Family Film', 'Animation']",1980,7
21155353,Say Hello to Yesterday,1971,['United Kingdom'],"['Romance Film', 'Romantic drama', 'Drama']",1970,1
2591597,Color Me Kubrick,2005,"['United Kingdom', 'France']","['LGBT', 'Indie', 'Comedy', 'Drama']",2000,5
28340151,Dear Murderer,1947,['United Kingdom'],"['Thriller', 'Crime Thriller']",1940,7
25828515,His Glorious Night,1929,['United States of America'],['Romance Film'],1920,9
1865502,Wrongfully Accused,1998,"['Germany', 'United States of America']","['Action', 'Parody', 'Action/Adventure', 'Comedy', 'Absurdism']",1990,8
1190681,Albert RN,1953,['United Kingdom'],"['Prison escape', 'War film']",1950,3
24771808,Going Inside a Storm,1965,['Soviet Union'],['Drama'],1960,5
3720437,Perumazhakkalam,2004,['India'],['Drama'],2000,4
5971538,28 Weeks Later,2007,"['United Kingdom', 'Spain']","['Thriller', 'Horror', 'Plague', 'Zombie Film', 'Doomsday film', 'Sci-Fi Horror', 'Science Fiction']",2000,7
26719738,One Way Ticket,2008,['India'],"['Musical', 'Comedy', 'Bollywood', 'World cinema']",2000,8
4036006,Kid Millions,1934,['United States of America'],"['Musical', 'Black-and-white', 'Comedy']",1930,4
1072060,Blood Work,2002,['United States of America'],"['Detective fiction', 'Crime Fiction', 'Mystery', 'Thriller', 'Crime Thriller', 'Drama', 'Suspense', 'Detective']",2000,2
25852256,Tora-san's Rise and Fall,1975,['Japan'],['Japanese Movies'],1970,5
1367183,Blueprint,2003,['Germany'],"['Science Fiction', 'Drama']",2000,3
6258479,The Craic,1999,['Australia'],"['Road movie', 'Screwball comedy', 'Comedy']",1990,9
894179,The Asphalt Jungle,1950,['United States of America'],"['Black-and-white', 'Crime Fiction', 'Gangster Film', 'Thriller', 'Film noir', 'Crime Thriller', 'Drama', 'Heist', 'Caper story']",1950,0
18178296,The West Point Story,1950,['United States of America'],"['Musical', 'Black-and-white', 'Comedy', 'Musical comedy', 'Romance Film']",1950,0
2508308,Romeo Is Bleeding,1994,"['United Kingdom', 'United States of America']","['Action', 'Neo-noir', 'Crime Fiction', 'Gangster Film', 'Action/Adventure', 'Thriller', 'Black comedy', 'Crime Thriller', 'Suspense', 'Erotic thriller']",1990,4
11380312,The Devil's Eye,1960,['Sweden'],"['Black-and-white', 'Drama', 'Comedy', 'Fantasy Comedy', 'Fantasy']",1960,0
17901762,The Ugly Truth,2009,['United States of America'],"['Romance Film', 'Romantic comedy', 'Comedy']",2000,9
4586733,Youngblood,1978,['United States of America'],"['Action', 'Crime Fiction', 'Drama']",1970,8
17070479,I Come with the Rain,2009,"['United States of America', 'France']","['Psychological thriller', 'Detective fiction', 'Crime Fiction', 'Drama', 'Indie', 'Thriller', 'Detective']",2000,9
22353314,Hoodlum & Son,2003,['United Kingdom'],"['Action', 'Crime Fiction', 'Gangster Film', 'Action/Adventure', 'Comedy']",2000,3
20797710,Pyaar Mein Twist,2005,['India'],"['Musical', 'Comedy', 'Drama']",2000,5
6504325,Gunga Din,1939,['United States of America'],"['British Empire Film', 'Action', 'Black-and-white', 'Action/Adventure', 'Cavalry Film', 'Adventure', 'Drama', 'Epic', 'War film']",1930,9
23747829,Detective Naani,2009,['India'],"['Crime Fiction', 'Drama', 'Family Film']",2000,9
27079761,Mao's Last Dancer,2009,['Australia'],"['Musical', 'Film adaptation', 'Biographical film', 'World cinema', 'Romance Film', 'Drama', 'Period piece', 'Biopic [feature]', 'Dance', 'Political drama']",2000,9
12567618,Tomboy,1985,['United States of America'],"['Indie', 'Comedy', 'Romance Film', 'Romantic comedy']",1980,5
1563948,The Shanghai Gesture,1941,['United States of America'],"['Black-and-white', 'Costume Adventure', 'Crime Fiction', 'Mystery', 'Thriller', 'Film noir', 'Crime Thriller', 'Drama', 'Suspense', 'Melodrama']",1940,1
1065214,Amadeus,1984,['United States of America'],"['Music', 'Biography', 'Biographical film', 'Musical Drama', 'Costume drama', 'Drama', 'Period piece', 'Biopic [feature]', 'Comedy-drama']",1980,4
10127547,Melinda's World,2003,['United States of America'],"['Period piece', 'Family Drama', 'Indie', 'Childhood Drama', 'Drama']",2000,3
6992985,Knockabout,1979,['Hong Kong'],"['Action', 'Martial Arts Film', 'Action Comedy', 'Action/Adventure', 'Comedy', 'World cinema', 'Chinese Movies']",1970,9
10921936,Ilzaam,1986,['India'],['Family Film'],1980,6
27113000,Affinity,2008,"['United Kingdom', 'Canada', 'Romania']","['Period piece', 'LGBT', 'Mystery', 'Thriller', 'Romance Film', 'Drama', 'Women in prison films']",2000,8
24353923,The Invincible Six,1970,['Iran'],['Adventure'],1970,0
2554598,One Week,1920,['United States of America'],"['Black-and-white', 'Indie', 'Short Film', 'Comedy', 'Silent film']",1920,0
8882635,Eat and Run,1986,['United States of America'],"['Crime Fiction', 'Parody', 'Comedy', 'Science Fiction']",1980,6
28151121,A Very Special Favor,1965,['United States of America'],"['Romance Film', 'Romantic comedy', 'Comedy']",1960,5
5003734,The Man Who Wouldn't Die,1994,['United States of America'],['Crime Fiction'],1990,4
4306406,My Best Friend Is a Vampire,1988,['United States of America'],"['Comedy', 'Teen', 'Horror']",1980,8
12130331,Frost/Nixon,2008,"['United Kingdom', 'France', 'United States of America']","['History', 'Docudrama', 'Political drama', 'Drama']",2000,8
1141438,The Aviator,2004,"['Germany', 'United States of America', 'Japan']","['Period piece', 'Airplanes and airports', 'Japanese Movies', 'Biography', 'Biographical film', 'Drama']",2000,4
397574,Remember the Titans,2000,['United States of America'],"['Inspirational Drama', 'Biography', 'Americana', 'Sports', 'Drama']",2000,0
7660298,Corridors of Blood,1958,['United Kingdom'],"['Black-and-white', 'Thriller', 'Horror', 'Addiction Drama', 'Drama']",1950,8
21686862,Colour Blind,2009,['United Kingdom'],['Short Film'],2000,9
33010334,The Mystery of a Hansom Cab,1925,[],['Silent film'],1920,5
10453526,Casa de Lava,1995,['Portugal'],['Drama'],1990,5
5275752,The Ultimate Gift,2006,['United States of America'],"['Film adaptation', 'Indie', 'Inspirational Drama', 'Family Drama', 'Christian film', 'Drama', 'Coming of age', 'Family Film']",2000,6
10815416,Patala Bhairavi,1951,['India'],['Swashbuckler films'],1950,1
28156854,Preminchu,2001,['India'],['Drama'],2000,1
3096383,Bobby,2006,['United States of America'],"['Period piece', 'History', 'Political drama', 'Drama']",2000,6
7457548,Doll Graveyard,2005,['United States of America'],"['B-movie', 'Teen', 'Horror']",2000,5
3053945,Start the Revolution Without Me,1970,['United States of America'],"['Slapstick', 'Comedy']",1970,0
9504064,El Boquete,2006,['Argentina'],"['Drama', 'Comedy']",2000,6
1164544,Identity,2003,['United States of America'],"['Psychological thriller', 'Mystery', 'Slasher', 'Thriller', 'Crime Thriller']",2000,3
29544434,Penance,2009,['United States of America'],"['Slasher', 'Horror']",2000,9
2696891,Charlotte's Web,2006,"['Germany', 'United States of America']","['Animation', 'Comedy', ""Children's"", 'Family Film', 'Fantasy']",2000,6
10642431,You Know My Name,1999,['United States of America'],"['Revisionist Western', 'Action/Adventure', 'Western', 'Biopic [feature]', 'Drama']",1990,9
1419209,O Homem Que Copiava,2003,['Brazil'],"['LGBT', 'Crime Fiction', 'Romantic drama', 'Comedy', 'World cinema', 'Romance Film', 'Drama', 'Romantic comedy']",2000,3
5720909,Primeval,2007,['United States of America'],"['Action', 'Action/Adventure', 'Thriller', 'Horror', 'Natural horror films']",2000,7
1266043,Hostage,2005,"['Germany', 'United States of America']","['Action', 'Mystery', 'Action/Adventure', 'Thriller', 'Crime Thriller', 'Drama']",2000,5
9421015,Three Roses,2003,['India'],"['Action', 'Adventure']",2000,3
2572619,"He's Your Dog, Charlie Brown",1968,['United States of America'],"['Animation', 'Drama', 'Family Film']",1960,8
6273879,Mademoiselle Fifi,1944,['United States of America'],['Black-and-white'],1940,4
8094994,Susie the Little Blue Coupe,1952,['United States of America'],"['Short Film', 'Animation']",1950,2
466612,Medium Cool,1969,['United States of America'],"['Romance Film', 'Social problem film', 'Political drama', 'Drama']",1960,9
24955967,Ci Ling,2009,['Taiwan'],"['Action', 'Adventure']",2000,9
8648196,A Way of Life,2006,['United Kingdom'],"['Psychological thriller', 'Drama', 'Tragedy']",2000,6
8454726,Savage Nights,1992,"['France', 'Italy']","['LGBT', 'Erotic Drama', 'Romantic drama', 'Biographical film', 'Drama', 'Gay Themed', 'Gay', 'Gay Interest']",1990,2
31145968,The White Girl,1990,['United States of America'],['Drama'],1990,0
5880421,The Golden Bowl,2000,"['United Kingdom', 'France', 'United States of America']","['Period piece', 'Romantic drama', 'Romance Film', 'Drama']",2000,0
20357059,And Now the Screaming Starts!,1973,['United Kingdom'],"['Gothic Film', 'Thriller', 'Horror']",1970,3
5413972,No Man of Her Own,1950,['United States of America'],"['Film noir', 'Drama']",1950,0
4956151,Charlie Ve'hetzi,1974,['Israel'],"['Comedy', 'Romance Film', 'Drama', 'Cult']",1970,4
10050056,Death at a Funeral,2007,"['United Kingdom', 'Germany', 'Netherlands', 'United States of America']","['Black comedy', 'Comedy']",2000,7
26200483,Frozen Assets,1992,['United States of America'],['Comedy'],1990,2
27546169,Turn of Faith,2001,[],"['Crime Fiction', 'Gangster Film', 'Indie', 'Buddy film', 'Drama']",2000,1
142461,Elizabeth,1998,['United Kingdom'],"['Period piece', 'Biography', 'Biographical film', 'Political drama', 'Epic', 'Costume drama', 'Drama']",1990,8
1195543,A Love Song for Bobby Long,2004,['United States of America'],"['Film adaptation', 'Melodrama', 'Drama', 'Ensemble Film']",2000,4
5416203,Profound Desires of the Gods,1968,['Japan'],"['Satire', 'Comedy-drama', 'Japanese Movies']",1960,8
18166171,The Dead Outside,2008,['United Kingdom'],"['Psychological thriller', 'Suspense', 'Horror', 'Zombie Film', 'Sci-Fi Horror']",2000,8
10613628,Live for Life,1967,"['France', 'Italy']","['Romantic drama', 'World cinema', 'Romance Film', 'Drama']",1960,7
3718903,Scooby-Doo and the Cyber Chase,2001,[],"[""Children's Fantasy"", 'Animation', 'Family-Oriented Adventure', ""Children's/Family""]",2000,1
439831,Will Penny,1968,['United States of America'],"['Western', 'Romantic drama', 'Action/Adventure']",1960,8
19108867,If You Could Only Cook,1935,['United States of America'],"['Romance Film', 'Black-and-white', 'Comedy']",1930,5
21034279,Scandal at Scourie,1953,['United States of America'],['Drama'],1950,3
1164646,Iron Jawed Angels,2004,['United States of America'],"['Period piece', 'Drama', 'Indie', 'Biopic [feature]', 'Docudrama', 'Political drama', 'Feminist Film']",2000,4
35785349,The Island Inside,2009,['Spain'],['Drama'],2000,9
6692985,The Case of the Mukkinese Battle Horn,1956,['United Kingdom'],"['Mystery', 'Parody', 'Short Film', 'Comedy']",1950,6
4084609,Wendy Wu: Homecoming Warrior,2006,['United States of America'],"['Martial Arts Film', 'Comedy', 'Teen', ""Children's/Family"", ""Children's"", 'Drama', 'Fantasy']",2000,6
12515229,The Incident,1967,['United States of America'],"['Indie', 'Black-and-white']",1960,7
385895,Alexander Nevsky,1938,"['Russia', 'Soviet Union']","['Action', 'Black-and-white', 'Art film', 'History', 'World cinema', 'War film', 'Drama']",1930,8
14950102,Hangman's Curse,2003,['United States of America'],"['Psychological thriller', 'Mystery', 'Thriller', 'Horror', 'Teen', 'Crime Thriller', 'Supernatural']",2000,3
2548068,Tom-Yum-Goong,2005,['Thailand'],"['Action', 'Action/Adventure', 'World cinema', 'Martial Arts Film']",2000,5
29125758,Black Arrow,1985,"['Spain', 'United States of America']",['Adventure'],1980,5
3154528,Just Friends,2005,"['Germany', 'United States of America', 'Canada']","['Romance Film', 'Romantic comedy', 'Comedy']",2000,5
333735,Pirates,2005,['United States of America'],"['Romance Film', 'Pornographic movie']",2000,5
73937,Gun Crazy,1949,['United States of America'],"['Black-and-white', 'Crime Fiction', 'Indie', 'Drama', 'Thriller', 'Film noir', 'Crime Thriller']",1940,9
13990745,Crusoe,1989,['United Kingdom'],"['Period piece', 'Film adaptation', 'Action/Adventure', 'Adventure', 'Drama']",1980,9
8175858,O Pioneers!,1992,['United States of America'],"['Film adaptation', 'Romantic drama', 'Action/Adventure', 'Romance Film', 'Drama', 'Period piece', 'Western', 'Television movie']",1990,2
16305665,Anastasia: The Mystery of Anna,1986,"['Austria', 'Italy', 'United States of America']","['Drama', 'Mystery', 'Thriller']",1980,6
891829,Celebrity,1998,['United States of America'],"['Black-and-white', 'Indie', 'Parody', 'Comedy', 'Drama', 'Comedy-drama']",1990,8
12595562,Mamá cumple cien años,1979,['Spain'],"['Comedy', 'Satire', 'Black comedy', 'Comedy-drama']",1970,9
26042450,Maskeli Beşler: Irak,2007,['Turkey'],"['Adventure', 'Comedy film']",2000,7
30018697,July 4,2007,[],"['Action', 'Drama', 'Comedy film']",2000,7
4228260,Cutter's Way,1981,['United States of America'],"['Crime Fiction', 'Mystery', 'Thriller', 'Crime Thriller', 'Drama']",1980,1
5727920,We Own the Night,2007,['United States of America'],"['Action', 'Crime Fiction', 'Gangster Film', 'Indie', 'Thriller', 'Crime Thriller', 'Drama', 'Period piece', 'Crime Drama']",2000,7
5629983,The Advocate,1993,"['United Kingdom', 'France', 'England']","['Crime Fiction', 'Mystery', 'Thriller', 'Crime Thriller', 'Costume drama', 'Drama', 'Courtroom Drama', 'Period piece', 'Suspense', 'Erotic thriller', 'Comedy-drama']",1990,3
11892585,Vengeance of the Zombies,1973,['Spain'],"['Creature Film', 'Horror', 'World cinema', 'Zombie Film', 'Drama']",1970,3
31186529,The Sea,2000,['Spain'],['Drama'],2000,0
19876554,Sleeping with the Devil,1997,['United States of America'],['Drama'],1990,7
3091873,The Crop,2004,['Australia'],['Comedy'],2000,4
61505,Anthony Adverse,1936,['United States of America'],"['Film adaptation', 'Black-and-white', 'Romantic drama', 'Romance Film', 'Adventure', 'Drama', 'Period piece', 'Epic']",1930,6
13794022,Touché and Go,1957,['United States of America'],"['Animation', 'Short Film', 'Comedy', 'Family Film']",1950,7
34420891,Raja Kaiya Vacha,1990,['India'],[],1990,0
13370123,How Is Your Fish Today?,2007,"['United Kingdom', 'England', 'China']","['World cinema', 'Chinese Movies', 'Drama', 'Culture & Society']",2000,7
12099955,Filth and Wisdom,2008,['United Kingdom'],"['Drama', 'Indie', 'Comedy', 'Romance Film', 'Comedy-drama', 'Ensemble Film']",2000,8
689763,Species,1995,['United States of America'],"['Science Fiction', 'Sci-Fi Horror', 'Horror']",1990,5
11994537,Emmanuelle 4,1984,['France'],"['Softcore Porn', 'Sexploitation', 'Pornographic movie', 'Adult', 'Drama']",1980,4
16166076,Anbudan,2000,['India'],[],2000,0
11064164,Capone,1975,"['Canada', 'United States of America']","['Crime Fiction', 'Short Film', 'Drama']",1970,5
4913821,The Crusaders,2001,['Italy'],"['Action', 'Period piece', 'Drama', 'Action/Adventure', 'Television movie', 'Docudrama']",2000,1
133672,Thunder Road,1958,['United States of America'],"['Black-and-white', 'Crime Fiction', 'Gangster Film', 'Crime Drama', 'Film noir', 'Drama']",1950,8
11257151,Kala Bazar,1960,['India'],"['Musical', 'Bollywood', 'World cinema']",1960,0
20520132,Skin,2009,"['United Kingdom', 'South Africa']","['Mystery', 'Indie', 'Biographical film', 'Drama']",2000,9
5009511,The Positively True Adventures of the Alleged Texas Cheerleader-Murdering Mom,1993,['United States of America'],"['Satire', 'Comedy', 'Media Satire', 'Black comedy', 'Docudrama', 'Drama', 'Parody', 'Melodrama', 'Television movie']",1990,3
16428005,Pollyanna,1920,['United States of America'],"['Black-and-white', 'Drama', 'Indie', 'Comedy', 'Silent film', 'Family Film']",1920,0
3732862,Jack and Sarah,1995,"['United Kingdom', 'France']","['Romantic drama', 'Comedy', 'Romance Film', 'Romantic comedy', 'Domestic Comedy', 'Comedy-drama', 'Drama']",1990,5
7644703,We Are the Strange,2007,['United States of America'],"['Animation', 'Indie', 'Avant-garde', 'Computer Animation', 'Creature Film', 'Monster movie', 'Experimental film', 'Anime', 'Stop motion', 'Fantasy']",2000,7
26511792,Shame,1987,['Australia'],['Drama'],1980,7
20535383,The Big One: The Great Los Angeles Earthquake,1990,['United States of America'],"['Disaster', 'Drama']",1990,0
5570094,The Spiral Road,1962,['United States of America'],"['Adventure', 'Drama']",1960,2
23146878,Curse of the Zodiac,2007,['United States of America'],"['Suspense', 'Crime Fiction', 'Mystery', 'Slasher', 'Thriller', 'Horror', 'Crime Thriller']",2000,7
2955883,Wonderland,2003,"['Canada', 'United States of America']","['Period piece', 'Crime Fiction', 'Mystery', 'Thriller', 'Crime Thriller', 'Drama']",2000,3
3160077,Hair-Raising Hare,1946,['United States of America'],"['Animation', 'Short Film', 'Comedy', 'Family Film']",1940,6
29526015,Les Morfalous,1984,['France'],"['Action', 'Adventure']",1980,4
4607980,To Kill a Mockingbird,1962,['United States of America'],"['Film adaptation', 'Black-and-white', 'Crime Fiction', 'Mystery', 'Family Drama', 'Childhood Drama', 'Drama', 'Courtroom Drama']",1960,2
6563151,Amityville 1992,1992,['United States of America'],['Horror'],1990,2
32756157,La môme vert-de-gris,1953,['France'],"['Drama', 'Crime Fiction', 'Thriller']",1950,3
27395955,Samson & Sally,1984,"['Sweden', 'Denmark']","['Romance Film', 'Animation', 'Family Film']",1980,4
5319784,Bill,1981,['United States of America'],"['Drama', 'Biographical film']",1980,1
14725125,Lumber Jack-Rabbit,1954,['United States of America'],"['Animation', 'Short Film', 'Comedy', 'Family Film']",1950,4
3927125,Wind Chill,2007,"['United Kingdom', 'United States of America']","['Road movie', 'Horror', 'Supernatural', 'Cult']",2000,7
12231155,The Papal Chase,2004,['Canada'],"['Culture & Society', 'Documentary']",2000,4
12790367,Vexille,2007,['Japan'],"['Action', 'Computer Animation', 'Animation', 'Japanese Movies', 'Anime', 'Science Fiction']",2000,7
4037444,Producing Adults,2004,"['Finland', 'Sweden']","['LGBT', 'Romantic drama', 'Comedy', 'World cinema', 'Drama', 'Gay Themed', 'Gay', 'Gay Interest', 'Comedy-drama']",2000,4
2555248,Dirty Deeds,2005,['United States of America'],['Comedy'],2000,5
4075105,The Hellstrom Chronicle,1971,['United States of America'],"['Indie', 'Drama', 'Documentary']",1970,1
1587823,Jason's Lyric,1994,['United States of America'],"['Crime Fiction', 'Coming of age', 'Romantic drama', 'Crime Drama', 'Romance Film', 'Drama']",1990,4
9344111,When a Woman Ascends the Stairs,1960,['Japan'],"['Black-and-white', 'Japanese Movies', 'World cinema', 'Melodrama', 'Drama']",1960,0
17166106,Medusa Challenger,1976,['United States of America'],"['Short Film', 'Drama', 'Family Film']",1970,6
9097942,The Quiller Memorandum,1966,['United Kingdom'],"['Action', 'Spy', 'Thriller']",1960,6
6407830,Bloodfist,1989,['United States of America'],"['Action', 'Indie', 'Action/Adventure', 'Martial Arts Film']",1980,9
3038787,Diya Aur Toofan,1969,['Pakistan'],['Romantic comedy'],1960,9
8202294,The Nightingale's Prayer,1959,['Egypt'],"['Romantic drama', 'World cinema', 'Romance Film', 'Drama']",1950,9
26245382,Vasantha Maligai,1972,['India'],"['Romantic drama', 'World cinema', 'Romance Film', 'Drama']",1970,2
483274,Point Break,1991,"['Japan', 'United States of America']","['Action', 'Crime Fiction', 'Action Thrillers', 'Action/Adventure', 'Thriller', 'Heist', 'Japanese Movies', 'Sports']",1990,1
1793072,From the Heart,1998,['India'],"['Musical', 'Romantic drama', 'Thriller', 'Bollywood', 'World cinema', 'Romance Film', 'Drama']",1990,8
12809766,Hwang Jin Yi,2007,['South Korea'],"['Drama', 'Biographical film']",2000,7
4143564,The White Cliffs of Dover,1944,['United States of America'],"['Black-and-white', 'Romance Film', 'War film', 'Drama']",1940,4
8034367,Paper Tiger,1975,['United Kingdom'],['Drama'],1970,5
23907048,Love in a Fallen City,1984,['Hong Kong'],"['Romance Film', 'Chinese Movies', 'War film', 'Drama']",1980,4
7418270,Facing the Truth,2002,['Denmark'],"['Social issues', 'Drama', 'Culture & Society']",2000,2
5786204,"Don't Ask, Don't Tell",2002,['United States of America'],"['Comedy', 'Political drama', 'Science Fiction', 'Drama', 'Fantasy']",2000,2
5017604,American Gangster,2007,['United States of America'],"['Crime Fiction', 'Gangster Film', 'Biographical film', 'Crime Thriller', 'Drama', 'Period piece', 'Crime Drama', 'War film']",2000,7
9573893,Chennai 600028,2007,['India'],['Comedy'],2000,7
8381952,Wintersleepers,1997,['Germany'],"['Romantic drama', 'Thriller', 'World cinema', 'Romance Film', 'Drama']",1990,7
9990409,"Hi, Dharma",2001,['South Korea'],"['Action', 'Action/Adventure', 'Comedy', 'Comedy film', 'World cinema', 'Drama']",2000,1
1170621,"Goodbye, Mr. Chips",1969,"['United Kingdom', 'United States of America']","['Musical', 'Romance Film', 'Drama']",1960,9
23276145,Thirst,1979,"['New Zealand', 'Australia']","['Horror', 'Science Fiction']",1970,9
21150086,Jack the Ripper,1959,['United Kingdom'],"['Crime Fiction', 'Mystery', 'Horror']",1950,9
19876240,The Pleasure Girls,1965,['United Kingdom'],"['Romance Film', 'Black-and-white', 'Drama']",1960,5
22668762,The Place Of The Dead,1997,"['United Kingdom', 'Australia']","['Action/Adventure', 'Thriller', 'Adventure', 'Television movie', 'Drama']",1990,7
3509663,Mystery Train,1989,"['Japan', 'United States of America']","['Drama', 'Crime Fiction', 'Japanese Movies', 'Indie', 'Comedy', 'Anthology']",1980,9
2232039,Scarecrow,1973,['United States of America'],"['Drama', 'Road movie']",1970,3
5804666,The Time Travelers,1964,['United States of America'],['Science Fiction'],1960,4
3756071,The Garbage Pail Kids Movie,1987,['United States of America'],"['Musical', 'Gross out', 'Gross-out film', 'Comedy', 'Black comedy', ""Children's/Family"", 'Adventure', 'Cult']",1980,7
1414394,Stroszek,1977,"['Germany', 'West Germany']","['Art film', 'Satire', 'World cinema', 'Comedy-drama', 'Road movie', 'Tragicomedy', 'Drama']",1970,7
3383848,Josh and S.A.M.,1993,['United States of America'],"['Coming of age', 'Comedy', ""Children's/Family"", 'Road movie', 'Adventure']",1990,3
4179081,Captain Ron,1992,['United States of America'],"['Action', 'Action/Adventure', 'Comedy', 'Domestic Comedy', 'Adventure', 'Family Film']",1990,2
172031,The Letter,1940,['United States of America'],"['Film adaptation', 'Black-and-white', 'Courtroom Drama', 'Crime Fiction', 'Film noir', 'Drama']",1940,0
5655878,MTV Unplugged+3,1992,['United States of America'],['Music'],1990,2
22892795,Prison Break: The Final Break,2009,['United States of America'],"['Action', 'Drama', 'Action Thrillers', 'Thriller']",2000,9
22558849,Safe Harbour,2007,['United States of America'],"['Film adaptation', 'Romantic drama', 'Romance Film', 'Drama']",2000,7
20026897,The Extraordinary Adventures of Mr. West in the Land of the Bolsheviks,1924,['Soviet Union'],"['Silent film', 'Comedy']",1920,4
887388,Dragonslayer,1981,"['United Kingdom', 'United States of America']","['Fantasy Adventure', 'Action/Adventure', 'Costume drama', 'Adventure', 'Sword and sorcery films', 'Sword and sorcery', 'Stop motion', 'Science Fiction', 'Fantasy']",1980,1
4933884,Mr and Mrs Khiladi,1997,['India'],['Comedy'],1990,7
9381312,Captive Hearts,1987,"['United States of America', 'Canada', 'Japan']","['Japanese Movies', 'Romantic drama', 'Romance Film', 'Drama']",1980,7
20634623,George and Mildred,1980,['United Kingdom'],['Comedy'],1980,0
6269479,"Big Man, Little Love",2001,"['Turkey', 'Hungary', 'Greece']",['Drama'],2000,1
6113391,Good Day for a Hanging,1959,['United States of America'],"['Action', 'Western', 'Action/Adventure']",1950,9
10487338,Doraemon: Nobita and the Steel Troops,1986,['Japan'],"['Japanese Movies', 'Animation']",1980,6
14187517,The Over-the-Hill Gang Rides Again,1970,['United States of America'],"['Comedy Western', 'Western', 'Comedy']",1970,0
963986,The Bourne Identity,2002,"['Germany', 'United States of America', 'Czech Republic']","['Action', 'Film adaptation', 'Crime Fiction', 'Mystery', 'Action/Adventure', 'Thriller', 'Adventure', 'Drama']",2000,2
6340115,Manny & Lo,1996,['United States of America'],"['Coming of age', 'Comedy', 'Childhood Drama', 'Teen', 'Comedy-drama', 'Road movie', 'Drama']",1990,6
4292032,Mother Küsters' Trip to Heaven,1975,['Germany'],"['Political drama', 'Drama', 'World cinema']",1970,5
4219387,North Shore,1987,['United States of America'],"['Romantic drama', 'Teen', 'Romance Film', 'Sports', 'Adventure', 'Drama']",1980,7
25370724,Rabbit Without Ears 2,2009,['Germany'],"['Romantic drama', 'Comedy', 'World cinema', 'Romance Film', 'Romantic comedy', 'Drama']",2000,9
5948854,Im Juli,2000,['Germany'],"['Romantic drama', 'Comedy', 'World cinema', 'Romance Film', 'Romantic comedy', 'Drama']",2000,0
8309300,Deewaar,2004,['India'],"['Action/Adventure', 'Drama', 'World cinema']",2000,4
5212057,SPOILER,1998,['United States of America'],"['Thriller', 'Horror', 'Sci-Fi Horror', 'Science Fiction']",1990,8
20614602,All a Bir-r-r-rd,1950,['United States of America'],"['Animation', 'Short Film', 'Comedy', ""Children's/Family"", 'Family Film']",1950,0
20288451,Bandhan,2004,['India'],"['Drama', 'Family Film']",2000,4
5947065,The Whispering Shadow,1933,['United States of America'],"['Action', 'Black-and-white', 'Crime Fiction', 'Thriller', 'Adventure']",1930,3
238004,The Rescuers Down Under,1990,['United States of America'],"['Fantasy Adventure', 'Crime Fiction', 'Animation', 'Mystery', ""Children's/Family"", 'Adventure', 'Drama', ""Children's Fantasy"", 'Family Film', 'Fantasy']",1990,0
30973633,The Circuit 2: The Final Punch,2003,['United States of America'],"['Action', 'Action/Adventure', 'Thriller', 'Martial Arts Film']",2000,3
11953814,Herb,2007,['South Korea'],['Drama'],2000,7
1911903,"I Love You, Alice B. Toklas",1968,['United States of America'],"['Parody', 'Satire', 'Comedy', 'Comedy of manners', 'Romance Film', 'Romantic comedy', 'Cult']",1960,8
23734032,Choices,1986,['United States of America'],"['Drama', 'Television movie']",1980,6
26528549,Lure of the Wilderness,1952,['United States of America'],"['Romance Film', 'Adventure', 'Drama']",1950,2
19286380,Vettaikkaaran,1964,['India'],['Drama'],1960,4
26396405,Last Light,1993,['United States of America'],"['Television movie', 'Crime Fiction', 'Drama']",1990,3
18631215,What Waits Below,1985,['United Kingdom'],"['Action', 'Science Fiction']",1980,5
12635019,Aloha Summer,1988,['United States of America'],"['Coming of age', 'Comedy', 'Comedy-drama', 'Drama']",1980,8
24011177,The Return of Chandu,1934,['United States of America'],"['Action', 'Black-and-white', 'Action/Adventure', 'Thriller', 'Adventure', 'Fantasy']",1930,4
8274726,Mr. Moto's Gamble,1938,['United States of America'],"['Detective fiction', 'Black-and-white', 'Crime Fiction', 'Mystery', 'Thriller', 'Crime Thriller', 'Drama', 'Detective']",1930,8
13154268,Dante 01,2008,['France'],"['Prison', 'Science Fiction', 'World cinema']",2000,8
4601985,When Time Ran Out,1980,"['Canada', 'United States of America']","['Action', 'Film adaptation', 'Action/Adventure', 'Thriller', 'Disaster', 'Drama']",1980,0
20671864,Looking for Love,1964,['United States of America'],"['Musical', 'Comedy']",1960,4
3654363,Unfaithfully Yours,1948,['United States of America'],"['Musical', 'Black-and-white', 'Screwball comedy', 'Comedy', 'Film noir', 'Black comedy', 'Romance Film', 'Romantic comedy']",1940,8
9000400,O Jerusalem,2007,"['Belgium', 'Israel', 'France', 'United Kingdom', 'Greece', 'Italy', 'United States of America']","['World cinema', 'Docudrama', 'Political drama', 'Drama']",2000,7
62440,The Sting,1973,['United States of America'],"['Action', 'Crime Fiction', 'Gangster Film', 'Buddy film', 'Comedy', 'Drama', 'Period piece', 'Crime Comedy', 'New Hollywood']",1970,3
693325,Dave,1993,['United States of America'],"['Political cinema', 'Political satire', 'Satire', 'Comedy', 'Romance Film', 'Comedy-drama', 'Americana']",1990,3
10893193,Faasle,1985,['India'],"['Romantic drama', 'World cinema', 'Romance Film', 'Drama']",1980,5
2641298,The Getaway,1994,"['Japan', 'United States of America']","['Action', 'Crime Fiction', 'Japanese Movies', 'Action/Adventure', 'Thriller', 'Road movie']",1990,4
9855233,La Guerra Gaucha,1942,['Argentina'],"['Black-and-white', 'Drama']",1940,2
28550166,Blighty,1927,['United Kingdom'],['Silent film'],1920,7
7681861,Maharadhi,2007,['India'],"['Musical', 'Romantic drama', 'Bollywood', 'World cinema', 'Romance Film', 'Drama']",2000,7
2735294,The Keys to the House,2004,"['France', 'Germany', 'Italy']","['Art film', 'Family Drama', 'World cinema', 'Drama']",2000,4
23315698,Mio in the Land of Faraway,1987,"['Sweden', 'Norway', 'Soviet Union']","['Fantasy Adventure', ""Children's Fantasy"", 'Family-Oriented Adventure', ""Children's/Family"", 'Adventure', 'Family Film', 'Fantasy']",1980,7
14811392,The Coachman,1961,['South Korea'],['Drama'],1960,1
34322568,Donga Dongadi,2004,['India'],['Comedy film'],2000,4
32798069,Kariya,2003,['India'],['Drama'],2000,3
267597,Schtonk!,1992,['Germany'],"['Comedy', 'Satire']",1990,2
7443488,"Triads, Yardies and Onion Bhajees",2003,"['United Kingdom', 'India']","['Adventure', 'Thriller']",2000,3
6575663,Sandakozhi,2005,['India'],"['Action', 'Musical', 'Romantic drama', 'Bollywood', 'World cinema', 'Romance Film', 'Drama']",2000,5
18252824,Billy Ze Kick,1985,['France'],"['Mystery', 'Comedy']",1980,5
19795169,Love Story,1944,['United Kingdom'],"['Romance Film', 'Black-and-white', 'Drama']",1940,4
17865807,The 13th Alley,2008,['United States of America'],['Horror'],2000,8
14548615,Slave Girls from Beyond Infinity,1987,['United States of America'],"['Comedy', 'Horror', 'Adventure', 'Science Fiction']",1980,7
12677727,The Return of Count Yorga,1971,['United States of America'],"['Horror', 'Comedy', 'Horror Comedy']",1970,1
8570240,The In Crowd,2000,['United States of America'],"['Psychological thriller', 'Thriller', 'Teen']",2000,0
12252981,Jalla! Jalla!,2000,['Sweden'],"['Romance Film', 'Comedy', 'Drama']",2000,0
21996387,I'm Through with White Girls,2007,['United States of America'],"['Romance Film', 'Comedy film']",2000,7
1468152,A World Without Thieves,2004,"['China', 'Hong Kong']","['Action', 'Crime Fiction', 'Action/Adventure', 'World cinema', 'Chinese Movies', 'Drama']",2000,4
24481168,Ratha Kanneer,1954,['India'],['Drama'],1950,4
19998244,Sathi,2002,['India'],"['Musical', 'Romance Film', 'Drama']",2000,2
9110934,Buddy Buddy,1981,['United States of America'],"['Gangster Film', 'Parody', 'Screwball comedy', 'Buddy film', 'Comedy', 'Black comedy']",1980,1
19653659,TASS Is Authorized to Declare,1984,['Soviet Union'],['Adventure'],1980,4
1334841,The Family Game,1983,['Japan'],"['Family Drama', 'Satire', 'Comedy', 'World cinema', 'Drama', 'Japanese Movies', 'Domestic Comedy', 'Comedy-drama']",1980,3
10402747,Antônia,2007,['Brazil'],['Musical'],2000,7
19684158,Dream Demon,1988,['United Kingdom'],['Horror'],1980,8
13310698,Mongol,2007,"['Russia', 'Germany', 'Mongolia']","['Action/Adventure', 'Biographical film', 'World cinema', 'Adventure', 'Drama', 'Biopic [feature]', 'Historical Epic', 'Epic', 'War film']",2000,7
6802205,Miracle Run,2003,['United States of America'],['Drama'],2000,3
25922706,Fog Island,1945,[],"['Action', 'Psychological thriller', 'Mystery', 'Thriller', 'Horror', 'Adventure']",1940,5
3342111,Europa '51,1952,['Italy'],"['Black-and-white', 'Drama']",1950,2
25348662,Gokulathil Seethai,1996,['India'],['World cinema'],1990,6
1428132,Cool Runnings,1993,['United States of America'],"['Comedy', 'Sports', 'Adventure', 'Family Film']",1990,3
5566359,Adventure,1945,['United States of America'],"['Black-and-white', 'Drama']",1940,5
171005,Henry V,1989,['United Kingdom'],"['Period piece', 'Film adaptation', 'War film', 'Epic', 'Costume drama', 'Drama']",1980,9
26245265,Daya,1998,['India'],"['Comedy', 'Romance Film', 'Drama', 'Fantasy']",1990,8
25649956,The Dirty Dozen: The Deadly Mission,1987,['United States of America'],"['Action', 'War film']",1980,7
1107354,Tempting Heart,1999,"['Hong Kong', 'China', 'Japan']","['Romance Film', 'Japanese Movies', 'Chinese Movies']",1990,9
18544488,Meera,1979,['India'],['Bollywood'],1970,9
21784819,Get Hep to Love,1942,['United States of America'],"['Musical', 'Black-and-white', 'Drama']",1940,2
34314532,Nikte,2009,['Mexico'],"['Animation', 'Comedy', 'Adventure']",2000,9
25493478,Odipolama,2009,['India'],['Romance Film'],2000,9
34190594,Ramachandra,2003,[],['Drama'],2000,3
27500533,The Return of the Whistler,1948,['United States of America'],['Mystery'],1940,8
14746698,Income Tax Sappy,1954,['United States of America'],"['Short Film', 'Black-and-white', 'Comedy']",1950,4
22776768,Eyes Wide Open,2009,"['Israel', 'France', 'Germany']","['Gay Themed', 'LGBT', 'World cinema', 'Political drama']",2000,9
4318560,Master of the Flying Guillotine,1975,"['Hong Kong', 'Taiwan']","['Action', 'Action/Adventure', 'World cinema', 'Wuxia', 'Chinese Movies', 'Martial Arts Film']",1970,5
33634176,Di Balik Kelambu,1983,[],['Drama'],1980,3
1222561,Curdled,1996,['United States of America'],"['Suspense', 'Crime Fiction', 'Mystery', 'Comedy', 'Thriller', 'Black comedy', 'Crime Thriller']",1990,6
14640837,Positive,2007,['India'],"['Gender Issues', 'Social issues', 'Short Film', 'Culture & Society']",2000,7
5861532,Paradise Alley,1978,['United States of America'],"['Period piece', 'Boxing', 'Sports', 'Drama']",1970,8
24032824,The Last Alarm,1940,['United States of America'],"['Drama', 'Crime Fiction', 'Thriller']",1940,0
3824677,The Big Broadcast,1932,['United States of America'],"['Musical', 'Black-and-white', 'Comedy']",1930,2
26196521,Spook Busters,1946,['United States of America'],"['Comedy', 'Horror Comedy']",1940,6
1886189,Close-up,1990,['Iran'],"['Crime Fiction', 'World cinema', 'Documentary', 'Drama']",1990,0
24186154,Return of the One-Armed Swordsman,1969,['Hong Kong'],"['Action/Adventure', 'World cinema', 'Wuxia', 'Chinese Movies', 'Martial Arts Film']",1960,9
362120,"Ladies and Gentlemen, The Fabulous Stains",1981,['United States of America'],"['Musical', 'Indie', 'Comedy', 'Punk rock', 'Drama']",1980,1
11096384,Noise,2007,"['New Zealand', 'Australia']","['Thriller', 'Indie', 'Drama']",2000,7
12874379,Thommanum Makkalum,2005,['India'],"['Action', 'Drama', 'Comedy']",2000,5
23198700,Night Hair Child,1971,"['Spain', 'United Kingdom', 'West Germany', 'Italy', 'United States of America']","['Psychological thriller', 'Family Drama', 'Thriller', 'Horror', 'Drama']",1970,1
5379346,Mahanadi,1993,['India'],"['Action', 'Crime Fiction', 'Bollywood']",1990,3
19143032,Chalo Let's Go,2008,['India'],"['Adventure', 'Drama', 'Comedy film']",2000,8
1237381,Blackmail,1929,"['United Kingdom', 'England']","['Psychological thriller', 'Black-and-white', 'Crime Fiction', 'Thriller', 'Goat gland', 'Drama']",1920,9
10979410,The Barefoot Executive,1971,['United States of America'],"['Comedy', 'Drama', 'Family Film']",1970,1
4230540,The Visit,1964,"['France', 'Germany', 'United States of America']",['Black-and-white'],1960,4
2737503,Soup to Nuts,1930,['United States of America'],"['Black-and-white', 'Slapstick', 'Comedy', 'Comedy of Errors']",1930,0
31211178,Sthithi,2002,[],['Drama'],2000,2
409754,Lan Yu,2001,['Hong Kong'],"['LGBT', 'Romantic drama', 'World cinema', 'Romance Film', 'Chinese Movies', 'Drama', 'Gay Themed', 'Gay', 'Gay Interest', 'Historical fiction', 'Political drama']",2000,1
10175052,Isle of the Dead,1945,['United States of America'],"['Black-and-white', 'Horror']",1940,5
913762,"The Super Dimension Fortress Macross II: Lovers, Again",1992,['Japan'],"['Animation', 'Japanese Movies', 'Short Film', 'Adventure', 'Anime', 'Science Fiction', 'Drama']",1990,2
2005355,Disturbing Behavior,1998,"['United States of America', 'Australia']","['Psychological thriller', 'Mystery', 'Thriller', 'Horror', 'Teen', 'Albino bias', 'Science Fiction']",1990,8
9673848,Loving Annabelle,2006,['United States of America'],"['Gay Themed', 'Gay', 'Erotic Drama', 'Coming of age', 'Gay Interest', 'Romance Film', 'Drama']",2000,6
4768915,Jana,2004,['India'],"['Action', 'Tamil cinema']",2000,4
61046,Wings,1927,['United States of America'],"['Combat Films', 'Action', 'Black-and-white', 'Indie', 'Action/Adventure', 'Romantic drama', 'Romance Film', 'Drama', 'Adventure', 'Airplanes and airports', 'Silent film', 'War film', 'Ensemble Film']",1920,7
20117980,Sorry Bhai!,2008,['India'],"['Musical', 'Romantic drama', 'Bollywood', 'World cinema', 'Romance Film', 'Comedy-drama', 'Drama']",2000,8
8731626,Invasion of the Saucer Men,1957,['United States of America'],"['Comedy', 'Horror', 'Alien Film', 'Science Fiction']",1950,7
12138493,The Doe Boy,2001,"['Japan', 'United States of America']","['Japanese Movies', 'Biography', 'Indie', 'Family Drama', 'Drama']",2000,1
61141,Song of the South,1946,['United States of America'],"['Musical', 'Animation', 'Childhood Drama', ""Children's/Family"", 'Family Film']",1940,6
18002243,Sadayam,1992,['India'],"['Thriller', 'Drama']",1990,2
8487305,Christmas Do-Over,2006,['United States of America'],"['Comedy', 'Holiday Film', 'Fantasy Comedy', 'Family Film', 'Fantasy']",2000,6
6545749,Zerophilia,2006,['United States of America'],"['LGBT', 'Indie', 'Comedy', 'Romance Film', 'Romantic comedy', 'Science Fiction']",2000,6
73412,North by Northwest,1959,['United States of America'],"['Action', 'Spy', 'Mystery', 'Action/Adventure', 'Thriller', 'Romance Film', 'Adventure', 'Drama', 'Suspense', 'Airplanes and airports', 'Chase Movie']",1950,9
9446254,Up the River,1930,['United States of America'],"['Comedy', 'Black-and-white']",1930,0
15203301,Cisco Pike,1972,['United States of America'],"['Drama', 'Crime Fiction']",1970,2
7236362,Battle Hymn,1956,['United States of America'],"['Period piece', 'Biography', 'Biopic [feature]', 'War film', 'Drama']",1950,6
73375,Bride of Frankenstein,1935,['United States of America'],"['Black-and-white', 'Monster', 'Comedy', 'Horror', 'Science Fiction']",1930,5
2637013,The Drowning Pool,1975,['United States of America'],"['Film adaptation', 'Mystery', 'Thriller', 'Crime Thriller', 'Drama']",1970,5
12157297,Hanging Woman,1973,"['Spain', 'Italy']","['Indie', 'Thriller', 'Horror', 'World cinema', 'Zombie Film', 'Crime Thriller', 'Supernatural']",1970,3
19009065,Leaves from Satan's Book,1921,['Denmark'],"['Black-and-white', 'Comedy', 'World cinema', 'Drama', 'Period piece', 'Silent film', 'Historical fiction', 'Religious Film']",1920,1
6536909,Carry On Dick,1974,['United Kingdom'],"['Parody', 'Satire', 'Comedy', 'Slapstick']",1970,4
18545794,Achanak,1973,['India'],"['Musical', 'Thriller', 'Bollywood', 'World cinema', 'Drama']",1970,3
26211475,I Wonder Who's Kissing Her Now,1947,['United States of America'],['Musical'],1940,7
34327276,Udaya Geetham,1985,['India'],['Drama'],1980,5
4187903,The Watcher in the Woods,1980,"['United Kingdom', 'United States of America']","['Mystery', 'Thriller', 'Haunted House Film', 'Suspense', 'Horror', 'Supernatural', 'Science Fiction', 'Family Film', 'Fantasy']",1980,0
1367143,Thunderbolt and Lightfoot,1974,['United States of America'],"['Action', 'Crime Fiction', 'Action/Adventure', 'Buddy film', 'Drama', 'Heist', 'Comedy film', 'Road movie']",1970,4
7939594,Great Guns,1941,['United States of America'],"['Black-and-white', 'Slapstick', 'Comedy']",1940,1
7100264,The Karnival Kid,1929,['United States of America'],"['Animation', 'Short Film', 'Comedy', 'Romance Film', 'Family Film']",1920,9
5121746,A Perfect Day,2005,"['Lebanon', 'Germany']","['Drama', 'World cinema']",2000,5
12494928,Stripped to Kill,1987,['United States of America'],"['Suspense', 'Crime Fiction', 'Mystery', 'Sexploitation', 'Thriller', 'Erotic thriller', 'Crime Thriller']",1980,7
5270222,Escape at Dawn,1950,['Japan'],"['Black-and-white', 'Japanese Movies', 'Drama']",1950,0
16700486,Argo,2006,['United States of America'],['Short Film'],2000,6
2010489,When a Stranger Calls,1979,['United States of America'],"['Psychological thriller', 'Indie', 'Thriller', 'Teen', 'Crime Thriller', 'Suspense', 'Slasher', 'Horror']",1970,9
13786783,American Guerrilla in the Philippines,1950,['United States of America'],['War film'],1950,0
18847566,Red Riding Hoodwinked,1955,['United States of America'],"['Animation', 'Short Film', 'Comedy', 'Family Film']",1950,5
36057870,Gajendra,2004,['India'],"['Action', 'Comedy film', 'Fantasy']",2000,4
33916206,Hyderabad Blues 2,2004,['India'],"['Drama', 'World cinema']",2000,4
25852016,Tora-san's Lullaby,1974,['Japan'],['Japanese Movies'],1970,4
6432572,The Covenant,2006,['United States of America'],"['Action', 'Thriller', 'Horror', 'Supernatural', 'Fantasy']",2000,6
1148228,Calamity Jane,1953,['United States of America'],"['Musical', 'Biography', 'Western', 'Comedy', 'Romance Film']",1950,3
5316019,That'll Be The Day,1973,['United Kingdom'],"['Musical', 'Period piece', 'Coming of age', 'Drama']",1970,3
24262101,Double Game,1978,['Italy'],"['Action', 'Action Thrillers', 'Action/Adventure', 'Thriller', 'World cinema']",1970,8
10688272,Hua Fei Man Cheng Chun,1975,['Hong Kong'],"['Chinese Movies', 'Comedy']",1970,5
26550807,Oblivion Island: Haruka and the Magic Mirror,2009,['Japan'],"['Animation', 'Japanese Movies', 'World cinema', 'Anime', 'Family Film', 'Fantasy']",2000,9
20540950,Hemanter Pakhi,2003,['India'],['Drama'],2000,3
6131298,The Farmer's Daughter,1973,[],['Pornographic movie'],1970,3
32129077,The Navy Comes Through,1942,['United States of America'],"['Combat Films', 'War film', 'Drama']",1940,2
9610735,Protégé,2007,"['Hong Kong', 'Singapore', 'China']","['Film adaptation', 'Thriller', 'World cinema', 'Crime Thriller', 'Chinese Movies']",2000,7
2198940,Bio-Dome,1996,['United States of America'],"['Gross out', 'Gross-out film', 'Comedy', 'Slapstick']",1990,6
5590764,Yu Ming is ainm dom,2003,['Ireland'],"['Short Film', 'Comedy']",2000,3
12526856,Flic Story,1975,"['France', 'Italy']","['Thriller', 'World cinema', 'Crime Thriller', 'Drama']",1970,5
5146327,The Fine Art of Love: Mine Ha-Ha,2005,"['United Kingdom', 'Czech Republic', 'Italy']","['Film adaptation', 'Mystery', 'Indie', 'Romance Film', 'Drama']",2000,5
19612707,The Spirit of Culver,1939,['United States of America'],"['Black-and-white', 'Drama']",1930,9
6296845,Arch of Triumph,1948,['United States of America'],"['Film adaptation', 'Black-and-white', 'Thriller', 'Film noir', 'Romance Film', 'War film', 'Drama']",1940,8
11089978,Along the Great Divide,1951,['United States of America'],"['Romance Film', 'Black-and-white', 'Western']",1950,1
4769950,Porkaalam,1997,['India'],[],1990,7
20517255,SS Girls,1977,['Italy'],"['Sexploitation', 'War film']",1970,7
26221272,One Dollar Too Many,1968,"['Spain', 'Italy']","['Spaghetti Western', 'Western', 'Comedy film']",1960,8
11993757,Haunted Mouse,1965,[],"[""Children's/Family""]",1960,5
1957324,Sitting Target,1972,['United Kingdom'],"['Action', 'Drama']",1970,2
3787708,8 Heads in a Duffel Bag,1997,"['United Kingdom', 'United States of America']","['Action', 'Gangster Film', 'Action/Adventure', 'Comedy', 'Crime Comedy', 'Black comedy', 'Comedy of Errors']",1990,7
1880706,Payback,1999,['United States of America'],"['Action', 'Crime Fiction', 'Action/Adventure', 'Comedy', 'Thriller', 'Remake', 'Black comedy', 'Crime Thriller', 'Drama']",1990,9
27487563,Oliviero Rising,2007,['Italy'],"['Romance Film', 'Comedy']",2000,7
33100038,Riders of the Whistling Pines,1949,['United States of America'],"['Action', 'Western', 'Adventure']",1940,9
1048695,Dracula,1979,"['United Kingdom', 'United States of America']",['Horror'],1970,9
19996811,Matira Manisha,1966,['India'],['Drama'],1960,6
23848853,Daddy Cool,2009,['India'],['Drama'],2000,9
12231265,Tears in the Rain,1988,['United Kingdom'],"['Film adaptation', 'Romantic drama', 'Melodrama', 'Drama']",1980,8
26018309,Silver River,1948,['United States of America'],"['Melodrama', 'Western', 'Drama']",1940,8
3834816,Trouble Brewing,1939,['United Kingdom'],"['Musical', 'Romance Film', 'Comedy film']",1930,9
11517830,The Facts of Life Reunion,2001,['United States of America'],"['Comedy', 'Television movie']",2000,1
10608687,Marius,1931,['France'],"['Black-and-white', 'Comedy', 'Romance Film', 'Drama']",1930,1
18367834,Cupid's Mistake,2001,['United States of America'],"['Indie', 'Comedy', 'Romance Film', 'Romantic comedy', 'Comedy-drama', 'Ensemble Film']",2000,1
217825,Speak to Me of Love,2002,['France'],['Drama'],2000,2
1317987,Blow Out,1981,['United States of America'],"['Psychological thriller', 'Crime Fiction', 'Mystery', 'Thriller', 'Drama', 'Political thriller']",1980,1
3620980,The Holy Mountain,1973,"['Mexico', 'United States of America']","['Surrealism', 'Art film', 'World cinema', 'Drama']",1970,3
15843050,Claws in the Lease,1963,['United States of America'],"['Animation', 'Short Film', 'Comedy', 'Family Film']",1960,3
3957383,The Land Before Time VIII: The Big Freeze,2001,['United States of America'],"['Animated cartoon', 'Animation', 'Adventure', ""Children's""]",2000,1
10400208,Bara no Konrei ~Mayonaka ni Kawashita Yakusoku~,2002,['Japan'],"['Silent film', 'Japanese Movies', 'Indie']",2000,2
29530341,Mukti,1977,['India'],"['Musical', 'Romantic drama', 'Bollywood', 'World cinema', 'Romance Film', 'Drama']",1970,7
18893008,Impasse,1969,['United States of America'],"['Action', 'Action/Adventure', 'Thriller']",1960,9
26230441,Look Who's Laughing,1941,['United States of America'],['Comedy'],1940,1
11335331,Dil Ek Mandir,1963,['India'],['Bollywood'],1960,3
14883225,Flying,1986,['Canada'],"['Romantic drama', 'Romance Film', 'Sports', 'Drama']",1980,6
5872413,Apache,1954,['United States of America'],"['Action', 'Revisionist Western', 'Action/Adventure', 'Western', 'Indian Western']",1950,4
299016,The Cotton Club,1984,['United States of America'],"['Musical', 'Crime Fiction', 'Gangster Film', 'Indie', 'Romantic drama', 'Musical Drama', 'Romance Film', 'Drama', 'Period piece']",1980,4
3398681,Don't Look Now... We're Being Shot At!,1966,"['United Kingdom', 'France']","['War film', 'Comedy']",1960,6
20666019,Almost Love,2006,['South Korea'],"['Romance Film', 'Comedy']",2000,6
16635453,Dance in the Rain,1961,['Yugoslavia'],['Drama'],1960,1
11993026,Emmanuelle 5,1986,['France'],"['Softcore Porn', 'Sexploitation', 'Pornographic movie', 'Pornography', 'Erotica', 'Adult']",1980,6
5603193,The Second Hundred Years,1927,['United States of America'],"['Black-and-white', 'Indie', 'Short Film', 'Comedy', 'Silent film', 'Slapstick', 'Escape Film']",1920,7
13053911,Friday the 13th,2009,['United States of America'],"['Slasher', 'Horror']",2000,9
31070456,The Wise Quacking Duck,1943,[],"['Animation', 'Short Film', 'Family Film']",1940,3
19219383,The Brainiac,1961,['Mexico'],"['World cinema', 'Horror']",1960,1
19859820,Obsessed,1992,['United States of America'],['Drama'],1990,2
6003967,Amma Nanna O Tamila Ammayi,2003,['India'],"['Tollywood', 'Drama', 'World cinema']",2000,3
6371775,High Roller: The Stu Ungar Story,2003,['United States of America'],"['Drama', 'Crime Fiction', 'Biography', 'Indie', 'Biographical film', 'Docudrama']",2000,3
1150634,Diner,1982,['United States of America'],"['Period piece', 'Coming of age', 'Comedy', 'Comedy-drama', 'Drama', 'Ensemble Film']",1980,2
32742302,Virus,2007,[],"['Romance Film', 'Drama', 'Documentary']",2000,7
2279610,Gaslight,1940,['United Kingdom'],"['Psychological thriller', 'Black-and-white', 'Mystery', 'Thriller', 'Crime Thriller', 'Costume drama', 'Drama', 'Suspense']",1940,0
2712122,Zazel,1997,['United States of America'],"['Adult', 'Pornographic movie']",1990,7
1743335,Joi Baba Felunath,1978,['India'],"['Detective fiction', 'Crime Fiction', 'Art film', 'Thriller', 'Bengali Cinema', 'World cinema', 'Family-Oriented Adventure', ""Children's/Family"", 'Adventure', 'Drama', 'Detective', 'Family Film']",1970,8
3676302,Tokyo Fist,1995,['Japan'],"['Action', 'Romantic drama', 'Action/Adventure', 'Thriller', 'World cinema', 'Romance Film', 'Black comedy', 'Drama', 'Japanese Movies', 'Horror']",1990,5
26973998,Widow's Perverted Hell,1991,['Japan'],['Japanese Movies'],1990,1
17287592,Manassinakkare,2003,['India'],"['Drama', 'Comedy']",2000,3
129493,Dead Poets Society,1989,['United States of America'],"['Period piece', 'Coming of age', 'School story', 'Teen', 'Drama', 'Ensemble Film']",1980,9
16469085,The Silence of Lorna,2008,"['Belgium', 'United Kingdom', 'France', 'Germany', 'Italy']","['Art film', 'Drama', 'World cinema']",2000,8
2056500,Running Scared,1986,['United States of America'],"['Action', 'Crime Fiction', 'Action/Adventure', 'Buddy film', 'Thriller', 'Comedy', 'Buddy cop']",1980,6
4052296,The Outside Chance of Maximilian Glick,1988,['Canada'],"['Coming of age', 'Drama', 'Comedy film']",1980,8
20635941,The Sleeping Cardinal,1931,['United Kingdom'],"['Mystery', 'Crime Fiction']",1930,1
24414526,Road to Salina,1970,"['France', 'Italy']",['Drama'],1970,0
286836,Jude,1996,['United Kingdom'],"['Indie', 'Romantic drama', 'Romance Film', 'Costume drama', 'Drama', 'Tragedy', 'Period piece', 'Erotica']",1990,6
36546495,Mom's on Strike,2002,['United States of America'],['Comedy'],2000,2
20249083,Noir Drive,2008,['Australia'],"['Short Film', 'Crime Fiction']",2000,8
19664001,This Other Eden,1959,"['Ireland', 'India']",['Comedy'],1950,9
14137409,Washington Square,1997,['United States of America'],"['Period piece', 'Film adaptation', 'Romantic drama', 'Romance Film', 'Drama']",1990,7
12425697,Born to the West,1937,['United States of America'],"['Black-and-white', 'Western', 'Action/Adventure', 'Drama']",1930,7
3742599,Bad Influence,1990,['United States of America'],"['Psychological thriller', 'Suspense', 'Thriller', 'Erotic thriller', 'Crime Thriller', 'Drama']",1990,0
2170326,Soldier's Girl,2003,['United States of America'],"['LGBT', 'Romantic drama', 'Biographical film', 'Romance Film', 'Docudrama', 'Drama', 'Gay Themed', 'Gay', 'Gay Interest']",2000,3
24615383,Chandranudikkunna Dikhil,1999,['India'],['Romance Film'],1990,9
3079162,Nanny McPhee,2005,"['United Kingdom', 'France', 'United States of America']","['Comedy', 'Fantasy Comedy', 'Family Film', 'Fantasy']",2000,5
12199287,Target,1985,['United States of America'],"['Action', 'Action/Adventure', 'Thriller']",1980,5
152328,Rocky III,1982,['United States of America'],"['Boxing', 'Melodrama', 'Sports', 'Drama']",1980,2
27930342,Awam,1987,['India'],"['Action', 'Action/Adventure', 'Thriller', 'World cinema']",1980,7
2552048,Nightfall,1957,['United States of America'],"['Suspense', 'Black-and-white', 'Crime Fiction', 'Thriller', 'Film noir', 'Crime Thriller', 'Drama']",1950,7
361135,Spetters,1980,['Netherlands'],"['LGBT', 'Biker Film', 'Teen', 'World cinema', 'Drama']",1980,0
18927989,Bigga Than Ben,2008,['United Kingdom'],"['Black comedy', 'Comedy', 'Drama']",2000,8
12332323,Jeevan Dhaara,1982,['India'],['Bollywood'],1980,2
7834545,Original Sin,1992,['Japan'],"['Romance Film', 'Japanese Movies', 'Drama']",1990,2
5720183,Jhoom Barabar Jhoom,2007,['India'],"['Musical', 'Romantic drama', 'Bollywood', 'World cinema', 'Romance Film', 'Romantic comedy', 'Drama']",2000,7
2643816,The Producers,2005,['United States of America'],"['Musical', 'LGBT', 'Parody', 'Comedy']",2000,5
11635934,A Woman's Face,1941,['United States of America'],"['Psychological thriller', 'Suspense', 'Black-and-white', 'Thriller', 'Drama']",1940,1
30174182,IMurders,2008,['United States of America'],"['Suspense', 'Mystery', 'Indie', 'Slasher', 'Thriller', 'Crime Thriller']",2000,8
9057875,Rishtey,2002,['India'],"['Drama', 'World cinema']",2000,2
15182776,Banning,1967,['United States of America'],"['Romance Film', 'Drama']",1960,7
13366886,La Señal,2007,['Argentina'],"['Indie', 'Drama']",2000,7
2400883,God of Gamblers Returns,1994,['Hong Kong'],"['Action', 'Crime Fiction', 'Action/Adventure', 'Comedy', 'World cinema', 'Chinese Movies']",1990,4
2084027,The Black Cat,1934,['United States of America'],"['Black-and-white', 'Horror']",1930,4
6331931,Mater and the Ghostlight,2006,['United States of America'],"[""Children's/Family"", 'Short Film', 'Comedy']",2000,6
3990824,The Major and the Minor,1942,['United States of America'],"['Comedy', 'Romance Film', 'Romantic comedy', 'Comedy of Errors', 'Sex comedy']",1940,2
20694087,Kanden Kadhalai,2009,['India'],"['Romance Film', 'Comedy']",2000,9
19296306,Journey into Fear,1943,['United States of America'],"['Psychological thriller', 'Spy', 'Black-and-white', 'Thriller', 'Film noir']",1940,3
17484937,Deewane,2000,['India'],"['Action', 'Drama', 'Romantic drama', 'World cinema', 'Romance Film']",2000,0
21196762,The Wrong Guys,1988,['United States of America'],['Comedy'],1980,8
11143131,Thoongadhey Thambi Thoongadhey,1983,['India'],"['Musical', 'Romantic drama', 'Bollywood', 'World cinema', 'Romance Film', 'Drama']",1980,3
28622004,Gooby,2009,['Canada'],"['Comedy', 'Family Film', 'Fantasy']",2000,9
10133485,The Day the Sky Exploded,1958,['Italy'],"['Action/Adventure', 'Science Fiction', 'World cinema', 'Disaster']",1950,8
6309664,A Chinese Tall Story,2005,['Hong Kong'],"['Fantasy Adventure', 'Action/Adventure', 'World cinema', 'Chinese Movies', 'Adventure', 'Mythological Fantasy', 'Road movie', 'Fantasy']",2000,5
26145440,Sri Venkateswara Mahatyam,1960,['India'],"['Musical', 'Drama']",1960,0
16596475,The Boat That Rocked,2009,"['United Kingdom', 'France', 'Germany', 'United States of America']","['Music', 'Political cinema', 'Comedy', 'Romance Film', 'Drama']",2000,9
7571304,The River's Edge,1957,['United States of America'],"['Action', 'Crime Fiction', 'Action/Adventure', 'Western', 'Thriller', 'Adventure', 'Drama']",1950,7
35766275,The Prince Who Was a Thief,1951,['United States of America'],"['Adventure', 'Crime Fiction']",1950,1
33568157,Vivaramana Aalu,2002,['India'],"['Comedy', 'Drama', 'World cinema']",2000,2
28875276,Crucible of Terror,1971,['United Kingdom'],"['Mystery', 'Horror']",1970,1
6954737,Justice League: New Frontier,2008,['United States of America'],"['Animation', 'Action/Adventure', 'Superhero movie', 'Family Film']",2000,8
2698486,The Shaggy Dog,2006,['United States of America'],"['Comedy', 'Family Film', 'Fantasy']",2000,6
21513166,Donga Kollu,1988,['India'],"['Drama', 'Comedy']",1980,8
11366102,The Pink Floyd and Syd Barrett Story,2007,['United Kingdom'],"['Musical', 'Rockumentary', 'Documentary']",2000,7
647756,Dragon: The Bruce Lee Story,1993,['United States of America'],"['Action', 'Biography', 'Action/Adventure', 'Biopic [feature]', 'Martial Arts Film', 'Drama']",1990,3
32656203,Orphan of the Wilderness,1936,[],"['Adventure', 'Drama']",1930,6
74978,My Darling Clementine,1946,['United States of America'],"['Action', 'Drama', 'Action/Adventure', 'Western']",1940,6
1012024,Nekromantik,1987,['Germany'],['Horror'],1980,7
44122,American Beauty,1999,['United States of America'],"['LGBT', 'Romantic drama', 'Satire', 'Comedy', 'Black comedy', 'Romance Film', 'Drama', 'Existentialism']",1990,9
9310175,Heathcliff: The Movie,1986,"['France', 'United States of America', 'Canada']","['Animation', 'Comedy', ""Children's"", 'Family Film']",1980,6
5377926,The Three Stooges Go Around the World in a Daze,1963,['United States of America'],"['Black-and-white', 'Slapstick', 'Comedy']",1960,3
25015679,La Cage aux Folles II,1980,"['France', 'Italy']","['Gay Themed', 'Gay', 'Gay Interest', 'Comedy', 'Comedy of Errors']",1980,0
8809789,Damul,1985,['India'],['Drama'],1980,5
76385,The Thief of Bagdad,1924,['United States of America'],"['Black-and-white', 'Indie', 'Action/Adventure', 'Romance Film', 'Swashbuckler films', 'Costume drama', 'Adventure', 'Drama', 'Silent film', 'Family Film', 'Fantasy']",1920,4
11196083,Detroit 9000,1973,['United States of America'],"['Action', 'Blaxploitation', 'Crime Fiction', 'Action Thrillers', 'Indie', 'Action/Adventure', 'Thriller']",1970,3
31647083,Punarjanmam,1972,['India'],['Erotic thriller'],1970,2
15167247,Mafia vs. Ninja,1985,"['Hong Kong', 'Taiwan']","['Action', 'Crime Fiction', 'Action/Adventure', 'World cinema', 'Chinese Movies', 'Martial Arts Film']",1980,5
21043028,Fathom,1967,"['United Kingdom', 'United States of America']","['Action', 'Parody', 'Action/Adventure', 'Comedy', 'Adventure']",1960,7
28269074,A Cottage on Dartmoor,1929,"['Sweden', 'United Kingdom']",['Silent film'],1920,9
14055139,Julian Po,1997,['United States of America'],"['Drama', 'Indie', 'Romantic drama', 'Comedy of manners', 'Romance Film', 'Comedy-drama']",1990,7
28529436,The Mouth Agape,1974,['France'],"['Social problem film', 'Family Drama', 'Drama']",1970,4
33572277,You Don't Know What You're Doin'!,1931,['United States of America'],['Black-and-white'],1930,1
2123755,Two Men and a Wardrobe,1958,['Poland'],['Short Film'],1950,8
6203432,Batman: New Times,2005,['United States of America'],"['Short Film', 'Animation']",2000,5
2507687,Oliver Twist,2005,"['United Kingdom', 'France', 'Czech Republic', 'Italy']","['Period piece', 'Film adaptation', 'Drama', 'Family Film']",2000,5
9041173,Thunderstruck,2004,['Australia'],"['Coming of age', 'Comedy', 'World cinema', 'Drama']",2000,4
10420250,Klepto,2006,['United States of America'],"['Drama', 'Crime Fiction', 'Indie', 'Caper story', 'Comedy', 'Crime Comedy', 'Romantic comedy']",2000,6
5313828,Bolero,1934,['United States of America'],"['Musical', 'Black-and-white', 'Drama']",1930,4
34549050,Road to Hell,2008,['United States of America'],"['Action', 'Fantasy', 'Thriller']",2000,8
19485814,Aayudham Seivom,2008,['India'],"['Romance Film', 'Drama']",2000,8
4977010,Leeches!,2003,['United States of America'],"['B-movie', 'Natural horror films', 'Horror']",2000,3
20259767,Gandhinagar 2nd Street,1986,['India'],"['Romance Film', 'Comedy', 'Family Film']",1980,6
21080658,Caboblanco,1980,"['Mexico', 'United States of America']","['Romance Film', 'Adventure', 'Drama']",1980,0
8465073,The Boy Who Drank Too Much,1980,['United States of America'],"['Sports', 'Drama', 'Family Film']",1980,0
18752398,Right to Die,2007,"['Canada', 'United States of America']","['Television movie', 'Cult', 'Horror']",2000,7
1055089,Bullets Over Broadway,1994,['United States of America'],"['Gangster Film', 'Satire', 'Comedy']",1990,4
733901,With Honors,1994,['United States of America'],"['Coming of age', 'Buddy film', 'Comedy', 'Comedy of manners', 'Comedy-drama', 'Drama']",1990,4
18939923,Orders Are Orders,1953,['United Kingdom'],"['Slapstick', 'Comedy']",1950,3
6257968,Something to Talk About,1995,['United States of America'],"['Romantic drama', 'Comedy', 'Romance Film', 'Romantic comedy', 'Domestic Comedy', 'Comedy-drama', 'Drama']",1990,5
5080099,The Hot Rock,1972,['United States of America'],"['Action', 'Heist', 'Crime Fiction', 'Caper story', 'Action/Adventure', 'Comedy', 'Crime Comedy']",1970,2
5099214,The Day of the Locust,1975,['United States of America'],"['Surrealism', 'Period piece', 'Film adaptation', 'Satire', 'New Hollywood', 'Drama', 'Tragedy']",1970,5
61531,Stage Door,1937,['United States of America'],"['Black-and-white', 'Comedy', 'Comedy-drama', 'Drama', 'Ensemble Film']",1930,7
13509822,Yudh,1985,['India'],"['Musical', 'Action/Adventure', 'Bollywood', 'World cinema']",1980,5
412314,Drowning by Numbers,1988,"['United Kingdom', 'Netherlands']","['Comedy', 'Black comedy', 'Comedy-drama', 'Ensemble Film']",1980,8
22311056,Fire Creek,2006,['United States of America'],['Drama'],2000,6
357186,Kingdom of Heaven,2005,"['Spain', 'United Kingdom', 'Germany', 'United States of America']","['Action', 'Action/Adventure', 'Historical drama', 'Costume drama', 'Adventure', 'Drama', 'Period piece', 'Historical Epic', 'Historical fiction', 'Epic', 'War film']",2000,5
596701,Pumpkinhead,1989,['United States of America'],"['Creature Film', 'Monster movie', 'Indie', 'Slasher', 'Horror', 'Supernatural']",1980,9
30010069,Sooryan,2007,[],"['Action', 'Musical', 'Drama']",2000,7
3617741,Rockers,1978,"['Jamaica', 'United States of America']","['Music', 'Action', 'Crime Fiction', 'Action/Adventure', 'Comedy', 'World cinema', 'Drama', 'Crime Drama']",1970,8
19067593,The Italian Connection,1972,['Italy'],"['Action', 'Blaxploitation', 'Action Thrillers', 'Action/Adventure', 'Thriller', 'World cinema', 'Drama']",1970,2
1700429,Saat Hindustani,1969,['India'],"['Action', 'Drama', 'Adventure']",1960,9
2307224,Nightmare,1956,['United States of America'],['Film noir'],1950,6
2154540,Times Square,1980,['United States of America'],"['LGBT', 'Indie', 'Punk rock', 'Drama']",1980,0
12593100,The Garden of Delights,1970,['Spain'],"['Satire', 'Comedy of manners', 'Comedy-drama', 'Drama']",1970,0
29868894,Heritage,1935,['Australia'],['Historical drama'],1930,5
10776318,Secret Rivals 2,1977,['Hong Kong'],"['Action', 'Action/Adventure', 'Chinese Movies', 'Martial Arts Film']",1970,7
12957045,Everyday People,2004,['United States of America'],"['Indie', 'Drama']",2000,4
14991953,Sarah,1982,['Australia'],['Animation'],1980,2
2918925,Shriek If You Know What I Did Last Friday the Thirteenth,2000,['United States of America'],"['Parody', 'Comedy']",2000,0
29886492,Krishna Prema,1943,['India'],"['Musical', 'Drama']",1940,3
7077556,A Tale of Two Cities,1958,['United Kingdom'],"['Film adaptation', 'Black-and-white', 'History', 'Romantic drama', 'Romance Film', 'Drama']",1950,8
21642375,Dheewarayo,1964,['Sri Lanka'],"['Black-and-white', 'Drama']",1960,4
6306849,Cleopatra,1999,"['Germany', 'United States of America']","['Biography', 'Romantic drama', 'Romance Film', 'Epic', 'Costume drama', 'Drama']",1990,9
31386439,Ladki,1953,['India'],['Comedy film'],1950,3
73402,Sullivan's Travels,1941,['United States of America'],"['Black-and-white', 'Screwball comedy', 'Satire', 'Comedy', 'Romance Film', 'Adventure', 'Drama', 'Romantic comedy', 'Road movie']",1940,1
13911693,The Secret Garden,1949,['United States of America'],"['Black-and-white', 'Drama']",1940,9
33417649,Un sábado más,1988,['Mexico'],"['Action', 'Drama']",1980,8
8729953,Haunted,1995,"['United Kingdom', 'United States of America']","['Mystery', 'Thriller', 'Horror', 'Supernatural']",1990,5
7482617,Family Ties,2006,['South Korea'],"['Family Drama', 'Ensemble Film', 'Drama']",2000,6
3644330,The Blood of a Poet,1930,['France'],"['Experimental film', 'Surrealism', 'Avant-garde']",1930,0
14580338,General's Son III,1992,['South Korea'],"['Action', 'Drama', 'Crime Fiction', 'Romance Film']",1990,2
286830,Lady and the Tramp II: Scamp's Adventure,2001,"['United States of America', 'Australia']","['Animation', 'Animal Picture', 'Family-Oriented Adventure', ""Children's/Family"", 'Adventure', 'Family Film']",2000,1
5523821,Karate Cop,1993,['United States of America'],"['Action', 'Crime Fiction', 'Martial Arts Film', 'Drama']",1990,3
3195590,Family - Ties of Blood,2006,['India'],"['Musical', 'Crime Fiction', 'Bollywood', 'World cinema', 'Drama']",2000,6
98164,Roger & Me,1989,['United States of America'],"['Social issues', 'History', 'Indie', 'Documentary', 'Culture & Society']",1980,9
833502,King of New York,1990,"['United Kingdom', 'Italy', 'United States of America']","['Action', 'Drama', 'Crime Fiction', 'Gangster Film', 'Indie', 'Thriller', 'Crime Thriller']",1990,0
33390824,Humanity's End,2009,['United States of America'],"['Science Fiction', 'Thriller']",2000,9
16362307,Indira Vizha,2009,['India'],"['Romance Film', 'Drama']",2000,9
23767378,Shapoklyak,1974,['Soviet Union'],"['Animation', 'Short Film', 'Family Film']",1970,4
22287758,Walk the Proud Land,1956,['United States of America'],"['Western', 'Biographical film']",1950,6
6139398,China Gate,1998,['India'],"['Musical', 'Bollywood', 'World cinema']",1990,8
13048288,Dollman vs. Demonic Toys,1993,['United States of America'],"['Action', 'Science Fiction', 'Thriller', 'Horror', 'Cult']",1990,3
20254951,That Sinking Feeling,1980,"['United Kingdom', 'Scotland']","['Action', 'Heist', 'Action/Adventure', 'Comedy']",1980,0
26430631,"Die Sister, Die!",1978,['United States of America'],"['Psychological thriller', 'Thriller', 'Horror']",1970,8
10918489,Tekkonkinkreet,2007,['Japan'],"['Fantasy Adventure', 'Animation', 'Adventure', 'Drama', 'Japanese Movies', 'Anime', 'Science Fiction', 'Fantasy']",2000,7
3336243,Three O'Clock High,1987,['United States of America'],"['Comedy', 'Teen']",1980,7
18678217,Rachel Getting Married,2008,['United States of America'],"['Family Drama', 'Indie', 'Romance Film', 'Drama', 'Ensemble Film']",2000,8
21779605,Nowhere Boy,2009,"['Canada', 'United Kingdom']","['Music', 'Coming of age', 'Family Drama', 'Biography', 'Biopic [feature]', 'Drama']",2000,9
18890079,My Brother Cicero,1998,['United States of America'],"['Short Film', 'Comedy']",1990,8
8150464,Madhumasam,2007,['India'],"['Musical', 'Romantic drama', 'Bollywood', 'World cinema', 'Romance Film', 'Drama']",2000,7
14142753,Sunshine Cleaning,2008,['United States of America'],"['Drama', 'Indie', 'Comedy', 'Black comedy', 'Comedy-drama', 'Slice of life story']",2000,8
26180482,Sanctuary,1961,['United States of America'],['Drama'],1960,1
9885736,"Chill Out, Scooby-Doo!",2007,['United States of America'],"['Family Film', 'Animation']",2000,7
716924,Jaane Bhi Do Yaaro,1983,['India'],"['Black comedy', 'Bollywood']",1980,3
32043404,The Ugly Girl,1933,[],['Comedy film'],1930,3
8723567,Zakhm,1998,['India'],"['Drama', 'Bollywood', 'World cinema']",1990,8
22465629,Far West,1973,"['France', 'Belgium']",['Comedy film'],1970,3
33186788,Parasmani,1963,[],"['Musical', 'Drama', 'Fantasy']",1960,3
8780871,A Bug and a Bag of Weed,2006,['Canada'],"['Stoner film', 'Comedy']",2000,6
21673036,The Return of the Musketeers,2009,['Russia'],"['Action', 'Comedy', 'Adventure', 'Fantasy']",2000,9
3520906,Motocrossed,2001,['United States of America'],"['Action', 'Action Comedy', ""Children's/Family"", 'Family Film']",2000,1
72317,Creature from the Black Lagoon,1954,['United States of America'],"['Creature Film', 'Monster movie', 'Black-and-white', 'Horror', 'Adventure', 'Science Fiction']",1950,4
12373270,Reversal of Fortune,2003,['South Korea'],"['Romantic comedy', 'Drama']",2000,3
22276357,The Last Challenge,1967,['United States of America'],"['Action', 'Western']",1960,7
1801788,More American Graffiti,1979,['United States of America'],"['Comedy', 'Americana', 'Drama', 'Period piece', 'Political cinema', 'Coming of age', 'Comedy-drama', 'Political drama', 'Ensemble Film']",1970,9
2982322,To Gillian on Her 37th Birthday,1996,['United States of America'],"['Romantic drama', 'Indie', 'Romance Film', 'Comedy-drama', 'Drama']",1990,6
2301542,Sleeping Bride,2000,['Japan'],"['Japanese Movies', 'Romance Film', 'Drama', 'Fantasy']",2000,0
2885062,In Enemy Hands,2004,['United States of America'],"['Action', 'Action/Adventure', 'Thriller', 'Adventure', 'War film', 'Drama']",2000,4
754810,Children of Paradise,1945,['France'],"['Romantic drama', 'World cinema', 'Romance Film', 'Drama']",1940,5
6640126,For Us the Living: The Medgar Evers Story,1983,['United States of America'],"['Drama', 'Biographical film']",1980,3
74011,High Noon,1952,['United States of America'],"['Western', 'Drama']",1950,2
8938448,"Angel, la diva y yo",1999,['Argentina'],"['Indie', 'Drama']",1990,9
1864142,The Beyond,1981,['Italy'],"['Splatter film', 'Horror', 'World cinema', 'Zombie Film', 'Supernatural']",1980,1
24051596,The Kennel Murder Case,1933,['United States of America'],"['Film adaptation', 'Black-and-white', 'Mystery', 'Thriller', 'Crime Thriller', 'Drama']",1930,3
8379031,The 30 Foot Bride of Candy Rock,1959,['United States of America'],"['Black-and-white', 'Parody', 'Comedy', 'Science Fiction', 'Family Film']",1950,9
4357997,Rancho Notorious,1952,['United States of America'],"['Hybrid Western', 'Western', 'Film noir', 'Crime Thriller']",1950,2
10536562,Rasathanthram,2006,['India'],"['Comedy', 'Drama', 'Family Film']",2000,6
8769475,Steptoe and Son,1972,['United Kingdom'],"['Drama', 'Comedy']",1970,2
13377940,The Final Terror,1983,['United States of America'],"['Slasher', 'Teen', 'Horror', 'B-movie']",1980,3
25524572,Raithu Bidda,1939,['India'],['Drama'],1930,9
9016532,Awakening of the Beast,1990,['Brazil'],"['Drama', 'Thriller', 'Horror']",1990,0
8908857,The Undefeatable,1994,['Hong Kong'],"['Action', 'Action/Adventure', 'Thriller', 'Chinese Movies', 'Martial Arts Film']",1990,4
1149303,Ilsa: She-Wolf of the SS,1975,"['United States of America', 'Canada', 'West Germany']","['Thriller', 'Horror', 'Erotica', 'War film']",1970,5
32790377,Bright Angel,1990,['United States of America'],"['Thriller', 'Crime Drama', 'Road movie', 'Americana', 'Drama']",1990,0
36353890,The I Don't Care Girl,1953,['United States of America'],"['Musical', 'Biographical film']",1950,3
13229264,He's Just Not That Into You,2009,"['Germany', 'United States of America', 'Netherlands']","['Comedy', 'Romance Film', 'Romantic comedy', 'Drama', 'Ensemble Film']",2000,9
22844171,Big Tit Sisters: Blow Through the Valley,2006,['Japan'],"['Erotica', 'Japanese Movies', 'Pornographic movie']",2000,6
2279228,Bewafaa,2005,['India'],"['Romantic drama', 'World cinema', 'Romance Film', 'Drama']",2000,5
3229348,Deliria,1987,['Italy'],"['Giallo', 'Mystery', 'Thriller', 'World cinema', 'Suspense', 'Natural horror films', 'Slasher', 'Horror', 'Supernatural']",1980,7
11395467,The List,2008,['United States of America'],"['Mystery', 'Supernatural', 'Thriller']",2000,8
14199991,The Ex-Mrs. Bradford,1936,['United States of America'],"['Detective fiction', 'Black-and-white', 'Mystery', 'Comedy', 'Detective']",1930,6
20969450,Behind Closed Doors,2003,[],['Drama'],2000,3
15103801,Pirivom Santhippom,2008,['India'],['Family Film'],2000,8
4427187,Vacation in Reno,1946,['United States of America'],"['Black-and-white', 'Crime Fiction', 'Short Film', 'Comedy']",1940,6
21606370,Botany Bay,1953,['United States of America'],"['Film adaptation', 'Action/Adventure', 'Historical fiction', 'Swashbuckler films', 'Adventure', 'Drama']",1950,3
17362385,Codename Cougar,1989,['China'],"['Thriller', 'Chinese Movies', 'Political thriller']",1980,9
18957939,Shopworn,1932,['United States of America'],"['Black-and-white', 'Romantic drama', 'Romance Film', 'Melodrama', 'Pre-Code', 'Drama']",1930,2
3776666,Bungee Jumping of Their Own,2001,['South Korea'],"['Romance Film', 'Drama']",2000,1
6128816,Neighbors,1981,['United States of America'],['Comedy'],1980,1
11091446,Tess of the Storm Country,1922,['United States of America'],"['Black-and-white', 'Drama', 'Indie', 'Silent film']",1920,2
12122757,Monte Walsh,2003,['United States of America'],"['Action/Adventure', 'Western', 'Costume drama', 'Drama']",2000,3
14907049,Arang,2006,['South Korea'],"['World cinema', 'Thriller', 'Horror']",2000,6
36621772,Hissatsu: Sure Death,1984,['Japan'],['Drama'],1980,4
3213691,There Will Be Blood,2007,['United States of America'],"['Period piece', 'Family Drama', 'Drama']",2000,7
18454887,My One and Only,2009,['United States of America'],"['Period piece', 'Indie', 'Comedy', 'Road movie', 'Drama']",2000,9
35151476,Mugam,1999,['India'],[],1990,9
12143841,The Scalphunters,1968,['United States of America'],"['Comedy Western', 'Parody', 'Action/Adventure', 'Western', 'Satire', 'Comedy']",1960,8
13112047,The Perfect Clown,1925,['United States of America'],"['Black-and-white', 'Indie', 'Comedy', 'Silent film']",1920,5
3050420,Saraswatichandra,1968,['India'],"['Musical', 'Black-and-white', 'Bollywood', 'World cinema']",1960,8
9977694,Loose Screws,1985,['Canada'],"['Comedy', 'Teen', 'Sex comedy']",1980,5
14356600,Qivitoq,1956,['Denmark'],"['Romantic drama', 'Drama', 'Family Film']",1950,6
8895933,ReBoot: My Two Bobs,2001,['Canada'],"['Computer Animation', 'Animation', 'Television movie', 'Anime', 'Fantasy', 'Science Fiction']",2000,1
25988065,Scarlet Dawn,1932,['United States of America'],"['Romance Film', 'Historical fiction', 'Drama']",1930,2
14873085,Balthus Through the Looking Glass,1996,['France'],"['Documentary', 'World cinema']",1990,6
7070728,Kabuliwala,1956,['India'],"['Drama', 'Crime Fiction']",1950,6
5566124,The Call of the Canyon,1923,['United States of America'],"['Black-and-white', 'Indie', 'Western', 'Silent film']",1920,3
21292344,Black and White,1999,['United States of America'],"['Indie', 'Drama']",1990,9
2522220,The Hidden,1987,['United States of America'],"['Indie', 'Science Fiction', 'Thriller', 'Horror', 'Cult']",1980,7
3127366,Yield to the Night,1956,['United Kingdom'],"['Black-and-white', 'Crime Fiction', 'Crime Drama', 'Drama']",1950,6
1007563,Commandments,1997,['United States of America'],"['Indie', 'Comedy', 'Black comedy', 'Religious Film']",1990,7
3520882,Going to the Mat,2004,['United States of America'],"['Television movie', 'Family Film', 'Sports', 'Drama']",2000,4
24818273,Full Circle,1978,"['Canada', 'United Kingdom']","['Mystery', 'Drama', 'Horror']",1970,8
1351316,Porky's Hare Hunt,1938,['United States of America'],"['Animation', 'Short Film', 'Comedy', 'Family Film']",1930,8
7809854,The Legend of the North Wind,1992,['Spain'],"['Animation', 'Family Film', 'Fantasy']",1990,2
80538,The Snake Pit,1948,['United States of America'],"['Black-and-white', 'Drama']",1940,8
4518378,Shottas,2002,"['Jamaica', 'United States of America']","['Action', 'Drama', 'Crime Fiction', 'Gangster Film', 'Crime Drama']",2000,2
26553506,So This Is Paris,1955,['United States of America'],['Musical comedy'],1950,5
32339893,My Girlfriend Is An Agent,2009,[],"['Action', 'Action/Adventure', 'Comedy', 'World cinema']",2000,9
14212173,Police Assassins,1985,['Hong Kong'],"['Action', 'Crime Fiction', 'Action/Adventure', 'World cinema', 'Chinese Movies', 'Martial Arts Film']",1980,5
15886019,Walk on the Wild Side,1962,['United States of America'],"['Period piece', 'Melodrama', 'Drama']",1960,2
23917609,A Killing in a Small Town,1990,['United States of America'],"['Crime Fiction', 'Television movie', 'Crime Thriller', 'Drama', 'Courtroom Drama']",1990,0
21185163,A Hole of My Own Making,1955,['Japan'],"['Black-and-white', 'Japanese Movies', 'Family Drama', 'Drama']",1950,5
18501873,How to Succeed in Business Without Really Trying,1967,['United States of America'],"['Musical', 'Comedy', 'Musical comedy', 'Workplace Comedy']",1960,7
1620938,"What's Up, Tiger Lily?",1966,"['Japan', 'United States of America']","['Spy', 'Japanese Movies', 'Parody', 'Comedy', 'Absurdism']",1960,6
15574710,King Arthur Was a Gentleman,1942,['United Kingdom'],"['Musical', 'Comedy', 'Adventure']",1940,2
28066754,Chenkol,2000,['India'],"['Action', 'Bollywood', 'World cinema', 'Drama']",2000,0
1057569,Bells Are Ringing,1960,['United States of America'],"['Musical', 'Comedy', 'Musical comedy', 'Romance Film', 'Romantic comedy']",1960,0
14793383,Train Man,2005,['Japan'],"['Romance Film', 'Comedy']",2000,5
27689089,The Man on the Balcony,1993,"['Sweden', 'Germany']",['Crime Fiction'],1990,3
13506326,Hair Show,2004,['United States of America'],"['Indie', 'Comedy']",2000,4
13064230,Children of Pleasure,1930,['United States of America'],"['Musical', 'Black-and-white', 'Comedy', 'Pre-Code']",1930,0
1362990,Pimpernel Smith,1941,['United Kingdom'],"['Spy', 'Action', 'Black-and-white', 'Action/Adventure', 'War film']",1940,1
62592,The Philadelphia Story,1940,['United States of America'],"['Black-and-white', 'Screwball comedy', 'Comedy', 'Romance Film', 'Romantic comedy']",1940,0
2117337,One Woman or Two,1985,['France'],['Comedy'],1980,5
25826060,Sister Mary Explains It All,2001,[],['Black comedy'],2000,1
10063659,The Cobweb,1955,['United States of America'],"['Satire', 'Drama']",1950,5
17730252,Swapnakoodu,2003,['India'],"['Drama', 'Comedy']",2000,3
12076925,Quest for Fire,1982,"['France', 'United States of America', 'Canada']","['Period piece', 'Action/Adventure', 'Costume drama', 'Adventure', 'Drama', 'Fantasy']",1980,2
7321868,Athidi,2007,['India'],"['Action', 'Drama', 'Crime Fiction', 'Romance Film']",2000,7
6014184,Do Chor,1966,['India'],"['Action', 'Drama']",1960,6
484153,Miranda,1948,['United Kingdom'],"['Romantic drama', 'Science Fiction', 'Romance Film', 'Romantic comedy', 'Drama']",1940,8
22452892,Hop-Along Cassidy,1935,['United States of America'],"['Western', 'Black-and-white']",1930,5
25829850,Tiger Claws,1992,"['Canada', 'United States of America']","['Action', 'Martial Arts Film']",1990,2
2812897,Wait 'Til You're Older,2005,"['China', 'Hong Kong']","['Comedy', 'Childhood Drama', 'World cinema', 'Chinese Movies', 'Drama', 'Fantasy']",2000,5
3997811,The Three Stooges in Orbit,1962,['United States of America'],"['Comedy', 'Adventure', 'Alien Film', 'Slapstick', 'Science Fiction']",1960,2
33184757,The Lambeth Walk,1939,[],['Musical'],1930,9
5871444,Balu ABCDEFG,2005,['India'],"['Tollywood', 'Romantic drama', 'World cinema', 'Romance Film', 'Drama']",2000,5
4827986,Natural City,2003,['South Korea'],"['Dystopia', 'Future noir', 'Action/Adventure', 'Thriller', 'World cinema', 'Science Fiction']",2000,3
19081365,Watch Your Stern,1960,['United Kingdom'],['Comedy'],1960,0
320502,Panic,2000,['United States of America'],"['Crime Fiction', 'Indie', 'Comedy', 'Thriller', 'Drama']",2000,0
166813,Spartacus,1960,['United States of America'],"['Action', 'Biographical film', 'Romance Film', 'Costume drama', 'Adventure', 'Drama', 'Historical fiction', 'Epic', 'War film']",1960,0
30864413,Zaalim,1994,[],['Action'],1990,4
25445821,Tingu Rangadu,1982,['India'],"['Action', 'Drama', 'Comedy', 'Family Film']",1980,2
7601868,Model Behaviour,1984,['United States of America'],"['Indie', 'Comedy']",1980,4
13627397,The Learning Curve,2001,['United States of America'],"['Crime Fiction', 'Indie', 'Thriller', 'Crime Thriller', 'Drama']",2000,1
3979809,Return of the Living Dead,1985,['United States of America'],"['Satire', 'Comedy', 'Horror', 'Zombie Film', 'Doomsday film', 'Science Fiction', 'Cult']",1980,5
32076153,Rakta Bandhan,1984,[],"['Action', 'Crime Fiction', 'Comedy film']",1980,4
8486623,Twice Upon A Christmas,2001,['United States of America'],"['Comedy', 'Romance Film', 'Holiday Film', 'Drama', 'Family Film', 'Fantasy']",2000,1
7503887,Judge for a Day,1935,['United States of America'],['Comedy'],1930,5
16523191,The Hoober-Bloob Highway,1975,['United States of America'],['Short Film'],1970,5
13458759,Big Fellas,2007,['South Africa'],['Comedy'],2000,7
76349,Shock Corridor,1963,['United States of America'],"['Psychological thriller', 'Mystery', 'Indie', 'Thriller', 'Drama']",1960,3
8554766,The Tale Of The Bunny Picnic,1986,"['United Kingdom', 'United States of America']","['Musical', 'Family Film']",1980,6
31718571,Masterji,1985,['India'],"['Drama', 'Comedy film']",1980,5
24641896,Fox,2009,['India'],"['Thriller', 'World cinema']",2000,9
11966731,When Andrew Came Home,2000,['United States of America'],"['Family Drama', 'Drama']",2000,0
30865545,High Kick Girl!,2009,['Japan'],"['Action', 'Japanese Movies', 'Action/Adventure', 'World cinema', 'Martial Arts Film']",2000,9
2886835,"Dancer, Texas Pop. 81",1998,['United States of America'],"['Indie', 'Comedy', 'Americana', 'Drama', 'Slice of life story', 'Coming of age', 'Comedy-drama', 'Family Film']",1990,8
1269138,Street Fighter,1994,"['Japan', 'United States of America']","['Action', 'Japanese Movies', 'Comedy', 'Thriller']",1990,4
11961851,Strange Interlude,1932,['United States of America'],"['Black-and-white', 'Romantic drama', 'Pre-Code', 'Drama']",1930,2
19566724,The Marc Pease Experience,2009,['United States of America'],['Comedy'],2000,9
11360720,Mouse Into Space,1962,['United States of America'],"['Animation', 'Short Film', 'Comedy', 'Family Film']",1960,2
8344208,Mary and Rhoda,2000,['United States of America'],"['Comedy', 'Romance Film', 'Comedy-drama', 'Drama']",2000,0
277006,Star Trek: The Motion Picture,1979,['United States of America'],"['Adventure', 'Science Fiction', 'Drama', 'Family Film']",1970,9
14538576,Bambai Ka Babu,1996,['India'],"['Action', 'Thriller', 'World cinema']",1990,6
9919820,Me and Her,2006,['United Kingdom'],['Short Film'],2000,6
10855118,Agaram,2007,['India'],['Action'],2000,7
12930932,And Then Came Love,2007,['United States of America'],"['Romance Film', 'Romantic comedy', 'Comedy']",2000,7
22906962,Go for It,1983,"['Italy', 'United States of America']","['Action', 'Adventure', 'Comedy film']",1980,3
1533733,The Mortal Storm,1940,['United States of America'],"['Black-and-white', 'War film', 'Political drama', 'Drama']",1940,0
3028191,A Nightmare on Elm Street,1984,['United States of America'],"['Mystery', 'Indie', 'Slasher', 'Teen', 'Horror', 'Supernatural', 'Cult']",1980,4
20842937,A Touch of Grey,2009,['Canada'],['Comedy'],2000,9
18287833,The Girl with the Red Scarf,1977,['Turkey'],"['Romance Film', 'Drama']",1970,7
3048276,The Work and The Glory,2004,['United States of America'],"['Period piece', 'Romantic drama', 'Romance Film', 'Historical fiction', 'Drama']",2000,4
6324060,Vodka Lemon,2004,"['Armenia', 'Switzerland', 'Russia', 'France', 'Italy']","['Political satire', 'Romantic drama', 'Comedy', 'World cinema', 'Romance Film', 'Black comedy', 'Drama', 'Political cinema', 'Romantic comedy', 'Comedy-drama', 'Political drama']",2000,4
16489330,Dostana,2008,"['India', 'United States of America']","['Musical', 'Romantic drama', 'Comedy', 'Bollywood', 'World cinema', 'Romance Film', 'Drama', 'Romantic comedy', 'Sex comedy']",2000,8
2513427,Dhoom 2,2006,['India'],"['Action', 'Musical', 'Crime Fiction', 'Action Thrillers', 'Action/Adventure', 'Comedy', 'Thriller', 'Bollywood', 'World cinema', 'Buddy cop']",2000,6
1878054,Pusher II,2004,"['United Kingdom', 'Denmark']","['Action', 'Crime Fiction', 'Gangster Film', 'Action/Adventure', 'Thriller', 'World cinema', 'Crime Thriller', 'Drama', 'Crime Drama']",2000,4
14222317,California Dreaming,2007,['United States of America'],"['Indie', 'Comedy', 'Family Film']",2000,7
13141411,Fierce People,2005,"['Canada', 'United States of America']","['Film adaptation', 'Coming of age', 'Indie', 'Thriller', 'Drama']",2000,5
21003194,Tales That Witness Madness,1973,['United Kingdom'],"['Comedy', 'Horror Comedy', 'Horror', 'Natural horror films']",1970,3
25845778,Tora-San's Cherished Mother,1969,['Japan'],"['Japanese Movies', 'Comedy', 'World cinema']",1960,9
18932671,The Other Side of Midnight,1977,['United States of America'],"['Romantic drama', 'Thriller', 'Romance Film', 'Melodrama', 'Drama']",1970,7
6785797,Dhill,2001,['India'],"['Action', 'Musical', 'Drama']",2000,1
29697967,Bengal Tiger,2001,['India'],"['Action', 'Crime Fiction']",2000,1
29890894,The First Texan,1956,[],"['Action/Adventure', 'Western']",1950,6
19069597,Paris Calling,1941,['United States of America'],['War film'],1940,1
25144574,In the Beginning,2000,['United States of America'],"['Adventure', 'Drama']",2000,0
352795,Jaws 2,1978,['United States of America'],"['Action', 'Action/Adventure', 'Thriller', 'Adventure', 'Creature Film', 'Suspense', 'Natural horror films', 'Slasher', 'Horror']",1970,8
28311597,Time of the Comet,2008,"['Albania', 'Germany']","['Period piece', 'Romantic drama', 'Black comedy', 'Drama']",2000,8
7183180,They Came Back,2004,['France'],"['Creature Film', 'Horror', 'World cinema', 'Zombie Film', 'Drama']",2000,4
1025841,Once Upon a Crime...,1992,['United States of America'],"['Mystery', 'Comedy', 'Thriller', 'Crime Thriller']",1990,2
28025756,The Canterville Ghost,1995,['United States of America'],"['Film adaptation', 'Family Drama', 'Television movie', 'Drama', 'Family Film', 'Fantasy']",1990,5
30542734,Ente Ammu Ninte Thulasi Avarude Chakki,1985,[],"['Romance Film', 'Drama', 'Comedy film']",1980,5
1983207,Angel Eyes,2001,['United States of America'],"['Crime Fiction', 'Romantic drama', 'Romance Film', 'Drama']",2000,1
19614697,Chronopolis,1983,"['France', 'Poland']","['Surrealism', 'Animation', 'Stop motion', 'Science Fiction']",1980,3
16861768,Ek Hi Raasta,1993,['India'],"['Action', 'Romantic drama', 'World cinema', 'Romance Film', 'Drama', 'Family Film']",1990,3
5422414,The Pit and the Pendulum,1961,['United States of America'],"['Giallo', 'Film adaptation', 'Horror', 'Costume drama', 'Drama']",1960,1
10938550,Gudgudee,1997,['India'],"['Musical', 'Romance Film']",1990,7
933349,The Lost Skeleton of Cadavra,2002,['United States of America'],"['Black-and-white', 'Parody', 'Comedy', 'Science Fiction']",2000,2
19031611,Captain Pantoja and the Special Services,2000,"['Spain', 'Peru']","['Comedy', 'Drama', 'World cinema']",2000,0
7171896,Challenge,1984,['India'],['Drama'],1980,4
27348163,Scandal Sheet,1985,['United States of America'],['Drama'],1980,5
2472440,Turbulence,1997,['United States of America'],"['Action', 'Action/Adventure', 'Thriller', 'Disaster']",1990,7
2332775,Fidel,2002,['United States of America'],"['Biographical film', 'Television movie', 'Political drama', 'Drama']",2000,2
1464962,The Osterman Weekend,1983,['United States of America'],"['Action', 'Psychological thriller', 'Spy', 'Film adaptation', 'Political thriller', 'Thriller', 'Drama']",1980,3
16652785,Flawless,2007,"['Luxembourg', 'United Kingdom']","['Drama', 'Crime Fiction', 'Thriller']",2000,7
5564502,The Goat,1921,['United States of America'],"['Black-and-white', 'Indie', 'Short Film', 'Comedy', 'Silent film']",1920,1
8364339,Stomp the Yard,2007,['United States of America'],"['Musical', 'Teen', 'Dance', 'Romance Film', 'Drama']",2000,7
24823991,My Super Psycho Sweet 16,2009,[],"['Slasher', 'Horror']",2000,9
21469222,Optimistic Tragedy,1963,['Soviet Union'],"['History', 'War film', 'Drama']",1960,3
242104,Local Hero,1983,"['United Kingdom', 'Scotland']","['Comedy', 'Drama', 'Cult']",1980,3
8657003,Khulood,1948,['Egypt'],['Romance Film'],1940,8
14954930,New In Town,2009,"['Canada', 'United States of America']","['Romance Film', 'Romantic comedy', 'Comedy']",2000,9
3540323,Talkin' Dirty After Dark,1991,['United States of America'],"['Stand-up comedy', 'Comedy']",1990,1
34977626,Mandhira Punnagai,1986,['India'],[],1980,6
8900483,Sands of the Kalahari,1965,['United Kingdom'],"['Action', 'Drama', 'Action/Adventure', 'Adventure']",1960,5
15770250,The Princess and the Goblin,1993,"['United Kingdom', 'Hungary', 'Japan']","['Animation', 'Japanese Movies', ""Children's"", 'Fantasy']",1990,3
2172927,The Sacrifice,2005,['United States of America'],['Horror'],2000,5
76630,The Wild Bunch,1969,['United States of America'],"['Action', 'Western']",1960,9
217982,Caddyshack,1980,['United States of America'],"['Gross out', 'Gross-out film', 'Satire', 'Comedy', 'Sports', 'Slapstick', 'Cult']",1980,0
1324831,Mujhse Dosti Karoge!,2002,['India'],"['Musical', 'Romantic drama', 'Comedy', 'Bollywood', 'World cinema', 'Romance Film', 'Drama', 'Romantic comedy', 'Family Film']",2000,2
16168286,Sullan,2004,['India'],"['Action', 'Crime Fiction', 'Drama']",2000,4
2452747,Britannia Hospital,1982,['United Kingdom'],"['Parody', 'Satire', 'Comedy', 'Black comedy']",1980,2
2008863,Flightplan,2005,['United States of America'],"['Psychological thriller', 'Suspense', 'Airplanes and airports', 'Mystery', 'Thriller', 'Disaster', 'Drama']",2000,5
32034910,Sun Sajna,1982,['India'],"['Romantic drama', 'World cinema', 'Romance Film', 'Drama']",1980,2
576198,Adventures in Babysitting,1987,['United States of America'],"['Action', 'Comedy', 'Thriller', 'Teen', 'Adventure', 'Family Film']",1980,7
21411328,Safe Harbor,2009,['United States of America'],"['Television movie', 'Family Drama', 'Drama']",2000,9
9183439,Hawking,2004,['United Kingdom'],"['Drama', 'Biographical film']",2000,4
24669308,El Miedo no anda en Burro,1967,['Mexico'],"['Comedy', 'Haunted House Film', 'Horror Comedy']",1960,7
2400255,All the Right Moves,1983,['United States of America'],"['Coming of age', 'Teen', 'Romance Film', 'Sports', 'Drama']",1980,3
4336248,Hell Is for Heroes,1962,['United States of America'],"['Anti-war', 'Action', 'Combat Films', 'Anti-war film', 'War film']",1960,2
19547540,Streets of Blood,2009,['United States of America'],"['Action', 'Crime Fiction', 'Mystery', 'Thriller', 'Crime Thriller', 'Drama']",2000,9
22379544,The Gazebo,1959,['United States of America'],"['Black-and-white', 'Comedy', 'Crime Comedy', 'Black comedy']",1950,9
35881378,Bullet for a Badman,1964,['United States of America'],['Western'],1960,4
22944264,Penny Princess,1952,['United Kingdom'],"['Parody', 'Comedy', 'Romance Film', 'Romantic comedy']",1950,2
1531473,The Hairy Bird,1998,"['United States of America', 'Canada', 'Italy']","['Period piece', 'Indie', 'Comedy']",1990,8
31449751,The Gang,2000,[],"['Action', 'Musical', 'Thriller']",2000,0
6232753,Everyone Stares: The Police Inside Out,2006,['United States of America'],['Rockumentary'],2000,6
12812790,The Affairs of Martha,1942,['United States of America'],"['Black-and-white', 'Comedy', 'Comedy of manners', 'Romantic comedy']",1940,2
5330839,Parents,1989,"['Canada', 'United States of America']","['Black comedy', 'Horror']",1980,9
9894962,The Mahabharata,1989,"['Iceland', 'Australia', 'Japan', 'Sweden', 'Finland', 'France', 'Ireland', 'Portugal', 'Denmark', 'Belgium', 'Norway', 'United Kingdom', 'Netherlands', 'United States of America']","['Japanese Movies', 'Drama']",1980,9
28695611,No Room at the Inn,1948,['United Kingdom'],['Drama'],1940,8
33457532,Rainbow Eyes,2007,['South Korea'],"['Crime Fiction', 'Mystery', 'Drama']",2000,7
2730191,La Ronde,1964,['France'],"['Romantic drama', 'World cinema', 'Romance Film', 'Drama']",1960,4
19286454,Panam Padaithavan,1965,['India'],['Drama'],1960,5
2873612,The Ghost Ship,1943,['United States of America'],"['Black-and-white', 'Adventure', 'Horror']",1940,3
2216055,Malice,1993,"['Canada', 'United States of America']","['Psychological thriller', 'Suspense', 'Crime Fiction', 'Mystery', 'Thriller', 'Crime Thriller']",1990,3
29664949,Heeralal Pannalal,1999,['India'],"['Action', 'Drama', 'Crime Fiction', 'Comedy film']",1990,9
6133862,The Barbie Diaries,2006,['United States of America'],"[""Children's Fantasy"", 'Animation', ""Children's/Family"", ""Children's"", 'Family Film', 'Computer Animation']",2000,6
5721251,Vampira,1974,['United Kingdom'],"['Parody', 'Comedy', 'Horror', 'Adult']",1970,4
1343208,Code 46,2004,['United Kingdom'],"['Romantic drama', 'Science Fiction', 'Thriller', 'Romance Film', 'Drama']",2000,4
6557406,Fast Food Nation,2006,"['United Kingdom', 'United States of America']","['Film adaptation', 'Comedy-drama', 'Americana', 'Drama', 'Ensemble Film']",2000,6
8398222,Gods and Generals,2003,['United States of America'],"['Period piece', 'Action', 'History', 'Costume drama', 'War film', 'Drama']",2000,3
2081791,Scooby-Doo on Zombie Island,1998,['United States of America'],"[""Children's Fantasy"", 'Animation', 'Zombie Film', ""Children's/Family""]",1990,8
16753523,The Raccoons and the Lost Star,1983,['Canada'],"[""Children's/Family"", 'Animation']",1980,3
75222,Spaceballs,1987,['United States of America'],"['Parody', 'Comedy', 'Adventure', 'Slapstick', 'Science Fiction', 'Cult', 'Absurdism']",1980,7
11667911,The Resurrected,1992,['United States of America'],"['Film adaptation', 'Detective fiction', 'Detective', 'Horror', 'Drama']",1990,2
8807042,Alfonsina,1957,['Argentina'],"['Black-and-white', 'Biographical film']",1950,7
27202754,Yes Your Honour,2006,['India'],"['Musical', 'Thriller', 'Bollywood', 'World cinema']",2000,6
34246591,Deadly Little Christmas,2008,['United States of America'],"['Slasher', 'B-movie', 'Horror']",2000,8
13232149,Aggar,2007,['India'],"['Musical', 'Thriller', 'Bollywood', 'World cinema']",2000,7
6355228,The Breed,2006,"['Germany', 'South Africa', 'United States of America']","['Horror', 'Natural horror films']",2000,6
9500895,The Good Girl,2004,['Spain'],"['Short Film', 'Pornographic movie']",2000,4
13065718,The Gray Man,2007,['United States of America'],"['Crime Fiction', 'Mystery', 'Biographical film', 'Thriller', 'Crime Thriller', 'Drama', 'Period piece', 'Biopic [feature]']",2000,7
20923240,One Word from You,2008,['Spain'],['Drama'],2000,8
15304214,Special Delivery,2008,['United States of America'],"['Action', 'Coming of age', 'Comedy', 'Teen', 'Television movie', 'Drama']",2000,8
13145083,On Guard,1997,"['France', 'Germany', 'Italy']","['Action/Adventure', 'World cinema', 'Adventure', 'Swashbuckler films']",1990,7
533515,Cat's Eye,1985,['United States of America'],"['Film adaptation', 'Horror']",1980,5
28519243,The Nursemaid Who Disappeared,1939,['United Kingdom'],['Crime Fiction'],1930,9
18599471,The Private Lives of Pippa Lee,2009,['United States of America'],"['Film adaptation', 'Romantic drama', 'Romance Film', 'Comedy-drama', 'Drama']",2000,9
12758832,Emergency Call,1952,['United Kingdom'],['Thriller'],1950,2
1278589,The Marine,2006,['United States of America'],"['Action', 'Drama', 'Action Thrillers', 'Action/Adventure', 'Thriller']",2000,6
15170509,A Petal,1996,['South Korea'],"['Drama', 'Political drama']",1990,6
26724711,Creature of Destruction,1967,['United States of America'],"['Horror', 'Science Fiction']",1960,7
12816598,Kickboxer 2,1991,['United States of America'],"['Action/Adventure', 'Martial Arts Film']",1990,1
9906067,Boiling Point,1993,"['France', 'Japan', 'United States of America']","['Action', 'Crime Fiction', 'Japanese Movies', 'Action/Adventure', 'Thriller']",1990,3
940106,Dangerous Curves,1989,['United States of America'],['Comedy film'],1980,9
3871640,I Not Stupid Too,2006,['Singapore'],"['Drama', 'Comedy']",2000,6
23470870,Twelve Mile Road,2003,['United States of America'],['Drama'],2000,3
1623252,Rich and Strange,1931,"['United Kingdom', 'England']","['Black-and-white', 'Comedy', 'Thriller', 'Romance Film', 'Adventure']",1930,1
10203043,The Scarlet Horseman,1946,['United States of America'],"['Action', 'Black-and-white', 'Western', 'Adventure']",1940,6
28651451,Crime and Punishment,2002,"['Russia', 'Poland', 'United States of America']","['Film adaptation', 'Drama', 'Crime Fiction', 'Indie']",2000,2
7760868,The Unbelievable Truth,1989,['United States of America'],"['Drama', 'Indie', 'Comedy', 'Black comedy', 'Romantic comedy', 'Comedy-drama', 'Romance Film']",1980,9
1896242,Naina,2005,['India'],"['Psychological thriller', 'World cinema', 'Horror']",2000,5
21210395,Revanche,2008,['Austria'],"['Crime Fiction', 'Romantic drama', 'Thriller', 'World cinema', 'Romance Film', 'Drama']",2000,8
26181579,For the Term of his Natural Life,1927,['Australia'],"['Romance Film', 'Adventure']",1920,7
68125,The Blood of Jesus,1941,['United States of America'],"['Christian film', 'Black-and-white', 'Race movie']",1940,1
8640412,Beethoven's 5th,2003,['United States of America'],"['Animal Picture', 'Comedy', 'Family Film']",2000,3
10842896,Night of the Twisters,1996,"['Canada', 'United States of America']","['Action/Adventure', 'Thriller', 'Television movie', 'Disaster']",1990,6
21520076,Bodyguard,2009,['India'],['Romantic comedy'],2000,9
4276400,One 2 Ka 4,2001,['India'],"['Action', 'Drama', 'Comedy']",2000,1
1405215,The Best Two Years,2003,['United States of America'],"['Religious Film', 'Comedy-drama', 'Comedy']",2000,3
32605438,Imago Mortis,2009,"['Spain', 'Ireland', 'Italy']","['Horror', 'Gothic Film']",2000,9
11216972,Fantaghirò 4,1994,['Italy'],"['Adventure', 'Family Film']",1990,4
21870294,T2,2009,['Philippines'],"['Filipino Movies', 'Thriller', 'Horror', 'World cinema']",2000,9
2399371,Kill Me Again,1989,['United States of America'],"['Action', 'Neo-noir', 'Crime Fiction', 'Gangster Film', 'Indie', 'Thriller', 'Crime Thriller', 'Drama', 'Suspense']",1980,9
16773265,Pauline and Paulette,2002,"['France', 'Netherlands', 'Belgium']","['Family Drama', 'Comedy', 'World cinema', 'Drama']",2000,2
3645251,The Lickerish Quartet,1970,"['West Germany', 'Italy', 'United States of America']","['Erotic Drama', 'Romantic drama', 'Romance Film', 'Drama', 'Softcore Porn', 'Sexploitation', 'Comedy-drama', 'Erotica', 'Adult']",1970,0
737803,Dumb & Dumber,1994,['United States of America'],"['Buddy film', 'Slapstick', 'Comedy']",1990,4
21378128,Wyvern,2009,"['Canada', 'United States of America']","['Creature Film', 'Horror', 'Adventure', 'Science Fiction', 'Fantasy']",2000,9
14348047,No End,1985,['Poland'],"['World cinema', 'Political drama', 'Drama', 'Fantasy']",1980,5
7377259,Overlord,1978,['United Kingdom'],"['Combat Films', 'Action', 'Drama', 'War film']",1970,8
89793,Out of Africa,1985,['United States of America'],"['British Empire Film', 'Film adaptation', 'Biography', 'Romantic drama', 'Biographical film', 'Romance Film', 'Adventure', 'Drama', 'Period piece', 'Biopic [feature]']",1980,5
3356623,Felicia's Journey,1999,"['United Kingdom', 'United States of America', 'Canada']","['Psychological thriller', 'Suspense', 'Crime Fiction', 'Thriller', 'Crime Drama', 'Crime Thriller', 'Drama']",1990,9
468311,In America,2003,"['United Kingdom', 'Ireland', 'United States of America']","['Indie', 'Family Drama', 'Childhood Drama', 'World cinema', 'Romance Film', 'Drama', 'Period piece', 'Comedy-drama']",2000,3
826482,Dead Ringers,1988,"['Canada', 'United States of America']","['Psychological thriller', 'Thriller', 'Horror', 'Crime Thriller', 'Drama', 'Medical fiction']",1980,8
24315911,The Invisible Kid,1988,['United States of America'],"['Science Fiction', 'Comedy']",1980,8
29781,The Texas Chain Saw Massacre,1974,['United States of America'],"['Mystery', 'Thriller', 'Horror', 'Cult']",1970,4
5584803,Sweetie,1989,['Australia'],"['Indie', 'Comedy', 'World cinema', 'Black comedy', 'Drama']",1980,9
1575809,I'm Gonna Git You Sucka,1988,['United States of America'],"['Action', 'Blaxploitation', 'Parody', 'Action/Adventure', 'Comedy', 'Slapstick']",1980,8
18357891,Tokyo!,2008,"['France', 'South Korea', 'Japan']","['Japanese Movies', 'Romantic drama', 'Comedy', 'World cinema', 'Romance Film', 'Anthology', 'Drama']",2000,8
11892833,Keemat: They Are Back,1998,['India'],"['Action', 'Romantic drama', 'Action/Adventure', 'World cinema', 'Romance Film', 'Drama']",1990,8
20278496,First Time Felon,1997,['United States of America'],"['Drama', 'Crime Fiction']",1990,7
6893869,Malaya,1949,['United States of America'],"['Black-and-white', 'War film', 'Adventure']",1940,9
19156632,White Night Wedding,2008,['Iceland'],"['Drama', 'World cinema']",2000,8
23066772,Prisoner of War,1954,['United States of America'],['War film'],1950,4
19864581,"B.B. King ""Into the Night""",1985,['United States of America'],"['Short Film', 'Documentary']",1980,5
2663035,Versus,2000,"['Japan', 'United States of America']","['Action', 'Action Thrillers', 'Action/Adventure', 'Thriller', 'World cinema', 'Zombie Film', 'Martial Arts Film', 'Japanese Movies', 'Horror', 'Supernatural', 'Science Fiction']",2000,0
6023801,The Ugly,1997,"['New Zealand', 'Australia']","['Psychological thriller', 'Indie', 'Slasher', 'Thriller', 'Horror', 'B-movie']",1990,7
1614875,The Rookie,2002,['United States of America'],"['Airplanes and airports', 'Sports', 'Family Drama', 'Drama', 'Family Film']",2000,2
8921046,The Congress Dances,1931,"['Weimar Republic', 'Germany']","['Musical', 'Black-and-white', 'Comedy']",1930,1
23933545,Yonkers Joe,2008,['United States of America'],"['Crime Fiction', 'Indie', 'Family Drama', 'Crime Drama', 'Drama']",2000,8
16857426,Life Mein Kabhie Kabhiee,2006,['India'],"['Musical', 'Comedy', 'Thriller', 'Bollywood', 'World cinema', 'Drama']",2000,6
5865108,Keerthi Chakra,2006,['India'],"['War film', 'Drama']",2000,6
21811510,"My Son, My Son, What Have Ye Done",2009,['United States of America'],"['Psychological thriller', 'Drama', 'Indie', 'Thriller', 'Horror', 'Crime Thriller']",2000,9
8120493,Blind Date,1984,['United States of America'],"['Indie', 'Thriller', 'Detective']",1980,4
748933,Fireworks,1997,['Japan'],"['Crime Fiction', 'Japanese Movies', 'Romance Film', 'Drama']",1990,7
8776448,A Dirty Carnival,2006,['South Korea'],"['Crime Fiction', 'Action/Adventure', 'Thriller', 'World cinema', 'Crime Drama', 'Crime Thriller']",2000,6
9694681,Convicted,1950,['United States of America'],"['Black-and-white', 'Crime Fiction', 'Thriller', 'Film noir', 'Drama']",1950,0
29781388,Horse Hare,1960,[],"['Animation', 'Short Film', 'Western', 'Comedy film', 'Family Film']",1960,0
1205786,The Stratton Story,1949,['United States of America'],"['Black-and-white', 'Biopic [feature]', 'Sports', 'Drama']",1940,9
1061565,All the Little Animals,1999,['United Kingdom'],"['Film adaptation', 'Family Drama', 'Drama']",1990,9
2679331,The Hole,1999,"['France', 'Taiwan', 'China']","['Musical', 'World cinema', 'Chinese Movies', 'Drama', 'Fantasy']",1990,9
30863010,Jushin Thunder Liger: Fist of Thunder,1995,['Japan'],"['Japanese Movies', 'Horror']",1990,5
1473007,Northwest Passage,1940,['United States of America'],"['Western', 'War film', 'Adventure', 'Drama']",1940,0
1273396,Surviving Christmas,2004,['United States of America'],"['Comedy', 'Romantic comedy', 'Romance Film', 'Domestic Comedy', 'Holiday Film', 'Slapstick', 'Christmas movie']",2000,4
12321731,Dreams on Spec,2007,['United States of America'],"['Biography', 'Documentary', 'Media Studies', 'Film']",2000,7
14929033,Summer Snow,1995,['Hong Kong'],"['Family Drama', 'Comedy', 'Comedy-drama', 'Chinese Movies', 'Drama']",1990,5
1927824,Puddle Cruiser,1996,['United States of America'],"['Indie', 'Comedy', 'Romance Film', 'Romantic comedy']",1990,6
26627899,Mohabbat,1997,['India'],"['Drama', 'World cinema']",1990,7
307553,The Lion King II: Simba's Pride,1998,['United States of America'],"['Family Film', 'Animation']",1990,8
5032246,Desiya Geetham,1999,['India'],['Drama'],1990,9
5260111,Beware! The Blob,1972,['United States of America'],"['Sci-Fi Horror', 'Science Fiction', 'Horror']",1970,2
281069,Sinbad: Legend of the Seven Seas,2003,['United States of America'],"['Fantasy Adventure', 'Animation', ""Children's/Family"", 'Adventure', 'Mythological Fantasy', ""Children's Fantasy"", 'Family Film', 'Fantasy']",2000,3
31562311,Uthama Puthiran,1958,['India'],[],1950,8
200694,Clerks.,1994,['United States of America'],"['Black-and-white', 'Drama', 'Indie', 'Buddy film', 'Comedy', 'Cult']",1990,4
3946917,Shakti: The Power,2002,['India'],"['Action', 'Drama', 'Action/Adventure', 'Bollywood', 'World cinema']",2000,2
8279549,Son of Zorro,1947,['United States of America'],"['Superhero movie', 'Black-and-white', 'Swashbuckler films']",1940,7
1410292,Samurai Fiction,1998,['Japan'],"['Samurai cinema', 'Action/Adventure', 'Comedy', 'World cinema', 'Martial Arts Film', 'Period piece', 'Japanese Movies', 'Parody', 'Comedy-drama']",1990,8
6015713,Indestructible Man,1956,['United States of America'],"['Black-and-white', 'Indie', 'Horror', 'Science Fiction']",1950,6
29836606,Night Slaves,1970,['United States of America'],"['Horror', 'Science Fiction']",1970,0
768526,The Baby-Sitters Club,1995,['United States of America'],"['Coming of age', 'Comedy', 'Teen', 'Comedy-drama', 'Family Film']",1990,5
6488571,The Meteor Man,1993,['United States of America'],"['Action', 'Superhero', 'Action/Adventure', 'Comedy', 'Action Comedy', 'Superhero movie', 'Science Fiction', 'Family Film', 'Fantasy']",1990,3
8279721,Radar Patrol vs Spy King,1949,['United States of America'],"['Action', 'Spy', 'Black-and-white', 'Adventure']",1940,9
2992408,Election,2005,['Hong Kong'],"['Action/Adventure', 'World cinema', 'Chinese Movies', 'Martial Arts Film']",2000,5
6185648,The Competition,1980,['United States of America'],"['Musical', 'Drama']",1980,0
2372958,Citizen Cohn,1992,['United States of America'],['Drama'],1990,2
1114328,Chandramukhi,2005,['India'],"['Musical', 'Comedy', 'Horror', 'World cinema', 'Tamil cinema']",2000,5
6148543,Dragon Princess,1981,['Japan'],"['Action', 'Japanese Movies', 'Martial Arts Film']",1980,1
12410964,La León,2006,"['Argentina', 'France']","['Gay Themed', 'LGBT', 'Gay', 'Black-and-white', 'Gay Interest', 'World cinema', 'Drama']",2000,6
327582,Assassination Tango,2003,"['Argentina', 'United States of America']","['Crime Fiction', 'Romantic drama', 'Thriller', 'Crime Drama', 'Romance Film', 'Crime Thriller', 'Drama']",2000,3
14903088,Naalu Pennungal,2007,['India'],['Drama'],2000,7
8523825,Paris,2008,['France'],"['Comedy', 'World cinema', 'Romance Film', 'Drama']",2000,8
1628658,Barnens Ö,1980,['Sweden'],"['Drama', 'Family Film']",1980,0
6684371,Udhaya,2004,['India'],"['Action', 'Romance Film', 'Drama']",2000,4
8733867,"Hook, Line & Sinker",1969,['United States of America'],['Comedy'],1960,9
61058,The Champ,1931,['United States of America'],"['Boxing', 'Black-and-white', 'Sports', 'Drama']",1930,1
32998807,Jewelled Nights,1925,[],['Silent film'],1920,5
28869936,The Sino-Dutch War 1661,2000,"['China', 'Hong Kong']","['Action', 'Chinese Movies', 'War film', 'Drama']",2000,0
18499953,Mosquito Squadron,1969,['United Kingdom'],"['Action', 'Action/Adventure', 'War film']",1960,9
2129355,The Chinese Feast,1995,"['France', 'Hong Kong']","['Action', 'Action/Adventure', 'Comedy', 'World cinema', 'Chinese Movies']",1990,5
8560225,Harpya,1979,['Belgium'],"['Animation', 'Short Film', 'Thriller', 'Fantasy']",1970,9
4073679,The Stud,1978,['United Kingdom'],"['Sexploitation', 'Melodrama', 'Erotica', 'Drama']",1970,8
7658324,Escanaba in da Moonlight,2001,['United States of America'],"['Indie', 'Comedy', 'Sports', 'Family Film']",2000,1
24252012,The Ace of Hearts,1921,['United States of America'],"['Black-and-white', 'Crime Fiction', 'Romantic drama', 'Silent film', 'Romance Film', 'Political drama', 'Drama']",1920,1
8341424,East Side Story,2006,['United States of America'],"['Gay Themed', 'LGBT', 'Comedy', 'Romance Film', 'Romantic comedy', 'Drama']",2000,6
6074902,Family,2007,[],"['Slasher', 'Horror', 'Black comedy', 'Television movie', 'Cult']",2000,7
8496235,Goldfish Memory,2003,"['Ireland', 'United Kingdom']","['LGBT', 'Drama', 'Indie', 'Comedy', 'Romance Film', 'Romantic comedy', 'Ensemble Film']",2000,3
19286279,Kalai Arasi,1963,['India'],"['Action', 'Drama', 'Romance Film', 'Science Fiction']",1960,3
25054346,Vinayakudu,2008,['India'],"['Romance Film', 'Comedy']",2000,8
27758516,The Southern Star,1969,"['United Kingdom', 'France']","['Crime Fiction', 'Adventure', 'Comedy film']",1960,9
8748100,Britannic,2000,"['United Kingdom', 'United States of America']","['Spy', 'Epic', 'Disaster', 'Drama']",2000,0
2454006,Tin Pan Alley Cats,1943,['United States of America'],"['Short Film', 'Animation']",1940,3
8009901,Shaolin Temple 2: Kids from Shaolin,1983,"['China', 'Hong Kong']","['Action/Adventure', 'World cinema', 'Chinese Movies', 'Martial Arts Film']",1980,3
18800331,Islands in the Stream,1977,['United States of America'],"['War film', 'Drama']",1970,7
9054868,Tennessee,2008,['United States of America'],"['Family Drama', 'Indie', 'Road movie', 'Drama']",2000,8
16564257,The Imposter,2008,['United States of America'],['Drama'],2000,8
17107916,Trucker,2009,['United States of America'],"['Drama', 'Family Drama', 'Indie', 'Slice of life story']",2000,9
18598592,The Man Who Broke the Bank at Monte Carlo,1935,['United States of America'],"['Romance Film', 'Romantic comedy', 'Comedy']",1930,5
28667234,Final Shot: The Hank Gathers Story,1992,['United States of America'],"['Sports', 'Biography', 'Biopic [feature]', 'Docudrama', 'Television movie', 'Drama']",1990,2
2556577,Thieves' Highway,1949,['United States of America'],"['Black-and-white', 'Crime Fiction', 'Thriller', 'Crime Drama', 'Film noir', 'Crime Thriller', 'Drama']",1940,9
22558719,Air Doll,2009,['Japan'],"['Fantasy Drama', 'World cinema', 'Black comedy', 'Romance Film', 'Drama', 'Japanese Movies', 'Erotica', 'Science Fiction', 'Fantasy']",2000,9
14746758,Pals and Gals,1954,['United States of America'],"['Short Film', 'Black-and-white', 'Comedy']",1950,4
8108806,Hoi Polloi,1935,['United States of America'],"['Short Film', 'Black-and-white', 'Comedy']",1930,5
2221107,The Fallen Idol,1948,['United Kingdom'],"['Drama', 'Mystery', 'Thriller']",1940,8
22360971,Metello,1970,['Italy'],"['Period piece', 'Political drama', 'Drama']",1970,0
7287091,Magician,2007,['United Kingdom'],"['Comedy', 'Thriller', 'Horror']",2000,7
6254878,Superbad,2007,['United States of America'],"['Coming of age', 'Buddy film', 'Comedy', 'Teen', 'Cult', 'Sex comedy']",2000,7
9303169,A Ninja Pays Half My Rent,2003,['United States of America'],"['Short Film', 'Comedy']",2000,3
1972783,Kshana Kshanam,1991,['India'],"['Crime Fiction', 'Thriller', 'Comedy film', 'Road movie', 'Drama']",1990,1
26868913,Eight Shani,2006,['India'],"['Musical', 'Thriller', 'Bollywood', 'Horror', 'World cinema', 'Supernatural']",2000,6
8359892,Bigfoot,1970,['United States of America'],"['Science Fiction', 'Thriller', 'Horror']",1970,0
18939796,The Kid From Borneo,1933,['United States of America'],"['Black-and-white', 'Short Film', 'Comedy', 'Family Film']",1930,3
15241745,The Travelling Players,1975,['Greece'],"['History', 'War film', 'Drama']",1970,5
20986970,Petey Wheatstraw,1977,['United States of America'],"['Action', 'Blaxploitation', 'Action/Adventure', 'Comedy film', 'Fantasy']",1970,7
24257335,The Great Game,1953,['United Kingdom'],"['Drama', 'Comedy film']",1950,3
1111237,Yuva,2004,['India'],"['Musical', 'Family Drama', 'Musical Drama', 'Bollywood', 'World cinema', 'Epic', 'Drama']",2000,4
10178441,The Intruder,1986,['Indonesia'],"['Action', 'Crime', 'Thriller']",1980,6
10049321,Finders Keepers,1984,['United States of America'],['Comedy'],1980,4
10791882,Ilamai Oonjal Aadukirathu,1978,['India'],"['Romance Film', 'Drama']",1970,8
11120706,Mouse for Sale,1955,['United States of America'],"[""Children's/Family""]",1950,5
5082650,The Human Vapor,1960,['Japan'],"['Science Fiction', 'Japanese Movies']",1960,0
7359078,Robin's Big Date,2005,['United States of America'],"['Parody', 'Short Film', 'Indie', 'Comedy']",2000,5
23984423,Frieda,1947,['United Kingdom'],['War film'],1940,7
1073955,Soul Food,1997,['United States of America'],"['Family Drama', 'Domestic Comedy', 'Comedy-drama', 'Drama', 'Ensemble Film']",1990,7
2803182,Foodfight!,2009,['United States of America'],"['Action', 'Animation', 'Comedy', ""Children's/Family"", ""Children's"", 'Computer Animation', ""Children's Fantasy"", 'Family Film']",2000,9
6983796,The Killing Floor,2007,['United States of America'],"['Psychological thriller', 'Crime Thriller', 'Thriller']",2000,7
19670269,Out of Control,2003,"['India', 'United States of America']","['Romance Film', 'Comedy', 'Drama']",2000,3
27344847,Kojak: The Price of Justice,1987,['United States of America'],"['Detective fiction', 'Crime Fiction', 'Mystery', 'Thriller', 'Detective', 'Drama']",1980,7
31157780,The Last Blitzkrieg,1959,[],"['War film', 'Drama']",1950,9
8579043,Hello,2007,['India'],"['Musical', 'Bollywood', 'World cinema', 'Drama']",2000,7
18118431,"Gwen, le livre de sable",1985,['France'],"['Animation', 'Adventure', 'Fantasy']",1980,5
31100425,Sarapancharam,1979,['India'],"['Action', 'Thriller', 'Drama']",1970,9
76034,The Public Enemy,1931,['United States of America'],"['Black-and-white', 'Crime Fiction', 'Gangster Film', 'Crime Drama', 'Pre-Code', 'Drama']",1930,1
73427,Detour,1945,['United States of America'],"['Black-and-white', 'Crime Fiction', 'Mystery', 'Thriller', 'Film noir', 'Crime Thriller', 'Drama', 'Cult']",1940,5
4046924,Flock of Dodos,2006,['United States of America'],"['Documentary', 'History']",2000,6
29770072,Kadhal Enum Nadhiyinile,1989,[],"['Romance Film', 'Drama']",1980,9
16228326,Le Matou,1985,"['Canada', 'France']",['Drama'],1980,5
11998913,Curtains,1983,['Canada'],"['Crime Fiction', 'Slasher', 'Thriller', 'Horror']",1980,3
5135868,The Mangler,1995,"['South Africa', 'United States of America', 'Australia']","['Creature Film', 'Film adaptation', 'Horror', 'Science Fiction', 'Cult']",1990,5
20982931,Singing Lovebirds,1939,['Japan'],"['Musical', 'Comedy film']",1930,9
23440349,Lighthouse Mouse,1955,['United States of America'],"['Animation', 'Short Film', 'Comedy film', 'Family Film']",1950,5
473268,Hollywood Ending,2002,['United States of America'],"['Screwball comedy', 'Parody', 'Satire', 'Comedy', 'Romance Film', 'Romantic comedy', 'Comedy of Errors']",2000,2
21752777,Love Has Many Faces,1965,['United States of America'],"['Romance Film', 'Melodrama', 'Drama']",1960,5
448385,Blowup,1966,"['United Kingdom', 'Italy', 'United States of America']","['Psychological thriller', 'Mystery', 'Thriller', 'Crime Thriller']",1960,6
31531583,Banglar Nayok,1995,['Bangladesh'],['Action'],1990,5
3727092,Speedway Junky,1999,"['Israel', 'United States of America']","['LGBT', 'Coming of age', 'Indie', 'Drama']",1990,9
6270070,The Hellbenders,1967,"['Spain', 'Italy']","['Action', 'Western', 'Action/Adventure', 'World cinema', 'Spaghetti Western', 'Drama']",1960,7
2772247,Chinthavishtayaya Shyamala,1998,['India'],"['Black comedy', 'Malayalam Cinema']",1990,8
1341543,Dolemite,1974,['United States of America'],"['Action', 'Blaxploitation', 'Indie', 'Action/Adventure', 'Comedy', 'Cult']",1970,4
26970731,Crosstalk,1982,[],"['Crime Fiction', 'Science Fiction', 'Thriller']",1980,2
1665817,Mother Joan of the Angels,1961,['Poland'],"['Black-and-white', 'Horror', 'World cinema', 'Drama']",1960,1
5427176,The Art of Love,1965,['United States of America'],"['Comedy', 'Comedy of Errors']",1960,5
21731712,The Fair-Haired Hare,1951,[],"['Animation', 'Short Film', 'Comedy film', 'Family Film']",1950,1
31525916,White Lightning,1953,[],"['Sports', 'Drama']",1950,3
3759090,"Another Time, Another Place",1958,['United Kingdom'],"['Black-and-white', 'Romantic drama', 'Romance Film', 'Drama']",1950,8
1986557,Invasion U.S.A.,1952,['United States of America'],"['Science Fiction', 'Cult']",1950,2
4781134,The Moon-Spinners,1964,['United States of America'],"['Mystery', 'Family Drama', 'Adventure', 'Drama', 'Family Film']",1960,4
18405563,Wild Horse Hank,1978,['Canada'],"['Adventure', 'Drama', 'Family Film']",1970,8
7279777,The Boy Who Cried Werewolf,1973,['United States of America'],"['Creature Film', 'Horror', 'Melodrama', 'Adventure']",1970,3
22208692,Quacker Tracker,1967,['United States of America'],"['Animation', 'Short Film', 'Family Film']",1960,7
4379553,Summer In Bethlahem,1998,['India'],[],1990,8
7210096,"Betty Boop, M.D.",1932,['United States of America'],"['Animation', 'Short Film', 'Comedy', 'Family Film']",1930,2
5707374,Crocodile 2: Death Swamp,2002,['United States of America'],"['Action', 'Action Thrillers', 'Action/Adventure', 'Thriller', 'Adventure', 'Creature Film', 'Horror', 'B-movie', 'Natural horror films']",2000,2
11076438,Surrender Dorothy,1998,['United States of America'],"['LGBT', 'Indie', 'Comedy film', 'Drama']",1990,8
1749093,Tarzan,1999,['United States of America'],"['Animated cartoon', 'Animation', 'Romance Film', 'Costume drama', 'Adventure', 'Drama', 'Family Film']",1990,9
20989675,Deliciosa Sinvergüenza,1990,['Mexico'],['Comedy'],1990,0
2083964,Let's Scare Jessica to Death,1971,['United States of America'],"['Psychological thriller', 'Thriller', 'Horror', 'Teen', 'Supernatural', 'Haunted House Film']",1970,1
23521224,Hennessy,1975,['United Kingdom'],"['Crime Thriller', 'Thriller', 'Political thriller']",1970,5
1424739,Pierrot le fou,1965,"['France', 'Italy']","['Musical', 'Crime Fiction', 'Art film', 'Romantic drama', 'Avant-garde', 'Comedy', 'World cinema', 'Romance Film', 'Drama', 'Experimental film', 'Road movie']",1960,5
2014595,Humor Risk,1921,['United States of America'],"['Black-and-white', 'Indie', 'Short Film', 'Comedy', 'Silent film']",1920,1
27005608,Jag är din krigare,1997,"['Sweden', 'Denmark']","['Drama', 'Family Film']",1990,7
20413984,The Divine Weapon,2008,['South Korea'],"['Period piece', 'World cinema', 'Historical fiction', 'War film', 'Drama']",2000,8
23947215,Uzhavan,1993,['India'],['Drama'],1990,3
8070699,Get Out Your Handkerchiefs,1978,"['France', 'Belgium']","['Comedy', 'Comedy of manners', 'World cinema', 'Romantic comedy', 'Sex comedy']",1970,8
1270703,The Lovers of the Arctic Circle,1998,"['France', 'Spain']","['Mystery', 'Romantic drama', 'World cinema', 'Romance Film', 'Drama']",1990,8
2465336,Half Light,2006,"['United Kingdom', 'Germany']","['Supernatural', 'Thriller']",2000,6
3361465,The Flame and the Arrow,1950,['United States of America'],"['Action', 'Fantasy Adventure', 'Costume Adventure', 'Action/Adventure', 'Costume drama', 'Adventure', 'Drama', 'Swashbuckler films', 'Period piece', 'Historical fiction', 'Epic']",1950,0
6189418,Trippin',1999,['United States of America'],"['Indie', 'Comedy', 'Teen', 'Romance Film', 'Romantic comedy', 'Comedy-drama']",1990,9
31323048,Vergesst mir meine Traudel nicht,1957,['German Democratic Republic'],['Comedy'],1950,7
9060099,The Invisible Boy,1957,['United States of America'],"['Comedy Thriller', 'Thriller', 'Adventure', 'Science Fiction']",1950,7
7440264,Mujhe Kucch Kehna Hai,2001,['India'],['Romance Film'],2000,1
9845973,Twisted,1997,['United States of America'],"['Gay Themed', 'LGBT', 'Gay', 'Indie', 'Drama']",1990,7
2163073,Brats,1930,['United States of America'],"['Short Film', 'Black-and-white', 'Comedy']",1930,0
21607739,I Love You,2005,['India'],['Drama'],2000,5
2015137,Grrl Power,2004,['Japan'],"['Action', 'Animation', ""Children's/Family"", 'Drama', 'Japanese Movies', ""Children's Fantasy"", 'Short Film', 'Anime']",2000,4
14994019,"A Fine, Windy Day",1980,['South Korea'],['Drama'],1980,0
18077213,Borstal Boy,2002,"['Ireland', 'United Kingdom']","['Period piece', 'Drama', 'Coming of age', 'Indie', 'Teen', 'Romance Film']",2000,2
25625501,Anything to Survive,1990,['United States of America'],['Adventure'],1990,0
24856278,Teav Aek,1972,['Cambodia'],['Drama'],1970,2
15469761,Smilla's Sense of Snow,1997,"['Denmark', 'Sweden', 'United Kingdom', 'Germany']","['Psychological thriller', 'Crime Fiction', 'Mystery', 'Indie', 'Thriller', 'World cinema', 'Romance Film', 'Crime Thriller', 'Drama']",1990,7
24330723,The Disappearance of Alice Creed,2009,['United Kingdom'],"['Psychological thriller', 'Crime Fiction', 'Thriller', 'Crime Thriller']",2000,9
6386652,The Death Sentence,1997,['India'],"['Musical', 'Bollywood', 'World cinema', 'Drama']",1990,7
3448890,George of the Jungle,1997,['United States of America'],"['Action', 'Comedy', 'Romance Film', 'Slapstick', 'Adventure', 'Parody', 'Jungle Film', 'Family Film']",1990,7
1320650,Crimes and Misdemeanors,1989,['United States of America'],"['Drama', 'Crime Fiction', 'Indie', 'Comedy', 'Black comedy', 'Comedy-drama', 'Ensemble Film']",1980,9
22022026,A Month by the Lake,1995,['United Kingdom'],"['Period piece', 'Romantic drama', 'Comedy', 'Romance Film', 'Romantic comedy', 'Comedy-drama', 'Drama']",1990,5
21394941,Tumaku Paruni Ta Bhuli,2007,['India'],['Drama'],2000,7
18857800,The Red Dwarf,1998,"['France', 'Italy', 'Belgium']","['Drama', 'Comedy']",1990,8
21436715,Walking the Edge,1983,['United States of America'],"['Action', 'Crime Fiction', 'Action/Adventure', 'Crime Thriller']",1980,3
9411771,Cosh Boy,1953,['United Kingdom'],"['Drama', 'Crime Fiction']",1950,3
34056177,Bed and Board,1970,['France'],"['Art film', 'Romantic drama', 'Comedy', 'World cinema', 'Romance Film', 'Romantic comedy', 'Drama']",1970,0
21744986,Mr. Imperium,1951,['United States of America'],"['Romance Film', 'Romantic drama', 'Drama']",1950,1
13407460,Annie,1999,['United States of America'],"['Music', 'Musical', 'Comedy', 'Television movie', ""Children's"", 'Family Film']",1990,9
6675128,King of the Zombies,1941,['United States of America'],"['Black-and-white', 'Horror', 'B-movie', 'Zombie Film']",1940,1
33575471,The Stranger Within,1990,['United States of America'],['Thriller'],1990,0
34529751,Bananes mécaniques,1973,['France'],['Comedy film'],1970,3
12755223,Undersea Super Train: Marine Express,1979,['Japan'],"['Anime', 'Science Fiction', 'Drama', 'Fantasy']",1970,9
20806295,Remember Last Night?,1935,['United States of America'],"['Mystery', 'Comedy', 'Detective']",1930,5
873029,"To Wong Foo, Thanks for Everything! Julie Newmar",1995,['United States of America'],"['LGBT', 'Satire', 'Comedy', 'Buddy film', 'Gay Themed', 'Gay', 'Gay Interest', 'Comedy-drama', 'Road movie', 'Cult']",1990,5
15749011,Solace,2006,['South Korea'],"['Romance Film', 'Drama']",2000,6
692739,The Fly II,1989,"['Canada', 'United States of America']","['Indie', 'Horror', 'Science Fiction', 'Drama']",1980,9
23877118,The King's Whore,1990,['France'],"['Romantic drama', 'Romance Film', 'Melodrama', 'Drama']",1990,0
8677471,Bas Ek Pal,2006,['India'],"['Romantic drama', 'World cinema', 'Romance Film', 'Drama', 'Ensemble Film']",2000,6
10906825,Specter,2005,['Japan'],"['Action', 'Short Film', 'Science Fiction']",2000,5
15499614,Ma tante Aline,2007,['Canada'],['Comedy'],2000,7
4743333,Clean Slate,1994,['United States of America'],"['Detective fiction', 'Mystery', 'Comedy', 'Thriller', 'Detective', 'Slapstick', 'Fantasy Comedy']",1990,4
460052,Mystic River,2003,"['United States of America', 'Australia']","['Psychological thriller', 'Film adaptation', 'Crime Fiction', 'Mystery', 'Thriller', 'Crime Thriller', 'Drama', 'Tragedy']",2000,3
6365321,Al Franken: God Spoke,2006,['United States of America'],"['Political cinema', 'Biography', 'Documentary', 'Mockumentary', 'Culture & Society']",2000,6
21951280,Bam Margera Presents: Where the #$&% Is Santa?,2008,['United States of America'],"['Sports', 'Comedy', 'Cult']",2000,8
3935731,Musashi Miyamoto,1954,['Japan'],"['Samurai cinema', 'Art film', 'Japanese Movies', 'Action/Adventure', 'World cinema', 'Drama']",1950,4
3086340,Gozu,2003,['Japan'],"['Surrealism', 'Japanese Movies', 'Comedy', 'Horror Comedy', 'World cinema', 'Horror']",2000,3
30177119,Adhikar,1986,['India'],"['Romance Film', 'Drama', 'Family Film']",1980,6
20481209,LaFayette Escadrille,1958,['United States of America'],"['Romance Film', 'War film', 'Drama']",1950,8
2260329,Maniac,1980,['United States of America'],"['Cult', 'Slasher', 'Horror']",1980,0
1283050,Clerks II,2006,['United States of America'],"['Buddy film', 'Workplace Comedy', 'Comedy']",2000,6
9247277,Forbidden Quest,2006,['South Korea'],"['Drama', 'World cinema']",2000,6
19819441,Flame,1975,['United States of America'],"['Musical', 'Drama']",1970,5
20556628,Sabar Uparey,1955,['India'],"['Romance Film', 'Mystery', 'Drama']",1950,5
21412318,Love Finds a Home,2009,['United States of America'],"['Period piece', 'Action/Adventure', 'Western', 'Drama', 'Family Film']",2000,9
4174550,Li'l Abner,1959,['United States of America'],"['Musical', 'Comedy', 'Family Film', 'Fantasy']",1950,9
23934845,Ride Ranger Ride,1936,['United States of America'],"['Action', 'Black-and-white', 'Western', 'Action/Adventure']",1930,6
18850952,Rambo,2008,"['Germany', 'United States of America']","['Action', 'Action Thrillers', 'Thriller', 'War film']",2000,8
113452,Kiss of the Spider Woman,1985,"['Brazil', 'United States of America']","['Prison', 'Film adaptation', 'LGBT', 'Crime Fiction', 'Indie', 'World cinema', 'Drama', 'Gay Themed', 'Gay', 'Prison film', 'Gay Interest', 'Political drama']",1980,5
9307130,"Bashu, the Little Stranger",1989,['Iran'],"['World cinema', ""Children's/Family"", 'Adventure', 'Drama']",1980,9
19486632,Vamanan,2009,['India'],['Action'],2000,9
4541221,Choorian,1998,['Pakistan'],"['Action', 'Romance Film', 'Comedy']",1990,8
6748163,The Paleface,1922,['United States of America'],"['Black-and-white', 'Indie', 'Short Film', 'Comedy', 'Silent film']",1920,2
3857180,I'll Never Heil Again,1941,['United States of America'],"['Black-and-white', 'Short Film', 'Satire', 'Comedy']",1940,1
21076018,Deadly Prey,1987,[],"['Action', 'Crime Fiction', 'Drama']",1980,7
27265073,Ghost Punting,1992,['Hong Kong'],['Chinese Movies'],1990,2
30859078,Dragon Ball Z: Bio-Broly,1994,['Japan'],"['Action', 'Animation', 'Japanese Movies', 'Anime', 'Science Fiction']",1990,4
2075820,Idlewild,2006,['United States of America'],"['Musical', 'Period piece', 'Crime Fiction', 'Gangster Film', 'Musical Drama', 'Romance Film', 'Drama']",2000,6
15398535,Drifting Clouds,1996,['Finland'],"['Drama', 'Comedy']",1990,6
27947539,Metamorphosis of a Melody,1996,['Israel'],['Drama'],1990,6
2923254,"Get Smart, Again!",1989,['United States of America'],"['Action', 'Parody', 'Action/Adventure', 'Comedy', 'Television movie', 'Slapstick']",1980,9
33064257,Super Star,2002,[],"['Romance Film', 'Crime Fiction']",2000,2
2345042,The Man Who Knew Too Much,1934,['United Kingdom'],"['Psychological thriller', 'Spy', 'Black-and-white', 'Mystery', 'Thriller', 'Film noir', 'Drama']",1930,4
3230593,Phantom,2000,['Portugal'],"['Gay Themed', 'LGBT', 'Gay', 'Gay Interest', 'World cinema', 'Erotica', 'Drama']",2000,0
4966348,The Snow Walker,2003,['Canada'],"['Indie', 'Action/Adventure', 'Adventure', 'Drama']",2000,3
14630339,Aakrosh,1980,['India'],"['Bollywood', 'Art film']",1980,0
9706751,Suzy,1936,['United States of America'],"['Action', 'Spy', 'Drama', 'Comedy', 'Romance Film']",1930,6
513149,Cannibal Holocaust,1980,['Italy'],"['Jungle Film', 'Horror', 'World cinema', 'Mockumentary']",1980,0
28156193,Johnny Frenchman,1945,['United Kingdom'],"['Comedy film', 'Romance Film', 'War film', 'Drama']",1940,5
12019919,Satham Podathey,2007,['India'],['Thriller'],2000,7
32833838,Dr. M,1990,"['France', 'Germany', 'Italy']","['Crime Fiction', 'Mystery', 'Science Fiction']",1990,0
8398736,Shikhar,2005,['India'],"['Musical', 'Romantic drama', 'Thriller', 'Bollywood', 'World cinema', 'Romance Film', 'Drama']",2000,5
2497347,Prom Night,1980,"['Canada', 'United States of America']","['Indie', 'Slasher', 'Teen', 'Horror', 'Cult']",1980,0
4882569,Yesterday Was a Lie,2008,['United States of America'],"['Music', 'Psychological thriller', 'Detective fiction', 'Crime Fiction', 'Mystery', 'Indie', 'Thriller', 'Romance Film', 'Drama', 'Detective', 'Science Fiction']",2000,8
1573108,The Jacksons: An American Dream,1992,['United States of America'],"['Music', 'Biographical film', 'Biopic [feature]', 'Drama']",1990,2
35987457,Senior Trip,1981,['United States of America'],"['Cult', 'Comedy film', 'Teen']",1980,1
28118579,Hollywood on Parade No. A-8,1933,['United States of America'],['Short Film'],1930,3
10270809,Ziegfeld Girl,1941,['United States of America'],"['Musical', 'Black-and-white', 'Musical Drama', 'Drama']",1940,1
7869288,Samarasimha Reddy,1999,['India'],['Action'],1990,9
26230601,Here We Go Again,1942,['United States of America'],"['Music', 'Comedy film']",1940,2
8636365,Asterix and Obelix vs Caesar,1999,"['France', 'Germany', 'Italy']","['Comedy', 'Family Film', 'Adventure']",1990,9
21411112,Eden Log,2007,['France'],"['Creature Film', 'Escape Film', 'Mystery', 'Thriller', 'Horror', 'World cinema', 'Science Fiction']",2000,7
19238378,Nuvve Kavali,2000,['India'],['Romance Film'],2000,0
6302415,Saving My Hubby,2002,['South Korea'],"['Drama', 'Comedy']",2000,2
20824552,Konchem Ishtam Konchem Kashtam,2009,['India'],['Romance Film'],2000,9
2887314,Ghost Story,1981,['United States of America'],"['Suspense', 'Thriller', 'Horror', 'Haunted House Film']",1980,1
8884368,A Very Private Affair,1962,['France'],['Drama'],1960,2
916775,Let’s Go with Pancho Villa,1936,['Mexico'],"['War film', 'Drama']",1930,6
22215272,Breaking In,1989,['United States of America'],"['Action', 'Crime Fiction', 'Action/Adventure', 'Comedy']",1980,9
5257549,The New Centurions,1972,['United States of America'],"['Film adaptation', 'Crime Fiction', 'Thriller', 'Crime Thriller', 'Drama']",1970,2
1860972,Impact,1949,['United States of America'],"['Black-and-white', 'Crime Fiction', 'Mystery', 'Thriller', 'Film noir', 'Crime Thriller', 'Drama', 'Suspense']",1940,9
30312846,The Chinese Cat,1944,['United States of America'],"['Mystery', 'Crime Thriller', 'Thriller']",1940,4
314093,Cool as Ice,1991,['United States of America'],"['Action', 'Musical', 'Action/Adventure', 'Comedy', 'Romance Film', 'Hip hop movies', 'Drama', 'Romantic comedy', 'Cult']",1990,1
11713761,Sangdil Sanam,1994,['India'],"['Musical', 'Romantic drama', 'World cinema', 'Romance Film', 'Drama']",1990,4
31629,Threads,1984,"['United Kingdom', 'Australia', 'United States of America']","['Dystopia', 'Nuclear warfare', 'Doomsday film', 'Disaster', 'War film', 'Drama']",1980,4
32036016,Taqdeer,1983,['India'],"['Drama', 'Thriller', 'World cinema']",1980,3
5379935,The Secret Book,2006,['Republic of Macedonia'],['Drama'],2000,6
23913031,Nancy Drew... Reporter,1939,['United States of America'],"['Black-and-white', 'Crime Fiction', 'Mystery', 'Comedy', 'Drama']",1930,9
142457,L.A. Confidential,1997,['United States of America'],"['Crime Fiction', 'Mystery', 'Thriller', 'Drama']",1990,7
13432613,Sword in the Desert,1949,['United States of America'],"['Black-and-white', 'Historical fiction', 'War film', 'Drama']",1940,9
4794695,Teenage Cave Man,1958,['United States of America'],"['Science Fiction', 'Fantasy']",1950,8
24473476,The Traveling Executioner,1970,['United States of America'],"['Black comedy', 'Comedy', 'Drama']",1970,0
6563473,Amityville Dollhouse,1996,['United States of America'],['Horror'],1990,6
19420639,Budhivanta,2008,['India'],"['Romance Film', 'Crime Fiction', 'Drama']",2000,8
24462994,Daring Game,1968,[],"['Action', 'Adventure']",1960,8
685832,Innerspace,1987,['United States of America'],"['Action', 'Crime Fiction', 'Action/Adventure', 'Comedy', 'Adventure', 'Science Fiction', 'Family Film']",1980,7
2663296,The Duellists,1977,['United Kingdom'],"['Period piece', 'War film', 'Costume drama', 'Drama']",1970,7
11380221,Dreams,1955,['Sweden'],"['Black-and-white', 'Drama']",1950,5
3830101,A Sunday in the Country,1984,['France'],"['Period piece', 'Art film', 'Family Drama', 'World cinema', 'Drama']",1980,4
28222279,Doomwatch,1972,['United Kingdom'],"['Monster movie', 'Detective fiction', 'Thriller', 'Detective', 'Horror', 'B-movie', 'Science Fiction']",1970,2
9710883,My Son the Fanatic,1997,"['United Kingdom', 'France']","['Political cinema', 'Drama', 'Political satire', 'Indie', 'Comedy', 'Romantic comedy', 'Political drama']",1990,7
277149,There's Something About Mary,1998,['United States of America'],"['Gross out', 'Gross-out film', 'Comedy', 'Romance Film', 'Romantic comedy', 'Slapstick']",1990,8
3815505,The Barbarian and the Geisha,1958,['United States of America'],"['Romantic drama', 'Adventure', 'Romance Film', 'Historical fiction', 'Drama']",1950,8
1126572,What a Girl Wants,2003,['United States of America'],"['Comedy', 'Teen', 'Romance Film', 'Drama', 'Coming of age', 'Romantic comedy', 'Comedy of manners', 'Family Film']",2000,3
13023545,Bunyan and Babe,2008,['United States of America'],"['Computer Animation', 'Animation', 'Comedy', 'Adventure', 'Family Film', 'Fantasy']",2000,8
26007295,Dead Man's Hand,2007,['United States of America'],"['Horror', 'B-movie']",2000,7
3151839,J.D.'s Revenge,1976,['United States of America'],"['Action', 'Blaxploitation', 'Crime Fiction', 'Action/Adventure', 'Thriller', 'Drama', 'Horror', 'Melodrama', 'Supernatural']",1970,6
1975939,The Desperate Hours,1955,['United States of America'],"['Suspense', 'Thriller', 'Film noir', 'Drama']",1950,5
10619482,Faraar,1975,['India'],"['Action', 'Drama', 'Crime Fiction', 'Thriller']",1970,5
13332407,The Lover,1992,"['United Kingdom', 'France', 'Vietnam']","['Period piece', 'Film adaptation', 'Romantic drama', 'World cinema', 'Romance Film', 'Erotica', 'Drama']",1990,2
6089288,The Hammer,2007,['United States of America'],"['Boxing', 'Indie', 'Comedy', 'Romance Film', 'Sports']",2000,7
17405162,Thirst,2009,['South Korea'],"['Comedy', 'Horror', 'Romance Film', 'Drama', 'Fantasy']",2000,9
3076631,99 River Street,1953,['United States of America'],"['Crime Fiction', 'Thriller', 'Film noir', 'Drama']",1950,3
6787125,The Disorderly Orderly,1964,['United States of America'],"['Slapstick', 'Comedy', 'Comedy of Errors']",1960,4
11770563,Custer of the West,1967,['United States of America'],"['Action', 'Biography', 'Action/Adventure', 'Costume drama', 'Epic Western', 'Western', 'Biopic [feature]', 'War film']",1960,7
2430462,No Escape,1994,['United States of America'],"['Action', 'Film adaptation', 'Action/Adventure', 'Science Fiction', 'Thriller', 'Drama']",1990,4
35254495,Fatal Termination,1990,['Hong Kong'],"['Action', 'Thriller']",1990,0
7352183,Cal,1984,"['Ireland', 'United Kingdom']","['Romantic drama', 'Thriller', 'Political drama', 'Drama']",1980,4
5716888,Attila,2001,"['Lithuania', 'United States of America']","['Action', 'History', 'Biopic [feature]', 'Historical fiction', 'Television movie', 'War film', 'Adventure']",2000,1
25727077,Gunslinger's Revenge,1998,['Italy'],"['Action', 'Crime Fiction', 'Action/Adventure', 'Western', 'World cinema']",1990,8
2728447,Bedrooms and Hallways,1998,['United Kingdom'],"['LGBT', 'Romantic drama', 'Comedy', 'Romance Film', 'Drama']",1990,8
5747495,Lage Raho Munna Bhai,2006,['India'],"['Musical', 'Romantic drama', 'Comedy', 'Bollywood', 'World cinema', 'Romance Film', 'Drama']",2000,6
5112444,When in Rome,1952,['United States of America'],['Comedy'],1950,2
234731,Virtuosity,1995,['United States of America'],"['Action', 'Crime Fiction', 'Chase Movie', 'Action/Adventure', 'Thriller', 'Crime Thriller', 'Science Fiction']",1990,5
2483209,La maschera del demonio/Black Sunday,1960,['Italy'],"['Black-and-white', 'Horror', 'Supernatural', 'Cult']",1960,0
3600059,Starter for Ten,2006,"['United Kingdom', 'United States of America']","['Comedy', 'Romance Film', 'Comedy-drama', 'Drama']",2000,6
8069398,Tycoon,2003,"['Russia', 'France', 'Germany']","['Thriller', 'World cinema', 'Crime Thriller', 'Political thriller']",2000,3
21081380,Pava Mannippu,1961,['India'],"['Drama', 'World cinema']",1960,1
10778878,Magnificent Ruffians,1979,['Hong Kong'],"['Chinese Movies', 'Martial Arts Film']",1970,9
4623520,Goldfish Warning!,1992,['Japan'],"['Anime', 'Short Film']",1990,2
25520370,Young Man with Ideas,1952,['United States of America'],['Comedy'],1950,2
20767875,Achamillai Achamillai,1984,['India'],"['Drama', 'Family Film']",1980,4
9001270,Naya Daur,1957,['India'],"['Musical', 'Bollywood', 'World cinema', 'Drama']",1950,7
13638226,Otello,1986,"['Italy', 'Netherlands', 'United States of America']","['Musical', 'Drama', 'World cinema']",1980,6
18906983,Out of the Clouds,1955,['United Kingdom'],['Drama'],1950,5
8140468,Mexican Hayride,1948,['United States of America'],"['Black-and-white', 'Comedy', 'Adventure', 'Family Film']",1940,8
36057867,Ayul Kaithi,1991,['India'],['Drama'],1990,1
25242499,"Wicked, Wicked",1973,['United States of America'],"['Detective fiction', 'Mystery', 'Thriller', 'Detective', 'Whodunit']",1970,3
5391943,Caught in the Draft,1941,['United States of America'],"['Black-and-white', 'Comedy', 'War film', 'Slapstick']",1940,1
1764812,Yaadein,2001,['India'],"['Musical', 'Romance Film', 'Drama']",2000,1
32452362,Boulevard du Rhum,1971,[],['Adventure'],1970,1
19771801,Crocodile Man,1972,['Cambodia'],"['Horror', 'Natural horror films']",1970,2
27073625,Hope Ranch,2002,['United States of America'],"['Family Drama', 'Action/Adventure', 'Western', 'Juvenile Delinquency Film', 'Television movie', 'Drama', 'Family Film']",2000,2
10792032,Naan Mahaan Alla,1984,['India'],[],1980,4
18675203,Phoonk,2008,['India'],"['World cinema', 'Thriller', 'Horror']",2000,8
4622896,Krull,1983,"['United Kingdom', 'United States of America']","['Action', 'Romance Film', 'Adventure', 'Sword and sorcery films', 'Sword and sorcery', 'Stop motion', 'Science Fiction', 'Fantasy']",1980,3
1128444,The Mother,2003,"['United Kingdom', 'England']","['Romance Film', 'Romantic drama', 'Drama']",2000,3
541642,Octopussy,1983,"['United Kingdom', 'United States of America']","['Action', 'Spy', 'Crime Fiction', 'Action Thrillers', 'Action/Adventure', 'Thriller', 'Glamorized Spy Film', 'Adventure']",1980,3
13007814,A Successful Calamity,1932,['United States of America'],"['Black-and-white', 'Comedy', 'Domestic Comedy', 'Drama']",1930,2
25155176,Ek Se Badhkar Ek,2004,['India'],"['Comedy', 'World cinema']",2000,4
1053502,Clean,2004,"['United Kingdom', 'France', 'Canada']","['Indie', 'Drama', 'World cinema']",2000,4
1429574,Deranged,1974,"['Canada', 'United States of America']","['Psychological thriller', 'Crime Fiction', 'Mystery', 'Slasher', 'Horror', 'Cult']",1970,4
34429074,Shubha Lagnam,1994,['India'],['Drama'],1990,4
1131832,The Muppet Christmas Carol,1992,['United States of America'],"['Musical', ""Children's Fantasy"", ""Children's/Family"", 'Christmas movie', 'Fantasy']",1990,2
6643948,Sleeping Dogs Lie,2006,['United States of America'],"['Drama', 'Indie', 'Comedy', 'Black comedy', 'Romantic comedy', 'Romance Film']",2000,6
27341604,The Young Girl and the Monsoon,2001,['United States of America'],"['Indie', 'Family Drama', 'Romantic drama', 'Comedy', 'Romance Film', 'Drama', 'Romantic comedy', 'Comedy-drama']",2000,1
13277969,Vinayaka Chaviti,1957,['India'],"['Musical', 'Drama']",1950,7
23731386,Black Noon,1971,['United States of America'],['Horror'],1970,1
19104869,Justice,1993,"['Switzerland', 'Germany']","['World cinema', 'Crime Drama', 'Drama', 'Courtroom Drama']",1990,3
2272403,Out to Sea,1997,['United States of America'],"['Buddy film', 'Comedy', 'Romance Film', 'Romantic comedy']",1990,7
2980727,They Made Me a Killer,1946,['United States of America'],"['Black-and-white', 'Crime Fiction', 'Thriller', 'Film noir', 'Crime Thriller', 'Drama']",1940,6
5697845,Sergeant Rutledge,1960,['United States of America'],"['Action/Adventure', 'Western', 'Social problem film', 'Drama', 'Courtroom Drama']",1960,0
5569730,Youth Without Youth,2007,"['Italy', 'France', 'Germany', 'Romania', 'United States of America']","['Film adaptation', 'Fantasy Drama', 'Mystery', 'Romantic drama', 'Thriller', 'World cinema', 'Romance Film', 'Drama', 'Period piece', 'Fantasy']",2000,7
16166406,Dosth,2001,['India'],['Romance Film'],2000,1
8352931,Agua,2006,"['Argentina', 'France']","['Indie', 'Drama']",2000,6
18565134,Baladur,2008,['India'],['Comedy'],2000,8
11386632,Boat,2007,['United States of America'],"['Surrealism', 'Indie', 'Short Film']",2000,7
4450578,A Problem with Fear,2003,['Canada'],"['Indie', 'Satire', 'Thriller']",2000,3
10883060,A Winner Never Quits,1986,['United States of America'],"['Biographical film', 'Biopic [feature]', 'Sports', 'Drama', 'Family Film']",1980,6
23988883,The Panther's Claw,1942,['United States of America'],"['Black-and-white', 'Mystery', 'Thriller', 'Crime Thriller']",1940,2
19928595,Le Récif de corail,1939,['France'],"['Adventure', 'Drama']",1930,9
2305786,Stealing Home,1988,['United States of America'],"['Coming of age', 'Romantic drama', 'Romance Film', 'Americana', 'Sports', 'Drama']",1980,8
8710347,Spring Break,1983,['United States of America'],"['Romance Film', 'Comedy', 'Sex comedy']",1980,3
1996562,The Secret Life of Words,2005,['Spain'],"['Romantic drama', 'Indie', 'World cinema', 'Romance Film', 'Drama']",2000,5
21664006,Toyland,2007,['Germany'],"['Short Film', 'War film', 'Drama']",2000,7
35031759,Women Love Diamonds,1927,['United States of America'],"['Silent film', 'Melodrama', 'Drama']",1920,7
330874,L'avventura,1960,"['France', 'Italy']","['Black-and-white', 'Mystery', 'World cinema', 'Adventure', 'Drama']",1960,0
2825783,"Mystery, Alaska",1999,"['Canada', 'United States of America']","['Comedy', 'Comedy-drama', 'Sports', 'Drama', 'Ensemble Film']",1990,9
15392682,Transsiberian,2008,"['Lithuania', 'Spain', 'United Kingdom', 'Germany', 'United States of America']","['Psychological thriller', 'Mystery', 'Indie', 'Thriller', 'Crime Thriller']",2000,8
3896645,Feng Shui,2004,['Philippines'],"['Filipino Movies', 'Thriller', 'Horror', 'World cinema', 'Filipino']",2000,4
9450708,The Loved One,1965,['United States of America'],"['Parody', 'Comedy film', 'Comedy of manners', 'Black comedy']",1960,5
217783,The Sterile Cuckoo,1969,['United States of America'],"['Coming of age', 'Romantic comedy', 'Romance Film', 'Comedy-drama']",1960,9
35569446,Get Married,2007,[],"['Romance Film', 'Comedy film']",2000,7
31457501,The Woman Condemned,1934,['United States of America'],"['Suspense', 'Detective fiction', 'Mystery', 'Thriller', 'Detective', 'Crime Thriller']",1930,4
17853465,Bombaat,2008,['India'],['Action'],2000,8
6811111,The Scarecrow,1982,['New Zealand'],"['Mystery', 'Thriller', 'Horror']",1980,2
28926759,Friends and Neighbours,1959,['United Kingdom'],['Comedy'],1950,9
23013129,Bhagyadevatha,2009,['India'],"['Drama', 'Comedy']",2000,9
5046538,The Wild Child,1970,['France'],"['Black-and-white', 'Drama', 'World cinema']",1970,0
7845053,Meet Dave,2008,['United States of America'],"['Science Fiction', 'Slapstick', 'Comedy']",2000,8
5649438,Zeus and Roxanne,1997,['United States of America'],"[""Children's"", 'Animal Picture', 'Family-Oriented Adventure', ""Children's/Family"", 'Adventure', 'Family Film']",1990,7
5557065,Four Sided Triangle,1953,['United Kingdom'],"['Romantic drama', 'Horror', 'Romance Film', 'Science Fiction', 'Drama', 'Fantasy']",1950,3
18920316,Yesterday's Enemy,1959,['United Kingdom'],"['Combat Films', 'Action', 'Drama', 'War film']",1950,9
12498936,Cry 'Havoc',1943,['United States of America'],"['Black-and-white', 'War film', 'Drama']",1940,3
787058,El Cid,1961,"['Italy', 'United States of America']","['Action', 'Biography', 'Romance Film', 'Drama', 'Historical Epic', 'Historical fiction', 'Epic', 'War film']",1960,1
29227920,A Piece of Our Life,2009,['Japan'],['Drama'],2000,9
5654699,Simhadri,2003,['India'],"['Action', 'Drama']",2000,3
5226194,Raggedy Ann & Andy: A Musical Adventure,1977,['United States of America'],"['Musical', 'Animation', ""Children's""]",1970,7
896674,20 Million Miles to Earth,1957,['United States of America'],"['Creature Film', 'Monster', 'Alien Film', 'Stop motion', 'Science Fiction']",1950,7
23891709,My Brother,2004,['South Korea'],['Drama'],2000,4
32000219,Mixed Doubles,2006,['India'],"['Musical', 'Romantic drama', 'Bollywood', 'World cinema', 'Romance Film', 'Drama']",2000,6
14717678,Afrodite Superstar,2006,['United States of America'],"['Adult', 'Indie', 'Romance Film', 'Erotica']",2000,6
76361,Snow White and the Seven Dwarfs,1937,['United States of America'],"['Musical', 'Animation', 'Romance Film', 'Family Film', 'Fantasy']",1930,7
8438951,Bachelor Party Vegas,2006,['United States of America'],"['Comedy', 'Adventure']",2000,6
19944273,Love and Money,1982,"['West Germany', 'United States of America']","['Psychological thriller', 'Drama', 'Thriller']",1980,2
12098160,Strange Bedfellows,2004,"['New Zealand', 'Australia']","['LGBT', 'Indie', 'Comedy', 'World cinema', 'Slapstick']",2000,4
2098715,The Big Clock,1948,['United States of America'],"['Psychological thriller', 'Black-and-white', 'Crime Fiction', 'Mystery', 'Thriller', 'Film noir', 'Drama']",1940,8
29649592,World War II: When Lions Roared,1994,['United States of America'],"['History', 'War film', 'Drama']",1990,4
2351556,Not of This Earth,1957,['United States of America'],['Science Fiction'],1950,7
10629623,I'm With Lucy,2002,"['United States of America', 'France']","['Romance Film', 'Romantic comedy', 'Comedy film']",2000,2
8982459,Lawman,1971,['United States of America'],"['Action', 'Revisionist Western', 'Action/Adventure', 'Western']",1970,1
15071971,Ma'am May We Go Out,1985,['Philippines'],"['Filipino Movies', 'Comedy']",1980,5
10621672,Lady Is the Boss,1983,['Hong Kong'],"['Chinese Movies', 'Martial Arts Film']",1980,3
2882838,Electric Dragon 80.000 V,2001,['Japan'],"['Japanese Movies', 'World cinema', 'Science Fiction', 'Drama']",2000,1
14312549,Dharavi,1991,['India'],['Art film'],1990,1
26613648,Nammal Thammil,2009,['India'],['Drama'],2000,9
24640838,The Good and the Bad,1976,['France'],['Drama'],1970,6
30084641,Faeries,1981,[],['Short Film'],1980,1
21149183,A Last Note,1995,['Japan'],"['Japanese Movies', 'Drama']",1990,5
2001887,Duets,2000,['United States of America'],"['Musical', 'Comedy', 'Drama']",2000,0
18612962,Doraemon: Nobita's South Sea Adventure,1998,['Japan'],['Japanese Movies'],1990,8
1348418,Joan of Arc,1948,['United States of America'],"['Biography', 'War film', 'Christian film', 'Epic', 'Roadshow theatrical release', 'Costume drama', 'Drama']",1940,8
3150394,Duck Soup to Nuts,1944,['United States of America'],"['Animation', 'Short Film', 'Comedy', 'Family Film']",1940,4
28704226,Caged Terror,1973,['Canada'],"['Erotic thriller', 'Thriller']",1970,3
10393953,The Lady Lies,1929,['United States of America'],"['Black-and-white', 'Comedy-drama', 'Drama']",1920,9
23926423,Apartment Wife: Affair In the Afternoon,1971,['Japan'],"['Erotica', 'Japanese Movies', 'Pornographic movie']",1970,1
11089663,Tarzan's Three Challenges,1963,['United States of America'],"['Action', 'Drama', 'Jungle Film', 'Adventure']",1960,3
24142265,Texas to Bataan,1942,['United States of America'],"['Action', 'Western', 'War film', 'Adventure']",1940,2
25807540,The Shooting of Dan McGrew,1924,['United States of America'],['Silent film'],1920,4
11527293,Two Comrades Were Serving,1968,"['Russia', 'Soviet Union']","['Action', 'Black-and-white', 'Comedy', 'World cinema', 'War film', 'Drama']",1960,8
2294598,Kidnapped,1938,['United States of America'],"['Costume drama', 'Adventure']",1930,8
29462285,The Man Who Walked Alone,1945,['United States of America'],"['Comedy', 'Romance Film', 'Romantic comedy', 'Comedy of Errors']",1940,5
1784731,Wallace & Gromit: The Curse of the Were-Rabbit,2005,['United Kingdom'],"['Animation', 'Comedy', ""Children's/Family"", 'Stop motion', 'Fantasy Comedy', 'Family Film', 'Fantasy']",2000,5
11471255,Deadly Sins,1995,"['Canada', 'United States of America']","['Drama', 'Mystery', 'Thriller']",1990,5
16168391,Amudhey,2005,['India'],"['Action', 'Romance Film']",2000,5
1399631,Brigham City,2001,['United States of America'],"['Drama', 'Crime Fiction', 'Mystery', 'Indie', 'Thriller', 'Crime Thriller']",2000,1
2330930,The Road to Hong Kong,1962,"['United Kingdom', 'United States of America']","['Adventure Comedy', 'Musical', 'Black-and-white', 'Action/Adventure', 'Buddy film', 'Comedy', 'Adventure']",1960,2
9776644,The Strangers,2008,['United States of America'],"['Psychological thriller', 'Indie', 'Slasher', 'Thriller', 'Horror', 'Crime Thriller']",2000,8
3239688,Interview with the Vampire: The Vampire Chronicles,1994,['United States of America'],"['Fantasy', 'Drama', 'Horror']",1990,4
2689080,Timebomb,1991,['United States of America'],['Science Fiction'],1990,1
29656423,Chasing Ghosts,2005,['United States of America'],"['Mystery', 'Crime Thriller', 'Thriller']",2000,5
20774714,Fist of the North Star,1986,['Japan'],"['Action', 'Animation', 'World cinema', 'Martial Arts Film', 'Japanese Movies', 'Anime', 'Science Fiction', 'Fantasy']",1980,6
24882606,"La Criada, Bien Criada",1972,['Mexico'],['Comedy'],1970,2
9650458,Thulladha Manamum Thullum,1999,['India'],"['Romance Film', 'Drama']",1990,9
2887199,Monsieur Beaucaire,1924,['United States of America'],"['Black-and-white', 'Drama', 'Indie', 'Silent film']",1920,4
6944471,Never Let Me Go,1953,['United Kingdom'],"['Black-and-white', 'Drama']",1950,3
1413353,Kai Doh Maru,2003,['Japan'],"['Action', 'Animation', 'Japanese Movies', 'Anime']",2000,3
21035176,Mussolini and I,1985,"['Switzerland', 'France', 'West Germany', 'Italy', 'United States of America']","['Biopic [feature]', 'War film', 'Docudrama', 'Political drama', 'Drama']",1980,5
6493268,Brother to Brother,2004,['United States of America'],"['LGBT', 'Drama', 'Indie']",2000,4
2134118,Danger Lights,1930,['United States of America'],"['Black-and-white', 'Romantic drama', 'Romance Film', 'Drama']",1930,0
2421234,Druids,2001,"['France', 'Canada', 'Belgium']","['Action/Adventure', 'World cinema', 'Adventure', 'Drama', 'Biopic [feature]', 'Historical fiction', 'Historical Epic', 'Epic', 'War film']",2000,1
10074270,Modati Cinema,2005,['India'],['Drama'],2000,5
8262764,The Alphabet Murders,1965,['United Kingdom'],"['Detective fiction', 'Mystery', 'Parody', 'Satire', 'Detective', 'Comedy']",1960,5
9815938,The Gilded Lily,1935,['United States of America'],['Comedy'],1930,5
6315178,Naresuan,2006,['Thailand'],['Biographical film'],2000,6
17391299,Dombivli Fast,2005,['India'],"['Musical', 'Bollywood', 'World cinema', 'Drama']",2000,5
363255,Muriel's Wedding,1994,"['France', 'Australia']","['Comedy', 'Black comedy', 'Romance Film', 'Comedy-drama', 'Domestic Comedy', 'Drama']",1990,4
26035388,Chakkikotha Chankaran,1989,['India'],"['Drama', 'Comedy']",1980,9
28066419,One Year Later,1933,['United States of America'],['Drama'],1930,3
61059,Five Star Final,1931,['United States of America'],"['Black-and-white', 'Crime Fiction', 'Media Satire', 'Melodrama', 'Pre-Code', 'Drama']",1930,1
5425039,A Good Time for a Dime,1941,['United States of America'],"['Animation', 'Short Film', 'Comedy', 'Family Film']",1940,1
42222,Beautiful Girls,1996,['United States of America'],"['Romance Film', 'Comedy', 'Drama']",1990,6
15579410,La Tía Tula,1963,['Spain'],"['Black-and-white', 'Drama']",1960,3
2885119,Playtime,1967,"['France', 'Italy', 'United States of America']","['Art film', 'Comedy', 'World cinema', 'Drama']",1960,7
22578492,La Fille de Monaco,2008,['France'],"['Drama', 'Comedy film']",2000,8
6426885,Running Out Of Time,1999,"['China', 'Hong Kong']","['Action', 'Action/Adventure', 'Thriller', 'World cinema', 'Chinese Movies']",1990,9
4851941,The Two Faces of Dr. Jekyll,1960,"['United Kingdom', 'United States of America']",['Horror'],1960,0
5558503,Les Trois Frères,1995,['France'],"['Comedy', 'Crime Comedy']",1990,5
26729192,Cathy's Child,1979,['Australia'],['Drama'],1970,9
4204059,Rustlers' Rhapsody,1985,['United States of America'],"['Comedy Western', 'Parody', 'Action/Adventure', 'Western', 'Satire', 'Comedy', 'Singing cowboy']",1980,5
2099934,The Password is Courage,1962,['United Kingdom'],"['War film', 'Biographical film', 'Drama']",1960,2
2502547,Faeries,1999,['United Kingdom'],"['Animation', 'Adventure', 'Family Film', 'Fantasy']",1990,9
33871412,Rajakumaran,1994,[],['Drama'],1990,4
4220745,Alley Cats Strike,2000,"['Canada', 'United States of America']","['Sports', 'Family Film']",2000,0
1876331,The Ninth Day,2005,"['Germany', 'Luxembourg', 'Czech Republic']","['Period piece', 'Drama', 'World cinema']",2000,5
7488792,Ha! Ha! Ha!,1934,['United States of America'],"['Animation', 'Short Film', 'Comedy', 'Family Film']",1930,4
2484540,Fletch,1985,['United States of America'],"['Mystery', 'Comedy', 'Thriller', 'Comedy Thriller', 'Cult']",1980,5
21392328,Lakshyabhed,2009,['India'],['Drama'],2000,9
27960481,Let's You and Him Fight,1934,['United States of America'],"['Animation', 'Short Film', 'Comedy', 'Family Film']",1930,4
35790648,En Aasai Machan,1994,['India'],['Drama'],1990,4
12940547,9,2009,['United States of America'],"['Action', 'Animation', 'Mystery', 'Thriller', 'Apocalyptic and post-apocalyptic fiction', 'Adventure', 'Computer Animation', 'Science Fiction', 'Fantasy']",2000,9
1169398,Double Tap,2000,['Hong Kong'],"['Action', 'Action/Adventure', 'World cinema', 'Chinese Movies']",2000,0
12328269,Fire Sale,1978,['United States of America'],"['Comedy', 'Absurdism']",1970,8
5401902,High Strung,1991,['United States of America'],"['Indie', 'Comedy']",1990,1
18792792,Deadly Target,1994,['United States of America'],"['Action', 'Action/Adventure', 'Thriller', 'Crime Thriller', 'Martial Arts Film']",1990,4
3454332,Whore,1991,"['United Kingdom', 'United States of America']",['Drama'],1990,1
3370990,Rabbit Hood,1949,['United States of America'],"['Animation', 'Short Film', 'Comedy', 'Family Film']",1940,9
3509188,Watchers,1988,"['Canada', 'United States of America']","['Action', 'Action/Adventure', 'Indie', 'Thriller', 'Horror', 'Science Fiction']",1980,8
2541757,Dunston Checks In,1996,['United States of America'],"['Slapstick', 'Comedy', 'Animal Picture', ""Children's/Family"", 'Family Film']",1990,6
4457806,Born on the Fourth of July,1989,['United States of America'],"['Film adaptation', 'Biography', 'Biographical film', 'War film', 'Drama', 'Anti-war', 'Period piece', 'Anti-war film', 'Biopic [feature]', 'Political drama']",1980,9
10450776,Lady Oscar,1979,"['France', 'Japan']","['History', 'Japanese Movies', 'Romance Film', 'Historical fiction', 'Drama']",1970,9
607735,Cocktail,1988,['United States of America'],"['Romantic drama', 'Buddy film', 'Romance Film', 'Drama']",1980,8
10657592,Runway,2004,[],"['Action', 'Comedy', 'Thriller']",2000,4
3611280,The Housemaid,1960,['South Korea'],"['Crime Fiction', 'Thriller', 'Horror', 'Drama']",1960,0
3837,Blazing Saddles,1974,['United States of America'],"['Western', 'Satire', 'Comedy']",1970,4
16200112,Sailor of the King,1953,"['United Kingdom', 'United States of America']","['Action', 'Black-and-white', 'War film', 'Drama']",1950,3
1378672,Ordinary Decent Criminal,2000,"['United Kingdom', 'Germany', 'Ireland', 'United States of America']","['Action', 'Film à clef', 'Crime Fiction', 'Action/Adventure', 'Thriller', 'Crime Drama', 'Crime Thriller']",2000,0
10523539,WarGames 2: The Dead Code,2008,['United States of America'],"['Action', 'Drama', 'Action/Adventure', 'Thriller']",2000,8
13243218,Sunday,2008,['India'],"['Musical', 'Comedy', 'Thriller', 'Bollywood', 'World cinema', 'Romance Film']",2000,8
2775046,Baaghi,2000,['India'],['Romance Film'],2000,0
17958786,What's the Matter with Helen?,1971,['United States of America'],"['Psychological thriller', 'Psycho-biddy', 'Thriller']",1970,1
7938436,Swiss Miss,1938,['United States of America'],"['Black-and-white', 'Short Film', 'Comedy', 'Romance Film']",1930,8
7624920,Naa Autograph,2004,['India'],"['Romance Film', 'Drama']",2000,4
4195543,Cookie's Fortune,1999,['United States of America'],"['Crime Fiction', 'Mystery', 'Indie', 'Comedy', 'Thriller', 'Drama', 'Domestic Comedy', 'Ensemble Film']",1990,9
3263452,Filantropica,2002,['Romania'],['Comedy'],2000,2
10799167,Jump Tomorrow,2001,"['United Kingdom', 'United States of America']","['Indie', 'Comedy', 'Romance Film', 'Romantic comedy']",2000,1
3033392,Career Girls,1997,"['United Kingdom', 'France']",['Drama'],1990,7
21791457,The Man with Bogart's Face,1980,['United States of America'],"['Detective fiction', 'Mystery', 'Comedy', 'Thriller', 'Crime Thriller', 'Parody', 'Comedy Thriller', 'Detective']",1980,0
12148707,"Kaasua, komisario Palmu!",1961,['Finland'],['Crime Fiction'],1960,1
676909,The Terminal,2004,['United States of America'],"['Romantic drama', 'Comedy', 'Romance Film', 'Romantic comedy', 'Comedy-drama', 'Drama', 'Comedy of Errors']",2000,4
25417931,The Users,1978,['United States of America'],['Drama'],1970,8
19308640,Dorian Gray,2009,['United Kingdom'],"['Film adaptation', 'Crime Fiction', 'Thriller', 'Costume drama', 'Drama', 'Period piece', 'Supernatural', 'Fantasy']",2000,9
1364899,The Saint in London,1939,['United States of America'],"['Detective fiction', 'Black-and-white', 'Crime Fiction', 'Mystery', 'Detective']",1930,9
695540,Knock Knock,1940,['United States of America'],"['Animation', 'Short Film', 'Comedy', 'Horror']",1940,0
21760793,Women of Twilight,1952,['United Kingdom'],"['Drama', 'Crime Fiction']",1950,2
3744721,Soldier in the Rain,1963,['United States of America'],"['Romantic drama', 'Comedy', 'Comedy-drama', 'Drama']",1960,3
10639796,Aadmi Aur Insaan,1969,['India'],"['Musical', 'Bollywood', 'World cinema', 'Drama']",1960,9
27567823,Shackleton's Antarctic Adventure,2001,['United States of America'],"['History', 'Short Film', 'Documentary', 'Travel']",2000,1
2861237,Last Dance,1996,['United States of America'],"['Drama', 'Crime Fiction', 'Thriller']",1990,6
4626310,Pyar ka Mausam,1969,['India'],"['Musical', 'Romantic comedy']",1960,9
28620895,Randaam Bhavam,2001,['India'],"['Action', 'Drama']",2000,1
14618858,Past Midnight,1992,['United States of America'],"['Mystery', 'Romantic drama', 'Indie', 'Thriller', 'Romance Film', 'Crime Thriller', 'Drama', 'Slasher', 'Horror', 'Erotica']",1990,2
9629572,Polladhavan,2007,['India'],"['Action', 'Romance Film', 'Drama']",2000,7
19898036,The Grass Harp,1995,['United States of America'],"['Film adaptation', 'Indie', 'Comedy', 'Americana', 'Drama', 'Period piece', 'Coming of age', 'Comedy-drama']",1990,5
451866,Mission: Impossible II,2000,"['Germany', 'United States of America', 'Australia']","['Action', 'Spy', 'Action Thrillers', 'Action/Adventure', 'Thriller', 'Glamorized Spy Film']",2000,0
12139040,The Orphanage,2007,"['Mexico', 'Spain']","['Mystery', 'Gothic Film', 'Thriller', 'Horror', 'Drama']",2000,7
1680070,Robinson Crusoe on Mars,1964,['United States of America'],"['Film adaptation', 'Adventure', 'Science Fiction', 'Drama']",1960,4
14946143,Beneath the 12-Mile Reef,1953,['United States of America'],"['Action', 'Romantic drama', 'Action/Adventure', 'Romance Film', 'Adventure', 'Drama']",1950,3
25826180,A Christmas Without Snow,1980,['United States of America'],"['Family Drama', 'Television movie', 'Family Film', 'Drama']",1980,0
2922151,Qayamat Se Qayamat Tak,1988,['India'],"['Musical', 'Romantic drama', 'Action/Adventure', 'Bollywood', 'World cinema', 'Romance Film', 'Drama']",1980,8
16490670,Seval,2008,['India'],"['Action', 'Drama']",2000,8
1836982,Pope John Paul II: The Movie,1984,['United States of America'],"['Biography', 'Drama']",1980,4
6836819,The Man Who Played God,1932,['United States of America'],"['Black-and-white', 'Drama']",1930,2
3778613,From Dusk Till Dawn 3: The Hangman's Daughter,2000,['United States of America'],"['Action', 'Hybrid Western', 'Action/Adventure', 'Thriller', 'Science fiction Western', 'Horror', 'Supernatural', 'Cult']",2000,0
25826815,Decalogue IX,1990,['Poland'],['Drama'],1990,0
1884173,Pulp,1972,['United Kingdom'],"['Crime Fiction', 'Mystery', 'Comedy', 'Thriller', 'Black comedy', 'Crime Thriller', 'Drama', 'Suspense', 'Parody']",1970,2
20194103,Die Stadt ohne Juden,1924,['Austria'],"['Silent film', 'Drama']",1920,4
19360011,The First Seven Years,1930,['United States of America'],"['Black-and-white', 'Short Film', 'Comedy', 'Family Film']",1930,0
815934,Mohabbatein,2000,['India'],"['Musical', 'Musical Drama', 'Romance Film', 'Drama']",2000,0
11086287,Gayab,2004,['India'],"['Comedy', 'World cinema']",2000,4
6407029,Thank Your Lucky Stars,1943,['United States of America'],"['Musical', 'Black-and-white', 'Backstage Musical', 'Comedy', 'Musical comedy']",1940,3
5028541,Jinxed!,1982,['United States of America'],"['Black comedy', 'Comedy']",1980,2
1249349,Nuovo Cinema Paradiso,1988,"['France', 'Italy']",['Drama'],1980,8
18947989,Bad Luck Blackie,1949,['United States of America'],"['Animation', 'Short Film', 'Comedy', 'Family Film']",1940,9
20509157,Going by the Book,2007,['South Korea'],"['Action Comedy', 'Comedy']",2000,7
18965892,Lymelife,2008,['United States of America'],"['Period piece', 'Drama', 'Indie', 'Coming of age', 'Comedy', 'Comedy-drama']",2000,8
34528677,Bye Bye Blackboard,1972,['United States of America'],"['Animation', 'Short Film', 'Comedy film', 'Family Film']",1970,2
593964,The Sacrifice,1986,"['Sweden', 'United Kingdom', 'France']",['Drama'],1980,6
24240420,L'aube à l'envers,1995,['France'],"['Short Film', 'Biographical film']",1990,5
24665535,The Box,2007,['United States of America'],"['Action', 'Mystery', 'Action/Adventure', 'Thriller', 'Crime Thriller']",2000,7
13893843,Nine Hours to Rama,1963,"['United Kingdom', 'United States of America']","['Historical fiction', 'Drama', 'Biopic [feature]']",1960,3
10707155,Dil Diya Dard Liya,1966,['India'],"['Romantic drama', 'Bollywood', 'World cinema', 'Romance Film', 'Drama']",1960,6
14059291,Land of the Midnight Fun,1939,['United States of America'],"['Animation', 'Short Film', 'Family Film']",1930,9
2259073,Frankenhooker,1990,['United States of America'],"['Monster', 'Comedy', 'Horror Comedy', 'Black comedy', 'Splatter film', 'Horror', 'Science Fiction', 'Cult']",1990,0
9019882,Casino Royale,1954,['United States of America'],"['Action', 'Spy', 'Film adaptation', 'Drama', 'Thriller', 'Television movie']",1950,4
31855039,The Prince and the Surfer,1999,['United States of America'],"['Comedy', ""Children's/Family"", 'Adventure', 'Family Film']",1990,9
15026605,The Princess and the Pirate,1944,['United States of America'],"['Adventure Comedy', 'Action', 'Costume Adventure', 'Action/Adventure', 'Comedy', 'Drama', 'Parody', 'Family Film']",1940,4
9252149,The Sun Comes Up,1949,['United States of America'],"['Comedy-drama', 'Drama', 'Family Film']",1940,9
25388443,"Left, Right & Centre",1959,['United Kingdom'],['Romantic comedy'],1950,9
23016541,The Blue Diner,2000,['United States of America'],"['Romantic drama', 'Indie', 'Comedy', 'Romance Film', 'Drama']",2000,0
422269,Contact,1997,['United States of America'],"['Film adaptation', 'Mystery', 'Thriller', 'Science Fiction', 'Drama']",1990,7
31485731,C. I. Mahadevan 5 Adi 4 Inchu,2004,[],"['Action', 'Thriller', 'Comedy film']",2000,4
15000816,Abilene Town,1946,['United States of America'],"['Western', 'B-Western']",1940,6
9626476,Next of Kin,1989,"['United States of America', 'Australia']","['Action', 'Action/Adventure', 'Thriller']",1980,9
2411357,A Bittersweet Life,2005,['South Korea'],"['Action', 'Drama', 'Crime Fiction', 'Gangster Film']",2000,5
25855321,Tora-san's Sunrise and Sunset,1976,['Japan'],['Japanese Movies'],1970,6
1545870,She's Gotta Have It,1986,['United States of America'],"['Indie', 'Comedy', 'Romance Film', 'Romantic comedy', 'Drama']",1980,6
3758886,Zenobia,1939,['United States of America'],"['Black-and-white', 'Slapstick', 'Comedy', 'Animal Picture']",1930,9
12138818,Jewel,2001,"['United Kingdom', 'United States of America', 'Canada']","['Film adaptation', 'Television movie', 'Drama']",2000,1
9863190,Cabin Fever 2: Spring Fever,2008,['United States of America'],"['Horror Comedy', 'Teen', 'Horror']",2000,8
5673502,Lydia,1941,"['France', 'United States of America']","['Black-and-white', 'Drama']",1940,1
17487908,Unfair: The Movie,2007,['Japan'],"['Action', 'Crime', 'Drama']",2000,7
4911873,Goldilocks and The Three Bares,1963,[],['Sexploitation'],1960,3
5399266,Mimino,1977,"['Russia', 'Soviet Union']","['Comedy', 'Comedy of manners', 'World cinema']",1970,7
6529514,Vaseegara,2003,['India'],['Comedy'],2000,3
22637123,Pippi in the South Seas,1970,"['Sweden', 'West Germany']","['Comedy', 'Adventure', ""Children's"", 'Family Film']",1970,0
18357694,A Driver for Vera,2004,"['Russia', 'Ukraine']",['Drama'],2000,4
28935479,Hold On!,1966,['United States of America'],"['Musical', 'Comedy']",1960,6
9015828,This Night I Will Possess Your Corpse,1967,['Brazil'],"['Black-and-white', 'Horror']",1960,7
7517533,The Vault of Horror,1973,"['United Kingdom', 'United States of America']","['Mystery', 'Thriller', 'Horror', 'Supernatural']",1970,3
31146040,Riverbend,1990,['United States of America'],"['Action', 'Drama']",1990,0
236122,Don't Say a Word,2001,"['United States of America', 'Australia']","['Psychological thriller', 'Suspense', 'Crime Fiction', 'Thriller']",2000,1
5222773,Blood on the Sun,1945,['United States of America'],"['War film', 'Drama', 'Political drama']",1940,5
22216,"O Brother, Where Art Thou?",2000,"['United Kingdom', 'France', 'United States of America']","['Music', 'Action', 'Crime Fiction', 'Action/Adventure', 'Comedy', 'Buddy film', 'Americana', 'Adventure', 'Parody', 'Crime Comedy', 'Road movie']",2000,0
8612952,Leo The Last,1970,['United Kingdom'],"['Film adaptation', 'Satire', 'Comedy', 'Comedy-drama', 'Drama']",1970,0
5882313,Investigating Sex,2002,"['Germany', 'United States of America']","['Comedy', 'Black comedy', 'Romantic comedy', 'Comedy-drama', 'Romance Film', 'Drama', 'Sex comedy']",2000,2
18566573,I'm Not Single,2008,['Malaysia'],"['Romance Film', 'Comedy']",2000,8
25358710,Cedar Boys,2009,"['New Zealand', 'Australia']","['Heist', 'Crime Fiction', 'World cinema', 'Drama']",2000,9
19436174,Mera Pind,2008,['India'],"['Musical', 'Bollywood', 'World cinema', 'Romantic comedy', 'Drama']",2000,8
25644848,Sarraounia,1986,"['Burkina Faso', 'France']","['History', 'War film', 'Drama']",1980,6
25152120,Actresses,2009,['South Korea'],"['Mockumentary', 'Drama', 'World cinema']",2000,9
15036863,Bodyguard,1948,['United States of America'],"['Black-and-white', 'Crime Fiction', 'Thriller', 'Detective', 'Film noir', 'Drama']",1940,8
31893550,Magrib,1993,[],['Drama'],1990,3
16666086,Love in Paris,1997,"['United Kingdom', 'France', 'United States of America']",['Erotica'],1990,7
26026669,Troublesome Night 8,2000,['Hong Kong'],"['Chinese Movies', 'Comedy', 'Horror']",2000,0
24654294,35 Shots of Rum,2008,"['France', 'Germany']","['Art film', 'Family Drama', 'World cinema', 'Drama', 'Slice of life story']",2000,8
414349,Racketeer Rabbit,1946,['United States of America'],"['Animation', 'Short Film', 'Comedy', 'Family Film']",1940,6
25080120,Return from the Ashes,1965,"['United Kingdom', 'United States of America']",['Thriller'],1960,5
32012357,"Those Glory, Glory Days",1984,[],"['Coming of age', 'Television movie', 'Sports', 'Drama']",1980,4
10653373,Cthulhu,2007,['United States of America'],"['LGBT', 'Thriller', 'Horror']",2000,7
954902,Crossing Delancey,1988,['United States of America'],"['Romance Film', 'Romantic comedy', 'Comedy']",1980,8
10343550,Oh Sailor Behave,1930,['United States of America'],['Musical'],1930,0
2439924,The Ascent,1976,"['Russia', 'Soviet Union']","['Art film', 'World cinema', 'War film', 'Drama']",1970,6
20950152,Anita,1967,['India'],"['Romantic drama', 'Thriller', 'World cinema', 'Romance Film', 'Drama']",1960,7
39311,JFK,1991,"['France', 'United States of America']","['History', 'Mystery', 'Biography', 'Thriller', 'Drama']",1990,1
18934490,Fast Life,1932,['United States of America'],['Romantic comedy'],1930,2
20393685,Secrets,1924,['United States of America'],"['Silent film', 'Drama']",1920,4
12576817,Futurama: Bender's Game,2008,['United States of America'],"['Science Fiction', 'Comedy']",2000,8
1057284,Gidget,1959,['United States of America'],"['Comedy', 'Teen', 'Romance Film', 'Romantic comedy', 'Beach Film']",1950,9
1436536,Aftershock: Earthquake in New York,1999,['United States of America'],"['Action', 'Suspense', 'Drama', 'Action/Adventure', 'Thriller', 'Television movie', 'Disaster']",1990,9
26494388,The Purple Plain,1955,['United Kingdom'],"['Action', 'Film adaptation', 'Action/Adventure', 'War film', 'Adventure', 'Drama']",1950,5
4089508,Kenny,1988,"['United States of America', 'Canada', 'Japan']","['Indie', 'Biographical film', 'Drama', 'Family Film']",1980,8
1763834,Guadalcanal Diary,1943,['United States of America'],"['Combat Films', 'Action', 'Black-and-white', 'Action/Adventure', 'War film']",1940,3
8233777,Hamoun,1990,['Iran'],"['World cinema', 'Social problem film', 'Comedy-drama', 'Drama']",1990,0
8960083,Megaville,1990,['United States of America'],"['Action', 'Dystopia', 'Mystery', 'Indie', 'Thriller', 'Adventure', 'Science Fiction']",1990,0
623452,Hannibal,2001,"['United Kingdom', 'United States of America']","['Action', 'Psychological thriller', 'Film adaptation', 'Mystery', 'Action/Adventure', 'Thriller', 'Crime Thriller', 'Drama', 'Suspense', 'Horror']",2000,1
6827301,Right at Your Door,2006,['United States of America'],"['Psychological thriller', 'Suspense', 'Indie', 'Thriller', 'Disaster']",2000,6
3073220,Accattone,1961,['Italy'],"['Black-and-white', 'Drama', 'World cinema']",1960,1
1224344,Topper,1937,['United States of America'],"['Black-and-white', 'Comedy', 'Drama', 'Fantasy']",1930,7
14359569,Sandakan No. 8,1974,['Japan'],"['Japanese Movies', 'Drama']",1970,4
31227986,Quiet Chaos,2008,"['United Kingdom', 'Italy']","['Family Drama', 'World cinema', 'Drama', 'Slice of life story']",2000,8
22781561,The Hole,1957,['Japan'],"['Mystery', 'Japanese Movies', 'Comedy film']",1950,7
2148370,North Country,2005,['United States of America'],"['Social problem film', 'Docudrama', 'Drama', 'Courtroom Drama']",2000,5
2010018,The Sentinel,1977,['United States of America'],"['Supernatural', 'Cult', 'Horror']",1970,7
4987435,The Slaughter Rule,2002,['United States of America'],"['Coming of age', 'Indie', 'Sports', 'Drama']",2000,2
16477359,Mickybo and Me,2004,"['Northern Ireland', 'Ireland']",['Comedy-drama'],2000,4
23669556,Friends,1938,['Soviet Union'],"['War film', 'Biographical film']",1930,8
8470910,I Drink Your Blood,1970,['United States of America'],"['Zombie Film', 'Cult', 'Horror']",1970,0
13736947,Counterpoint,1968,['United States of America'],"['War film', 'Drama']",1960,8
33404927,Wildness of Youth,1922,[],['Silent film'],1920,2
19254681,Maria Candelaria,1943,['Mexico'],"['Black-and-white', 'Romantic drama', 'World cinema', 'Romance Film', 'Melodrama', 'Drama']",1940,3
2474408,Mom and Dad,1945,['United States of America'],"['Exploitation', 'Sexploitation', 'Roadshow/Carny', 'Documentary', 'Melodrama', 'Drama', 'Cult']",1940,5
4635580,Aethiree,2004,['India'],"['Comedy', 'Tollywood']",2000,4
7088758,The Movie From the Future,2000,['United States of America'],"['Science Fiction', 'Comedy']",2000,0
20244619,Mirage,1972,['Peru'],"['Drama', 'World cinema']",1970,2
4578386,I Downloaded A Ghost,2004,"['Canada', 'United States of America']","['Comedy', ""Children's/Family"", ""Children's"", 'Fantasy Comedy', 'Family Film', 'Fantasy']",2000,4
183740,Duel in the Sun,1946,['United States of America'],"['Romantic drama', 'Action/Adventure', 'Romance Film', 'Roadshow theatrical release', 'Drama', 'Epic Western', 'Western', 'Melodrama']",1940,6
13380578,Offerings,1989,['United States of America'],"['Psychological thriller', 'Slasher', 'Horror']",1980,9
8786135,Blind Justice,1994,['United States of America'],"['Action/Adventure', 'Western']",1990,4
1295686,Santa's Slay,2005,"['Canada', 'United States of America']","['Slasher', 'Horror', 'Black comedy', 'Holiday Film', 'Christmas movie']",2000,5
2559713,Rain,1932,['United States of America'],"['Black-and-white', 'Romantic drama', 'Romance Film', 'Pre-Code', 'Drama']",1930,2
18246654,The Substitute,1993,['United States of America'],"['Psychological thriller', 'Thriller']",1990,3
426761,Wet Hot American Summer,2001,['United States of America'],"['Indie', 'Parody', 'Comedy', 'Romance Film']",2000,1
3070954,D2: The Mighty Ducks,1994,['United States of America'],"['Action', 'Comedy', ""Children's/Family"", 'Drama', 'Coming of age', 'Comedy-drama', 'Sports', 'Family Film']",1990,4
26049282,Soorya Gayathri,1992,['India'],"['Musical', 'Drama']",1990,2
11037141,Moving August,2002,['United States of America'],"['Indie', 'Comedy']",2000,2
5090736,Baazi,1951,['India'],['World cinema'],1950,1
18247508,Freebird,2008,['United Kingdom'],['Comedy'],2000,8
3059082,The Ice Harvest,2005,['United States of America'],"['Action', 'Crime Fiction', 'Action/Adventure', 'Comedy', 'Black comedy', 'Drama', 'Crime Comedy', 'Comedy-drama']",2000,5
828607,Savior,1998,['United States of America'],"['War film', 'Drama', 'Political drama']",1990,8
2251161,Damien: Omen II,1978,['United States of America'],"['Mystery', 'Demonic child', 'Thriller', 'Horror', 'Crime Thriller', 'Supernatural', 'Cult']",1970,8
4446736,Warriors of Virtue,1997,"['China', 'United States of America']","['Chinese Movies', ""Children's Fantasy"", ""Children's/Family"", 'Martial Arts Film', 'Adventure', 'Family Film', 'Fantasy']",1990,7
9264265,Forgetting Sarah Marshall,2008,['United States of America'],"['Music', 'Comedy', 'Romance Film', 'Romantic comedy', 'Drama']",2000,8
10048277,Guru,1997,['India'],"['Drama', 'Fantasy']",1990,7
19669545,Dinner at the Ritz,1937,['United Kingdom'],"['Mystery', 'Romance Film']",1930,7
23948026,Chinna Vathiyar,1995,['India'],"['Science Fiction', 'Comedy film']",1990,5
711106,Square Dance,1987,['United States of America'],"['Romance Film', 'Drama', 'Teen']",1980,7
2652684,You Were Never Lovelier,1942,['United States of America'],"['Musical', 'Black-and-white']",1940,2
5112836,Guncrazy,1992,['United States of America'],"['Action', 'Crime Fiction', 'Indie', 'Romantic drama', 'Thriller', 'Romance Film', 'Crime Thriller', 'Drama']",1990,2
2704374,The Ring Virus,1999,['South Korea'],"['Thriller', 'Horror', 'World cinema', 'Crime Thriller', 'Supernatural']",1990,9
7513491,Aaram Thamburan,1997,['India'],"['Action', 'Drama', 'Bollywood']",1990,7
4179770,The Mighty Quinn,1989,['United States of America'],"['Action', 'Suspense', 'Crime Fiction', 'Mystery', 'Thriller', 'Comedy-drama', 'Crime Thriller']",1980,9
32255889,I'll Be Home for Christmas,1988,['United States of America'],['Drama'],1980,8
7024876,Hello Dolly!,1969,['United States of America'],"['Musical', 'Comedy', 'Romance Film', 'Romantic comedy', 'Family Film']",1960,9
19237560,The Fever,2004,"['United Kingdom', 'United States of America']","['Film adaptation', 'Television movie', 'Drama']",2000,4
695435,Higher Learning,1995,['United States of America'],"['LGBT', 'Drama', 'Ensemble Film']",1990,5
27605718,Feudin' Fools,1952,['United States of America'],['Comedy film'],1950,2
7344950,Happy Days,1930,['United States of America'],"['Musical', 'Black-and-white']",1930,0
27162062,The Devil's Pass Key,1920,['United States of America'],['Silent film'],1920,0
27482742,Raamanam,2009,['India'],['Drama'],2000,9
1447885,Multi-Facial,1995,['United States of America'],['Short Film'],1990,5
5133308,Animal Crossing,2006,['Japan'],"['Anime', 'Japanese Movies']",2000,6
9779498,The Trial of Billy Jack,1974,['United States of America'],"['Action', 'Drama', 'Indie', 'Political drama', 'Martial Arts Film']",1970,4
11129310,"Citizen: I'm Not Losing My Mind, I'm Giving It Away",1982,['United States of America'],['Drama'],1980,2
27227959,Rockabye,1986,['United States of America'],['Drama'],1980,6
2014153,2 Young,2005,['Hong Kong'],"['Romantic drama', 'World cinema', 'Teen', 'Romance Film', 'Chinese Movies', 'Drama']",2000,5
6005439,Nenunnanu,2004,['India'],"['Romantic drama', 'World cinema', 'Romance Film', 'Drama']",2000,4
25902448,Vaa Arugil Vaa,1991,['India'],['Horror'],1990,1
8094205,Here Come The Co-Eds,1945,['United States of America'],"['Musical', 'Black-and-white', 'Comedy', 'Slapstick', 'Family Film']",1940,5
42147,Midnight Cowboy,1969,['United States of America'],"['Buddy film', 'Drama']",1960,9
702217,The 51st State,2001,"['Canada', 'United Kingdom']","['Action', 'Crime Fiction', 'Indie', 'Action/Adventure', 'Buddy film', 'Thriller', 'Comedy']",2000,1
2276775,"Sister, Sister",1979,['United States of America'],"['Drama', 'Television movie']",1970,9
10565718,Mean Girls,2004,"['Canada', 'United States of America']","['LGBT', 'Coming of age', 'Comedy', 'Teen', 'Comedy of manners', 'Comedy-drama']",2000,4
24871531,Soldiers of Freedom,1977,[],"['War film', 'Drama']",1970,7
21766755,The Pack,1977,['United States of America'],"['Horror', 'Natural horror films']",1970,7
27701047,Is There Sex After Death?,1971,['United States of America'],"['Mockumentary', 'Parody', 'Comedy']",1970,1
8932397,Girl with a Suitcase,1961,['Italy'],"['Black-and-white', 'Romantic drama', 'Comedy', 'World cinema', 'Romance Film', 'Drama']",1960,1
28203916,Block Busters,1944,['United States of America'],['Comedy'],1940,4
17624772,Everybody's Fine,2009,"['Italy', 'United States of America']","['Comedy', 'Drama', 'Adventure']",2000,9
17315314,Yentl,1983,"['United Kingdom', 'United States of America']","['Musical', 'Musical Drama', 'Romance Film', 'Drama', 'Feminist Film']",1980,3
6989710,The Boy with a Thorn in His Side,2005,['United Kingdom'],['Comedy'],2000,5
20395814,Land Down Under,2009,['Philippines'],"['Filipino Movies', 'Romantic drama', 'World cinema', 'Romance Film', 'Romantic comedy', 'Drama']",2000,9
25722138,The Black Widow,1977,['Mexico'],['Drama'],1970,7
22270025,The Infinite Worlds of H.G. Wells,2001,[],"['Romantic drama', 'Science Fiction', 'Romance Film', 'Sci-Fi Adventure', 'Drama']",2000,1
1475902,"Dirty Mary, Crazy Larry",1974,['United States of America'],"['Action', 'Crime Fiction', 'Chase Movie', 'Action/Adventure', 'Adventure']",1970,4
882050,Mannequin,1987,['United States of America'],"['LGBT', 'Indie', 'Comedy', 'Romance Film', 'Romantic comedy', 'Fantasy']",1980,7
1973848,Gol Maal,1979,['India'],"['Musical', 'Comedy', 'Bollywood', 'World cinema']",1970,9
6106857,Something Something ... Unnakum Ennakum,2006,['India'],"['Musical', 'Bollywood', 'World cinema', 'Drama']",2000,6
23400318,Kisaan,2009,['India'],"['Melodrama', 'Drama', 'World cinema']",2000,9
3754443,I Wish I Had a Wife,2001,['South Korea'],"['Romantic comedy', 'Drama']",2000,1
11963758,Phantom Of Chinatown,1940,['United States of America'],"['Detective fiction', 'Black-and-white', 'Mystery', 'Thriller', 'Detective', 'Crime Thriller']",1940,0
3697394,Renegade,1987,['Italy'],['Adventure'],1980,7
21854382,Days of Nietzche in Turin,2001,['Brazil'],"['Drama', 'Biographical film']",2000,1
6401155,The Trumpet of the Swan,2001,['United States of America'],"['Music', 'Animated cartoon', 'Animation', ""Children's"", 'Family Film']",2000,1
7352271,Rendition,2007,"['United States of America', 'South Africa']","['Drama', 'War film', 'Thriller']",2000,7
797798,Resident Evil: Apocalypse,2004,"['Canada', 'United Kingdom', 'France', 'Germany']","['Action', 'Thriller', 'World cinema', 'Zombie Film', 'Sci-Fi Horror', 'Horror', 'Doomsday film', 'Science Fiction']",2000,4
5667757,The Leech Woman,1960,['United States of America'],"['Black-and-white', 'Science Fiction', 'Horror']",1960,0
4150566,Union Station,1950,['United States of America'],"['Black-and-white', 'Crime Fiction', 'Thriller', 'Film noir', 'Crime Thriller', 'Drama']",1950,0
14230829,The Little Minister,1934,['United States of America'],"['Black-and-white', 'Drama']",1930,4
12196041,Plague,1978,['Canada'],"['Thriller', 'Horror', 'Science Fiction', 'Drama']",1970,8
5703641,Wild America,1997,['United States of America'],"['Action', ""Children's"", 'Comedy', 'Family-Oriented Adventure', ""Children's/Family"", 'Adventure', 'Family Film']",1990,7
26166420,The Love War,1970,['United States of America'],"['Action', 'Science Fiction']",1970,0
61508,Mr. Deeds Goes to Town,1936,['United States of America'],"['Black-and-white', 'Screwball comedy', 'Comedy', 'Romance Film', 'Americana', 'Drama', 'Romantic comedy', 'Comedy-drama', 'Comedy of manners']",1930,6
3500651,Sopyonje,1993,['South Korea'],"['Musical', 'Drama']",1990,3
6976850,Battlefield Earth,2000,['United States of America'],"['Action', 'Film adaptation', 'Alien Film', 'Space opera', 'Science Fiction']",2000,0
24478594,Main Chup Rahungi,1962,['India'],"['Drama', 'Bollywood', 'Family Film']",1960,2
12234609,We All Scream for Ice Cream,2007,"['Canada', 'United States of America']","['Slasher', 'Horror', 'Television movie', 'Cult']",2000,7
22136681,The Jailhouse,2009,['United States of America'],"['Mystery', 'Thriller', 'Horror']",2000,9
24985700,Campfire Tales,1991,['United States of America'],['Horror'],1990,1
8316422,James Dean,2001,['United States of America'],"['Biography', 'Biographical film', 'Drama']",2000,1
1244836,Jingle All the Way,1996,['United States of America'],"[""Children's"", 'Comedy', 'Domestic Comedy', ""Children's/Family"", 'Holiday Film', 'Christmas movie', 'Family Film']",1990,6
10086955,Naked Tango,1990,"['Switzerland', 'Japan', 'Argentina', 'United States of America']","['Romance Film', 'Japanese Movies', 'Drama']",1990,0
4492975,The New Adventures of Pippi Longstocking,1988,"['Sweden', 'United States of America']","['Musical', ""Children's"", 'Family-Oriented Adventure', ""Children's/Family"", 'Adventure', 'Family Film']",1980,8
35490374,Shabdavedhi,2000,['India'],['Crime Fiction'],2000,0
9507768,Lassiter,1984,['United States of America'],"['Crime Fiction', 'Romance Film', 'Adventure', 'Drama']",1980,4
237134,"Paris, Texas",1984,"['United Kingdom', 'France', 'West Germany', 'United States of America']","['Mystery', 'Indie', 'Romance Film', 'Road movie', 'Drama']",1980,4
27932459,The Giant of Metropolis,1961,['Italy'],"['Action/Adventure', 'World cinema']",1960,1
6124685,Vampires: Los Muertos,2002,['United States of America'],"['Action', 'Creature Film', 'Action/Adventure', 'Thriller', 'Horror']",2000,2
9406991,Jerry and the Lion,1950,[],"['Animation', 'Short Film', 'Comedy', 'Family Film']",1950,0
22554167,Murderous Maids,2000,['France'],"['Crime Fiction', 'World cinema', 'Docudrama', 'Drama']",2000,0
29166776,Those Kids from Town,1942,[],['War film'],1940,2
3592202,Rachel and the Stranger,1948,['United States of America'],"['Western', 'Drama']",1940,8
17030343,Anth,1993,['India'],"['Musical', 'Bollywood', 'World cinema', 'Drama']",1990,3
1059195,Anna Karenina,1985,['United States of America'],['Costume drama'],1980,5
12465157,Three Faces West,1940,['United States of America'],"['Black-and-white', 'Family Drama', 'Action/Adventure', 'Romantic drama', 'Romance Film', 'Adventure', 'Drama']",1940,0
1933551,Gettin' Square,2004,"['New Zealand', 'Australia']","['Action', 'Crime Fiction', 'Gangster Film', 'Action/Adventure', 'Comedy', 'World cinema', 'Drama', 'Caper story', 'Crime Comedy']",2000,4
21045857,Shark in Venice,2008,['United States of America'],"['Action', 'Thriller', 'Horror', 'B-movie', 'Natural horror films']",2000,8
20826938,After the Ball,1932,['United States of America'],['Comedy'],1930,2
6887230,Thr3e,2007,"['Poland', 'United States of America']","['Psychological thriller', 'Film adaptation', 'Mystery', 'Thriller', 'World cinema', 'Christian film', 'Crime Thriller', 'Drama']",2000,7
26015620,Chinese Roulette,1977,"['France', 'Germany', 'West Germany']","['Drama', 'World cinema']",1970,7
13963229,The Sisterhood of the Traveling Pants 2,2008,['United States of America'],"['Film adaptation', 'Buddy film', 'Comedy', 'Teen', 'Romance Film', 'Drama', 'Coming of age', 'Comedy-drama']",2000,8
17384281,"Oro, Plata, Mata",1982,['Philippines'],"['Filipino Movies', 'World cinema', 'War film', 'Drama']",1980,2
6825979,Mugguru Monagallu,1994,['India'],"['Action', 'Family Film']",1990,4
1690244,Age of Consent,1969,"['New Zealand', 'Australia']","['Romantic drama', 'Biographical film', 'Romance Film', 'Drama']",1960,9
1584981,Under Capricorn,1949,['United Kingdom'],"['Period piece', 'Film adaptation', 'Drama']",1940,9
5130772,The Karate Dog,2004,"['Germany', 'United States of America']","['Action', 'Crime Fiction', 'Comedy', 'Family Film']",2000,4
28237392,Butterfly Circus,2009,['United States of America'],['Short Film'],2000,9
4220121,The Condemned,2007,['United States of America'],"['Action', 'Thriller', 'Escape Film']",2000,7
5341691,Riding Alone for Thousands of Miles,2006,"['China', 'Japan']","['Period piece', 'Japanese Movies', 'World cinema', 'Chinese Movies', 'Drama']",2000,6
11599737,26 Years Diary,2007,"['Japan', 'South Korea']","['Japanese Movies', 'Biographical film', 'Drama']",2000,7
3499995,All of Me,1984,['United States of America'],"['Screwball comedy', 'Comedy', 'Fantasy']",1980,4
26163463,Threshold,1981,['Canada'],"['Science Fiction', 'Drama']",1980,1
1971520,Mitchell,1975,['United States of America'],"['Action', 'Crime Fiction']",1970,5
3178798,Pepe,1960,"['Mexico', 'United States of America']","['Musical', 'Comedy']",1960,0
12066244,AmericanEast,2007,['United States of America'],"['Romantic drama', 'Indie', 'Romance Film', 'Drama']",2000,7
21800088,Rasputin and the Empress,1932,['United States of America'],"['Historical Epic', 'Epic', 'Drama']",1930,2
2303875,Blood on the Moon,1948,['United States of America'],"['Film noir', 'Western']",1940,8
2620748,Metro,1997,['United States of America'],"['Action', 'Crime Fiction', 'Action/Adventure', 'Comedy', 'Thriller']",1990,7
11435243,The Diving Bell and the Butterfly,2007,"['United States of America', 'France']","['Biography', 'Drama']",2000,7
9380065,Alien Express,2005,['United States of America'],"['Horror', 'Science Fiction']",2000,5
5353084,Tunnel Vision,1976,['United States of America'],"['Parody', 'Comedy']",1970,6
650219,Godzilla vs. Mechagodzilla II,1993,['Japan'],"['Japanese Movies', 'Monster', 'World cinema', 'Science Fiction', 'Fantasy']",1990,3
8155943,Candles on Bay Street,2006,"['Canada', 'United States of America']",['Drama'],2000,6
18016293,Breakheart Pass,1975,['United States of America'],"['Action', 'Detective fiction', 'Crime Fiction', 'Hybrid Western', 'Action/Adventure', 'Adventure', 'Drama', 'Western', 'Detective']",1970,5
17683199,Ruslan,2009,"['Canada', 'United States of America']","['Action', 'Crime Fiction', 'Thriller']",2000,9
26666339,Madhya Venal,2009,['India'],[],2000,9
20737830,Hellbound,1994,['United States of America'],"['Action', 'Action/Adventure', 'Thriller', 'Supernatural']",1990,4
4901623,Dirty Ho,1979,['Hong Kong'],"['Chinese Movies', 'Martial Arts Film', 'Adventure']",1970,9
7784456,Willy McBean and his Magic Machine,1965,['United States of America'],"['Family Film', 'Animation']",1960,5
8591389,Naqaab,2007,['India'],"['Crime Fiction', 'Thriller', 'Romance Film', 'Drama']",2000,7
4678174,Grill Point,2002,['Germany'],['Drama'],2000,2
19796380,Zay El Naharda,2008,['Egypt'],"['Mystery', 'Thriller']",2000,8
18249330,The Devil's Sword,1984,['Indonesia'],"['Action', 'Fantasy Adventure', 'World cinema', 'Sword and sorcery', 'Fantasy', 'Sword and sorcery films']",1980,4
26208838,Thodi Kodallu,1957,['India'],['Drama'],1950,7
1989045,Pokémon 4Ever,2002,"['Japan', 'United States of America']","['Action', 'Fantasy Adventure', 'Animated cartoon', 'Animation', 'World cinema', ""Children's/Family"", ""Children's"", 'Adventure', ""Children's Fantasy"", 'Japanese Movies', 'Anime', 'Family Film', 'Fantasy']",2000,2
7511592,Springtime in The Rockies,1942,['United States of America'],['Musical'],1940,2
1643419,The Interpreter,2005,"['United Kingdom', 'France', 'Germany', 'United States of America']","['Mystery', 'Thriller', 'Drama', 'Political thriller']",2000,5
27380492,A Name for Evil,1973,['United States of America'],['Horror'],1970,3
22816098,Double Identity,2009,"['Canada', 'United States of America']","['Action', 'Short Film', 'Action/Adventure', 'Thriller', 'Crime Thriller']",2000,9
32767328,Music in Manhattan,1944,[],['Musical'],1940,4
18871379,Turn Back the Clock,1933,['United States of America'],['Black-and-white'],1930,3
570321,How to Lose a Guy in 10 Days,2003,"['Germany', 'United States of America']","['Romance Film', 'Romantic comedy', 'Comedy']",2000,3
24785258,Tinker Bell and the Lost Treasure,2009,['United States of America'],"['Fairy tale', ""Children's Fantasy"", 'Animation', ""Children's/Family"", 'Adventure', 'Family Film']",2000,9
5515388,The Killer,2006,['India'],"['Musical', 'Bollywood', 'World cinema', 'Drama']",2000,6
2014023,Daughters of the Dust,1991,"['United Kingdom', 'United States of America']","['Period piece', 'Drama', 'Family Drama', 'Indie', 'Romance Film', 'Family Film', 'Feminist Film']",1990,1
8753468,The Shrimp on the Barbie,1990,"['New Zealand', 'United States of America']","['Comedy', 'Romance Film', 'Romantic comedy', 'Comedy of Errors']",1990,0
1383548,Freedomland,2006,['United States of America'],"['Film adaptation', 'Crime Fiction', 'Mystery', 'Thriller', 'Crime Drama', 'Crime Thriller', 'Drama']",2000,6
930387,Going the Distance,2004,['Canada'],['Comedy'],2000,4
12837431,Solar Attack,2005,['Canada'],"['Action/Adventure', 'Thriller', 'Disaster', 'Science Fiction']",2000,5
30736552,Bleak Moments,1971,['United Kingdom'],"['Romantic drama', 'Romance Film', 'Melodrama', 'Television movie', 'Drama', 'Ensemble Film']",1970,1
9362734,Hail the Judge,1994,['Hong Kong'],"['Chinese Movies', 'Comedy']",1990,4
11679162,Nidhanaya,1972,['Sri Lanka'],"['Romance Film', 'Drama']",1970,2
21662430,Yeh Dil Aashiqanaa,2002,['India'],"['Musical', 'Romantic drama', 'Action/Adventure', 'Bollywood', 'World cinema', 'Romance Film', 'Drama']",2000,2
24818202,That Certain Feeling,1956,['United States of America'],['Comedy'],1950,6
17417872,Natturajavu,2004,['India'],"['Action', 'Drama', 'Thriller', 'Bollywood']",2000,4
12986359,King Dinosaur,1955,['United States of America'],"['Monster', 'Horror', 'B-movie', 'Science Fiction', 'Fantasy']",1950,5
20107910,Food of the Gods II,1989,"['Canada', 'United States of America']","['Monster', 'Horror', 'Science Fiction', 'Natural horror films']",1980,9
19596597,Sherlock Holmes,2009,"['United Kingdom', 'Germany', 'United States of America']","['Action', 'Detective fiction', 'Crime Fiction', 'Action/Adventure', 'Comedy', 'Thriller', 'Crime Thriller', 'Drama', 'Period piece']",2000,9
24796776,Backstage,2005,['France'],"['Musical', 'Drama', 'World cinema']",2000,5
22055483,Playing For Time,1980,['United States of America'],"['Music', 'Drama']",1980,0
19064165,Slalom,1965,"['France', 'Italy', 'Egypt']",['Comedy'],1960,5
1670656,8 Million Ways to Die,1986,['United States of America'],"['Detective fiction', 'Crime Fiction', 'Mystery', 'Detective']",1980,6
12145602,Animal Treasure Island,1971,['Japan'],"['Animation', 'Japanese Movies', 'Anime', 'Adventure', 'Drama', 'Family Film']",1970,1
17471406,Wild Blood,2008,['Italy'],"['Historical drama', 'Biographical film', 'Drama']",2000,8
12814753,"I, the Jury",1953,['United States of America'],"['Black-and-white', 'Crime Fiction', 'Mystery', 'Detective', 'Film noir']",1950,3
1373922,How High,2001,['United States of America'],"['Stoner film', 'Comedy']",2000,1
74535,Plane Crazy,1928,['United States of America'],"['Airplanes and airports', 'Black-and-white', 'Short Film', 'Comedy']",1920,8
4589873,Dr. Goldfoot and the Girl Bombs,1966,"['Italy', 'United States of America']","['Action', 'Parody', 'Action/Adventure', 'Comedy', 'World cinema', 'Science Fiction']",1960,6
1188638,Ecstasy,1933,"['Czechoslovakia', 'Austria']","['Black-and-white', 'Romantic drama', 'World cinema', 'Romance Film', 'Pre-Code', 'Drama']",1930,3
16953192,Kuch Meetha Ho Jaaye,2005,['India'],"['Romantic drama', 'Comedy', 'World cinema', 'Romance Film', 'Romantic comedy', 'Drama']",2000,5
27750710,H6: Diary of a Serial Killer,2005,['Spain'],"['World cinema', 'Horror']",2000,5
9784887,Quiet days in hollywood,1994,['Germany'],"['LGBT', 'Indie', 'World cinema', 'Drama']",1990,4
6781858,Oh Heavenly Dog,1980,['United States of America'],"['Religious Film', 'Comedy', 'Fantasy']",1980,0
23257981,Sex and Lies in Sin City,2008,['United States of America'],"['Mystery', 'Crime Fiction', 'Thriller', 'Crime Thriller', 'Drama']",2000,8
898655,Visions of Light,1992,"['Japan', 'United States of America']","['Japanese Movies', 'Indie', 'Documentary']",1990,2
7376937,Asylum,2008,['United States of America'],"['Psychological thriller', 'Thriller', 'Horror', 'Supernatural']",2000,8
1134373,Primer,2004,['United States of America'],"['Psychological thriller', 'Drama', 'Time travel', 'Indie', 'Thriller', 'Science Fiction']",2000,4
5158792,Def by Temptation,1990,['United States of America'],"['Suspense', 'Thriller', 'Horror', 'Erotic thriller', 'Crime Thriller', 'Supernatural']",1990,0
19374616,Man on the Run,1949,[],['Drama'],1940,9
286893,Rudy,1993,['United States of America'],"['Family Drama', 'Sports', 'Drama', 'Family Film']",1990,3
2298689,Coney Island Baby,2003,"['Ireland', 'United States of America']","['Drama', 'Indie', 'Comedy', 'Comedy film', 'Romance Film', 'Romantic comedy']",2000,3
2212695,Alice in Wonderland,1976,['United States of America'],"['Musical', 'Comedy', 'Pornographic movie']",1970,6
5574594,Borat: Cultural Learnings of America for Make Benefit Glorious Nation of Kazakhstan,2006,['United States of America'],"['Parody', 'Satire', 'Comedy', 'Mockumentary', 'Cult']",2000,6
3032467,Vampyros Lesbos,1971,['Germany'],"['Erotica', 'World cinema', 'Horror']",1970,1
26586731,I G Inspector General,2009,['India'],['Action'],2000,9
10640919,Paayum Puli,1987,['India'],"['Musical', 'Romantic drama', 'Action/Adventure', 'Bollywood', 'World cinema', 'Romance Film', 'Drama']",1980,7
12973724,A Throw of Dice,1929,"['United Kingdom', 'India', 'Germany']","['Silent film', 'Romance Film', 'Adventure', 'Drama']",1920,9
24789475,Steele Justice,1987,['United States of America'],"['Action', 'Drama', 'Crime Fiction', 'Action/Adventure', 'Thriller']",1980,7
1056696,Cat People,1982,['United States of America'],"['Thriller', 'Horror', 'Erotic thriller', 'Erotica', 'Cult']",1980,2
4871676,The Star of Christmas,2002,[],"['Music', 'Musical', 'Animation', 'Short Film', ""Children's"", 'Family Film']",2000,2
32534824,We of the Never Never,1982,"['New Zealand', 'Australia']","['Film adaptation', 'Drama', 'Indie', 'Historical drama', 'World cinema']",1980,2
31825883,Nua Bou,1962,['India'],['Drama'],1960,2
45606,Zorba the Greek,1964,"['United Kingdom', 'Greece', 'United States of America']","['Film adaptation', 'Buddy film', 'Adventure', 'Drama']",1960,4
14605927,Storm Warning,2007,['Australia'],"['Slasher', 'Horror']",2000,7
962010,Meet the Fockers,2004,['United States of America'],"['Screwball comedy', 'Comedy', 'Romance Film', 'Domestic Comedy']",2000,4
6790266,Trapped in Paradise,1994,['United States of America'],"['Action', 'Heist', 'Crime Fiction', 'Christmas movie', 'Action/Adventure', 'Comedy', 'Crime Comedy']",1990,4
3249964,House by the River,1950,['United States of America'],"['Crime Fiction', 'Horror', 'Film noir', 'Drama']",1950,0
9280038,The Wrath of God,1972,['United States of America'],"['Parody', 'Western', 'Satire', 'Comedy', 'Adventure']",1970,2
10021034,Sometimes a Great Notion,1970,['United States of America'],"['Romance Film', 'Drama']",1970,0
27139182,The Last Days of Pompeii,1950,"['France', 'Italy']",['Historical drama'],1950,0
23058629,Mum & Dad,2008,['United Kingdom'],"['Slasher', 'Thriller', 'Horror']",2000,8
19097311,Awaaz,1984,['India'],"['Action', 'Crime Fiction', 'Drama']",1980,4
2495028,Women in Revolt,1971,['United States of America'],"['LGBT', 'Indie', 'Satire', 'Comedy', 'Drama', 'Feminist Film', 'Absurdism', 'Parody']",1970,1
292956,The Manxman,1929,['United Kingdom'],"['Black-and-white', 'Drama', 'Indie', 'Silent film']",1920,9
26553383,All Ashore,1953,['United States of America'],"['Musical', 'Comedy']",1950,3
1567210,Swept Away,2002,"['United Kingdom', 'Italy']","['Romance Film', 'Romantic comedy', 'Comedy']",2000,2
24577404,Money Talks,1926,['United States of America'],['Silent film'],1920,6
17896379,Dustclouds,2007,['United States of America'],['Drama'],2000,7
9222642,The Sicilian,1987,['United States of America'],"['Action', 'Crime Fiction', 'Biopic [feature]', 'Crime Drama', 'Drama']",1980,7
8732946,The Night Caller,1998,['United States of America'],"['Psychological thriller', 'Suspense', 'Indie', 'Thriller', 'Crime Thriller']",1990,8
24349526,Aayushkalam,1992,['India'],"['Psychological thriller', 'Horror']",1990,2
6842089,Vargam,2006,['India'],['Crime Fiction'],2000,6
13156165,Hidden Track,2003,['Hong Kong'],['Chinese Movies'],2000,3
14780376,"Enteng Kabisote: Okay ka, Fairy Ko: The Legend",2004,['Philippines'],"['Filipino Movies', 'Comedy', 'World cinema', 'Drama', 'Fantasy']",2000,4
24677331,The Promise of Love,1980,['United States of America'],"['Romance Film', 'War film', 'Drama']",1980,0
7420852,The Battle Over Citizen Kane,1996,['United States of America'],"['Black-and-white', 'History', 'Biography', 'Documentary', 'Film']",1990,6
1031231,"Black Cat, White Cat",1998,"['France', 'Germany', 'Yugoslavia']","['Music', 'Slapstick', 'Comedy', 'Romance Film', 'Romantic comedy', 'Comedy of Errors']",1990,8
14718686,The 6 Ultra Brothers Vs. the Monster Army,1974,"['Japan', 'Thailand']","['Action', 'Science Fiction']",1970,4
12757469,Sinbad: Beyond the Veil of Mists,2000,"['India', 'United States of America']","['Fantasy Adventure', 'Computer Animation', 'Animation', ""Children's/Family"", 'Adventure', 'Family Film', 'Fantasy']",2000,0
14359394,Nights and Days,1975,['Poland'],"['Drama', 'World cinema']",1970,5
15901584,New Cutie Honey,1994,[],"['Action', 'Animation', 'Comedy', 'Anime', 'Science Fiction', 'Fantasy']",1990,4
16697504,Satya In Love,2008,['India'],"['Action', 'Drama']",2000,8
31556852,Hridoyer Bandhon,2001,['Bangladesh'],"['Drama', 'Family Film']",2000,1
13654305,A Farewell to Arms,1932,['United States of America'],"['Film adaptation', 'Black-and-white', 'Romantic drama', 'Romance Film', 'War film', 'Pre-Code', 'Drama']",1930,2
19461735,Day of the Outlaw,1959,['United States of America'],"['Action/Adventure', 'Western', 'Thriller', 'Film noir', 'Drama']",1950,9
10105635,This Is Not a Test,2008,['United States of America'],"['Parody', 'Comedy']",2000,8
9013167,The Golden Blaze,2005,['United States of America'],"['Animation', 'Family Film', 'Fantasy']",2000,5
3565461,Mars Attacks!,1996,['United States of America'],"['Action', 'Comedy', 'Thriller', 'Ensemble Film', 'Parody', 'Alien Film', 'Science Fiction', 'Fantasy']",1990,6
7277117,Napoli violenta,1976,"['France', 'Italy']","['Action', 'Crime Fiction']",1970,6
28831771,Mind the Gap,2007,['Sweden'],"['Drama', 'Comedy']",2000,7
3813940,Kiss the Blood Off My Hands,1948,['United States of America'],"['Black-and-white', 'Crime Fiction', 'Film noir', 'Crime Drama', 'Drama']",1940,8
20520727,Half Empty Saddles,1958,['United States of America'],"['Animation', 'Short Film', 'Western', 'Comedy film', 'Family Film']",1950,8
30011044,Say One for Me,1959,['United States of America'],"['Musical', 'Comedy', 'Musical comedy', 'Romance Film']",1950,9
2487720,Rain,2001,"['New Zealand', 'Australia']","['Period piece', 'Film adaptation', 'World cinema', 'Romance Film', 'Drama']",2000,1
8832396,Slap Shot 2: Breaking the Ice,2002,['United States of America'],"['Sports', 'Comedy']",2000,2
9776999,Breakfast on Pluto,2005,"['Ireland', 'United Kingdom']","['LGBT', 'Indie', 'Comedy', 'World cinema', 'Tragicomedy', 'Drama', 'Period piece', 'Comedy-drama', 'Political drama']",2000,5
15083754,Aag Ka Gola,1990,['India'],['Action'],1990,0
8700683,The X Files 2,2008,"['Canada', 'United States of America']","['Mystery', 'Thriller', 'Science Fiction', 'Drama']",2000,8
19671715,Heart of Midnight,1988,['United States of America'],"['Psychological thriller', 'Thriller', 'Horror']",1980,8
18231553,Rajadhi Raja,2009,['India'],['Action'],2000,9
26823691,Meleparambil Aanveedu,1993,['India'],"['Musical', 'Romantic comedy', 'Comedy']",1990,3
26879903,Weekend Pass,1988,['United States of America'],['Comedy'],1980,8
17594419,Green Dolphin Street,1947,['United States of America'],"['Black-and-white', 'Romance Film', 'Adventure', 'Drama', 'Period piece', 'Melodrama', 'Epic', 'Historical Epic']",1940,7
3769721,Diary of a Madman,1963,['United States of America'],['Horror'],1960,3
6138703,Blueberry,2004,"['United Kingdom', 'France', 'Mexico']","['Action', 'Western', 'Thriller']",2000,4
2883942,Cheats,2002,['United States of America'],"['Comedy', 'Teen']",2000,2
30502744,Swaroopam,1992,[],['Drama'],1990,2
8752596,Dead Clever,2007,['United Kingdom'],"['Black comedy', 'Drama', 'Thriller']",2000,7
2058406,Up the Creek,1984,['United States of America'],"['Action', 'Indie', 'Action/Adventure', 'Comedy', 'Adventure']",1980,4
26640605,The Racers,1955,['United States of America'],['Drama'],1950,5
457578,Pandora's Box,1929,"['Weimar Republic', 'Germany']","['Black-and-white', 'Crime Fiction', 'Art film', 'Indie', 'Romantic drama', 'World cinema', 'Romance Film', 'Drama', 'Silent film']",1920,9
12634263,Ballet Shoes,2007,['United Kingdom'],"['Period piece', 'Film adaptation', 'Dance', 'Television movie', 'Drama', 'Family Film']",2000,7
29531230,Swing Your Lady,1938,['United States of America'],"['Music', 'Comedy film', 'Romance Film', 'Sports']",1930,8
6795100,Uyirodu Uyiraga,1998,['India'],"['Drama', 'World cinema']",1990,8
161452,Bad Day at Black Rock,1955,['United States of America'],"['Psychological thriller', 'Mystery', 'Action/Adventure', 'Thriller', 'Film noir', 'Drama', 'Suspense', 'Western']",1950,5
7199437,The Penalty,1920,['United States of America'],"['Black-and-white', 'Indie', 'Horror', 'Silent film', 'Drama']",1920,0
12138219,100 Feet,2008,['United States of America'],"['Supernatural', 'Thriller', 'Horror']",2000,8
12258868,Words in Blue,2004,['France'],"['Period piece', 'Romantic drama', 'Drama']",2000,4
18983118,Good-Time Girl,1948,['United Kingdom'],"['Film adaptation', 'Drama']",1940,8
16262270,Shaurya,2008,['India'],"['Musical', 'Thriller', 'Bollywood', 'World cinema']",2000,8
4388524,Romance on Lushan Mountain,1980,['China'],['Romance Film'],1980,0
9403464,Who Am I This Time?,1982,['United States of America'],"['History', 'Romantic drama', 'Biography', 'Romance Film', 'Television movie', 'Drama']",1980,2
17666428,Flodder,1986,['Netherlands'],['Comedy'],1980,6
846329,Late Spring,1949,['Japan'],"['Black-and-white', 'Art film', 'Japanese Movies', 'Family Drama', 'World cinema', 'Drama']",1940,9
9564605,Jai Santoshi Maa,1975,['India'],"['Musical', 'Bollywood', 'World cinema', 'Drama']",1970,5
10394418,Secrets of a Secretary,1931,['United States of America'],"['Black-and-white', 'Drama']",1930,1
2980052,Pilot no. 5,1943,['United States of America'],"['Action', 'Black-and-white', 'War film', 'Adventure']",1940,3
27658356,Come Dance with Me!,1959,"['France', 'Italy']","['Crime Fiction', 'Mystery', 'Drama']",1950,9
11668064,Modigliani,2004,"['Italy', 'United Kingdom', 'France', 'Germany', 'Romania', 'United States of America']","['Period piece', 'Drama', 'Indie', 'Biography', 'Romantic drama', 'Biographical film', 'Romance Film']",2000,4
23497557,Blessed,2009,"['New Zealand', 'Australia']","['Indie', 'Drama', 'World cinema']",2000,9
6551671,The Killer Shrews,1959,['United States of America'],"['Black-and-white', 'Monster', 'Horror', 'Science Fiction', 'Natural horror films']",1950,9
61527,In Old Chicago,1938,['United States of America'],"['Period piece', 'Black-and-white', 'Action/Adventure', 'Disaster', 'Drama']",1930,8
28270857,A Broken Sole,2007,['United States of America'],"['Indie', 'Short Film', 'Drama', 'Ensemble Film']",2000,7
2940538,Mr. Topaze,1961,['United Kingdom'],"['Drama', 'Comedy']",1960,1
32730892,Land of Doom,1986,['United States of America'],"['Science Fiction', 'Adventure']",1980,6
16247804,Oliver Twist,1982,"['United Kingdom', 'United States of America']","['Drama', 'Crime Fiction']",1980,2
594422,Moulin Rouge,1952,['United Kingdom'],"['Period piece', 'Biography', 'Biographical film', 'Drama']",1950,2
21145334,Bugged by a Bee,1969,['United States of America'],"['Animation', 'Short Film', 'Comedy']",1960,9
29785,The Rock,1996,['United States of America'],"['Action', 'Action Thrillers', 'Buddy film', 'Thriller']",1990,6
19070310,When Love Begins,2008,['Philippines'],"['Filipino Movies', 'Romantic drama', 'World cinema', 'Romance Film', 'Drama']",2000,8
26681233,Novel,2008,['India'],"['Musical', 'Romantic drama', 'Bollywood', 'World cinema', 'Romance Film', 'Drama']",2000,8
32655915,Desert Flower,2009,"['Austria', 'United Kingdom', 'France', 'Germany', 'England']","['Film adaptation', 'Drama', 'Indie', 'Biography', 'Biographical film', 'World cinema', 'Political drama']",2000,9
21883163,Sleeping with Strangers,1994,['Canada'],"['Indie', 'Comedy']",1990,4
14911735,Two If by Sea,1996,['United States of America'],"['Crime Fiction', 'Comedy', 'Crime Comedy', 'Romantic comedy', 'Romance Film']",1990,6
9328915,Thrill Seekers,1999,['United States of America'],"['Action/Adventure', 'Science Fiction', 'Television movie', 'Disaster']",1990,9
1399289,Are We There Yet,2005,"['Canada', 'United States of America']","['Comedy', 'Adventure', 'Romance Film', ""Children's"", 'Drama', 'Family Film']",2000,5
759820,Debt of Honour,1936,['United Kingdom'],['Drama'],1930,6
26583284,Las verdes praderas,1979,['Spain'],"['Drama', 'Comedy film']",1970,9
2730554,Kopps,2003,"['Sweden', 'Denmark']",['Comedy'],2000,3
13031234,I Want You,1998,['United Kingdom'],"['Musical', 'Crime Fiction', 'Romance Film', 'Drama']",1990,8
5434141,Footrot Flats: The Dog's Tale,1986,['New Zealand'],['Animation'],1980,6
10395300,Skylark,1941,['United States of America'],"['Comedy', 'Black-and-white']",1940,1
13934837,Caballos Salvajes,1995,['Argentina'],"['Crime Fiction', 'Chase Movie', 'Action/Adventure', 'World cinema', 'Adventure', 'Drama']",1990,5
7487552,Harry in Your Pocket,1973,['United States of America'],"['Crime Fiction', 'Comedy', 'Crime Drama', 'Drama']",1970,3
4485641,Police Academy 4: Citizens on Patrol,1987,['United States of America'],"['Action', 'Crime Fiction', 'Action/Adventure', 'Comedy', 'Slapstick']",1980,7
11191665,My Favorite Season,1993,['France'],"['Family Drama', 'Drama', 'World cinema']",1990,3
11604017,Chained,1934,['United States of America'],"['Black-and-white', 'Romantic drama', 'Romance Film', 'Melodrama', 'Drama']",1930,4
35991931,The Girl Rush,1955,['United States of America'],"['Musical', 'Comedy film']",1950,5
22516815,Colt .45,1950,['United States of America'],"['Action', 'Crime Fiction', 'Action/Adventure', 'Western', 'Adventure']",1950,0
1982322,H.G. Wells' War of the Worlds,2005,['United States of America'],"['Action', 'Film adaptation', 'Drama', 'Indie', 'Thriller', 'Alien Film', 'Science Fiction']",2000,5
17680842,Tsubasa Chronicle the Movie: The Princess of the Country of Birdcages,2005,['Japan'],"['Animation', 'Thriller', 'World cinema', 'Drama', 'Japanese Movies', 'Short Film', 'Anime', 'Supernatural', 'Fantasy']",2000,5
31553889,Wise Girl,1937,['United States of America'],['Comedy'],1930,7
19062975,Harry and Walter Go to New York,1976,['United States of America'],"['Action', 'Screwball comedy', 'Action/Adventure', 'Comedy']",1970,6
7739639,Swordsman,1990,"['Hong Kong', 'Taiwan']","['Action', 'Time travel', 'World cinema', 'Wuxia', 'Chinese Movies', 'Martial Arts Film']",1990,0
29782,The Big Lebowski,1998,"['United Kingdom', 'United States of America']","['Crime Fiction', 'Screwball comedy', 'Indie', 'Stoner film', 'Buddy film', 'Comedy', 'Crime Comedy', 'Cult']",1990,8
19112931,They Have Changed Their Face,1971,['Italy'],['Horror'],1970,1
2411122,Vaada,2005,['India'],"['Romantic drama', 'Thriller', 'World cinema', 'Romance Film', 'Drama']",2000,5
23901126,The Miracle Worker,2000,['United States of America'],"['Film adaptation', 'Biography', 'Drama']",2000,0
4795395,White Room,1990,['Canada'],['Drama'],1990,0
25602422,The Curse of King Tut's Tomb,1980,"['United Kingdom', 'United States of America']","['Mystery', 'Thriller', 'Horror', 'Adventure']",1980,0
13547354,Ninna Nedu Repu,2008,['India'],['Romance Film'],2000,8
6241436,Picture Perfect,1997,['United States of America'],"['Romance Film', 'Romantic comedy', 'Comedy']",1990,7
9537896,Payback,1995,['United States of America'],"['Indie', 'Thriller']",1990,5
6823089,King's game,2004,"['Sweden', 'Denmark']","['Drama', 'Thriller', 'World cinema']",2000,4
8175453,Sharpe's Rifles,1993,['United Kingdom'],"['Action', 'Historical drama', 'Adventure']",1990,3
399402,Cinderella,1950,['United States of America'],"['Musical', 'Animation', 'Romance Film', 'Family Film', 'Fantasy']",1950,0
1373224,La Brassiere,2001,['Hong Kong'],"['Romantic drama', 'Comedy', 'World cinema', 'Romance Film', 'Romantic comedy', 'Chinese Movies', 'Drama']",2000,1
27818228,Lewd Priest: Playful Writing on a Woman's Body,2007,['Japan'],['Japanese Movies'],2000,7
25432586,The Casino Job,2009,['United States of America'],"['Action', 'Indie', 'Thriller', 'Crime Thriller']",2000,9
12247642,Gekijōban Pocket Monsters Diamond & Pearl 2008,2008,"['United Kingdom', 'Japan', 'United States of America']",['Japanese Movies'],2000,8
26774022,Little 'Tinker,1948,['United States of America'],"['Animation', 'Short Film', 'Comedy', 'Family Film']",1940,8
24646997,Copper Angel,1984,['Soviet Union'],['Action'],1980,4
11056435,Doctor Benny,2003,['United States of America'],['Comedy'],2000,3
98991,Dogma,1999,['United States of America'],"['Indie', 'Satire', 'Comedy', 'Adventure', 'Parody', 'Religious Film', 'Road movie', 'Cult', 'Fantasy']",1990,9
8470728,Adolescencia,1942,['Argentina'],['Black-and-white'],1940,2
30880828,Alchemy,2005,[],"['Romance Film', 'Comedy film']",2000,5
4767370,José Rizal,1998,['Philippines'],"['Filipino Movies', 'Biopic [feature]', 'World cinema', 'Historical fiction', 'War film', 'Drama']",1990,8
25405727,The Wager,2007,['United States of America'],"['Film adaptation', 'Christian film', 'Drama']",2000,7
32507626,Where Is Fred?,2006,['Germany'],"['Romance Film', 'Sports', 'Comedy film']",2000,6
1334144,Shakespeare Wallah,1965,['India'],"['Period piece', 'Romantic drama', 'World cinema', 'Romance Film', 'Drama']",1960,5
2853200,Thalapathi,1991,['India'],"['Action', 'Drama', 'Gangster Film', 'Thriller', 'Bollywood']",1990,1
2177662,The Secret War of Harry Frigg,1968,['United States of America'],"['War film', 'Comedy']",1960,8
651538,Dracula,1958,['United Kingdom'],"['Thriller', 'Horror']",1950,8
30629482,Mafia Raaj,1998,[],['Action'],1990,8
3100181,The Big Journey,2004,"['Morocco', 'France']","['Coming of age', 'Drama', 'World cinema']",2000,4
2615418,Red Dust,1932,['United States of America'],"['Black-and-white', 'Pre-Code', 'Drama']",1930,2
2560779,Batman: Dead End,2003,['United States of America'],"['Fan film', 'Indie', 'Short Film']",2000,3
6123488,El Aura,2005,"['Argentina', 'Spain', 'France']","['Drama', 'Crime Fiction', 'Indie', 'Action/Adventure', 'Thriller', 'World cinema']",2000,5
5326648,An Everlasting Piece,2000,['United States of America'],['Comedy'],2000,0
19111921,Curtains,1995,['Canada'],['Short Film'],1990,5
4664724,My Reputation,1946,['United States of America'],"['Film adaptation', 'Romance Film', 'War film', 'Drama']",1940,6
1164579,Kiss the Girls,1997,['United States of America'],"['Psychological thriller', 'Mystery', 'Thriller', 'Crime Thriller', 'Drama']",1990,7
24243299,Brian's Song,2001,['United States of America'],"['Period piece', 'Biography', 'Sports', 'Drama']",2000,1
27306875,The Escape Artist,1982,['United States of America'],"['Film adaptation', 'Detective fiction', 'Crime Fiction', 'Mystery', 'Thriller', 'Crime Thriller', 'Drama', 'Detective']",1980,2
10703779,Jhuk Gaya Aasman,1968,['India'],"['Action', 'Crime Fiction', 'Drama']",1960,8
11129337,Two Lost Worlds,1950,['United States of America'],"['Action', 'Action/Adventure', 'Adventure', 'Science Fiction', 'Fantasy']",1950,0
1296863,Mouse Menace,1946,[],"['Animation', 'Short Film', 'Comedy', 'Family Film']",1940,6
17163571,The Mystery of Mr. Wong,1939,['United States of America'],"['Film adaptation', 'Detective fiction', 'Black-and-white', 'Mystery', 'Thriller', 'Crime Thriller', 'Drama', 'Detective']",1930,9
12603681,Once Upon a Honeymoon,1942,['United States of America'],"['Romance Film', 'Black-and-white']",1940,2
26524247,Keralotsavam 2009,2009,[],['Drama'],2000,9
6899858,The Banquet,2006,['China'],"['Crime Fiction', 'Action/Adventure', 'World cinema', 'Wuxia', 'Chinese Movies', 'Drama']",2000,6
3649554,Public Access,1993,['United States of America'],"['Psychological thriller', 'Indie', 'Thriller', 'Media Satire']",1990,3
9731588,Jeanne Eagels,1957,['United States of America'],"['Drama', 'Biographical film', 'Biopic [feature]']",1950,7
2728247,House of 9,2005,"['United Kingdom', 'France', 'Germany', 'Romania']","['Psychological thriller', 'Suspense', 'Thriller', 'Horror', 'Crime Thriller']",2000,5
19958360,Mirrors,2008,"['Germany', 'United States of America', 'Romania']","['Mystery', 'Thriller', 'Horror']",2000,8
1770836,Haven,2004,"['Spain', 'United Kingdom', 'Germany', 'United States of America']","['Action', 'Crime Fiction', 'Romantic drama', 'Action/Adventure', 'Thriller', 'Romance Film', 'Crime Thriller', 'Drama']",2000,4
4098741,Salt and Pepper,1968,['United Kingdom'],"['Action', 'Spy', 'Crime Fiction', 'Mystery', 'Action/Adventure', 'Buddy film', 'Thriller', 'Comedy', 'Slapstick']",1960,8
18616886,Stolen Women: Captured Hearts,1997,['United States of America'],"['Romance Film', 'Western', 'Drama']",1990,7
14739538,The Tooth Will Out,1951,['United States of America'],"['Short Film', 'Black-and-white', 'Comedy']",1950,1
35107447,City of Fear,1959,[],['Film noir'],1950,9
4611613,Being Cyrus,2006,['India'],"['Psychological thriller', 'Mystery', 'Comedy', 'Thriller', 'World cinema', 'Black comedy', 'Crime Thriller', 'Drama']",2000,6
23081594,One Way,2006,['Germany'],"['Psychological thriller', 'Mystery', 'Indie', 'Thriller', 'World cinema', 'Crime Thriller']",2000,6
21565991,La Lingerie,2008,['Hong Kong'],"['Romantic drama', 'Comedy', 'World cinema', 'Romance Film', 'Chinese Movies', 'Drama', 'Romantic comedy', 'Ensemble Film']",2000,8
14285478,The Counterfeit Traitor,1962,['United States of America'],"['Spy', 'Thriller', 'War film', 'Drama']",1960,2
8142515,Samantha: An American Girl Holiday,2004,['United States of America'],"['Period piece', 'Coming of age', 'Family Drama', ""Children's/Family"", 'Holiday Film', 'Drama', 'Family Film']",2000,4
28124065,Against the Wind,1948,['United Kingdom'],"['Action', 'Drama', 'War film']",1940,8
2378040,The Rage In Placid Lake,2003,"['New Zealand', 'Australia']","['Indie', 'Comedy', 'Teen', 'World cinema', 'Romantic comedy']",2000,3
5356013,Mann,1999,['India'],"['Musical', 'Romantic drama', 'Bollywood', 'World cinema', 'Romance Film', 'Drama']",1990,9
1578168,The Dangerous Lives of Altar Boys,2002,['United States of America'],"['Period piece', 'Drama', 'Coming of age', 'Indie', 'Black comedy', 'Comedy-drama']",2000,2
9709480,The Long Walk Home,1989,['United States of America'],"['Period piece', 'Indie', 'Historical fiction', 'Political drama', 'Drama']",1980,9
1394579,Basic,2003,"['Germany', 'United States of America', 'Canada']","['Action', 'Psychological thriller', 'Detective fiction', 'Crime Fiction', 'Action/Adventure', 'Thriller', 'Crime Thriller', 'Drama', 'Detective']",2000,3
24818051,Hitman's Run,1999,['United States of America'],"['Action', 'Crime Fiction', 'Gangster Film', 'Action/Adventure', 'Crime Thriller']",1990,9
28844326,Sthalathe Pradhana Payyans,1993,[],"['Action', 'Crime Fiction', 'Thriller']",1990,3
1181828,The Heart Is Deceitful Above All Things,2004,"['Japan', 'United Kingdom', 'France', 'United States of America']","['Film adaptation', 'Japanese Movies', 'Indie', 'Childhood Drama', 'Drama']",2000,4
23955452,Dynamite Brothers,1974,['United States of America'],"['Action', 'Blaxploitation', 'Action/Adventure', 'Comedy', 'Martial Arts Film']",1970,4
2887831,The Day of the Roses,2001,['Australia'],"['Television movie', 'Drama', 'Documentary']",2000,1
14811847,Downloading Nancy,2008,['United States of America'],"['Psychological thriller', 'Crime Fiction', 'Erotic Drama', 'Indie', 'Thriller', 'Crime Thriller', 'Drama', 'Erotica']",2000,8
15020855,Lake Placid 2,2007,['United States of America'],"['Action', 'Action/Adventure', 'Thriller', 'Cult', 'Suspense', 'Natural horror films', 'Horror', 'Science Fiction']",2000,7
4340088,The Loves of Carmen,1948,['United States of America'],"['Romantic drama', 'Romance Film', 'Melodrama', 'Drama']",1940,8
3751105,Final Examination,2003,['United States of America'],"['Crime Fiction', 'Slasher', 'Thriller', 'Horror', 'Erotic thriller', 'Teen']",2000,3
26699606,Santhanagopalam,1994,['India'],[],1990,4
852742,Kama Sutra: A Tale of Love,1996,"['Japan', 'India', 'United Kingdom', 'Germany', 'United States of America']","['Crime Fiction', 'Erotic Drama', 'Romantic drama', 'World cinema', 'Romance Film', 'Drama', 'Period piece', 'History', 'Japanese Movies', 'Melodrama']",1990,6
10107470,The Beehive,1982,['Spain'],"['War film', 'Drama']",1980,2
682628,The Crimson Permanent Assurance,1983,['United Kingdom'],"['Indie', 'Short Film', 'Comedy']",1980,3
3883051,National Lampoon's Class Reunion,1982,['United States of America'],"['Gross out', 'Gross-out film', 'Indie', 'Satire', 'Comedy', 'Horror Comedy', 'Parody', 'Slasher']",1980,2
75266,Out of the Past,1947,['United States of America'],"['LGBT', 'Crime Fiction', 'Black-and-white', 'Mystery', 'Thriller', 'Film noir', 'Drama']",1940,7
1252685,Jimmy Hollywood,1994,['United States of America'],"['Parody', 'Satire', 'Comedy']",1990,4
3342195,Werckmeister Harmonies,2000,"['France', 'Germany', 'Hungary', 'Italy']","['Crime Fiction', 'Mystery', 'Thriller', 'Horror', 'World cinema', 'Political drama', 'Drama']",2000,0
10196366,I Cover the Waterfront,1933,['United States of America'],"['Black-and-white', 'Crime Fiction', 'Romantic drama', 'Romance Film', 'Crime Thriller', 'Drama']",1930,3
225476,The Way We Were,1973,['United States of America'],"['Musical', 'Period piece', 'Film adaptation', 'Romantic drama', 'Romance Film', 'Drama']",1970,3
5308985,How the Grinch Stole Christmas!,1966,[],"['Short Film', 'Christmas movie']",1960,6
18162734,The Culpepper Cattle Co.,1972,['United States of America'],['Western'],1970,2
23181204,Mayandi Kudumbathar,2009,[],"['Drama', 'Family Film']",2000,9
23691195,"Trigger, Jr.",1950,['United States of America'],"['Action/Adventure', 'Western']",1950,0
20833484,Arizona Sky,2008,['United States of America'],"['Romance Film', 'Drama']",2000,8
13613782,Sparrows,1926,['United States of America'],"['Silent film', 'Black-and-white', 'Drama']",1920,6
13775502,Cloistered Nun: Runa’s Confession,1976,['Japan'],"['Japanese Movies', 'World cinema', 'Pornographic movie', 'Pinku eiga', 'Romance Film', 'Erotica', 'Drama']",1970,6
3511253,Police Academy 3: Back in Training,1986,['United States of America'],"['Action', 'Crime Fiction', 'Action/Adventure', 'Comedy', 'Slapstick']",1980,6
23433774,Shadows,1922,['United States of America'],"['Silent film', 'Black-and-white', 'Drama']",1920,2
17441941,Plain Clothes,1988,['United States of America'],"['Mystery', 'Comedy', 'Thriller', 'Romance Film', 'Romantic comedy', 'Crime Thriller']",1980,8
24634802,Bettada Hoovu,1985,['India'],[],1980,5
27451148,Cracker Jack,1994,"['Canada', 'United States of America']","['Action', 'Heist', 'Action/Adventure', 'Thriller', 'Disaster']",1990,4
1468747,52 Pick-Up,1986,['United States of America'],"['Action', 'Film adaptation', 'Neo-noir', 'Crime Fiction', 'Action/Adventure', 'Thriller', 'Crime Thriller', 'Drama']",1980,6
19080730,"Farewell, Kamen Rider Den-O: Final Countdown",2008,['Japan'],"['Action', 'Japanese Movies', 'Fantasy']",2000,8
236283,Secretary,2002,['United States of America'],"['Indie', 'Comedy', 'Black comedy', 'Romance Film', 'Drama', 'Romantic comedy', 'Comedy-drama', 'Erotica', 'Sex comedy']",2000,2
602965,Sky Captain and the World of Tomorrow,2004,"['United Kingdom', 'Italy', 'United States of America']","['Action', 'Mystery', 'Action/Adventure', 'Thriller', 'Master Criminal Films', 'Adventure', 'Airplanes and airports', 'Period piece', 'Steampunk', 'Science Fiction']",2000,4
2194169,Teenage Mutant Ninja Turtles III,1993,"['Hong Kong', 'Japan', 'United States of America']","['Action', 'Superhero', 'Indie', 'Action/Adventure', 'Comedy', 'Chinese Movies', 'Martial Arts Film', 'Adventure', 'Japanese Movies', 'Action Comedy', 'Superhero movie', 'Family Film', 'Fantasy']",1990,3
12495553,Walk Like a Man,1987,"['United Kingdom', 'United States of America']","['Parody', 'Comedy', 'Thriller', 'Slapstick']",1980,7
15703732,The Scarlet Pimpernel,1982,['United Kingdom'],"['Romantic drama', 'Action/Adventure', 'Romance Film', 'Costume drama', 'Drama', 'Adventure', 'Swashbuckler films', 'Television movie']",1980,2
30863646,Mondo Cane,1962,['Italy'],"['Mondo film', 'Horror', 'World cinema', 'Documentary', 'Culture & Society']",1960,2
16192018,A Crime,2006,"['United States of America', 'France']","['Psychological thriller', 'Mystery', 'Thriller', 'World cinema', 'Crime Thriller', 'Drama']",2000,6
3707927,Hey Babe!,1980,['Canada'],"['Musical', 'Drama']",1980,0
19760679,Death Racers,2008,['United States of America'],"['Action', 'Indie', 'Action/Adventure', 'Comedy', 'Thriller', 'Auto racing', 'Sports', 'Horror']",2000,8
5845807,Taking Care of Business,1990,['United States of America'],['Comedy'],1990,0
2541685,Red Rock West,1993,['United States of America'],"['Suspense', 'Neo-noir', 'Crime Fiction', 'Mystery', 'Indie', 'Thriller', 'Crime Thriller']",1990,3
1121941,Martian Through Georgia,1962,['United States of America'],"['Animation', 'Short Film', 'Comedy', 'Romance Film', 'Science Fiction', 'Family Film']",1960,2
16881575,The Reality of the Virtual,2004,['United Kingdom'],['Documentary'],2000,4
26196717,Oh Shucks! Here Comes UNTAG,1993,['South Africa'],['Comedy'],1990,3
8982899,"Take Her, She's Mine",1963,['United States of America'],"['Domestic Comedy', 'Comedy']",1960,3
18689836,Thalappavu,2008,['India'],"['Musical', 'Bollywood', 'World cinema', 'Drama']",2000,8
13698770,Hello-Goodbye,1970,['United Kingdom'],['Comedy'],1970,0
7404698,The Bucket List,2007,['United States of America'],"['Buddy film', 'Comedy', 'Comedy-drama', 'Road movie', 'Adventure', 'Drama']",2000,7
31332767,Odongo,1956,['United Kingdom'],"['Adventure', 'Drama']",1950,6
25940830,Mayuri,1984,['India'],"['Musical', 'Family Film']",1980,4
1104981,Marie Antoinette,1938,['United States of America'],"['Black-and-white', 'Biographical film', 'Drama']",1930,8
13780382,Borderland,2007,"['Mexico', 'United States of America']","['Crime Fiction', 'Slasher', 'Horror']",2000,7
261402,Robin Hood: Prince of Thieves,1991,['United States of America'],"['Costume Adventure', 'Romantic drama', 'Action/Adventure', 'Romance Film', 'Costume drama', 'Adventure', 'Drama', 'Swashbuckler films', 'Period piece']",1990,1
27038962,The Christmas Raccoons,1980,['Canada'],['Short Film'],1980,0
3918828,Jane Austen's Mafia!,1998,['United States of America'],"['Parody', 'Comedy']",1990,8
4333908,The Foul King,2000,['South Korea'],"['Comedy', 'Comedy of manners', 'World cinema', 'Comedy-drama', 'Sports', 'Slapstick']",2000,0
468353,Thirteen,2003,['United States of America'],"['LGBT', 'Drama', 'Coming of age', 'Indie', 'Biographical film', 'Teen']",2000,3
31716374,Lost Flight,1969,['United States of America'],"['Action', 'Drama']",1960,9
25008319,Death of a Ghost Hunter,2007,['United States of America'],"['Mystery', 'Thriller', 'Horror', 'Crime Thriller', 'Supernatural']",2000,7
2239595,Ben and Me,1953,['United States of America'],['Short Film'],1950,3
2894585,Dead Birds,2005,['United States of America'],['Horror'],2000,5
5850874,Tiara Tahiti,1962,['United Kingdom'],"['Drama', 'Indie', 'Comedy', 'Romance Film']",1960,2
8108970,The Uchoten Hotel,2006,['Japan'],"['Comedy', 'Japanese Movies']",2000,6
10159386,Arth,1982,['India'],"['Bollywood', 'Art film']",1980,2
4593958,The Maltese Falcon,1941,['United States of America'],"['Film adaptation', 'Detective fiction', 'Black-and-white', 'LGBT', 'Crime Fiction', 'Mystery', 'Thriller', 'Film noir', 'Crime Thriller', 'Drama', 'Detective']",1940,1
20433007,A Man Who Was Superman,2008,['South Korea'],"['Drama', 'Comedy']",2000,8
24724348,Lots of Luck,1985,['United States of America'],"['Comedy', 'Family Film']",1980,5
24689511,Ash Wednesday,1973,['United States of America'],['Drama'],1970,3
587507,Best in Show,2000,['United States of America'],"['LGBT', 'Indie', 'Comedy', 'Mockumentary', 'Parody', 'Sports', 'Comedy of manners', 'Cult', 'Ensemble Film']",2000,0
15718938,Aegan,2008,['India'],['Action'],2000,8
2885102,Save the Green Planet!,2003,['South Korea'],"['Satire', 'Thriller', 'Comedy', 'World cinema', 'Black comedy', 'Drama', 'Horror', 'Science Fiction']",2000,3
6339198,Hot Boyz,2000,['United States of America'],"['Action', 'Drama', 'Crime Fiction', 'Indie', 'Action/Adventure', 'Thriller', 'Crime Thriller']",2000,0
12273809,Anuradha,1960,['India'],"['Musical', 'Black-and-white', 'Romantic drama', 'Bollywood', 'World cinema', 'Romance Film', 'Drama']",1960,0
23412761,Mountain Strawberries,1982,['South Korea'],['Erotica'],1980,2
537024,Eternal Sunshine of the Spotless Mind,2004,['United States of America'],"['Romantic fantasy', 'Romance Film', 'Romantic comedy', 'Comedy-drama', 'Science Fiction', 'Drama']",2000,4
782794,Enchanted April,1992,"['United Kingdom', 'England']","['Period piece', 'Film adaptation', 'Romantic drama', 'Romance Film', 'Drama']",1990,2
13840353,Pastor Hall,1940,['United Kingdom'],"['War film', 'Drama']",1940,0
17231014,Long Walk to Forever,1987,['United States of America'],"['Short Film', 'Drama']",1980,7
7185773,Happy End,1999,['South Korea'],"['Crime Fiction', 'Romantic drama', 'World cinema', 'Romance Film', 'Drama']",1990,9
3578986,Second Chorus,1940,['United States of America'],"['Musical', 'Black-and-white', 'Comedy', 'Musical comedy', 'Romance Film', 'Romantic comedy']",1940,0
24236900,Advantage Hart,2003,['United States of America'],"['Short Film', 'Comedy film']",2000,3
22785689,Apache Territory,1958,['United States of America'],"['Action', 'Romance Film', 'Western']",1950,8
11745640,Auto Shankar,2005,['India'],"['Action', 'Romance Film']",2000,5
2061941,Serpent of the Nile,1953,['United States of America'],"['Historical fiction', 'Drama']",1950,3
604444,Koi... Mil Gaya,2003,['India'],"['Musical', 'Romantic drama', 'World cinema', 'Romance Film', 'Science Fiction', 'Drama', 'Fantasy']",2000,3
6039804,Hold Everything,1930,['United States of America'],"['Musical', 'Pre-Code', 'Comedy']",1930,0
11527681,ELI,2007,['United States of America'],"['Short Film', 'Science Fiction', 'Thriller']",2000,7
1645634,The Big Sleep,1978,['United Kingdom'],"['Crime Fiction', 'Gangster Film', 'Mystery', 'Thriller', 'Crime Thriller', 'Drama']",1970,8
10090909,Time Limit,1957,['United States of America'],"['Film adaptation', 'Mystery', 'War film', 'Drama', 'Courtroom Drama']",1950,7
17384479,Ransom,1975,['United Kingdom'],"['Action', 'Action/Adventure', 'Thriller']",1970,5
12836428,Marrying the Mafia,2002,['South Korea'],"['Gangster Film', 'Comedy', 'World cinema']",2000,2
5501180,Going Berserk,1983,"['Canada', 'United States of America']","['Parody', 'Satire', 'Comedy']",1980,3
2847356,9th Company,2005,"['Russia', 'Finland', 'Ukraine']","['War film', 'Drama', 'World cinema']",2000,5
573304,The Wedding Banquet,1993,"['Taiwan', 'United States of America']","['LGBT', 'Romantic drama', 'Comedy', 'World cinema', 'Romance Film', 'Drama', 'Comedy of Errors', 'Gay Themed', 'Gay', 'Gay Interest', 'Romantic comedy', 'Comedy-drama']",1990,3
204839,Lost Highway,1997,"['United States of America', 'France']","['Surrealism', 'Psychological thriller', 'Neo-noir', 'Mystery', 'Indie', 'Thriller', 'Crime Thriller', 'Drama', 'Horror']",1990,7
6180965,Slayers Great,1997,[],"['Anime', 'Comedy', 'Adventure']",1990,7
2236330,Doctor Detroit,1983,['United States of America'],"['Indie', 'Parody', 'Comedy', 'Sex comedy']",1980,3
3389965,Invasion of the Neptune Men,1961,['Japan'],"['Japanese Movies', 'Action/Adventure', 'Science Fiction', 'World cinema', 'Superhero movie', 'Martial Arts Film']",1960,1
9260315,Message from Space,1978,['Japan'],"['Action', 'Japanese Movies', 'World cinema', 'Adventure', 'Science Fiction']",1970,8
26553351,Purple Heart Diary,1951,['United States of America'],['Drama'],1950,1
27742629,Model for Murder,1959,[],['Crime Fiction'],1950,9
17883146,Training Pigeons,1936,['United States of America'],"['Animation', 'Short Film', 'Comedy', 'Family Film']",1930,6
17261204,The Ring Finger,2005,"['United Kingdom', 'France', 'Germany']","['Romantic drama', 'World cinema', 'Romance Film', 'Erotica', 'Drama']",2000,5
8586814,Syndicate Sadists,1976,['Italy'],"['Action', 'Crime Fiction', 'Action Thrillers', 'Action/Adventure', 'Thriller', 'World cinema', 'Crime Thriller']",1970,6
781219,Teaching Mrs. Tingle,1999,['United States of America'],"['Suspense', 'Comedy Thriller', 'Thriller', 'Teen', 'Comedy', 'Black comedy']",1990,9
5524740,Osmosis Jones,2001,['United States of America'],"['Action', 'Gross out', 'Gross-out film', 'Animation', 'Action/Adventure', 'Comedy', 'Adventure', 'Action Comedy', 'Family Film', 'Fantasy']",2000,1
24095018,"Texas, Brooklyn and Heaven",1948,['United States of America'],"['Black-and-white', 'Comedy Western', 'Comedy']",1940,8
26613800,Banaras,2009,['India'],['Musical'],2000,9
16072264,Chained Heat,1983,"['West Germany', 'United States of America']","['Crime Fiction', 'Sexploitation', 'Drama', 'Women in prison films']",1980,3
1421977,Shaft's Big Score,1972,['United States of America'],"['Action', 'Blaxploitation', 'Crime Fiction', 'Mystery', 'Action/Adventure', 'Detective']",1970,2
5206795,L'Enfer,2005,"['Japan', 'Belgium', 'France', 'Italy']",['Japanese Movies'],2000,5
2215047,The Thirteenth Year,1999,['United States of America'],"[""Children's/Family"", 'Coming of age', 'Comedy']",1990,9
10843767,Avenue Montaigne,2006,['France'],"['Comedy', 'World cinema', 'Romance Film', 'Drama']",2000,6
18791040,Martial Law,1991,['United States of America'],"['Action', 'Crime Fiction', 'Martial Arts Film']",1990,1
34342406,Good Little Girls,1971,['France'],"['Comedy', 'Erotica']",1970,1
5823562,"Slunce, seno, jahody",1984,"['Czechoslovakia', 'Czech Republic']",['Comedy'],1980,4
5414801,Gin-iro no Kami no Agito,2006,['Japan'],"['Animation', 'Japanese Movies', 'Romance Film', 'Anime', 'Science Fiction', 'Drama']",2000,6
10777380,"Hot, Cool, & Vicious",1980,['Taiwan'],"['Action', 'Action/Adventure', 'World cinema', 'Chinese Movies', 'Martial Arts Film']",1980,0
31039968,Hanna's War,1988,['United States of America'],"['Biography', 'War film', 'Drama']",1980,8
10208176,Khela,2008,['India'],"['Drama', 'Comedy']",2000,8
1882956,Moonlight Mile,2002,['United States of America'],"['Crime Fiction', 'Family Drama', 'Romantic drama', 'Romance Film', 'Drama', 'Courtroom Drama', 'Period piece', 'Coming of age']",2000,2
32842508,Park Avenue Logger,1937,['United States of America'],"['Action', 'Crime Fiction', 'Action/Adventure', 'Adventure']",1930,7
12317186,Hawayein,2003,['India'],"['Historical Epic', 'Drama']",2000,3
32817974,A Son Is Born,1946,[],['Drama'],1940,6
11992,Godzilla vs. the Sea Monster,1966,['Japan'],"['Monster', 'World cinema', 'Creature Film', 'Japanese Movies', 'Horror', 'Science Fiction', 'Cult', 'Fantasy']",1960,6
20593843,Major Saab,1998,['India'],['World cinema'],1990,8
20250608,Chaturanga,2008,['India'],"['Musical', 'Bollywood', 'World cinema', 'Drama']",2000,8
15400276,Hamlet 2,2008,['United States of America'],"['Musical', 'Indie', 'Parody', 'Comedy', 'Musical comedy']",2000,8
4299508,Friends with Money,2006,['United States of America'],"['Drama', 'Indie', 'Comedy', 'Comedy of manners', 'Romance Film', 'Comedy-drama', 'Ensemble Film']",2000,6
30503750,Angel Town,1990,['United States of America'],"['Action', 'Drama', 'Action/Adventure', 'Thriller', 'Martial Arts Film']",1990,0
709318,The Stepford Wives,2004,['United States of America'],"['Parody', 'Satire', 'Thriller', 'Comedy', 'Black comedy', 'Science Fiction']",2000,4
1425779,"Martha, Meet Frank, Daniel and Laurence",1998,['United Kingdom'],"['Indie', 'Comedy', 'Romance Film', 'Romantic comedy']",1990,8
25361239,Fatso,2008,['Norway'],"['Comedy', 'Drama', 'World cinema']",2000,8
1704120,Blastfighter,1984,"['France', 'Italy', 'United States of America']","['Action', 'Crime Fiction', 'Mystery', 'Thriller', 'Horror', 'Drama']",1980,4
8279517,Daughter of Don Q,1946,['United States of America'],"['Action', 'Black-and-white', 'Crime Fiction', 'Adventure']",1940,6
10215898,"Welcome, or No Trespassing",1964,['Soviet Union'],['Comedy'],1960,4
4131876,Soul Survivors,2001,['United States of America'],"['Psychological thriller', 'Thriller', 'Teen', 'Supernatural']",2000,1
26435363,La horde,2009,['France'],"['Creature Film', 'Action', 'Action/Adventure', 'Thriller', 'Horror', 'World cinema', 'Zombie Film']",2000,9
10826329,Living in a Big Way,1947,['United States of America'],"['Musical', 'Black-and-white', 'Comedy', 'Musical comedy', 'Romance Film']",1940,7
6703160,The Adventures of Quentin Durward,1955,['United States of America'],"['Action', 'Romance Film', 'Historical fiction', 'Costume drama', 'Adventure', 'Swashbuckler films']",1950,5
15418729,Business as Usual,1989,"['United Kingdom', 'United States of America']","['Indie', 'Drama']",1980,9
28198235,Joey Breaker,1993,[],['Romance Film'],1990,3
6802108,The Derby Stallion,2005,['United States of America'],"['Family Drama', ""Children's/Family"", 'Horse racing', 'Adventure', 'Drama', 'Coming of age', 'Sports', 'Family Film']",2000,5
13727909,Wraiths of Roanoke,2007,"['Bulgaria', 'United States of America']",['Horror'],2000,7
9790786,The Last Lear,2007,['India'],"['Art film', 'Drama', 'World cinema']",2000,7
16490829,Vallamai Tharayo,2008,['India'],['Drama'],2000,8
6257892,Bangkok Loco,2004,['Thailand'],"['Musical', 'Comedy', 'Fantasy Comedy']",2000,4
5176136,Conceiving Ada,1997,"['Germany', 'United States of America']","['Biography', 'Indie', 'Drama', 'Feminist Film', 'Time travel', 'Biopic [feature]', 'Epic', 'Science Fiction', 'Fantasy']",1990,7
2416538,The Perfect Husband: The Laci Peterson Story,2004,['United States of America'],"['Crime Fiction', 'Television movie', 'Docudrama', 'Drama']",2000,4
3377893,Alaska,1996,['United States of America'],"['Family Drama', 'Adventure', 'Drama', 'Family Film']",1990,6
7124067,Vampyres,1974,['United Kingdom'],"['Erotic thriller', 'Cult', 'Horror']",1970,4
6822250,The Seventh Coin,1993,"['Israel', 'United States of America']","['Action', 'Indie', 'Adventure']",1990,3
2711674,Show Boat,1936,['United States of America'],"['Musical', 'Black-and-white', 'Comedy', 'Romance Film', 'Drama']",1930,6
11623872,One Way Passage,1932,['United States of America'],"['Black-and-white', 'Romantic drama', 'Romance Film', 'Melodrama', 'Pre-Code', 'Drama']",1930,2
549949,Carnal Knowledge,1971,['United States of America'],"['Romantic drama', 'Comedy', 'Romance Film', 'Drama', 'Coming of age', 'New Hollywood', 'Comedy-drama', 'Comedy of manners', 'Sex comedy']",1970,1
5444283,The Bridge of San Luis Rey,1944,['United States of America'],"['Black-and-white', 'Action/Adventure', 'Disaster', 'Drama']",1940,4
10538405,Death Defying Acts,2008,"['United Kingdom', 'Australia']","['Period piece', 'Romantic drama', 'Romance Film', 'Docudrama', 'Drama']",2000,8
418598,Gentlemen Prefer Blondes,1953,['United States of America'],"['Musical', 'Comedy', 'Romance Film', 'Drama']",1950,3
10000053,The Trap,1966,"['Canada', 'United Kingdom']","['Indie', 'Romance Film', 'Adventure', 'Drama']",1960,6
9543858,First Snow,2006,"['Germany', 'United States of America']","['Psychological thriller', 'Suspense', 'Thriller']",2000,6
706047,Spirit: Stallion of the Cimarron,2002,['United States of America'],"['Animation', 'Animated Musical', 'Romance Film', ""Children's/Family"", ""Children's"", 'Adventure', ""Children's Fantasy"", 'Western', 'Family Film']",2000,2
9593620,Rabid Grannies,1988,"['France', 'Netherlands', 'Belgium']","['Comedy', 'Horror Comedy', 'Horror', 'B-movie']",1980,8
20983990,Volta,2004,['Philippines'],"['Filipino Movies', 'Action/Adventure', 'Comedy', 'World cinema', 'Fantasy']",2000,4
996094,Bullies,1986,['Canada'],"['Psychological thriller', 'Action', 'Action Thrillers', 'Action/Adventure', 'Thriller', 'Drama']",1980,6
573288,Babe: Pig in the City,1998,"['United Kingdom', 'Australia', 'United States of America']","['Comedy', 'World cinema', ""Children's/Family"", 'Adventure', 'Drama', ""Children's Fantasy"", 'Animal Picture', 'Family Film', 'Fantasy']",1990,8
17871536,L'Étudiante,1988,['France'],"['Romance Film', 'Romantic drama', 'Drama']",1980,8
5314234,Harrison Bergeron,1995,['Canada'],"['Science Fiction', 'Dystopia', 'Satire']",1990,5
6450779,Street Angel,1937,['China'],"['Black-and-white', 'Drama', 'Chinese Movies']",1930,7
8891889,Ogo Bodhu Shundori,1981,['India'],"['Family Film', 'Drama', 'Comedy film']",1980,1
2714697,The Witches Cave,1989,"['Soviet Union', 'Czechoslovakia']","['Adventure', 'Romance Film', 'Science Fiction', 'Fantasy']",1980,9
1229992,"All's Well, Ends Well Too",1993,['Hong Kong'],"['Chinese Movies', 'Comedy']",1990,3
17020838,Three Weeks,1924,['United States of America'],"['Silent film', 'Black-and-white', 'Drama']",1920,4
33396282,Quickie Express,2007,[],['Comedy film'],2000,7
9225834,Bosque de Sombras,2007,"['United Kingdom', 'France', 'Spain']","['Suspense', 'Thriller', 'Crime Thriller', 'Drama']",2000,7
18770600,The Forty-first,1956,"['Russia', 'Soviet Union']","['Romantic drama', 'World cinema', 'Romance Film', 'War film', 'Drama']",1950,6
29755185,The Daffy Doc,1938,[],"['Animation', 'Short Film', 'Family Film']",1930,8
16156731,Street of Shame,1956,['Japan'],"['Black-and-white', 'Art film', 'Japanese Movies', 'World cinema', 'Melodrama', 'Drama', 'Ensemble Film']",1950,6
33508761,Baghaawat - Ek Jung,2001,[],['Action'],2000,1
3694061,Carry On Teacher,1959,['United Kingdom'],"['Parody', 'Comedy']",1950,9
26389395,The Sins of Rachel Cade,1961,['United States of America'],"['Romance Film', 'Drama']",1960,1
28090980,Act of Piracy,1990,"['United States of America', 'South Africa']",['Thriller'],1990,0
3710372,Yi Yi: A One and a Two,2000,"['Taiwan', 'China', 'Japan']","['Music', 'Japanese Movies', 'World cinema', 'Romance Film', 'Chinese Movies', 'Drama']",2000,0
27713939,Macho Callahan,1970,"['Mexico', 'United States of America']","['Crime Fiction', 'Revisionist Western', 'Western']",1970,0
4836239,The Sound of Music,1965,['United States of America'],"['Musical', 'Musical Drama', 'Biographical film', 'Romance Film', ""Children's/Family"", 'Roadshow theatrical release', 'Drama', 'Family Film']",1960,5
28301986,Dig That Uranium,1956,['United States of America'],['Comedy film'],1950,6
29540683,Commando,1988,['India'],"['Romantic drama', 'Action/Adventure', 'World cinema', 'Romance Film', 'Drama']",1980,8
3021038,The Big Fix,1978,['United States of America'],"['Mystery', 'Comedy', 'Thriller', 'Crime Thriller']",1970,8
24459970,The Bandolero,1924,[],['Silent film'],1920,4
3402751,Maniac,1934,['United States of America'],"['Exploitation', 'Black-and-white', 'Roadshow/Carny', 'Horror', 'Cult']",1930,4
9833145,The Great Man,1956,['United States of America'],"['Black-and-white', 'Drama']",1950,6
3475071,The Program,1993,['United States of America'],"['Action', 'Sports', 'Drama']",1990,3
21589402,Jai Veeru,2009,['India'],"['Musical', 'Bollywood', 'World cinema', 'Drama']",2000,9
173941,The Lord of the Rings: The Fellowship of the Ring,2001,"['New Zealand', 'United States of America']","['Action', 'Fantasy Adventure', 'Film adaptation', 'Adventure', 'Drama', 'Sword and sorcery films', 'Epic', 'Fantasy']",2000,1
24034237,"Devil Face, Angel Heart",2002,['Hong Kong'],"['Action', 'Crime Fiction', 'Thriller', 'Chinese Movies']",2000,2
10072963,Scouts to the Rescue,1939,['United States of America'],"['Action', 'Black-and-white', 'Adventure', ""Children's""]",1930,9
1643555,Saint Joan,1957,"['United Kingdom', 'United States of America']","['Biopic [feature]', 'Christian film', 'Historical fiction', 'War film', 'Drama']",1950,7
451109,Delicatessen,1991,['France'],"['Surrealism', 'Comedy', 'World cinema', 'Black comedy', 'Fantasy Comedy', 'Absurdism']",1990,1
17881324,Box Elder,2008,['United States of America'],"['Indie', 'Comedy']",2000,8
8100298,A Battle of Wits,2006,"['Hong Kong', 'South Korea', 'China', 'Japan']","['Action', 'Action/Adventure', 'World cinema', 'Chinese Movies', 'Drama', 'Japanese Movies', 'Wuxia', 'War film']",2000,6
18449476,The Shape of Things,2003,['United States of America'],"['Romantic drama', 'Indie', 'Comedy', 'Romance Film', 'Drama']",2000,3
2541839,Sea of Love,1989,['United States of America'],"['Psychological thriller', 'Crime Fiction', 'Mystery', 'Thriller', 'Crime Thriller', 'Drama', 'Suspense', 'Detective', 'Erotic thriller']",1980,9
26926995,Paramanandayya Shishyula Katha,1966,['India'],"['Musical', 'Drama']",1960,6
24147327,September Affair,1950,['United States of America'],"['Romance Film', 'Romantic drama', 'Drama']",1950,0
18775322,Queens of Langkasuka,2008,['Thailand'],"['Fantasy Adventure', 'Action/Adventure', 'World cinema', 'Wuxia', 'Martial Arts Film', 'Adventure', 'Fantasy']",2000,8
19405442,Christmas in Love,2004,['Italy'],"['Holiday Film', 'Comedy', 'Ensemble Film']",2000,4
77639,The Pride of the Yankees,1942,['United States of America'],"['Sports', 'Black-and-white', 'Biography', 'Biographical film', 'Biopic [feature]', 'Drama']",1940,2
92999,Wag the Dog,1997,['United States of America'],"['Political cinema', 'Political satire', 'Parody', 'Comedy', 'Media Satire', 'Political drama', 'Drama']",1990,7
21672242,Merlin and the War of the Dragons,2008,['United States of America'],"['Fantasy Adventure', 'Mythological Fantasy', 'Indie', 'Adventure', 'Fantasy']",2000,8
25458033,Joyride,1977,['United States of America'],"['Action', 'Crime Fiction', 'Action/Adventure', 'Comedy', 'Thriller', 'Adventure']",1970,7
10638528,Dhund,1973,['India'],"['Thriller', 'World cinema']",1970,3
8756666,Arabian Nights,1942,['United States of America'],"['Action', 'Romantic drama', 'Action/Adventure', 'Romance Film', 'Costume drama', 'Adventure', 'Drama', 'Epic', 'Fantasy']",1940,2
28343867,Rynox,1932,['United Kingdom'],"['Drama', 'Crime Fiction']",1930,2
1584998,Black Christmas,1974,['Canada'],"['Mystery', 'Indie', 'Slasher', 'Thriller', 'Horror', 'Cult']",1970,4
214148,Bulletproof Monk,2003,['United States of America'],"['Action', 'Action/Adventure', 'Buddy film', 'Thriller', 'Comedy', 'Martial Arts Film', 'Action Comedy', 'Fantasy']",2000,3
9823771,Death Wish V: The Face of Death,1994,['United States of America'],"['Action', 'Crime Fiction', 'Action/Adventure', 'Thriller', 'Crime Thriller']",1990,4
24055607,Meet the Parents,1992,['United States of America'],['Comedy'],1990,2
15747276,Rose Hill,1997,"['Canada', 'United States of America']","['Period piece', 'Coming of age', 'Romantic drama', 'Action/Adventure', 'Western', 'Romance Film', 'Drama']",1990,7
8015443,Sounds Like,2007,['United States of America'],"['Psychological thriller', 'Horror', 'Television movie', 'Cult']",2000,7
26683130,Old Mother Riley in Paris,1938,['United Kingdom'],['Comedy'],1930,8
714334,Freddy vs. Jason,2003,"['United States of America', 'Canada', 'Italy']","['Slasher', 'Thriller', 'Horror', 'Teen']",2000,3
28740183,La porta del cielo,1945,['Italy'],['Drama'],1940,5
28344827,Someday,1935,['United Kingdom'],['Drama'],1930,5
20955005,Silencing Mary,1998,['United States of America'],['Drama'],1990,8
355548,Brother Bear,2003,['United States of America'],"['Animation', 'Comedy', ""Children's/Family"", 'Adventure', 'Drama', 'Coming of age', 'Animal Picture', 'Family Film', 'Fantasy']",2000,3
26916088,Mr. Black Mr. White,2008,['India'],"['Drama', 'World cinema']",2000,8
5649318,If Lucy Fell,1996,['United States of America'],"['Indie', 'Comedy', 'Romance Film', 'Romantic comedy']",1990,6
1604902,Bigger Than the Sky,2005,['United States of America'],"['Romantic drama', 'Comedy', 'Romance Film', 'Romantic comedy', 'Comedy-drama', 'Drama']",2000,5
3041635,Faust: Love of the Damned,2001,"['Spain', 'United States of America']","['Action', 'Film adaptation', 'Action Thrillers', 'Superhero', 'Action/Adventure', 'Thriller', 'Drama', 'Horror', 'Superhero movie', 'B-movie', 'Supernatural']",2000,1
5700286,Falling from the Sky: Flight 174,1995,"['Canada', 'United States of America']",['Drama'],1990,5
24725483,Voici le temps des assassins,1956,['France'],"['Crime Drama', 'Melodrama', 'Drama']",1950,6
27150590,Thanthram,1998,['India'],"['Action', 'Mystery', 'Thriller']",1990,8
3398472,Humanap Ka ng Panget,1991,['Philippines'],['Filipino Movies'],1990,1
23955940,Anjaneyulu,2009,['India'],"['Action', 'Drama', 'Crime Fiction', 'Thriller']",2000,9
1647718,Return to Glennascaul,1951,['Ireland'],"['Short Film', 'Horror']",1950,1
22256334,"1, 2, 3, Sun",1993,['France'],"['Parody', 'Comedy', 'World cinema', 'Drama']",1990,3
21243938,A Class to Remember,1993,['Japan'],"['Japanese Movies', 'Drama']",1990,3
29193924,Chaand Kaa Tukdaa,1994,[],"['Action', 'Drama', 'Crime Fiction', 'Comedy film', 'Romance Film']",1990,4
15265997,Witchouse,1999,['United States of America'],"['Teen', 'Horror', 'B-movie', 'Haunted House Film']",1990,9
15349469,Defiance,2008,['United States of America'],"['Action', 'Drama', 'History', 'Thriller', 'War film']",2000,8
24204860,Baaria - La porta del vento,2009,['Italy'],"['Comedy', 'Drama', 'World cinema']",2000,9
9950884,The Mark of Cain,2007,['United Kingdom'],"['War film', 'Drama']",2000,7
21702693,Airlock Or How To Say Goodbye In Space,2007,['United Kingdom'],"['Short Film', 'Science Fiction']",2000,7
887452,Swimfan,2002,['United States of America'],"['Psychological thriller', 'Suspense', 'Thriller', 'Teen', 'Drama']",2000,2
9546734,Just Married,2007,['India'],"['Musical', 'Romantic drama', 'Comedy', 'Bollywood', 'World cinema', 'Romance Film', 'Drama']",2000,7
21954355,Killer Party,1986,['United States of America'],['Horror'],1980,6
1958425,Red Eye,2005,['United States of America'],"['Action', 'Psychological thriller', 'Suspense', 'Thriller']",2000,5
24549305,The Summertime Killer,1973,"['France', 'Spain', 'Italy']","['Action', 'Crime Fiction']",1970,3
15667865,Evil Twin,2007,['South Korea'],['Horror'],2000,7
628843,House on Haunted Hill,1959,['United States of America'],"['Indie', 'Cult', 'Horror']",1950,9
26013626,Adhinayak,2006,['India'],['Drama'],2000,6
18907411,Campbell's Kingdom,1957,['United Kingdom'],"['Action', 'Western', 'Adventure']",1950,7
2777580,The Linguini Incident,1991,['United States of America'],"['Comedy Thriller', 'Comedy', 'Adventure']",1990,1
11514132,Jokefalls,2005,['India'],"['Comedy', 'World cinema']",2000,5
16747410,Defendor,2009,"['United Kingdom', 'United States of America', 'Canada']","['Action', 'Crime Fiction', 'Superhero', 'Action/Adventure', 'Indie', 'Comedy', 'Tragicomedy', 'Drama', 'Superhero movie', 'Comedy-drama']",2000,9
15695777,Sugar Cane Alley,1983,['France'],"['Coming of age', 'Drama', 'World cinema']",1980,3
14722502,Hangman's Knot,1952,['United States of America'],"['Action/Adventure', 'Western']",1950,2
20903426,Bada Kabutar,1973,['India'],"['Action', 'Crime Fiction', 'Comedy']",1970,3
341399,Revenge of the Nerds,1984,['United States of America'],"['Comedy', 'Cult', 'Sex comedy']",1980,4
23654077,Kakkakuyil,2001,['India'],"['Romantic comedy', 'Bollywood']",2000,1
31993063,Frosty Roads,1985,['Iran'],[],1980,5
24427416,The Tale of Zatoichi,1962,['Japan'],"['Costume Adventure', 'Samurai cinema', 'Action/Adventure', 'World cinema', 'Martial Arts Film', 'Adventure', 'Drama', 'Japanese Movies']",1960,2
303928,Escape from the Planet of the Apes,1971,['United States of America'],"['Science Fiction', 'Escape Film', 'Adventure']",1970,1
2969022,The Killer Elite,1975,['United States of America'],"['Psychological thriller', 'Action', 'Spy', 'Action Thrillers', 'Action/Adventure', 'Thriller']",1970,5
19463368,Pontypool,2008,['Canada'],"['Psychological thriller', 'Film adaptation', 'Horror', 'Zombie Film', 'Drama']",2000,8
14055212,The Trial of Madame X,1948,['United Kingdom'],"['Black-and-white', 'Drama', 'Courtroom Drama']",1940,8
3792062,Águila o sol,1937,['Mexico'],"['Musical', 'Black-and-white', 'Comedy']",1930,7
6629405,Stray Dog: Kerberos Panzer Cops,1991,['Japan'],"['Action', 'Art film', 'Action/Adventure', 'Thriller', 'World cinema', 'Drama', 'Japanese Movies', 'Science Fiction']",1990,1
16062566,"Mother, May I Sleep with Danger?",1996,['United States of America'],"['Psychological thriller', 'Slasher', 'Thriller', 'Crime Thriller']",1990,6
11558237,Cone of Silence,1960,['United Kingdom'],"['Black-and-white', 'Drama']",1960,0
6785614,Apartment Zero,1989,"['Argentina', 'United Kingdom', 'United States of America']","['Psychological thriller', 'Suspense', 'LGBT', 'Thriller', 'Crime Thriller', 'Drama', 'Political thriller']",1980,9
35766299,Kansas Raiders,1950,['United States of America'],"['Action', 'Western', 'War film', 'Adventure']",1950,0
2898682,Ek Hasina Thi,2004,['India'],"['Drama', 'Bollywood', 'World cinema']",2000,4
9899883,Kadawunu Poronduwa,1947,['Sri Lanka'],['Drama'],1940,7
15534756,I Thank You,1941,['United Kingdom'],"['Slapstick', 'Comedy']",1940,1
12521881,Cluny Brown,1946,['United States of America'],"['Black-and-white', 'Comedy', 'Romance Film', 'Romantic comedy']",1940,6
3901054,Noi the Albino,2003,"['Denmark', 'Iceland', 'United Kingdom', 'Germany']","['Coming of age', 'Comedy', 'World cinema', 'Comedy-drama', 'Drama']",2000,3
13547387,Queens Logic,1991,['United States of America'],"['Comedy', 'Comedy-drama', 'Drama', 'Ensemble Film']",1990,1
3700806,Darkness Falls,1999,['United Kingdom'],"['Psychological thriller', 'Indie', 'Thriller', 'Erotic thriller', 'Drama']",1990,9
2510440,Parash Pathar,1958,['India'],"['Musical', 'Art film', 'Satire', 'Comedy', 'Bollywood', 'World cinema', 'Drama', 'Fantasy Comedy']",1950,8
23999188,Piccadilly Incident,1946,[],"['War film', 'Drama']",1940,6
24974442,Guess What We Learned in School Today?,1970,['United States of America'],['Comedy'],1970,0
476008,The Statement,2003,"['United Kingdom', 'France', 'Canada']","['Period piece', 'Film adaptation', 'Crime Fiction', 'Thriller', 'Drama', 'Political thriller']",2000,3
2969963,Stay,2005,['United States of America'],"['Psychological thriller', 'Mystery', 'Thriller', 'Supernatural', 'Drama']",2000,5
31165238,Dark Purpose,1964,"['France', 'Italy', 'United States of America']",['Mystery'],1960,4
31309330,14 Hours,2005,['United States of America'],"['Action', 'Drama', 'Action/Adventure', 'Thriller', 'Television movie', 'Disaster']",2000,5
8088101,Drums of Fu Manchu,1940,['United States of America'],"['Action', 'Black-and-white', 'Master Criminal Films', 'Adventure']",1940,0
226331,Purple Rain,1984,['United States of America'],"['Musical', 'Romance Film', 'Drama']",1980,4
22834770,Montana Belle,1952,['United States of America'],"['Action/Adventure', 'Western']",1950,2
183797,"Smash-Up, the Story of a Woman",1947,['United States of America'],['Drama'],1940,7
9462004,The Hawk,1993,['United Kingdom'],"['Thriller', 'Drama']",1990,3
1793784,Netaji Subhas Chandra Bose: The Forgotten Hero,2004,['India'],"['History', 'Art film', 'Biographical film', 'War film', 'Drama']",2000,4
23202902,Los Ojos Azules de la Muneca Rota,1973,['Spain'],"['Mystery', 'Thriller', 'Horror']",1970,3
8710784,Only You,1992,['United States of America'],"['Romance Film', 'Romantic comedy', 'Comedy']",1990,2
29206514,"Murder, He Says",1945,['United States of America'],['Comedy'],1940,5
3654133,Casque d'or,1952,['France'],"['Film à clef', 'Crime Fiction', 'Romantic drama', 'World cinema', 'Romance Film', 'Drama', 'Crime Drama', 'Melodrama']",1950,2
15370769,A Woman's War,1957,['South Korea'],"['Melodrama', 'Drama']",1950,7
348449,Garfield: The Movie,2004,['United States of America'],"['Animation', 'Comedy', 'Slapstick', 'Family Film']",2000,4
21455630,Welcome to Macintosh,2008,['United States of America'],"['Computers', 'Documentary']",2000,8
13578403,Hatya,1988,['India'],"['Action', 'Drama', 'Crime Fiction', 'Thriller', 'Romance Film']",1980,8
2428475,1942: A Love Story,1994,['India'],"['Musical', 'Romantic drama', 'Action/Adventure', 'Bollywood', 'World cinema', 'Romance Film', 'Drama', 'Melodrama', 'Epic']",1990,4
2695729,Police Story 4: First Strike,1996,"['Hong Kong', 'United States of America']","['Action', 'Action/Adventure', 'Comedy', 'World cinema', 'Chinese Movies', 'Martial Arts Film', 'Adventure']",1990,6
5483227,The Ladykillers,2004,['United States of America'],"['Crime Fiction', 'Comedy', 'Thriller']",2000,4
2205718,The Cube,1969,"['Canada', 'United States of America']","['Comedy', 'Documentary']",1960,9
2013364,Malibu's Most Wanted,2003,['United States of America'],"['Crime Fiction', 'Parody', 'Satire', 'Comedy', 'Teen', 'Hip hop movies', 'Comedy of manners']",2000,3
25091829,How Much Do You Love Me?,2005,"['France', 'Italy']","['Crime Fiction', 'Romantic drama', 'Comedy', 'World cinema', 'Romantic comedy', 'Romance Film', 'Drama']",2000,5
30581,The Crying Game,1992,"['United Kingdom', 'Japan']","['LGBT', 'Japanese Movies', 'Indie', 'Drama', 'Thriller', 'Crime Thriller', 'Political thriller']",1990,2
26035123,Vyooham,1990,['India'],"['Action', 'Crime Fiction', 'Thriller']",1990,0
17687304,Dilwale,1994,['India'],['Bollywood'],1990,4
15850590,If a Man Answers,1962,['United States of America'],"['Comedy', 'Romance Film', 'Romantic comedy', 'Domestic Comedy']",1960,2
2236324,Freaky Friday,2003,['United States of America'],"['Comedy', 'Family Film', 'Fantasy']",2000,3
27237236,Mazhavillu,1999,['India'],"['Crime Fiction', 'Comedy', 'Romance Film', 'Drama']",1990,9
2876569,The Punisher,2004,"['Germany', 'United States of America']","['Action', 'Drama', 'Crime Fiction', 'Thriller']",2000,4
11097772,The 601st Phone Call,2006,['China'],"['Chinese Movies', 'Drama']",2000,6
27067663,Kuch Tum Kaho Kuch Hum Kahein,2002,['India'],"['Action', 'Romance Film', 'Drama']",2000,2
32812400,Framed,1975,['United States of America'],"['Action', 'Crime Thriller', 'Thriller']",1970,5
34356357,Bharathan Effect,2007,['India'],"['Science Fiction', 'Comedy film']",2000,7
23719367,Robinsonada or My English Grandfather,1987,"['Soviet Union', 'Georgia']",['Comedy film'],1980,7
26293568,College Confidential,1960,['United States of America'],['Drama'],1960,0
14472255,5ive Girls,2006,['Canada'],"['Thriller', 'Horror', 'Teen', 'B-movie', 'Juvenile Delinquency Film']",2000,6
1766476,Tickle Me,1965,['United States of America'],"['Musical', 'Western', 'Comedy', 'Musical comedy', 'Romance Film', 'Romantic comedy']",1960,5
6834654,Old Joy,2006,['United States of America'],"['Gay Themed', 'LGBT', 'Drama', 'Indie', 'Buddy film', 'Road movie']",2000,6
5600244,500 Years Later,2005,"['United Kingdom', 'United States of America']","['Documentary', 'History', 'Indie']",2000,5
24597709,Gun Shy,2000,['United States of America'],"['Action', 'Crime Fiction', 'Gangster Film', 'Action/Adventure', 'Comedy', 'Romantic comedy', 'Romance Film']",2000,0
34387127,Shiva,1989,['India'],['Action'],1980,9
31557,"The Good, the Bad and the Ugly",1966,"['Spain', 'West Germany', 'Italy']","['Action', 'Revisionist Western', 'Action/Adventure', 'World cinema', 'Spaghetti Western', 'Epic Western', 'Western', 'War film']",1960,6
12528729,Left For Dead,2007,['United Kingdom'],"['Action', 'Crime Fiction', 'Indie', 'Action/Adventure', 'Thriller', 'Crime Thriller', 'Martial Arts Film', 'Adventure']",2000,7
1618936,No Way Out,1950,['United States of America'],"['Black-and-white', 'Crime Fiction', 'Thriller', 'Film noir', 'Drama']",1950,0
6736202,The All Together,2007,['United Kingdom'],"['Romance Film', 'Comedy', 'Drama']",2000,7
18504054,Lone Rider,2008,['United States of America'],"['Action/Adventure', 'Western']",2000,8
14328976,The Brotherhood of Satan,1971,['United States of America'],"['Crime Fiction', 'Horror']",1970,1
35553176,Fatso,2009,['India'],"['Romance Film', 'Comedy film']",2000,9
7032286,Jedara Bale,1968,[],['Action'],1960,8
6325875,Duane Hopwood,2005,['United States of America'],"['Indie', 'Drama']",2000,5
28635851,Deadly Hero,1976,['United States of America'],"['Drama', 'Crime Fiction', 'Thriller']",1970,6
7531222,Be Big!,1931,['United States of America'],"['Short Film', 'Black-and-white', 'Comedy']",1930,1
545615,Monsieur Verdoux,1947,['United States of America'],"['Black-and-white', 'Crime Fiction', 'Comedy', 'Crime Comedy', 'Black comedy', 'Comedy-drama', 'Drama']",1940,7
6247686,Normal Adolescent Behavior,2007,['United States of America'],"['Romance Film', 'Drama']",2000,7
25313713,Red Velvet,2009,['United States of America'],"['Slasher', 'B-movie', 'Horror']",2000,9
7986184,The Gravedancers,2005,['United States of America'],"['Supernatural', 'Horror']",2000,5
30872164,Naruto the Movie: Snow Princess' Book of Ninja Arts,2004,['Japan'],"['Action', 'Animation', 'Japanese Movies', 'Anime']",2000,4
3598984,The Constant Gardener,2005,"['United Kingdom', 'Germany']","['Film adaptation', 'Crime Fiction', 'Mystery', 'Thriller', 'Romance Film', 'Crime Thriller', 'Drama', 'Political drama', 'Political thriller']",2000,5
7809109,ReBoot: Daemon Rising,2001,['Canada'],"['Computer Animation', 'Animation', 'Television movie', 'Anime', 'Fantasy', 'Science Fiction']",2000,1
20571608,Naruto: Shippūden the Movie 3,2009,['Japan'],['Animation'],2000,9
16671731,Hanky Panky,1982,['United States of America'],"['Action', 'Crime Fiction', 'Mystery', 'Action/Adventure', 'Comedy', 'Thriller', 'Crime Thriller', 'Suspense']",1980,2
2161086,Ju Dou,1990,"['China', 'Japan']","['Erotic Drama', 'Family Drama', 'Romantic drama', 'World cinema', 'Romance Film', 'Chinese Movies', 'Drama', 'Tragedy', 'Period piece', 'Japanese Movies', 'Marriage Drama']",1990,0
1766226,Return to the Blue Lagoon,1991,['United States of America'],"['Coming of age', 'Romantic drama', 'Action/Adventure', 'Teen', 'Romance Film', 'Adventure', 'Drama']",1990,1
1849364,When I Fall in Love... with Both,2000,['Hong Kong'],['Chinese Movies'],2000,0
3268711,Melody,1971,['United Kingdom'],"['Indie', 'Comedy', 'Drama']",1970,1
25948394,The Pickle,1993,['United States of America'],"['Drama', 'Comedy']",1990,3
8961059,White Wolves 3: Cry of The White Wolf,1998,"['Canada', 'United States of America']","['Action/Adventure', 'Adventure', 'Animal Picture', 'Family-Oriented Adventure', ""Children's/Family""]",1990,8
14088330,The Death Kiss,1932,['United States of America'],"['Suspense', 'Detective fiction', 'Black-and-white', 'Mystery', 'Thriller', 'Detective', 'Crime Thriller']",1930,2
4162938,Lionheart,1991,['United States of America'],"['Action', 'Indie', 'Action/Adventure', 'Thriller', 'Martial Arts Film']",1990,1
4645051,The Bicyclist,1987,['Iran'],"['Drama', 'World cinema']",1980,7
17789399,Lesbian Vampire Killers,2009,"['United Kingdom', 'England']","['Action', 'Parody', 'Comedy', 'Horror Comedy', 'Horror']",2000,9
2583472,Roll Bounce,2005,['United States of America'],"['Period piece', 'Coming of age', 'Comedy', 'Teen', 'Dance', 'Comedy-drama', 'Drama']",2000,5
15938267,Monologue About Love,1986,"['Soviet Union', 'Ukraine']","['Musical', 'Concert film']",1980,6
23006569,Grave Secrets: The Legacy of Hilltop Drive,1992,['United States of America'],"['Thriller', 'Horror']",1990,2
24013376,Carriers,2009,['United States of America'],"['Psychological thriller', 'Action/Adventure', 'Thriller', 'Zombie Film', 'Disaster', 'Drama', 'Horror', 'Science Fiction']",2000,9
73366,The Band Wagon,1953,['United States of America'],"['Musical', 'Backstage Musical', 'Comedy', 'Musical comedy']",1950,3
17613909,Reign of Terror,1949,['United States of America'],"['Black-and-white', 'Film noir', 'Adventure', 'Drama']",1940,9
1289336,The Replacement Killers,1998,['United States of America'],"['Action', 'Crime Fiction', 'Action Thrillers', 'Action/Adventure', 'Thriller', 'Crime Thriller']",1990,8
7017821,The Practical Pig,1939,['United States of America'],"['Animation', 'Short Film', 'Comedy', 'Family Film']",1930,9
7202949,A Home of Our Own,1993,['United States of America'],"['Family Drama', 'Indie', 'Drama', 'Family Film']",1990,3
1898116,Radio,2003,['United States of America'],"['Period piece', 'Biography', 'Sports', 'Drama']",2000,3
1827834,Big Money Hustlas,2000,['United States of America'],"['Crime Fiction', 'Parody', 'Indie', 'Comedy', 'Hip hop movies']",2000,0
1577984,Stir of Echoes,1999,['United States of America'],"['Psychological thriller', 'Mystery', 'Thriller', 'Crime Thriller', 'Haunted House Film', 'Suspense', 'Horror', 'Supernatural']",1990,9
27398409,This Earth Is Mine,1959,['United States of America'],['Drama'],1950,9
1095954,Idiot's Delight,1939,['United States of America'],"['Black-and-white', 'Comedy', 'Drama']",1930,9
11256435,Insaniyat,1994,['India'],"['Action', 'Crime Fiction', 'Drama']",1990,4
15242615,The House of Clocks,1989,['Italy'],"['Horror', 'World cinema', 'Zombie Film', 'Supernatural', 'Haunted House Film']",1980,9
6017242,King of Texas,2002,['United States of America'],"['Western', 'Drama']",2000,2
2918673,Cast a Deadly Spell,1991,['United States of America'],"['Detective fiction', 'Mystery', 'Comedy', 'Detective', 'Horror Comedy', 'Horror', 'Supernatural']",1990,1
10578574,Gloomy Sunday - Ein Lied von Liebe und Tod,1999,"['Hungary', 'Germany']","['Romantic drama', 'World cinema', 'Romance Film', 'Drama']",1990,9
26758096,Iyer the Great,1990,['India'],['Psychological thriller'],1990,0
12729324,The ChubbChubbs Save Xmas,2007,['United States of America'],['Short Film'],2000,7
9718646,All Quiet on the Western Front,1979,"['United Kingdom', 'United States of America']","['Film adaptation', 'Television movie', 'War film', 'Drama']",1970,9
12908045,Aurat,1967,['India'],"['Drama', 'Comedy']",1960,7
19985118,Billa,2009,['India'],"['Action', 'Romance Film', 'Thriller']",2000,9
24803101,Sock-a-Doodle-Do,1952,[],"['Animation', 'Short Film', 'Comedy film', 'Family Film']",1950,2
1875611,People Will Talk,1951,['United States of America'],"['Romantic drama', 'Comedy', 'Romance Film', 'Romantic comedy', 'Drama']",1950,1
26797962,I Killed the Count,1939,['United Kingdom'],"['Mystery', 'Comedy']",1930,9
8985219,Arizona Sur,2004,['Argentina'],['Comedy'],2000,4
29773275,Vadakkum Nathan,2006,[],"['Musical', 'Romance Film', 'Drama']",2000,6
12210037,Ghost of Mae Nak,2005,"['United Kingdom', 'Thailand']","['Thriller', 'Horror', 'World cinema', 'Supernatural']",2000,5
32079759,Blue,2003,['South Korea'],"['Action', 'Action/Adventure', 'World cinema', 'Romance Film', 'War film', 'Drama']",2000,3
26527102,Naa Illu,1953,['India'],"['Musical', 'Drama']",1950,3
16275299,Sur,2002,['India'],"['Musical', 'Bollywood', 'World cinema', 'Drama']",2000,2
3771276,My Bloody Valentine,1981,['Canada'],"['Indie', 'Slasher', 'Teen', 'Horror']",1980,1
6664274,Thenali,2001,['India'],"['Drama', 'Comedy']",2000,1
11741801,Surf II,1984,['United States of America'],"['Music', 'Indie', 'Parody', 'Comedy', 'Zombie Film', 'Beach Party film']",1980,4
29164822,She Had to Say Yes,1933,['United States of America'],"['Workplace Comedy', 'Comedy', 'Romantic comedy', 'Pre-Code']",1930,3
6100131,Crackers,1984,['United States of America'],"['Crime Fiction', 'Comedy', 'Thriller', 'Adventure']",1980,4
12835046,Virginia's Run,2002,"['Canada', 'United States of America']","['Drama', 'Coming of age', 'Indie', 'Family Drama', 'Animal Picture', ""Children's/Family"", 'Family Film']",2000,2
129427,Working Girl,1988,['United States of America'],"['Romance Film', 'Comedy', 'Drama']",1980,8
30059575,Los Bandoleros,2009,['United States of America'],"['Action', 'Short Film', 'Drama']",2000,9
22112249,Puerto Maldito,1977,['Mexico'],"['Action', 'Adventure']",1970,7
4567681,Hare Rama Hare Krishna,1971,['India'],"['Musical', 'Bollywood', 'World cinema', 'Drama']",1970,1
410939,Ulzana's Raid,1972,['United States of America'],"['Action/Adventure', 'Western', 'Cavalry Film', 'Indian Western']",1970,2
328344,Arachnophobia,1990,['United States of America'],"['Parody', 'Comedy', 'Thriller', 'Horror Comedy', 'Horror', 'Science Fiction', 'Natural horror films']",1990,0
20917102,Far East,1982,['Australia'],"['Action', 'Drama', 'Adventure']",1980,2
24578337,Upstage,1926,['United States of America'],['Silent film'],1920,6
21742534,Linear,2009,['United Kingdom'],['Music'],2000,9
20030612,District B13 Ultimatum,2009,['France'],"['Action', 'Crime Fiction', 'Action/Adventure', 'Thriller', 'World cinema', 'Parkour in popular culture', 'Martial Arts Film', 'Science Fiction']",2000,9
7080965,Bagavathi,2002,['India'],['Action'],2000,2
1241597,Enigma,2001,"['United Kingdom', 'Germany', 'Netherlands', 'United States of America']","['Spy', 'Film adaptation', 'Mystery', 'Thriller', 'Romance Film', 'Drama', 'Period piece', 'War film']",2000,1
8629307,Mamta,1966,['India'],"['Musical', 'Romantic drama', 'Bollywood', 'World cinema', 'Romance Film', 'Drama']",1960,6
30432988,Sahara Jaluchi,1998,['India'],['Drama'],1990,8
5188508,From the Mixed-Up Files of Mrs. Basil E. Frankweiler,1995,['United States of America'],"[""Children's""]",1990,5
11883104,Night Game,1989,['United States of America'],"['Drama', 'Crime Fiction', 'Thriller']",1980,9
1271416,Hillbilly Hare,1950,['United States of America'],"['Animation', 'Short Film', 'Comedy', 'Family Film']",1950,0
1997397,Big Wednesday,1978,['United States of America'],"['Coming of age', 'Buddy film', 'Comedy', 'Sports', 'Drama']",1970,8
665946,The Big Brawl,1980,"['Hong Kong', 'United States of America']","['Action', 'Action/Adventure', 'Comedy', 'Chinese Movies', 'Martial Arts Film']",1980,0
4521906,A League of Ordinary Gentlemen,2006,['United States of America'],"['Biography', 'Documentary', 'Sports', 'Culture & Society']",2000,6
657824,Barcelona,1994,['United States of America'],"['Indie', 'Comedy', 'Romance Film', 'Romantic comedy']",1990,4
23205095,The Wicked Lady,1983,['United Kingdom'],"['Adventure', 'Drama']",1980,3
30207613,Murappennu,1965,[],"['Romance Film', 'Drama']",1960,5
509676,Glory,1989,['United States of America'],"['Period piece', 'Action', 'War film', 'Political drama', 'Epic', 'Costume drama', 'Drama']",1980,9
7460316,Saving Grace,1985,['United States of America'],"['Drama', 'Comedy']",1980,5
6335418,Harsh Times,2005,['United States of America'],"['Action', 'Drama', 'Crime Fiction', 'Gangster Film', 'Indie', 'Thriller']",2000,5
7893193,Coast to Coast,1980,['United States of America'],"['Comedy', 'Romance Film', 'Romantic comedy', 'Drama']",1980,0
24903334,Brotherhood,2009,['Denmark'],"['LGBT', 'World cinema', 'Political drama', 'Drama']",2000,9
26296521,"McDull, Kung Fu Kindergarten",2009,"['Hong Kong', 'China', 'Japan']","['Animation', 'Japanese Movies', 'Comedy', 'Chinese Movies']",2000,9
34395954,Sri Seetha Rama Kalyanam,1961,['India'],"['Musical', 'Drama']",1960,1
28192781,Ravagers,1979,['United States of America'],"['Science Fiction', 'Drama', 'Fantasy']",1970,9
6155040,Scrapbook,2000,['United States of America'],"['Comedy', 'Thriller', 'Horror', 'Drama']",2000,0
4409434,Generation X,1996,['United States of America'],"['Science Fiction', 'Superhero movie']",1990,6
28960943,Redline,2009,['Japan'],"['Action', 'Auto racing', 'Animation', 'Anime', 'Sports', 'Science Fiction', 'Fantasy']",2000,9
32158759,Velutha Kathreena,1968,[],['Drama'],1960,8
5991505,The Shadow,1994,['United States of America'],"['Action', 'Crime Fiction', 'Mystery', 'Action/Adventure', 'Thriller', 'Superhero movie', 'Supernatural', 'Fantasy']",1990,4
2457278,The Man Who Knew Too Little,1997,"['Germany', 'United States of America']","['Spy', 'Film adaptation', 'Screwball comedy', 'Comedy', 'Thriller', 'Slapstick', 'Drama', 'Comedy of Errors', 'Parody']",1990,7
1758342,Serenade,1956,['United States of America'],['Musical'],1950,6
19844591,Chupacabra: Dark Seas,2005,['United States of America'],"['Creature Film', 'Horror', 'Television movie', 'Natural horror films']",2000,5
961659,Battle of the Bulge,1965,['United States of America'],"['Action', 'Drama', 'Action/Adventure', 'War film']",1960,5
19369363,The Isle of Love,1920,['United States of America'],"['Adventure Comedy', 'Black-and-white', 'Silent film', 'Romantic comedy', 'Adventure']",1920,0
18959475,Kailangan Kita,2002,['Philippines'],"['Filipino Movies', 'Romantic drama', 'World cinema', 'Romance Film', 'Drama']",2000,2
25340278,The Merchant of Four Seasons,1972,"['Germany', 'West Germany']","['Family Drama', 'Drama', 'World cinema']",1970,2
3143504,Michael,1996,['United States of America'],"['Comedy', 'Romantic comedy', 'Religious Film', 'Drama', 'Fantasy']",1990,6
1396533,Pushing Tin,1999,"['Germany', 'United States of America']","['Airplanes and airports', 'Comedy', 'Comedy-drama', 'Workplace Comedy', 'Drama', 'Ensemble Film']",1990,9
3452126,Angel-A,2005,['France'],"['Art film', 'Romantic drama', 'Comedy', 'World cinema', 'Romance Film', 'Drama', 'Fantasy']",2000,5
1254902,Thursday,1998,['United States of America'],"['Gangster Film', 'Caper story', 'Thriller', 'Crime Thriller']",1990,8
5790223,All Or Nothing,2002,"['United Kingdom', 'France']","['Romance Film', 'Indie', 'Drama']",2000,2
35995900,Story of a Beloved Wife,1951,['Japan'],"['Romance Film', 'Drama']",1950,1
11789222,Giovanna d'Arco al rogo,1954,['Italy'],"['Musical', 'Musical Drama', 'Biopic [feature]', 'Christian film', 'Hagiography', 'Drama']",1950,4
19413173,Prelude to Fame,1950,['United Kingdom'],"['Film adaptation', 'Musical Drama', 'Drama']",1950,0
31632887,A New Life,1988,['United States of America'],"['Romantic drama', 'Comedy', 'Romance Film', 'Romantic comedy', 'Drama']",1980,8
17999484,Universal Soldier II: Brothers in Arms,1998,['Canada'],"['Action', 'Science Fiction', 'Action/Adventure']",1990,8
434738,Yossi & Jagger,2002,['Israel'],"['LGBT', 'Romantic drama', 'World cinema', 'Romance Film', 'War film', 'Drama', 'Gay Themed', 'Gay', 'Gay Interest']",2000,2
14334358,The Golden Arrow,1936,['United States of America'],"['Black-and-white', 'Comedy', 'Romance Film', 'Romantic comedy']",1930,6
3822528,Satyricon,1969,"['France', 'Italy']","['LGBT', 'Art film', 'World cinema', 'Romantic comedy', 'Drama']",1960,9
1693768,Eat the Rich,1987,['United Kingdom'],"['Parody', 'Satire', 'Comedy', 'Black comedy']",1980,7
11601053,Tuff Turf,1985,['United States of America'],"['Action', 'Drama', 'Romantic drama', 'Teen', 'Romance Film']",1980,5
2571477,Madea's Class Reunion,2003,['United States of America'],['Comedy'],2000,3
805053,Before Sunrise,1995,"['Switzerland', 'Austria', 'United States of America']","['Romantic drama', 'Romance Film', 'Romantic comedy', 'Comedy-drama', 'Drama']",1990,5
1721159,The Return of the Pink Panther,1975,['United Kingdom'],"['Detective fiction', 'Crime Fiction', 'Parody', 'Comedy', 'Detective', 'Crime Comedy', 'Slapstick']",1970,5
10155456,Detention,2003,"['Canada', 'United States of America']","['Action', 'Action/Adventure', 'Thriller', 'Crime Thriller']",2000,3
6738041,Private School,1983,['United States of America'],"['Comedy', 'Teen', 'Romantic comedy', 'Sex comedy']",1980,3
10815585,Zero Tolerance,1995,['United States of America'],"['Action', 'Crime Fiction', 'Indie', 'Action/Adventure', 'Thriller']",1990,5
6592085,Pokiri,2007,['India'],['Action'],2000,7
29511732,A Millionaire for Christy,1951,['United States of America'],"['Romance Film', 'Screwball comedy', 'Comedy']",1950,1
23691110,My Pal Trigger,1946,['United States of America'],"['Action', 'Action/Adventure', 'Western', 'Animal Picture']",1940,6
19669890,Bonnie Prince Charlie,1923,['United Kingdom'],"['Historical drama', 'Biographical film', 'Silent film', 'Drama']",1920,3
18623102,Perlasca,2002,['Italy'],"['History', 'Biopic [feature]', 'War film', 'Drama']",2000,2
17377861,Dimples,1936,['United States of America'],"['Musical', 'Black-and-white', 'Family Drama', 'Drama', 'Family Film']",1930,6
79729,The Bells of St. Mary's,1945,['United States of America'],"['Black-and-white', 'Christmas movie', 'Drama', 'Family Film']",1940,5
569790,Prime Cut,1972,['United States of America'],"['Action', 'Suspense', 'Crime Fiction', 'Thriller', 'Crime Thriller', 'Drama']",1970,2
14955031,We'll Meet Again,2002,['United States of America'],"['Film adaptation', 'Crime Fiction', 'Mystery', 'Thriller', 'Television movie', 'Crime Thriller', 'Drama']",2000,2
26538108,Wrong World,1984,['Australia'],['Drama'],1980,4
14734817,Outer Space Jitters,1957,['United States of America'],"['Black-and-white', 'Short Film', 'Comedy', 'Adventure', 'Science Fiction']",1950,7
34955947,Warish,2004,['India'],[],2000,4
1623775,The Seventh Bullet,1974,['Soviet Union'],"['Western', 'War film', 'Adventure']",1970,4
28536315,A Wall of Silence,1993,"['Argentina', 'United Kingdom', 'Mexico']",['Drama'],1990,3
7468970,Rinne,2005,['Japan'],"['Psychological thriller', 'Japanese Movies', 'Horror', 'World cinema', 'Supernatural']",2000,5
23310329,Undercover,1943,['United States of America'],['War film'],1940,3
25943980,Sitaara,1983,['India'],"['Musical', 'Drama', 'Family Film']",1980,3
20332464,Couples Retreat,2009,['United States of America'],"['Comedy', 'Romance Film', 'Romantic comedy', 'Sex comedy']",2000,9
602501,Who's Harry Crumb?,1989,['United States of America'],"['Detective fiction', 'Mystery', 'Comedy Thriller', 'Thriller', 'Detective', 'Comedy']",1980,9
3293243,Les Uns et les Autres,1981,['France'],"['Music', 'Period piece', 'World cinema', 'Drama']",1980,1
4008886,Ratboy,1986,['United States of America'],"['Creature Film', 'Mystery', 'Satire', 'Media Satire', 'Black comedy', 'Comedy-drama', 'Drama']",1980,6
13580766,Dulaara,1994,['India'],"['Mystery', 'Romantic drama', 'World cinema', 'Romance Film', 'Drama']",1990,4
7134822,7 Women,1966,['United States of America'],['Drama'],1960,6
1653264,Gangster No. 1,2000,"['United Kingdom', 'Germany', 'Ireland']","['Action', 'Crime Fiction', 'Gangster Film', 'Action/Adventure', 'Thriller', 'Crime Thriller', 'Drama', 'Period piece']",2000,0
5138153,Enchanted,2007,['United States of America'],"['Musical', 'Animation', 'Comedy', 'Romance Film', 'Costume drama', 'Parody', 'Romantic comedy', 'Family Film', 'Fantasy']",2000,7
10172553,Road to Ruin,1991,"['United States of America', 'France']","['Romance Film', 'Comedy']",1990,1
10352270,Paruthi Veeran,2007,['India'],"['Romance Film', 'Drama']",2000,7
32516138,Black Point,2001,['United States of America'],"['Action', 'Crime Fiction', 'Drama']",2000,1
5035,Bride of the Monster,1956,['United States of America'],"['Creature Film', 'Monster movie', 'Horror', 'B-movie', 'Science Fiction', 'Cult']",1950,6
8949458,Geppetto,2000,['United States of America'],"['Musical', 'Family Drama', 'Comedy', ""Children's/Family"", 'Drama', 'Fairy tale', ""Children's Fantasy"", 'Family Film', 'Fantasy']",2000,0
3207603,Bed of Roses,1996,['United States of America'],"['Romance Film', 'Romantic drama', 'Drama']",1990,6
25947106,The Stoker,1932,['United States of America'],['Drama'],1930,2
10599304,Dushmun,1971,['India'],"['Bollywood', 'Drama']",1970,1
15307603,Sandwich,2006,['India'],"['Romantic drama', 'Comedy', 'World cinema', 'Romance Film', 'Romantic comedy', 'Drama']",2000,6
19878508,No More Orchids,1932,['United States of America'],"['Romance Film', 'Black-and-white', 'Drama']",1930,2
18486103,Felon,2008,['United States of America'],"['Action', 'Prison', 'Drama', 'Crime Fiction', 'Thriller']",2000,8
7524279,7 Man Army,1976,['Hong Kong'],"['Chinese Movies', 'Martial Arts Film']",1970,6
25085189,Hell Ship Mutiny,1957,['United States of America'],"['Action', 'Action/Adventure', 'Adventure', 'Swashbuckler films']",1950,7
15843419,Pinkfinger,1965,[],"['Animation', 'Short Film', 'Comedy']",1960,5
1458713,The Great Muppet Caper,1981,['United Kingdom'],"['Adventure Comedy', 'Musical', 'Crime Fiction', 'Mystery', 'Comedy', 'Family-Oriented Adventure', ""Children's/Family"", 'Adventure', 'Drama', 'Family Film']",1980,1
8266590,Billa,1980,['India'],"['Action', 'Bollywood']",1980,0
28953208,The Whole Shootin' Match,1978,['United States of America'],"['Indie', 'Comedy-drama', 'Comedy of manners', 'Drama']",1970,8
2979644,Charlotte Gray,2001,"['United Kingdom', 'Germany', 'Australia']","['Period piece', 'Film adaptation', 'Romantic drama', 'Political drama', 'Romance Film', 'War film', 'Drama']",2000,1
24668194,National Lampoon's Joy of Sex,1984,['United States of America'],"['Comedy', 'Sex comedy']",1980,4
5294089,Erskineville Kings,1999,['Australia'],"['Drama', 'Ensemble Film']",1990,9
4440277,Highlander,1986,"['United Kingdom', 'United States of America']","['Action/Adventure', 'Science Fiction', 'Superhero movie', 'Cult', 'Fantasy']",1980,6
5587473,Aladdin,1994,"['Japan', 'United States of America']","['Animation', 'Japanese Movies', 'Adventure', 'Family Film']",1990,4
25349790,Devathai,1997,['India'],['Fantasy'],1990,7
10862318,King Solomon's Mines,2004,"['Germany', 'United States of America']","['Television movie', 'Action/Adventure', 'Adventure']",2000,4
21942458,Death of a Salesman,1951,['United States of America'],['Drama'],1950,1
16655899,Sex Hygiene,1942,['United States of America'],"['Short Film', 'Black-and-white', 'Documentary']",1940,2
6673398,A Tale of Two Mice,1945,['United States of America'],"['Animation', 'Short Film', 'Family Film']",1940,5
33673437,Sant Dnyaneshwar,1940,[],['Drama'],1940,0
5082550,Bellman and True,1987,['United Kingdom'],"['Heist', 'Crime Fiction', 'Thriller', 'Crime Thriller', 'Drama']",1980,7
2951463,The Devil's Rain,1975,['United States of America'],['Horror'],1970,5
18549628,Maria Mariana II,1998,['Malaysia'],"['Action', 'Romance Film']",1990,8
24527356,The Making of a King,1935,['Germany'],['Drama'],1930,5
45568,The Abyss,1989,['United States of America'],"['Drama', 'Science Fiction', 'Thriller']",1980,9
22237851,"Louise Bourgeois: The Spider, the Mistress, and the Tangerine",2008,['United States of America'],['Documentary'],2000,8
12064079,Bhagyalakshmi Bumper Draw,2006,['India'],['Comedy'],2000,6
17273738,The Favor,2006,['United States of America'],"['Indie', 'Drama']",2000,6
692682,A Walk on the Moon,1999,"['United States of America', 'Australia']","['Period piece', 'Romantic drama', 'Indie', 'Romance Film', 'Drama']",1990,9
23464136,Dalamarmarangal,2009,[],['Family Film'],2000,9
1629388,The Extra Girl,1923,['United States of America'],"['Black-and-white', 'Comedy', 'Silent film', 'Melodrama', 'Comedy-drama']",1920,3
12212448,Winds of the Wasteland,1936,['United States of America'],"['Western', 'Black-and-white', 'Action/Adventure']",1930,6
9470281,Dreamland,2006,['United States of America'],"['Romantic drama', 'Indie', 'Romance Film', 'Drama']",2000,6
10613496,Stupid Teenagers Must Die!,2007,['United States of America'],"['Slasher', 'Comedy', 'Teen', 'Horror']",2000,7
15342625,The Rising of the Moon,1957,"['Ireland', 'United States of America']","['Black-and-white', 'Comedy', 'Drama']",1950,7
13594438,When Did You Last See Your Father?,2007,"['Ireland', 'United Kingdom']","['Film adaptation', 'Drama', 'Coming of age', 'Indie', 'Biography', 'Family Drama', 'Slice of life story']",2000,7
1898832,Why We Fight,2005,"['Canada', 'United Kingdom', 'France', 'United States of America']","['Social issues', 'Political cinema', 'Private military company', 'Indie', 'Documentary', 'War film', 'Culture & Society']",2000,5
28031209,Le choc,1982,['France'],"['Action', 'Crime Fiction', 'Thriller', 'Romance Film']",1980,2
1640649,At Home Among Strangers,1974,"['Russia', 'Soviet Union']","['Action', 'Drama', 'Action/Adventure', 'World cinema']",1970,4
972234,Blue Desert,1991,['United States of America'],"['Psychological thriller', 'Action', 'Action Thrillers', 'Indie', 'Action/Adventure', 'Thriller', 'Crime Thriller']",1990,1
29057447,Miss Susie Slagle's,1946,['United States of America'],"['Comedy-drama', 'Drama']",1940,6
20645492,Last Chance Harvey,2008,['United States of America'],"['Romantic drama', 'Indie', 'Romance Film', 'Drama', 'Slice of life story']",2000,8
9141195,Traffic Signal,2007,['India'],"['Drama', 'World cinema']",2000,7
8048149,Bhoothakkannadi,1997,['India'],"['Drama', 'World cinema']",1990,7
8727133,Till I Met You,2006,['Philippines'],"['Filipino Movies', 'Romantic drama', 'World cinema', 'Romance Film', 'Drama']",2000,6
27500572,Mad Youth,1940,['United States of America'],"['Dance', 'Drama']",1940,0
3598911,Conflict,1945,['United States of America'],"['Film noir', 'Black-and-white']",1940,5
3055521,Magic Town,1947,['United States of America'],"['Comedy', 'Satire', 'Romance Film', 'Romantic comedy']",1940,7
11901104,Prom Night,2008,"['Canada', 'United States of America']","['Mystery', 'Slasher', 'Thriller', 'Horror', 'Teen']",2000,8
18978310,Tomorrow We Live,1943,['United Kingdom'],['Black-and-white'],1940,3
11218354,Lootmaar,1980,['India'],"['Action/Adventure', 'Thriller', 'World cinema']",1980,0
25198436,The Joy Girl,1927,['United States of America'],"['Silent film', 'Comedy']",1920,7
6061913,To Our Loves,1983,['France'],"['Coming of age', 'World cinema', 'Romance Film', 'Juvenile Delinquency Film', 'Drama']",1980,3
2396574,The Formula,1980,['United States of America'],"['Suspense', 'Mystery', 'Thriller', 'Crime Thriller', 'Political thriller']",1980,0
915499,Land of the Dead,2005,"['France', 'United States of America', 'Canada']","['Action', 'Indie', 'Thriller', 'Zombie Film', 'Creature Film', 'Doomsday film', 'Dystopia', 'Splatter film', 'Horror', 'Science Fiction', 'Cult']",2000,5
3590838,Get Christie Love!,1974,['United States of America'],"['Blaxploitation', 'Crime Fiction', 'Mystery', 'Thriller', 'Crime Thriller', 'Drama']",1970,4
487300,Fanny and Alexander,1982,"['Sweden', 'France', 'Germany', 'West Germany']","['Mystery', 'Family Drama', 'World cinema', 'Drama', 'Fantasy']",1980,2
1508868,The Serpent and the Rainbow,1988,['United States of America'],"['Indie', 'Thriller', 'Horror', 'Zombie Film', 'Supernatural']",1980,8
19859269,Jailbreakers,1994,['United States of America'],"['Suspense', 'Mystery', 'Thriller', 'Drama']",1990,4
3111594,The Marriage of Maria Braun,1979,"['Germany', 'West Germany']","['Art film', 'World cinema', 'Melodrama', 'War film', 'Drama']",1970,9
29647722,Tom Thumb and Little Red Riding Hood,1962,['Mexico'],"['Musical', 'Comedy film', 'Horror', 'Family Film', 'Fantasy']",1960,2
1157922,Haute Tension,2003,['France'],"['Mystery', 'Indie', 'Thriller', 'World cinema', 'Drama', 'Slasher', 'Horror', 'Road-Horror']",2000,3
2267088,Orca,1977,['United States of America'],"['Action', 'Action/Adventure', 'Thriller', 'Horror', 'Disaster', 'Adventure', 'Natural horror films']",1970,7
7587190,Linda Linda Linda,2005,['Japan'],"['Japanese Movies', 'Comedy', 'Teen', 'World cinema', 'Musical comedy', 'Comedy-drama', 'Drama']",2000,5
10954743,Getawarayo,1964,['Sri Lanka'],['Drama'],1960,4
10155744,Salween,1998,['Thailand'],"['Action', 'Drama', 'War film']",1990,8
14521327,The Ritz,1976,"['United Kingdom', 'United States of America']","['Gay Themed', 'LGBT', 'Comedy']",1970,6
20966610,"Paradise, Texas",2005,['United States of America'],"['Indie', 'Marriage Drama', 'Drama']",2000,5
12256912,Wishmaster 4: The Prophecy Fulfilled,2002,[],"['Monster movie', 'Supernatural', 'Horror']",2000,2
15142854,Like Water for Chocolate,1992,['Mexico'],"['Erotic Drama', 'Romantic drama', 'World cinema', 'Romance Film', 'Drama']",1990,2
4229342,The Work and the Story,2003,['United States of America'],"['Mockumentary', 'Comedy']",2000,3
5617131,Perfect Day,1929,['United States of America'],"['Short Film', 'Black-and-white', 'Comedy']",1920,9
2184642,Into the Blue,2005,['United States of America'],"['Action', 'Crime Fiction', 'Action/Adventure', 'Thriller', 'Remake', 'Adventure']",2000,5
3450570,A Star Is Born,1954,['United States of America'],"['Musical', 'Drama']",1950,4
7804484,Paradesi,2007,['India'],['Drama'],2000,7
10016161,The Weight of Water,2001,"['United States of America', 'France']","['Psychological thriller', 'Film adaptation', 'Crime Fiction', 'Mystery', 'Indie', 'Thriller', 'Crime Thriller', 'Drama', 'Period piece', 'Suspense', 'Marriage Drama']",2000,1
80405,Johnny Mnemonic,1995,"['Canada', 'United States of America']","['Action', 'Cyberpunk', 'Science Fiction']",1990,5
12064241,Funny Girl,1968,['United States of America'],"['Musical', 'Biography', 'Comedy', 'Romance Film', 'Drama']",1960,8
14925191,Remember?,1939,['United States of America'],"['Romance Film', 'Black-and-white', 'Comedy']",1930,9
33082797,Da grande,1987,[],"['Drama', 'Comedy film', 'Fantasy']",1980,7
324616,My Cousin Vinny,1992,['United States of America'],"['Crime Fiction', 'Courtroom Comedy', 'Comedy', 'Comedy of manners']",1990,2
7681320,Turn the River,2007,['United States of America'],"['Crime Fiction', 'Indie', 'Sports', 'Drama']",2000,7
4926447,The Big Trees,1952,['United States of America'],"['Melodrama', 'Drama']",1950,2
8704297,They Made Me a Criminal,1939,['United States of America'],"['Social problem film', 'Black-and-white', 'Drama']",1930,9
74892,The Life and Death of 9413: a Hollywood Extra,1928,['United States of America'],"['Black-and-white', 'Indie', 'Short Film', 'Silent film']",1920,8
8077348,Ishq Hai Tumse,2004,['India'],['Romance Film'],2000,4
26615730,Uttar Dakshin,1987,['India'],['World cinema'],1980,7
21409994,Pakal Nakshatrangal,2008,['India'],['Drama'],2000,8
1691989,The Howling,1981,"['Canada', 'United States of America']","['Creature Film', 'Film adaptation', 'Drama', 'Indie', 'Werewolf fiction', 'Horror', 'Cult']",1980,1
7154908,Puppet Master Vs The Demonic Toys,2004,['United States of America'],"['Monster movie', 'Horror', 'B-movie', 'Television movie']",2000,4
1572821,Liebestraum,1991,['United States of America'],"['Suspense', 'Mystery', 'Thriller', 'Erotic thriller', 'Crime Thriller', 'Drama']",1990,1
9678335,Vasantha Vaasal,1996,['India'],"['Romantic drama', 'Tamil cinema']",1990,6
342041,Los Diaz de Doris,2002,['Puerto Rico'],['Drama'],2000,2
28176057,"Hyppolit, the Butler",1931,['Hungary'],"['Romance Film', 'Comedy']",1930,1
6007686,Hot Rods to Hell,1967,['United States of America'],"['Action', 'Auto racing', 'Action/Adventure', 'Thriller', 'Sports', 'Juvenile Delinquency Film', 'Drama']",1960,7
19272325,Footsteps,2008,['India'],['Drama'],2000,8
26188295,Bird of Paradise,1951,['United States of America'],"['Romance Film', 'Adventure', 'Drama']",1950,1
7173157,Be Human,1936,['United States of America'],"['Animation', 'Short Film', 'Comedy', 'Family Film']",1930,6
27348520,Nothing But the Night,1973,['United Kingdom'],['Horror'],1970,3
2773212,Winnie the Pooh and the Honey Tree,1966,['United States of America'],"[""Children's Fantasy"", 'Animation', 'Short Film', 'Comedy', ""Children's/Family""]",1960,6
17227799,Paroma,1984,['India'],['Drama'],1980,4
4115219,Mrs. Santa Claus,1996,['United States of America'],"['Holiday Film', ""Children's/Family""]",1990,6
9190922,That Hagen Girl,1947,['United States of America'],"['Black-and-white', 'Drama']",1940,7
7715229,The Game Plan,2007,['United States of America'],"['Sports', 'Comedy', 'Family Film']",2000,7
17981877,A Star Is Bored,1956,['United States of America'],"['Animation', 'Short Film', 'Comedy', 'Family Film']",1950,6
731501,Deep Cover,1992,['United States of America'],"['Action', 'Neo-noir', 'Crime Fiction', 'Action/Adventure', 'Thriller', 'Crime Thriller']",1990,2
20713868,Flight for Freedom,1943,['United States of America'],"['Drama', 'Biographical film']",1940,3
12873578,Palattu Koman,1962,['India'],['Drama'],1960,2
25090684,Mixing Nia,1998,['United States of America'],"['Black comedy', 'Comedy-drama', 'Comedy']",1990,8
20388612,The Secret Invasion,1964,['United States of America'],"['Action', 'Drama', 'Action/Adventure', 'Thriller', 'War film']",1960,4
8764756,Boy S Tenyu,2005,['Russia'],['Drama'],2000,5
7323532,The Cuban Connection,1997,['Mexico'],['Drama'],1990,7
13755834,The Bigamist,1953,['United States of America'],"['Black-and-white', 'Drama']",1950,3
31119172,Makkal Mahatmyam,1992,[],['Comedy film'],1990,2
20541936,Hello Schoolgirl,2008,['South Korea'],"['Romance Film', 'Comedy']",2000,8
5933142,Chess,2006,['India'],"['Action', 'Crime Fiction', 'Malayalam Cinema', 'Comedy', 'Thriller']",2000,6
5341658,"Smell of Camphor, Fragrance of Jasmine",2000,['Iran'],"['Film à clef', 'Drama', 'World cinema']",2000,0
17259609,Give Us This Day,1949,"['Kingdom of Great Britain', 'United Kingdom']","['Black-and-white', 'Political drama', 'Drama', 'Culture & Society']",1940,9
22340794,Saint Sinner,2002,['United States of America'],"['Television movie', 'Horror']",2000,2
10068581,She Killed in Ecstasy,1971,"['West Germany', 'Spain']","['World cinema', 'Horror']",1970,1
24372734,Saudagar,1973,['India'],['Bollywood'],1970,3
15804268,Final Approach,1991,['United States of America'],"['Action', 'Psychological thriller', 'Action/Adventure', 'Science Fiction', 'Thriller']",1990,1
16928777,Agnes of God,1985,"['Canada', 'United States of America']","['Psychological thriller', 'Mystery', 'Thriller', 'Drama']",1980,5
4018828,RV,2006,"['United Kingdom', 'Germany', 'United States of America']","['Comedy', 'Road movie', 'Adventure', 'Family Film']",2000,6
9813617,Shiloh 2: Shiloh Season,1999,['United States of America'],"['Family Drama', 'Family-Oriented Adventure', ""Children's/Family"", ""Children's"", 'Adventure', 'Drama', 'Animal Picture', 'Family Film']",1990,9
5565318,The Passionate Friends,1949,['United Kingdom'],"['Film adaptation', 'Romantic drama', 'Romance Film', 'Drama']",1940,9
6232030,April in Paris,1952,['United States of America'],"['Musical', 'Comedy', 'Musical comedy', 'Romance Film', 'Romantic comedy']",1950,2
10792106,Thee,1981,['India'],"['Action', 'Crime Fiction', 'Drama']",1980,1
933321,Kelly's Heroes,1970,"['Socialist Federal Republic of Yugoslavia', 'Yugoslavia', 'United States of America']","['Action', 'Crime Fiction', 'Action/Adventure', 'Satire', 'Comedy', 'Adventure', 'Anti-war', 'Heist', 'Anti-war film', 'War film']",1970,0
23446384,Mountain Strawberries 2,1985,['South Korea'],['Erotica'],1980,5
19793556,Zorro,1975,"['France', 'Italy']","['Action', 'Western', 'Comedy', 'Swashbuckler films', 'Adventure']",1970,5
3423042,Rain Without Thunder,1993,['United States of America'],"['Indie', 'Science Fiction', 'Drama', 'Feminist Film']",1990,3
6248136,"Danny, the Champion of the World",1989,['United Kingdom'],"['Comedy-drama', ""Children's/Family"", 'Sports']",1980,9
31456026,The Pay-Off,1930,['United States of America'],['Drama'],1930,0
11862690,Juno,2007,"['Canada', 'United States of America']","['Indie', 'Comedy', 'Teen', 'Romance Film', 'Drama', 'Coming of age', 'Domestic Comedy', 'Comedy-drama', 'Ensemble Film']",2000,7
2823903,The Sunchaser,1996,['United States of America'],"['Crime Fiction', 'Thriller', 'Crime Thriller', 'Road movie', 'Drama']",1990,6
1873693,Taste of Cherry,1997,['Iran'],"['Drama', 'World cinema']",1990,7
26241157,Bowery Buckaroos,1947,['United States of America'],"['Comedy Western', 'Western', 'Comedy', 'Slapstick']",1940,7
7210351,Smoking/No Smoking,1993,"['France', 'Switzerland', 'Italy']","['Time travel', 'Satire', 'Comedy', 'Avant-garde', 'Comedy of manners', 'Experimental film']",1990,3
4213172,The Duchess and the Dirtwater Fox,1976,['United States of America'],"['Action', 'Comedy Western', 'Action/Adventure', 'Western', 'Comedy', 'Romance Film', 'Romantic comedy']",1970,6
2200993,For Keeps?,1988,['United States of America'],"['Romantic drama', 'Teen', 'Romance Film', 'Drama']",1980,8
42293,From Here to Eternity,1953,['United States of America'],"['Film adaptation', 'Romantic drama', 'Romance Film', 'Epic', 'War film', 'Drama']",1950,3
1352794,The Chronicles of Riddick: Dark Fury,2004,['United States of America'],"['Action', 'Animation', 'Action/Adventure', 'Short Film', 'Science Fiction', 'Thriller', 'Anime']",2000,4
19812190,Amrithadhare,2005,['India'],['Drama'],2000,5
10602018,Five Shaolin Masters,1974,['Hong Kong'],"['Action', 'Chinese Movies', 'Martial Arts Film']",1970,4
4965004,Rajamanikyam,2005,['India'],"['Action', 'Comedy']",2000,5
15351941,Genova,2008,['United Kingdom'],"['Drama', 'Mystery', 'Indie', 'Romantic drama', 'Family Drama', 'Horror', 'Romance Film']",2000,8
3584797,The Lineup,1958,['United States of America'],"['Crime Fiction', 'Thriller', 'Film noir', 'Crime Thriller', 'Drama']",1950,8
11506772,"Murder Me, Murder You",1983,['United States of America'],"['Action', 'Detective fiction', 'Crime Fiction', 'Mystery', 'Thriller', 'Crime Thriller', 'Detective', 'Television movie']",1980,3
11582167,Maynila: Sa mga Kuko ng Liwanag,1975,['Philippines'],"['Filipino Movies', 'Drama']",1970,5
14503961,Spook Louder,1943,['United States of America'],"['Black-and-white', 'Mystery', 'Short Film', 'Comedy', 'Film noir', 'Slapstick']",1940,3
682275,The Preacher's Wife,1996,['United States of America'],"['Romantic fantasy', 'Family Drama', 'Heavenly Comedy', 'Romantic drama', 'Romance Film', 'Drama', 'Family Film', 'Fantasy']",1990,6
1189804,Presumed Innocent,1990,['United States of America'],"['Psychological thriller', 'Suspense', 'Mystery', 'Thriller', 'Drama', 'Courtroom Drama']",1990,0
733176,The Double Life of Véronique,1991,"['Norway', 'France', 'Poland']","['Art film', 'Romantic drama', 'World cinema', 'Drama']",1990,1
19557400,Shanghai Story,2004,['China'],"['Chinese Movies', 'Drama']",2000,4
1885499,Au hasard Balthazar,1966,"['Sweden', 'France']","['Crime Fiction', 'Art film', 'World cinema', 'Drama']",1960,6
699208,National Treasure,2004,['United States of America'],"['Action', 'Crime Fiction', 'Action Thrillers', 'Mystery', 'Action/Adventure', 'Thriller', 'Archives and records', 'Adventure', 'Drama', 'Caper story']",2000,4
27384074,P.O.W. The Escape,1986,['United States of America'],"['Action', 'War film', 'Adventure', 'Drama']",1980,6
19844891,Saw VI,2009,"['Canada', 'Australia', 'United Kingdom', 'United States of America']","['Mystery', 'Thriller', 'Horror']",2000,9
14855907,Thick as Thieves,2009,"['Germany', 'United States of America']","['Heist', 'Crime Fiction', 'Gangster Film', 'Thriller', 'Crime Thriller']",2000,9
8931001,Maximum Overdrive,1986,['United States of America'],"['Action', 'Psychological thriller', 'Film adaptation', 'Action/Adventure', 'Comedy', 'Disaster', 'Horror', 'Doomsday film', 'Science Fiction']",1980,6
187642,The Moon Is Blue,1953,['United States of America'],"['Comedy', 'Romance Film', 'Romantic comedy', 'Sex comedy']",1950,3
2037842,Harley Davidson and the Marlboro Man,1991,['United States of America'],"['Action', 'Crime Fiction', 'Action/Adventure', 'Buddy film', 'Adventure', 'Drama', 'Biker Film', 'Western']",1990,1
21052499,Mermaid,2000,['United States of America'],"['Family Drama', 'Television movie', 'Family Film', 'Drama']",2000,0
12235107,Choke,2008,['United States of America'],"['Film adaptation', 'Drama', 'Indie', 'Comedy', 'Black comedy', 'Sex comedy']",2000,8
7567631,Jatt Punjab Daa,1992,['India'],['Action'],1990,2
6701452,Boy on a Dolphin,1957,['United States of America'],"['Romance Film', 'Adventure', 'Drama']",1950,7
666419,Mr. Duck Steps Out,1940,['United States of America'],"['Animation', 'Short Film', 'Comedy']",1940,0
2383581,Chiriyakhana,1967,['India'],"['Mystery', 'Thriller']",1960,7
34476943,The Lawful Cheater,1925,['United States of America'],"['Silent film', 'Crime Fiction', 'Drama']",1920,5
13734892,G.I. Joe: The Rise of Cobra,2009,"['Czech Republic', 'United States of America']","['Action', 'Action Thrillers', 'Thriller', 'Adventure', 'Science Fiction']",2000,9
2246979,My Favorite Brunette,1947,['United States of America'],"['Detective fiction', 'Mystery', 'Comedy', 'Thriller', 'Film noir', 'Romance Film', 'Crime Thriller', 'Parody', 'Detective', 'Romantic comedy']",1940,7
9516017,Lakshmi Kalyanam,2007,['India'],['Drama'],2000,7
23974422,Gangster Story,1960,['United States of America'],"['Heist', 'Black-and-white', 'Crime Fiction', 'Gangster Film', 'Biopic [feature]', 'Crime Drama', 'Drama']",1960,0
3096248,Howling IV: The Original Nightmare,1988,"['United Kingdom', 'United States of America']","['Creature Film', 'Indie', 'Horror']",1980,8
3957197,Cry Danger,1951,['United States of America'],"['Thriller', 'Film noir', 'Crime Thriller', 'Drama']",1950,1
98503,Alfie,1966,['United Kingdom'],"['LGBT', 'Romantic drama', 'Comedy', 'Romance Film', 'Drama', 'Sex comedy']",1960,6
4556334,The Last Voyage,1960,['United States of America'],"['Action', 'Drama', 'Action/Adventure', 'Disaster']",1960,0
5458268,Bye Bye Brasil,1979,"['Brazil', 'Argentina', 'France']","['World cinema', 'Comedy-drama', 'Road movie', 'Drama']",1970,9
18733228,The Son of Dr. Jekyll,1951,['United States of America'],['Horror'],1950,1
23998137,"Daniel Boone, Trail Blazer",1956,['United States of America'],"['Period piece', 'Biography', 'Action/Adventure', 'Western', 'Adventure']",1950,6
14671645,The Pride of St. Louis,1952,['United States of America'],"['Black-and-white', 'Biographical film', 'Biopic [feature]', 'Drama']",1950,2
12888902,Father Brown,1954,['United Kingdom'],"['Black-and-white', 'Crime Fiction', 'Comedy', 'Drama']",1950,4
2372994,The General's Daughter,1999,"['Germany', 'United States of America']","['Crime Fiction', 'Mystery', 'Thriller', 'Crime Thriller', 'Drama']",1990,9
14432487,Charandas Chor,1975,['India'],"[""Children's"", 'Art film']",1970,5
7752732,The Comebacks,2007,['United States of America'],"['Sports', 'Parody', 'Comedy']",2000,7
1052246,Topsy Turvy,1999,['United Kingdom'],"['Musical', 'Biography', 'Indie', 'Comedy', 'Biographical film', 'Romance Film', 'Costume drama', 'Drama', 'Period piece', 'Parody']",1990,9
24643555,Itinéraire d'un enfant gâté,1988,"['France', 'Germany', 'West Germany']","['Romantic drama', 'Comedy', 'Romance Film', 'Comedy-drama', 'Adventure', 'Drama']",1980,8
8775743,The Alphabet Killer,2008,['United States of America'],"['Psychological thriller', 'Crime Fiction', 'Mystery', 'Indie', 'Thriller', 'Crime Thriller', 'Slasher', 'Horror']",2000,8
13104315,Salim Langde Pe Mat Ro,1990,['India'],"['Musical', 'Bollywood', 'World cinema', 'Drama']",1990,0
33500890,Dog Tags,2008,['United States of America'],"['LGBT', 'Drama', 'Indie']",2000,8
6734914,The Haunted Palace,1963,['United States of America'],"['Film adaptation', 'Gothic Film', 'Horror', 'Costume Horror', 'Supernatural', 'Drama', 'Haunted House Film']",1960,3
28459589,Playing Beatie Bow,1986,['Australia'],"['Family Film', 'Fantasy']",1980,6
21212647,Post Impact,2004,"['Germany', 'United States of America']","['Action', 'Action/Adventure', 'Adventure', 'Television movie', 'Disaster', 'Supernatural', 'Science Fiction']",2000,4
10841191,You Are the One,2007,['Philippines'],"['Filipino Movies', 'Romantic drama', 'World cinema', 'Romance Film', 'Drama']",2000,7
28946416,After Tomorrow,1932,['United States of America'],['Drama'],1930,2
6244430,Subway,1985,['France'],"['Action', 'Comedy Thriller', 'Thriller', 'Action/Adventure', 'World cinema', 'Crime Thriller']",1980,5
2558435,Skin Game,1971,['United States of America'],"['Action', 'Action/Adventure', 'Western', 'Comedy']",1970,1
2557050,Silver Lode,1954,['United States of America'],"['Action/Adventure', 'Western']",1950,4
5271335,Twice in a Lifetime,1985,['United States of America'],"['Romance Film', 'Indie', 'Drama']",1980,5
19543621,The Glasshead,1998,['United States of America'],['Horror'],1990,8
12850795,Dark Resurrection,2007,['Italy'],['Indie'],2000,7
1591979,Inside Daisy Clover,1965,['United States of America'],"['Period piece', 'Drama']",1960,5
896395,Peyton Place,1957,['United States of America'],"['Film adaptation', 'Coming of age', 'Romantic drama', 'Ensemble Film', 'Teen', 'Romance Film', 'Drama']",1950,7
6393328,Witchcraft II: The Temptress,1989,['United States of America'],"['Softcore Porn', 'Horror']",1980,9
9002807,The Untold,2002,['Canada'],['Horror'],2000,2
3707686,Vicki,1953,['United States of America'],"['Psychological thriller', 'Black-and-white', 'Mystery', 'Thriller', 'Film noir', 'Drama']",1950,3
199505,The Man with Two Brains,1983,['United States of America'],"['Parody', 'Satire', 'Comedy', 'Horror', 'Romance Film', 'Romantic comedy', 'Science Fiction']",1980,3
26164871,3 Nuts in Search of a Bolt,1964,['United States of America'],"['Comedy', 'Cult']",1960,4
15117612,Chocolate,2008,['Thailand'],"['Action', 'Action/Adventure', 'Comedy', 'World cinema', 'Martial Arts Film']",2000,8
25366294,A Killer Among Friends,1992,['United States of America'],['Drama'],1990,2
1353086,The Fearless Vampire Killers,1967,"['United Kingdom', 'United States of America']","['Parody', 'Comedy', 'Horror', 'Cult']",1960,7
7865906,Bridge to Terabithia,1985,['Canada'],"['Television movie', 'Adventure', 'Family Film']",1980,5
25548532,Moonlight and Mistletoe,2008,['United States of America'],"['Family Drama', 'Television movie', 'Family Film', 'Drama']",2000,8
7800159,Full Grown Men,2006,['United States of America'],"['Indie', 'Comedy', 'Drama']",2000,6
32442607,Hothat Brishti,2002,"['India', 'Bangladesh']",['Romance Film'],2000,2
2977312,Pumpkin,2002,['United States of America'],"['Drama', 'Indie', 'Romantic drama', 'Comedy', 'Black comedy', 'Romantic comedy', 'Romance Film']",2000,2
5150761,Devour,2005,['United States of America'],"['Psychological thriller', 'Sci-Fi Horror', 'Horror']",2000,5
1202791,Raise Your Voice,2004,['United States of America'],"['Musical', 'Family Drama', 'Musical Drama', 'Teen', 'Romance Film', 'Drama', 'Family Film']",2000,4
1423029,Tortoise Beats Hare,1941,['United States of America'],"['Animation', 'Short Film', 'Comedy', 'Family Film']",1940,1
13861985,The Perfect Holiday,2007,['United States of America'],"['Romantic drama', 'Comedy', 'Romance Film', ""Children's/Family"", 'Holiday Film', 'Drama', 'Romantic comedy', 'Family Film']",2000,7
2590391,The Head of Janus,1920,"['Weimar Republic', 'Germany']","['Black-and-white', 'Indie', 'Horror', 'Silent film']",1920,0
27286055,Murder by the Clock,1931,['United States of America'],"['Mystery', 'Horror']",1930,1
20632614,Speedy Scandal,2008,['South Korea'],"['Music', 'Comedy film', 'Romantic comedy', 'Drama', 'Family Film']",2000,8
2739013,Fatso,1980,['United States of America'],"['Romance Film', 'Romantic comedy', 'Comedy']",1980,0
15033858,Sleep Dealer,2008,"['Mexico', 'United States of America']","['Drama', 'Indie', 'World cinema', 'Science Fiction']",2000,8
21852596,Anand Aur Anand,1984,['India'],"['Musical', 'Thriller', 'Bollywood', 'World cinema']",1980,4
19247108,Crown vs. Stevens,1936,['United Kingdom'],"['Crime Fiction', 'Thriller']",1930,6
1152416,Antitrust,2001,['United States of America'],"['Action', 'Suspense', 'Crime Fiction', 'Action/Adventure', 'Thriller', 'Crime Thriller', 'Drama']",2000,1
5154250,Hot to Trot,1988,['United States of America'],['Comedy'],1980,8
17813880,The Beach Nut,1944,[],['Animation'],1940,4
13914696,Arayannagalude Veedu,2000,['India'],['Drama'],2000,0
5326903,Triple agent,2004,"['Spain', 'Russia', 'France', 'Greece', 'Italy']","['Spy', 'Marriage Drama', 'Thriller', 'World cinema', 'Drama']",2000,4
4213198,Wildcats,1986,['United States of America'],"['Sports', 'Comedy']",1980,6
33440196,The Girl on the Bridge,1951,[],['Drama'],1950,1
2415806,Inventing the Abbotts,1997,['United States of America'],"['Period piece', 'Coming of age', 'Romantic drama', 'Teen', 'Romance Film', 'Americana', 'Drama']",1990,7
25119882,The First 7th Night,2009,['Hong Kong'],"['Chinese Movies', 'Horror']",2000,9
8475649,Anima,2003,['United States of America'],"['Short Film', 'Drama', 'Horror']",2000,3
694405,Beloved,1998,['United States of America'],"['Costume drama', 'Drama']",1990,8
264869,Lifeboat,1944,['United States of America'],"['Film adaptation', 'War film', 'Adventure', 'Drama', 'Ensemble Film']",1940,4
7677747,Blind Horizon,2003,['United States of America'],"['Psychological thriller', 'Suspense', 'Mystery', 'Thriller', 'Drama', 'Political thriller']",2000,3
5387833,The History Boys,2006,['United Kingdom'],"['LGBT', 'Comedy', 'Teen', 'Drama', 'Period piece', 'Coming of age', 'Comedy-drama', 'Ensemble Film']",2000,6
1067272,Bandits,2001,['United States of America'],"['Heist', 'Crime Fiction', 'Buddy film', 'Comedy', 'Romantic comedy', 'Romance Film', 'Drama']",2000,1
6719022,Barbie in the 12 Dancing Princesses,2006,['United States of America'],"['Computer Animation', ""Children's Fantasy"", 'Animation', ""Children's/Family"", ""Children's"", 'Family Film', 'Fantasy']",2000,6
25902613,Pillai Nila,1985,['India'],['Horror'],1980,5
21905305,Short Sharp Shock,1998,['Germany'],"['Drama', 'Crime Fiction', 'Thriller']",1990,8
24380314,Mac,1992,['United States of America'],"['Period piece', 'Indie', 'Drama']",1990,2
1273496,Contraband,1940,['United Kingdom'],"['Spy', 'Black-and-white']",1940,0
570428,One Million Years BC,1966,['United Kingdom'],"['Action/Adventure', 'Science Fiction', 'Stop motion', 'Adventure', 'Fantasy']",1960,6
3702581,Holy Man,1998,['United States of America'],"['Screwball comedy', 'Parody', 'Comedy', 'Media Satire']",1990,8
4083099,Alone in the Dark,1982,['United States of America'],"['Indie', 'Slasher', 'Thriller', 'Horror', 'Black comedy']",1980,2
28296161,Barbed Wire,1952,['United States of America'],"['Action', 'Drama', 'Action/Adventure', 'Western']",1950,2
21278119,Starquest II,1997,['United States of America'],"['Science Fiction', 'Thriller']",1990,7
2216783,Bounce,2000,['United States of America'],"['Romance Film', 'Drama']",2000,0
19246209,Bhalobasa Bhalobasa,2008,['India'],"['Musical', 'Drama', 'Comedy film']",2000,8
11962392,The Day Will Dawn,1942,['United Kingdom'],"['Action', 'Black-and-white', 'Drama', 'Thriller', 'War film']",1940,2
12234896,Anokhi Raat,1968,['India'],"['Romantic drama', 'World cinema', 'Romance Film', 'Drama']",1960,8
8125563,Judgement Day,1999,['United States of America'],"['Action', 'Action/Adventure', 'Science Fiction', 'Thriller', 'Disaster']",1990,9
2846827,Doraemon: Nobita Drifts in the Universe,1999,['Japan'],"['Japanese Movies', 'Animation']",1990,9
8897338,Like Father Like Son,1987,['United States of America'],"['Screwball comedy', 'Comedy', 'Teen', 'Family Film', 'Fantasy']",1980,7
7999852,Khosla Ka Ghosla,2006,['India'],"['Musical', 'Art film', 'Comedy', 'Bollywood', 'World cinema']",2000,6
488484,Pitch Black,2000,['United States of America'],"['Action', 'Indie', 'Thriller', 'Horror', 'Adventure', 'Science Fiction']",2000,0
600209,Kalifornia,1993,['United States of America'],"['Crime Fiction', 'Thriller', 'Crime Thriller', 'Road movie', 'Drama']",1990,3
6774987,Gideon Tuba Warrior,2006,[],"['Musical', 'Animation', ""Children's""]",2000,6
3256994,Mom at Sixteen,2005,['United States of America'],"['Television movie', 'Family Drama', 'Drama']",2000,5
165366,Stranger Than Paradise,1984,"['Germany', 'United States of America', 'West Germany']","['Black-and-white', 'Indie', 'Buddy film', 'Comedy', 'Black comedy', 'Road movie']",1980,4
1001896,The First of the Few,1942,['United Kingdom'],"['Black-and-white', 'Biopic [feature]', 'War film', 'Drama']",1940,2
2012442,Up Close & Personal,1996,['United States of America'],"['Romance Film', 'Romantic drama', 'Drama']",1990,6
17046277,Greaser's Palace,1972,['United States of America'],"['Parody', 'Western', 'Comedy', 'Action/Adventure', 'Acid western']",1970,2
27997159,Land Raiders,1969,['United States of America'],"['Action', 'Crime Fiction', 'Action/Adventure', 'Thriller', 'Romance Film', 'Crime Thriller', 'Spaghetti Western', 'Drama', 'Western']",1960,9
4836948,Mrs. Miniver,1942,"['United Kingdom', 'United States of America']","['Black-and-white', 'Family Drama', 'War film', 'Propaganda film', 'Drama']",1940,2
287767,The Firm,1993,['United States of America'],"['Film adaptation', 'Mystery', 'Thriller', 'Documentary', 'Crime Thriller', 'Drama', 'Courtroom Drama', 'Suspense']",1990,3
9606474,Flame of Barbary Coast,1945,['United States of America'],"['Action', 'Black-and-white', 'Hybrid Western', 'Action/Adventure', 'Western', 'Romance Film', 'Drama']",1940,5
20192695,The Crocodile,2005,['Cambodia'],"['Horror', 'Natural horror films']",2000,5
25297309,Thunder in the East,1952,['United States of America'],"['Romantic drama', 'Romance Film', 'War film', 'Drama']",1950,2
12055899,Like a Virgin,2006,['South Korea'],"['LGBT', 'Coming of age', 'Comedy', 'Sports', 'Drama']",2000,6
4260551,The Arrival,1996,"['Mexico', 'United States of America']","['Science Fiction', 'Drama']",1990,6
213224,Shadow of the Vampire,2000,"['United Kingdom', 'Luxembourg', 'United States of America']","['Period piece', 'Drama', 'Indie', 'Gothic Film', 'Horror', 'Costume Horror']",2000,0
17999628,Universal Soldier III: Unfinished Business,1998,['Canada'],"['Action', 'Science Fiction', 'Action/Adventure']",1990,8
19908658,Transylvania Twist,1989,['United States of America'],"['Parody', 'Comedy', 'Horror', 'B-movie', 'Fantasy']",1980,9
61052,Skippy,1931,['United States of America'],"['Black-and-white', 'Comedy', 'Drama', 'Family Film']",1930,1
21078898,Son of the Dragon,2006,"['China', 'United States of America']",['Chinese Movies'],2000,6
2262072,The Spirit of St. Louis,1957,['United States of America'],"['Action', 'Biography', 'Action/Adventure', 'Biographical film', 'Drama', 'Airplanes and airports', 'Biopic [feature]', 'Historical fiction', 'Epic']",1950,7
1480748,House Party 3,1994,['United States of America'],"['Coming of age', 'Comedy', 'Teen', 'Cult']",1990,4
25757812,Garuda,2004,['Thailand'],"['Creature Film', 'Action/Adventure', 'Horror', 'World cinema']",2000,4
19931725,Slaughter Hotel,1971,['Italy'],"['Slasher', 'World cinema', 'Horror']",1970,1
17618251,Dashavatar,2008,['India'],"['Musical', 'Animation', 'Bollywood', 'World cinema']",2000,8
26550158,Vettam,2004,['India'],['Romantic comedy'],2000,4
7427038,The Naked Monster,2006,['United States of America'],"['Comedy horror', 'Parody', 'Horror', 'B-movie', 'Alien Film', 'Science Fiction']",2000,6
950429,Swimming Pool,2003,"['United Kingdom', 'France']","['Psychological thriller', 'Crime Fiction', 'Mystery', 'Indie', 'Thriller', 'World cinema', 'Romance Film', 'Drama', 'Erotic thriller', 'Erotica']",2000,3
25771135,The Chain Reaction,1980,['Australia'],"['Action', 'Thriller']",1980,0
6109201,Joshua Tree,1993,['United States of America'],"['Action', 'Crime Fiction', 'Indie', 'Action/Adventure', 'Thriller', 'Adventure']",1990,3
12657358,Black Water,2007,"['United Kingdom', 'New Zealand', 'Australia']","['Thriller', 'Horror', 'Drama', 'Natural horror films']",2000,7
5700240,Flesheater,1988,['United States of America'],"['Creature Film', 'Indie', 'Teen', 'Horror', 'B-movie', 'Zombie Film']",1980,8
918091,Easter Parade,1948,['United States of America'],"['Musical', 'Backstage Musical', 'Comedy', 'Musical comedy']",1940,8
3838937,The Ghost of St. Michael's,1941,['United Kingdom'],"['Black-and-white', 'Mystery', 'Comedy', 'Thriller']",1940,1
24372500,Margery and Gladys,2003,['United Kingdom'],"['Drama', 'Comedy']",2000,3
4894283,The Stewardesses,1969,['United States of America'],"['Drama', 'Softcore Porn', 'Sexploitation', 'Comedy', 'Pornographic movie', 'Adult']",1960,9
25766248,Charlie Chan in Honolulu,1938,['United States of America'],"['Mystery', 'Crime Thriller', 'Thriller']",1930,8
16907084,Sweeney 2,1978,['United Kingdom'],"['Detective fiction', 'Crime Fiction', 'Mystery', 'Detective', 'Drama']",1970,8
10034941,The Next Race: The Remote Viewings,2007,['United States of America'],"['Short Film', 'Science Fiction']",2000,7
286852,A Kid in King Arthur's Court,1995,"['United Kingdom', 'Hungary', 'United States of America']","[""Children's Fantasy"", 'Comedy', ""Children's/Family"", 'Adventure', 'Fantasy Comedy', 'Family Film', 'Fantasy']",1990,5
20985745,Women in Trouble,2009,['United States of America'],"['Indie', 'Ensemble Film', 'Comedy', 'Sex comedy']",2000,9
30864791,Majhdhaar,1996,['India'],"['Romance Film', 'Drama']",1990,6
1771625,"Easy Come, Easy Go",1967,['United States of America'],"['Musical', 'Comedy', 'Romance Film', 'Romantic comedy']",1960,7
1986156,Tango & Cash,1989,['United States of America'],"['Action', 'Crime Fiction', 'Action Comedy', 'Action/Adventure', 'Buddy film', 'Comedy', 'Drama']",1980,9
13266250,Docteur Françoise Gailland,1976,['France'],"['Family Drama', 'Drama']",1970,6
18002803,No.20 Madras Mail,1990,['India'],['Comedy'],1990,0
4939088,Away From Her,2007,"['United Kingdom', 'United States of America', 'Canada']","['Romantic drama', 'Indie', 'Marriage Drama', 'Romance Film', 'Drama']",2000,7
3644204,Naked Alibi,1954,['United States of America'],"['Black-and-white', 'Crime Fiction', 'Thriller', 'Film noir', 'Crime Thriller', 'Drama']",1950,4
4265347,Hairspray,2007,"['United Kingdom', 'United States of America']","['Musical', 'LGBT', 'Parody', 'Comedy film', 'Romance Film', 'Cult']",2000,7
10772270,The Puppetoon Movie,1987,['United States of America'],"['Family Film', 'Animation']",1980,7
1433676,The Delinquents,1989,['Australia'],['Drama'],1980,9
19877711,Biloxi Blues,1988,['United States of America'],"['Period piece', 'Film adaptation', 'Comedy', 'Drama']",1980,8
26052390,The Men I Wanted,2007,['Italy'],['Gay pornography'],2000,7
10217126,Gaman,1978,['India'],['Drama'],1970,8
12347447,Nightmare Weekend,1986,"['United Kingdom', 'France', 'United States of America']","['Indie', 'Horror', 'B-movie', 'Zombie Film', 'Science Fiction']",1980,6
24776112,His Hare-Raising Tale,1951,[],"['Animation', 'Short Film', 'Family Film']",1950,1
24642297,26 Summer Street,1996,[],['Short Film'],1990,6
1018874,First Daughter,2004,['United States of America'],"['Comedy', 'Teen', 'Romance Film', 'Romantic comedy', 'Drama']",2000,4
334156,Character,1997,"['Netherlands', 'Belgium']","['Period piece', 'Crime Fiction', 'Family Drama', 'World cinema', 'Drama']",1990,7
177776,The Sin of Madelon Claudet,1931,['United States of America'],"['Black-and-white', 'Melodrama', 'Drama']",1930,1
17273758,Outside the Law,1920,['United States of America'],"['Silent film', 'Black-and-white', 'Crime Fiction']",1920,0
11618840,Intruder,1989,['United States of America'],"['Slasher', 'B-movie', 'Horror']",1980,9
3614858,Ju-on 2,2000,['Japan'],"['Japanese Movies', 'World cinema', 'Horror']",2000,0
2565462,Sophie Scholl – The Final Days,2005,['Germany'],"['Crime Fiction', 'History', 'Biographical film', 'World cinema', 'Political drama', 'War film', 'Drama']",2000,5
8077258,Gunaah,2002,['India'],"['Drama', 'Crime Fiction']",2000,2
28462923,Le Voyage en douce,1980,['France'],"['Drama', 'World cinema']",1980,0
3011301,Kondaveeti Donga,1990,['India'],"['Action', 'Musical']",1990,0
956994,The Skydivers,1963,['United States of America'],"['Drama', 'Crime Fiction']",1960,3
16791614,Son of Fury: The Story of Benjamin Blake,1942,['United States of America'],"['Action', 'Black-and-white', 'Action/Adventure', 'Adventure', 'Romance Film', 'Drama']",1940,2
15263355,Two:Thirteen,2009,['United States of America'],"['Psychological thriller', 'Slasher', 'Thriller', 'Crime Thriller']",2000,9
17550887,Elina: As If I Wasn't There,2002,"['Finland', 'Sweden']","['Drama', 'Family Film']",2000,2
22216002,Judgment,2001,"['Canada', 'United States of America']","['Indie', 'Drama', 'Courtroom Drama']",2000,1
25557070,The Most Wonderful Time of the Year,2008,['United States of America'],"['Comedy', 'Romantic comedy', 'Television movie', 'Romance Film', 'Holiday Film', 'Family Film']",2000,8
23257851,Paa,2009,['India'],"['Drama', 'Bollywood', 'World cinema']",2000,9
27249473,The Tenderness of Wolves,1973,['Germany'],"['Drama', 'World cinema']",1970,3
183851,"Edward, My Son",1949,"['United Kingdom', 'United States of America']","['Black-and-white', 'Family Drama', 'Melodrama', 'Drama']",1940,9
26599859,Patham Nilayile Theevandi,2009,['India'],"['Family Drama', 'Drama']",2000,9
3315039,Black Mask,1996,['Hong Kong'],"['Action/Adventure', 'World cinema', 'Superhero movie', 'Chinese Movies', 'Martial Arts Film']",1990,6
1188393,Title to Murder,2001,['United States of America'],"['Action', 'Gangster Film', 'Indie', 'Mystery', 'Thriller', 'Romance Film', 'Crime Thriller', 'Comedy film', 'Romantic comedy']",2000,1
364250,Cowboy Bebop: The Movie,2001,['Japan'],"['Action', 'Animation', 'Japanese Movies', 'Future noir', 'Comedy', 'Anime', 'Science Fiction']",2000,1
811849,Once a Thief,1991,['Hong Kong'],"['Crime Fiction', 'Gangster Film', 'Action/Adventure', 'Buddy film', 'Thriller', 'World cinema', 'Crime Thriller', 'Chinese Movies', 'Martial Arts Film', 'Heist']",1990,1
8248274,Bread and Chocolate,1974,['Italy'],"['Comedy', 'Drama', 'World cinema']",1970,4
5945470,Dil,1990,['India'],"['Romance Film', 'Comedy', 'Drama']",1990,0
20179720,Ghost World,2001,"['United Kingdom', 'Germany', 'United States of America']","['Indie', 'Action/Adventure', 'Coming of age', 'Comedy', 'Teen', 'Black comedy', 'Comedy-drama']",2000,1
27714851,Kiss Tomorrow Goodbye,1950,['United States of America'],"['Black-and-white', 'Crime Fiction', 'Gangster Film', 'Thriller', 'Film noir', 'Crime Thriller']",1950,0
18062757,Joy Ride 2: Dead Ahead,2008,['United States of America'],"['Psychological thriller', 'Suspense', 'Mystery', 'Thriller', 'Horror', 'Crime Thriller', 'Road movie']",2000,8
13393215,Imagine That,2009,"['Germany', 'United States of America']","['Comedy', 'Drama', 'Family Film', 'Fantasy']",2000,9
28873034,A Feather in Her Hat,1935,['United States of America'],"['Melodrama', 'Drama']",1930,5
2700693,The Big Easy,1986,['United States of America'],"['Crime Fiction', 'Mystery', 'Indie', 'Thriller', 'Romance Film', 'Crime Thriller', 'Drama', 'Erotic thriller']",1980,6
14230594,Jayamkondaan,2008,['India'],"['Action', 'Romance Film']",2000,8
475977,Can't Hardly Wait,1998,['United States of America'],"['Comedy', 'Teen', 'Romance Film', 'Romantic comedy', 'Drama', 'Ensemble Film']",1990,8
4616881,Slam Dunk Ernest,1995,['United States of America'],"['Slapstick', 'Comedy', 'Sports', 'Family Film']",1990,5
2209172,Overboard,1987,['United States of America'],"['Screwball comedy', 'Comedy', 'Romance Film', 'Romantic comedy', 'Drama']",1980,7
5470975,Stakeout on Dope Street,1958,['United States of America'],"['Black-and-white', 'Crime Fiction', 'Drama']",1950,8
17475674,On a Clear Day You Can See Forever,1970,['United States of America'],"['Musical', 'Comedy', 'Musical comedy', 'Romance Film', 'Romantic comedy', 'Drama', 'Fantasy']",1970,0
22391703,Great Moments in Aviation,1993,['United Kingdom'],"['Romance Film', 'Romantic drama', 'Drama']",1990,3
26109999,Please Believe Me,1950,['United States of America'],['Romantic comedy'],1950,0
19408575,Arbor Day,1936,['United States of America'],"['Black-and-white', 'Short Film', 'Comedy', 'Family Film']",1930,6
7558410,Totally Fucked Up,1994,['United States of America'],"['LGBT', 'Drama', 'Indie']",1990,4
12652521,Rancho Deluxe,1975,['United States of America'],"['Action', 'Comedy Western', 'Action/Adventure', 'Western', 'Comedy']",1970,5
77619,Kings Row,1942,['United States of America'],"['Black-and-white', 'Family Drama', 'Romantic drama', 'Romance Film', 'Melodrama', 'Americana', 'Drama']",1940,2
14938510,Class Trip,1998,['France'],"['LGBT', 'Mystery', 'Childhood Drama', 'World cinema', 'Drama']",1990,8
17826058,Sex,1920,['United States of America'],"['Silent film', 'Black-and-white', 'Drama']",1920,0
22771725,The Revenant,2009,['United States of America'],"['Action', 'Comedy', 'Horror', 'Zombie Film', 'B-movie', 'Adventure']",2000,9
9536996,Young Soul Rebels,1991,['United Kingdom'],"['LGBT', 'Mystery', 'Indie', 'Thriller', 'Drama', 'Gay Themed', 'Gay', 'Gay Interest']",1990,1
6288902,Petulia,1968,"['United Kingdom', 'United States of America']","['Romance Film', 'Romantic drama', 'Drama']",1960,8
7584796,Dharam Jeet,1975,['India'],[],1970,5
2120933,An Innocent Man,1989,['United States of America'],"['Action', 'Prison', 'Crime Fiction', 'Drama']",1980,9
431014,Big Fish,2003,['United States of America'],"['Film adaptation', 'Family Drama', 'Comedy', 'Adventure', 'Drama', 'Period piece', 'Comedy-drama', 'War film', 'Fantasy Comedy', 'Fantasy']",2000,3
22775734,The Devil's Tomb,2009,['United States of America'],"['Action', 'Thriller', 'Horror', 'Science Fiction']",2000,9
11585638,Came a Hot Friday,1985,['New Zealand'],"['Period piece', 'Comedy', 'Crime Comedy']",1980,5
3158499,Juice,1992,['United States of America'],"['Action', 'Crime Fiction', 'Action/Adventure', 'Thriller', 'Horror', 'Crime Thriller', 'Drama']",1990,2
18097760,Wake Up and Dream,1946,['United States of America'],['Drama'],1940,6
11501271,Anna Karenina,1997,['United States of America'],"['Romance Film', 'Costume drama', 'Drama']",1990,7
8002440,The Trial of the Incredible Hulk,1989,['United States of America'],"['Action', 'Superhero', 'Adventure', 'Superhero movie', 'Science Fiction', 'Drama', 'Fantasy']",1980,9
31529757,Tara Sasankam,1969,['India'],"['Musical', 'Romance Film', 'Drama']",1960,9
19087098,A Waste of Shame,2005,['United Kingdom'],"['Period piece', 'Romantic drama', 'Biopic [feature]', 'Romance Film', 'Docudrama', 'Drama']",2000,5
5018573,Pet Sematary,1989,['United States of America'],"['Film adaptation', 'Mystery', 'Thriller', 'Zombie Film', 'Drama', 'Horror', 'Supernatural', 'Fantasy']",1980,9
2617126,Get Rich or Die Tryin',2005,['United States of America'],"['Action', 'Crime Fiction', 'Coming of age', 'Musical Drama', 'Biographical film', 'Hip hop movies', 'Drama']",2000,5
308430,The Faculty,1998,['United States of America'],"['Mystery', 'Thriller', 'Horror', 'Teen', 'Alien Film', 'Sci-Fi Horror', 'Science Fiction']",1990,8
3779120,The Karaoke King,2006,['United States of America'],"['Musical', 'Indie', 'Comedy', 'Drama']",2000,6
7832996,Youth,2002,['India'],[],2000,2
8118416,Tony Hawk in Boom Boom Sabotage,2006,['United States of America'],"['Animation', 'Chase Movie', 'Adventure', 'Family Film', 'Computer Animation']",2000,6
10662403,Le Golem,1936,"['Czechoslovakia', 'France']","['Fantasy', 'Horror']",1930,6
2272726,Angie,1994,['United States of America'],"['Film adaptation', 'Romantic drama', 'Romance Film', 'Romantic comedy', 'Drama']",1990,4
19422338,My Dear Enemy,2008,['South Korea'],"['Romantic drama', 'World cinema', 'Romance Film', 'Drama']",2000,8
29220422,The Man in the Back Seat,1961,[],"['Drama', 'Crime Fiction']",1960,1
165330,The Black Stallion,1979,['United States of America'],"['Film adaptation', 'Family Drama', 'Sports', 'Adventure', 'Drama', 'Family Film']",1970,9
34694046,Naseeb Apna Apna,1986,['India'],[],1980,6
31092862,The Daughter of Rosie O'Grady,1950,['United States of America'],"['Musical', 'Romance Film', 'Comedy']",1950,0
2995378,Waterfront,1944,['United States of America'],"['Thriller', 'Romance Film', 'Crime Thriller', 'War film', 'Drama']",1940,4
3970995,The Hired Hand,1971,['United States of America'],"['Revisionist Western', 'Action/Adventure', 'Western', 'Acid western']",1970,1
3654841,"Kiss Me, Stupid",1964,['United States of America'],"['Black-and-white', 'Screwball comedy', 'Comedy']",1960,4
33406568,Mar Mitenge,1988,['India'],"['Action', 'Drama']",1980,8
10396412,Family Honeymoon,1949,['United States of America'],"['Black-and-white', 'Comedy', 'Romance Film', ""Children's/Family""]",1940,9
9912115,The Bodyguard 2,2007,['Thailand'],"['Action', 'Action/Adventure', 'Comedy', 'World cinema', 'Martial Arts Film', 'Absurdism']",2000,7
23927080,Mr. Soft Touch,1949,['United States of America'],"['Black-and-white', 'Film noir', 'Comedy-drama', 'Drama']",1940,9
30864723,Before the Rain,1994,"['United Kingdom', 'France', 'Republic of Macedonia']","['World cinema', 'War film', 'Political drama', 'Drama']",1990,4
28795408,Valmiki,1946,['India'],[],1940,6
29636403,Scooby-Doo and the Alien Invaders,2000,['United States of America'],"[""Children's Fantasy"", 'Animation', ""Children's/Family"", 'Alien Film', 'Science Fiction', 'Family Film']",2000,0
24162487,The Gamblers,1929,['United States of America'],['Drama'],1920,9
18738928,Moggina Manasu,2008,['India'],[],2000,8
11243510,Strife with Father,1950,['United States of America'],"['Animation', 'Short Film', 'Comedy']",1950,0
9186353,Pendekar Bujang Lapok,1959,"['Singapore', 'Malaysia']","['Musical', 'Martial Arts Film', 'Comedy']",1950,9
9129701,Cleaner,2008,['United States of America'],"['Thriller', 'Crime Thriller']",2000,8
3863892,Full Body Massage,1995,['United States of America'],['Drama'],1990,5
240357,Interiors,1978,['United States of America'],"['Drama', 'Family Drama', 'Indie', 'New Hollywood']",1970,8
33403102,Atomic Dog,1998,['United States of America'],"['Science Fiction', 'Thriller', 'Horror']",1990,8
156613,Bright Victory,1951,['United States of America'],"['Romance Film', 'War film', 'Drama']",1950,1
4440206,Bathory,2008,"['Slovakia', 'Slovak Republic', 'United Kingdom', 'Hungary', 'Czech Republic']","['Period piece', 'History', 'Gothic Film', 'Biopic [feature]', 'World cinema', 'Drama', 'Fantasy']",2000,8
1203340,Lovewrecked,2006,['United States of America'],"['Comedy', 'Teen', 'Romance Film', 'Romantic comedy', 'Adventure']",2000,6
14144177,Pirates of the High Seas,1950,['United States of America'],"['Adventure', 'Black-and-white']",1950,0
65834,Schindler's List,1993,['United States of America'],"['Film adaptation', 'Black-and-white', 'Biography', 'Biographical film', 'Drama', 'Period piece', 'Tragedy', 'History', 'Biopic [feature]', 'War film']",1990,3
10570436,After Midnight,1989,['United States of America'],"['Slasher', 'Horror']",1980,9
31754318,The Last Supper,1976,['Cuba'],"['Drama', 'World cinema']",1970,6
16166862,Five Star,2002,['India'],['World cinema'],2000,2
3024248,Stay Alive,2006,['United States of America'],"['Slasher', 'Thriller', 'Horror', 'Teen']",2000,6
25162403,The Triumph of Sherlock Holmes,1935,['United Kingdom'],"['Suspense', 'Mystery', 'Thriller', 'Crime Thriller']",1930,5
29198845,Morning Call,1957,[],"['Crime Fiction', 'Thriller']",1950,7
1961084,Boomerang,1992,['United States of America'],"['Comedy', 'Romance Film', 'Romantic comedy', 'Drama', 'Sex comedy']",1990,2
3640544,Persuasion,1995,"['United Kingdom', 'France', 'United States of America']","['Period piece', 'Film adaptation', 'Romantic drama', 'Romance Film', 'Costume drama', 'Drama']",1990,5
4908352,Solaris,2002,['United States of America'],"['Psychological thriller', 'Film adaptation', 'Mystery', 'Thriller', 'Romance Film', 'Adventure', 'Drama', 'Supernatural', 'Science Fiction']",2000,2
3671100,L'Atalante,1934,['France'],"['Black-and-white', 'Romantic drama', 'Marriage Drama', 'World cinema', 'Romance Film', 'Adventure', 'Drama']",1930,4
76346,"Sherlock, Jr.",1924,['United States of America'],"['Black-and-white', 'Crime Fiction', 'Drama', 'Indie', 'Comedy', 'Silent film', 'Fantasy']",1920,4
4450552,The House That Dripped Blood,1971,['United Kingdom'],"['Horror Comedy', 'Horror', 'Haunted House Film', 'B-movie', 'Cult']",1970,1
26074963,Georgekutty C/O Georgekutty,1991,['India'],"['Drama', 'Comedy film']",1990,1
1411283,The Virgin Spring,1960,['Sweden'],"['Black-and-white', 'Crime Fiction', 'Art film', 'Thriller', 'World cinema', 'Crime Thriller', 'Costume drama', 'Drama', 'Period piece', 'Crime Drama']",1960,0
5483303,In the Wake of the Bounty,1933,['Australia'],"['Action', 'Black-and-white', 'Adventure', 'Drama']",1930,3
16255612,Unbelievable Adventures of Italians in Russia,1974,"['Soviet Union', 'Italy']","['Comedy', 'Adventure']",1970,4
4121036,London,2006,"['United Kingdom', 'United States of America']","['Romantic drama', 'Indie', 'Romance Film', 'Drama']",2000,6
12211624,A Flintstone Family Christmas,1993,['United States of America'],['Short Film'],1990,3
1123132,Fright Night,1985,['United States of America'],"['Comedy', 'Thriller', 'Horror', 'Teen', 'Cult']",1980,5
9549959,The Book of Revelation,2006,['Australia'],"['Suspense', 'Mystery', 'Thriller', 'World cinema', 'Erotic thriller', 'Drama']",2000,6
13070759,Heartlands,2003,['United Kingdom'],"['Comedy', 'Comedy-drama', 'Road movie', 'Drama']",2000,3
8267640,King of the Texas Rangers,1941,['United States of America'],"['Action', 'Spy', 'Black-and-white', 'Western']",1940,1
14625185,Shiner,2000,['United Kingdom'],"['Boxing', 'Crime Fiction', 'Gangster Film', 'Thriller', 'Crime Thriller', 'Sports', 'Drama']",2000,0
2650227,Their Eyes Were Watching God,2005,['United States of America'],"['Period piece', 'Film adaptation', 'Romantic drama', 'Romance Film', 'Television movie', 'Drama']",2000,5
8620409,The Dead Girl,2006,['United States of America'],"['Crime Fiction', 'Mystery', 'Indie', 'Thriller', 'Crime Thriller', 'Drama', 'Crime Drama', 'Ensemble Film']",2000,6
1151726,Being Human,1993,"['United Kingdom', 'Japan']","['Japanese Movies', 'Comedy', 'Drama', 'Fantasy']",1990,3
11864625,Avunu Valliddaru Ista Paddaru,2002,['India'],"['Romance Film', 'Comedy', 'Drama']",2000,2
910742,Real Life,1979,['United States of America'],"['Mockumentary', 'Comedy']",1970,9
16957895,The Escapist,2008,"['Ireland', 'United Kingdom']","['Action', 'Drama', 'Crime Fiction', 'Indie', 'Action/Adventure', 'Thriller', 'Crime Thriller']",2000,8
25248084,The New Kids,1985,['United States of America'],"['Slasher', 'Thriller', 'Horror', 'Teen', 'Drama']",1980,5
496401,Forbidden Zone,1980,['United States of America'],"['Surrealism', 'Musical', 'Black-and-white', 'Mystery', 'Comedy', 'Thriller', 'Musical comedy', 'Adventure', 'Parody', 'Science Fiction', 'Cult']",1980,0
22226172,Broken Lullaby,1932,['United States of America'],"['Black-and-white', 'Drama']",1930,2
18153153,Middle Men,2009,['United States of America'],"['Crime Fiction', 'Gangster Film', 'Indie', 'Comedy', 'Black comedy', 'Drama', 'Period piece', 'Biopic [feature]']",2000,9
7885364,The Touch,2004,['Hong Kong'],"['Action/Adventure', 'World cinema', 'Chinese Movies', 'Martial Arts Film', 'Drama']",2000,4
12000999,The Brave One,2007,"['United States of America', 'Australia']","['Action', 'Drama', 'Crime Fiction', 'Thriller', 'Crime Thriller']",2000,7
29541576,Dushmani,2009,['India'],['Action'],2000,9
15062229,The Tale of Sweeney Todd,1997,['United States of America'],"['Musical', 'Mystery', 'Black comedy', 'Drama']",1990,7
32051337,Hulla,2008,['India'],"['Musical', 'Comedy', 'Bollywood', 'World cinema']",2000,8
1745413,Kicking & Screaming,2005,['United States of America'],"['Comedy', ""Children's/Family"", 'Sports', 'Family Film']",2000,5
3099586,Skyjacked,1972,['United States of America'],"['Action', 'Action Thrillers', 'Action/Adventure', 'Thriller', 'Disaster']",1970,2
5374593,Tumsa Nahim Dekha,2004,['India'],"['Romantic drama', 'World cinema', 'Romance Film', 'Drama']",2000,4
6057810,Toward the Unknown,1956,['United States of America'],"['Drama', 'Adventure', 'Thriller']",1950,6
481649,Basic Instinct,1992,"['United States of America', 'France']","['Psychological thriller', 'LGBT', 'Mystery', 'Thriller', 'Erotic thriller', 'Crime Thriller', 'Drama']",1990,2
9322577,Bedlam,1946,['United States of America'],"['Drama', 'Thriller', 'Horror']",1940,6
24999842,The Fifth Day of Peace,1969,"['Yugoslavia', 'Italy']","['War film', 'Drama', 'World cinema']",1960,9
29266340,Aryan,1988,['India'],"['Action', 'Drama', 'Bollywood', 'Romance Film']",1980,8
2443868,Koi Mere Dil Se Poochhe,2002,['India'],"['Musical', 'Romance Film', 'Thriller']",2000,2
4736692,Shyamchi Aai,1953,['India'],"['Musical', 'Bollywood', 'World cinema', 'Drama']",1950,3
4902239,Atonement,2007,"['United Kingdom', 'France']","['Period piece', 'Film adaptation', 'Mystery', 'Romantic drama', 'Romance Film', 'War film', 'Drama']",2000,7
5878592,Don Giovanni,1979,"['United Kingdom', 'France', 'Germany', 'Italy']",[],1970,9
443718,Days of Heaven,1978,['United States of America'],"['Period piece', 'Crime Fiction', 'Romantic drama', 'New Hollywood', 'Romance Film', 'Drama']",1970,8
23141260,Passenger,2009,['India'],"['Thriller', 'Drama']",2000,9
4259578,Devdas,1935,['India'],"['Black-and-white', 'Bengali Cinema']",1930,5
431685,Meeting People Is Easy,1998,['United Kingdom'],"['Music', 'Biography', 'Documentary']",1990,8
19136103,The Cold Room,1984,['United Kingdom'],"['Mystery', 'Thriller', 'Romance Film', 'Science Fiction', 'Drama']",1980,4
6392129,Diggstown,1992,['United States of America'],"['Boxing', 'Crime Fiction', 'Comedy', 'Crime Comedy', 'Sports', 'Drama']",1990,2
1855828,Australian Rules,2002,['Australia'],['Drama'],2000,2
724551,À nous la liberté,1931,"['France', 'United States of America']","['Musical', 'Black-and-white', 'World cinema', 'Satire', 'Comedy', 'Workplace Comedy', 'Fantasy']",1930,1
25639403,Raging Phoenix,2009,['Thailand'],"['Action', 'Action/Adventure', 'Thriller', 'World cinema', 'Crime Thriller', 'Martial Arts Film', 'Adventure']",2000,9
1276943,Anatomy,2000,['Germany'],"['Psychological thriller', 'Thriller', 'Horror', 'World cinema', 'Crime Thriller']",2000,0
23901929,The Sacrament,1990,['Belgium'],['Comedy'],1990,0
28880973,Fort Massacre,1958,['United States of America'],"['Action/Adventure', 'Western']",1950,8
4496097,The Calling,2002,"['Germany', 'United States of America']","['Supernatural', 'Thriller', 'Horror']",2000,2
174560,Willy Wonka & the Chocolate Factory,1971,"['United Kingdom', 'Germany', 'United States of America']","['Musical', 'Film adaptation', 'Comedy', 'Family-Oriented Adventure', ""Children's/Family"", 'Adventure', 'Drama', 'Coming of age', 'Family Film', 'Fantasy']",1970,1
492056,Jacob's Ladder,1990,['United States of America'],"['Psychological thriller', 'Thriller', 'Kafkaesque', 'Horror', 'Supernatural', 'Drama']",1990,0
164517,Love and Kisses,1965,['United States of America'],"['Coming of age', 'Comedy']",1960,5
438417,Orange County,2002,['United States of America'],"['Coming of age', 'Comedy', 'Teen']",2000,2
5138762,Battlefield Baseball,2003,['Japan'],"['Comedy', 'Horror Comedy', 'World cinema', 'Musical comedy', 'Martial Arts Film', 'Japanese Movies', 'Horror', 'Sports']",2000,3
12975952,The Harlem Globetrotters on Gilligan's Island,1981,['United States of America'],['Comedy'],1980,1
19998520,Biswaprakash,1999,['India'],['Drama'],1990,9
27263856,Charlie Chan's Courage,1934,['United States of America'],"['Detective fiction', 'Crime Fiction', 'Mystery', 'Detective', 'Crime Thriller']",1930,4
10034470,Hangin' with the Homeboys,1991,['United States of America'],"['Coming of age', 'Comedy', 'Comedy-drama', 'Drama']",1990,1
15183799,Saath Saath,1982,['India'],['Drama'],1980,2
27365249,Johnny Tiger,1966,['United States of America'],['Drama'],1960,6
6559480,Zatoichi,2003,['Japan'],"['Music', 'Action', 'Crime Fiction', 'Action/Adventure', 'Comedy', 'World cinema', 'Martial Arts Film', 'Drama', 'Japanese Movies']",2000,3
9976763,Kashmir Ki Kali,1964,['India'],['World cinema'],1960,4
1055569,Mike Bassett: England Manager,2001,['United Kingdom'],"['Satire', 'Mockumentary', 'Comedy']",2000,1
6760614,The Southerner,1945,['United States of America'],"['Film adaptation', 'Family Drama', 'Drama']",1940,5
11255321,Jeene Ki Raah,1969,['India'],"['Musical', 'Romantic drama', 'Bollywood', 'World cinema', 'Romance Film', 'Drama']",1960,9
7893719,A Year Without Love,2005,['Argentina'],"['LGBT', 'Erotic Drama', 'Biographical film', 'World cinema', 'Romance Film', 'Drama', 'Gay Themed', 'Gay', 'Gay Interest']",2000,5
12824962,Queen Of The Yukon,1940,['United States of America'],"['Black-and-white', 'Western', 'Drama']",1940,0
1315063,Dragon Ball Z: The Return of Cooler,1992,['Japan'],"['Action', 'Animation', 'Japanese Movies', ""Children's"", 'Anime', 'Science Fiction']",1990,2
74902,Little Fugitive,1953,['United States of America'],"['Black-and-white', 'Drama', ""Children's""]",1950,3
2319006,Spiderbabe,2003,['United States of America'],"['Sexploitation', 'Parody', 'Action/Adventure', 'Comedy', 'Superhero movie', 'Erotica', 'Adult']",2000,3
20869369,Three: After life,2003,"['France', 'Belgium']","['Crime Fiction', 'Comedy', 'World cinema', 'Crime Drama', 'Drama']",2000,3
18661279,Style,2001,['India'],"['Comedy', 'Thriller', 'World cinema', 'Romance Film']",2000,1
20600500,Vampire Cop Ricky,2006,['South Korea'],"['Action', 'Comedy']",2000,6
5346664,Survival Island,2006,"['United Kingdom', 'Luxembourg', 'Netherlands']","['Action', 'Animals', 'Indie', 'Action/Adventure', 'Thriller', 'Suspense', 'Television movie', 'Nature']",2000,6
18612895,Doraemon: Nobita in Dorabian Nights,1991,['Japan'],['Japanese Movies'],1990,1
2857073,Twitches,2005,['United States of America'],"[""Children's Fantasy"", 'Comedy', ""Children's/Family"", 'Family Film', 'Fantasy']",2000,5
1756687,Je suis le seigneur du château,1989,['France'],['Comedy-drama'],1980,9
6493287,Daughter of Darkness,1990,['United States of America'],['Horror'],1990,0
18387449,Legend of Tianyun Mountain,1980,['China'],"['Chinese Movies', 'Drama']",1980,0
26178888,The Story of Ruth,1960,['United States of America'],"['Hagiography', 'Drama']",1960,0
2175456,A Study in Terror,1965,['United Kingdom'],"['Detective fiction', 'Mystery', 'Thriller', 'Detective']",1960,5
21984149,Death on Demand,2007,['United States of America'],"['Slasher', 'Horror', 'B-movie', 'Haunted House Film']",2000,7
24915636,Bakgat,2008,['South Africa'],['Comedy film'],2000,8
25725655,The Dirty Dozen: The Fatal Mission,1988,"['Yugoslavia', 'Italy', 'United States of America']","['Period piece', 'Action', 'Action/Adventure', 'Thriller', 'Television movie', 'War film', 'Adventure']",1980,8
21029252,Miss March,2009,['United States of America'],"['Comedy', 'Buddy film', 'Teen', 'Road movie', 'Sex comedy']",2000,9
296252,EXistenZ,1999,"['Canada', 'United Kingdom']","['Psychological thriller', 'Future noir', 'Thriller', 'Adventure', 'Crime Thriller', 'Science Fiction']",1990,9
12103218,Chandralekha,1997,['India'],['Comedy'],1990,7
10791769,Moondru Mudichu,1977,['India'],['Drama'],1970,7
27664841,Stop Press Girl,1949,['United Kingdom'],['Comedy'],1940,9
74912,Love Finds Andy Hardy,1938,['United States of America'],"['Black-and-white', 'Comedy', 'Teen', 'Romance Film', 'Romantic comedy']",1930,8
22816824,Goemon,2009,['Japan'],"['Action', 'Period piece', 'Japanese Movies', 'Historical Epic', 'Epic', 'Adventure', 'Drama']",2000,9
5463760,Call of the Cuckoo,1927,['United States of America'],"['Black-and-white', 'Indie', 'Short Film', 'Comedy', 'Silent film']",1920,7
781758,Little Women,1994,['United States of America'],"['Film adaptation', 'Family Drama', 'Romantic drama', 'Romance Film', 'Costume drama', 'Drama', 'Period piece', 'Coming of age', 'Family Film']",1990,4
2018960,The Curse of the Jade Scorpion,2001,"['Germany', 'United States of America']","['Detective fiction', 'Screwball comedy', 'Indie', 'Mystery', 'Comedy', 'Thriller', 'Romance Film', 'Crime Thriller', 'Detective', 'Romantic comedy', 'Workplace Comedy']",2000,1
1394661,Ned Kelly,2003,"['Australia', 'France', 'United Kingdom', 'New Zealand', 'United States of America']","['Outlaw', 'Crime Fiction', 'Biography', 'Action/Adventure', 'Biographical film', 'World cinema', 'Drama', 'Period piece', 'History', 'Western']",2000,3
2417064,Croupier,1999,"['United Kingdom', 'France', 'Germany', 'Ireland']","['Drama', 'Crime Fiction', 'Indie', 'Crime Drama', 'Film noir', 'Crime Thriller']",1990,9
4037368,They Still Call Me Bruce,1987,['United States of America'],"['Action', 'Parody', 'Satire', 'Comedy']",1980,7
1425905,A Common Thread,2004,['France'],"['Melodrama', 'Drama', 'World cinema']",2000,4
10938786,Achanak,1998,['India'],['World cinema'],1990,8
16749885,Surviving Evil,2009,"['United Kingdom', 'South Africa']",['Horror'],2000,9
6117126,Narasimhudu,2005,['India'],['Action'],2000,5
21482017,Chichi koishi,1951,['Japan'],"['Japanese Movies', 'Black-and-white']",1950,1
6159275,Ju-on,2000,['Japan'],"['Japanese Movies', 'Horror']",2000,0
147810,Boys Over Flowers,1997,['Japan'],"['Anime', 'Japanese Movies']",1990,7
2839369,The House on the Edge of the Park,1980,['Italy'],"['Giallo', 'Crime Fiction', 'Thriller', 'World cinema', 'Sexploitation', 'Slasher', 'Horror', 'Adult']",1980,0
5107366,Speed Demon,2003,['United States of America'],"['Indie', 'Science Fiction', 'Horror']",2000,3
16007032,Marius et Jeannette,1997,['France'],"['Romantic drama', 'Comedy', 'World cinema', 'Romance Film', 'Romantic comedy', 'Comedy-drama', 'Drama']",1990,7
15242215,The Time to Live and the Time to Die,1985,"['China', 'Taiwan']","['Chinese Movies', 'Coming of age', 'Biography', 'Family Drama', 'Drama']",1980,5
265508,Shadowlands,1985,['United Kingdom'],"['Period piece', 'Romantic drama', 'Biography', 'Romance Film', 'Drama']",1980,5
2963323,Guizi lai le,2000,['China'],"['Comedy', 'Black comedy', 'Chinese Movies', 'War film', 'Drama']",2000,0
24663528,Hate Crime,2006,[],"['Psychological thriller', 'LGBT', 'Crime Fiction', 'Mystery', 'Thriller', 'Crime Thriller', 'Drama', 'Gay Themed']",2000,6
673682,Angel Heart,1987,"['United Kingdom', 'United States of America', 'Canada']","['Mystery', 'Thriller', 'Detective', 'Horror', 'Erotic thriller', 'Crime Thriller', 'Supernatural']",1980,7
3629098,Hated: GG Allin and the Murder Junkies,1994,['United States of America'],"['Rockumentary', 'Documentary']",1990,4
9460450,Love Phobia,2006,['South Korea'],"['Romance Film', 'Drama']",2000,6
19035964,Please Turn Over,1959,['United Kingdom'],['Comedy'],1950,9
34290726,Unnai Solli Kutramillai,1990,['India'],[],1990,0
3757107,God is My Co-Pilot,1945,['United States of America'],"['Combat Films', 'Historical fiction', 'War film', 'Drama']",1940,5
6819522,"Don't Cry, It's Only Thunder",1982,['United States of America'],"['Drama', 'Indie', 'Docudrama', 'War film']",1980,2
2969247,Quantum of Solace,2008,"['United Kingdom', 'United States of America']","['Action', 'Spy', 'Crime Fiction', 'Action Thrillers', 'Thriller', 'Glamorized Spy Film', 'Adventure']",2000,8
23979665,"The Lion, the Witch and the Wardrobe",1979,"['United Kingdom', 'United States of America']","['Fairy tale', ""Children's Fantasy"", 'Animation', ""Children's/Family"", 'Family Film']",1970,9
12190326,Auggie Rose,2000,['United States of America'],['Drama'],2000,0
16842403,I Want a Divorce,1940,['United States of America'],"['Black-and-white', 'Melodrama', 'Comedy-drama']",1940,0
23758269,1921,1988,['India'],"['Action', 'Bollywood', 'War film', 'Drama']",1980,8
21960600,Allegro,2005,['Denmark'],"['Romantic drama', 'Science Fiction', 'World cinema', 'Romance Film', 'Drama']",2000,5
25222645,Street Law,1974,['Italy'],"['Action', 'Crime Fiction', 'Action/Adventure', 'Thriller', 'World cinema']",1970,4
13269065,All About Love,2006,['Philippines'],"['Filipino Movies', 'Romantic drama', 'Comedy', 'World cinema', 'Romance Film', 'Drama']",2000,6
15223883,The Goofy Gophers,1947,['United States of America'],"['Animation', 'Short Film', 'Comedy film', 'Family Film']",1940,7
15130405,Bloody Moon,1981,['Germany'],"['Slasher', 'World cinema', 'Horror']",1980,1
2221389,Solid Serenade,1946,['United States of America'],"['Short Film', 'Comedy']",1940,6
872441,First Blood,1982,['United States of America'],"['Psychological thriller', 'Action', 'Action Thrillers', 'Thriller', 'Adventure', 'Drama']",1980,2
30712363,Return of Jewel Thief,1996,['India'],['Crime Fiction'],1990,6
2171715,Jack Frost,1998,['United States of America'],"['Comedy', 'Family Film', 'Fantasy']",1990,8
74028,The Hitch-Hiker,1953,['United States of America'],"['Black-and-white', 'Crime Fiction', 'Thriller', 'Film noir', 'Crime Thriller', 'Drama']",1950,3
3900596,Lamhe,1991,['India'],"['Musical', 'Romantic drama', 'Bollywood', 'World cinema', 'Romance Film', 'Drama']",1990,1
17956798,New World,1995,['France'],"['Romantic drama', 'World cinema', 'Romance Film', 'Drama']",1990,5
27434903,Bedardi,1993,['India'],"['Action/Adventure', 'World cinema']",1990,3
3517536,The Lovely Bones,2009,"['United Kingdom', 'New Zealand', 'United States of America']","['Film adaptation', 'Fantasy Drama', 'Thriller', 'World cinema', 'Crime Thriller', 'Fantasy', 'Drama']",2000,9
5787604,Arena,1989,"['Italy', 'United States of America']","['Indie', 'Science Fiction', 'World cinema']",1980,9
13245430,Photograbber,2004,['France'],['Short Film'],2000,4
19880579,West of the Pesos,1960,['United States of America'],"['Animation', 'Short Film', 'Comedy', 'Family Film']",1960,0
26759151,Crime and Punishment,1973,['India'],['Drama'],1970,3
2798805,3 Women,1977,['United States of America'],"['Indie', 'Drama', 'New Hollywood']",1970,7
21135479,Little Lord Fauntleroy,1921,['United States of America'],"['Film adaptation', 'Black-and-white', 'Comedy', 'Silent film', 'Drama']",1920,1
13162391,The Duke,1999,"['Canada', 'United Kingdom']","['Comedy', 'Family Film']",1990,9
8994566,Oysters at Nam Kee's,2002,"['Germany', 'Netherlands']","['Romance Film', 'Drama']",2000,2
2019849,Supervixens,1975,['United States of America'],"['Erotica', 'Sexploitation', 'Adult']",1970,5
14965069,Doubt,2008,['United States of America'],"['Period piece', 'Film adaptation', 'Mystery', 'Christian film', 'Drama']",2000,8
34042752,A Holy Terror,1931,['United States of America'],['Western'],1930,1
26408859,Gehrayee,1980,['India'],"['World cinema', 'Horror']",1980,0
14736972,Monkey Businessmen,1946,['United States of America'],"['Black-and-white', 'Short Film', 'Comedy', 'Slapstick']",1940,6
6704917,Jump Start!,2007,['United States of America'],"['Family Drama', 'Comedy', 'Teen', 'Romance Film', ""Children's"", 'Drama', 'Sports', 'Romantic comedy', 'Television movie', 'Family Film']",2000,7
2379908,Switching Goals,1999,['United States of America'],"['Comedy', ""Children's/Family"", 'Sports', 'Family Film']",1990,9
19908244,Nenu Meeku Telusa...?,2008,['India'],"['Thriller', 'Tamil cinema']",2000,8
24760349,The Paper Wedding,1990,['Canada'],"['Romantic drama', 'Indie', 'Romance Film', 'Drama']",1990,0
23487599,Naadodigal,2009,['India'],"['Drama', 'Comedy']",2000,9
2376432,The Year My Voice Broke,1987,"['New Zealand', 'Australia']","['Period piece', 'Film à clef', 'Coming of age', 'Romantic drama', 'World cinema', 'Romance Film', 'Drama']",1980,7
14076924,Frightmare,1974,['United Kingdom'],"['Slasher', 'B-movie', 'Horror']",1970,4
10274845,Peter Ibbetson,1935,['United States of America'],"['Romance Film', 'Black-and-white', 'Drama']",1930,5
242542,Testament,1983,['United States of America'],"['Action/Adventure', 'Apocalyptic and post-apocalyptic fiction', 'Doomsday film', 'Disaster', 'Science Fiction', 'Drama']",1980,3
15329247,Child Bride of Short Creek,1981,['United States of America'],"['Period piece', 'Drama']",1980,1
24052462,A Reason to Believe,1995,['United States of America'],['Drama'],1990,5
21405011,Mate Ta Love Helare,2008,['India'],"['Action', 'Musical', 'Drama']",2000,8
2572072,Dr. Cyclops,1940,['United States of America'],"['Action', 'Horror', 'Adventure', 'Sci-Fi Horror', 'Science Fiction']",1940,0
26561763,There,2009,['Turkey'],['Drama'],2000,9
8355088,A Dos Aguas,1988,['Argentina'],['Drama'],1980,8
14054434,The Colony,1996,"['Canada', 'United States of America']",['Thriller'],1990,6
24626370,Teenage Dirtbag,2009,['United States of America'],"['Indie', 'Drama', 'Teen']",2000,9
206845,Antz,1998,['United States of America'],"['Animation', 'Comedy', 'Fantasy', 'Adventure', 'Fantasy Comedy', 'Family Film', 'Computer Animation']",1990,8
22939533,Naked Fame,2005,['United States of America'],"['Music', 'LGBT', 'Biography', 'Documentary', 'Film']",2000,5
31232673,A Private's Affair,1959,['United States of America'],['Comedy'],1950,9
26114902,Aadhaaram,1992,['India'],['Drama'],1990,2
11482407,Profumo di donna,1974,['Italy'],"['Romantic drama', 'Comedy', 'Melodrama', 'Comedy-drama', 'Road movie', 'Drama']",1970,4
16511975,Black Magic,1949,"['Italy', 'United States of America']",['Black-and-white'],1940,9
2066412,Johnny Stool Pigeon,1949,['United States of America'],"['Film noir', 'Crime Drama', 'Crime Fiction']",1940,9
20186742,Uncertainty,2008,['United States of America'],"['Family Drama', 'Indie', 'Crime Thriller', 'Drama']",2000,8
29784104,Adventures of Tarzan,1985,['India'],"['Romantic drama', 'World cinema', 'Romance Film', 'Drama']",1980,5
18467597,Walking on Dead Fish,2007,['United States of America'],"['Sports', 'Indie', 'Documentary']",2000,7
1189552,Book of Shadows: Blair Witch 2,2000,['United States of America'],"['Psychological thriller', 'Crime Fiction', 'Mystery', 'Thriller', 'Slasher', 'Horror', 'Supernatural', 'Ensemble Film']",2000,0
4451440,Whatever It Takes,2000,['United States of America'],"['Comedy', 'Teen', 'Romance Film', 'Drama']",2000,0
19938184,Return to Sender,2004,"['United Kingdom', 'Denmark', 'United States of America']","['Suspense', 'Thriller', 'Crime Thriller', 'Courtroom Drama']",2000,4
27639550,Law and Order,1953,['United States of America'],"['Action', 'Western']",1950,3
6149419,The Good Mother,2006,['United States of America'],"['Psychological thriller', 'Mystery', 'Thriller', 'Crime Thriller', 'Drama']",2000,6
61519,A Tale of Two Cities,1935,['United States of America'],"['Action', 'Black-and-white', 'Action/Adventure', 'Political drama', 'Epic', 'Costume drama', 'Drama']",1930,5
16071798,She Couldn't Say No,1954,['United States of America'],"['Black-and-white', 'Comedy', 'Drama']",1950,4
15079086,Tainá 2: A New Amazon Adventure,2004,['Brazil'],"['Comedy', 'Family Film', 'Adventure']",2000,4
723288,The Newton Boys,1998,['United States of America'],"['Action', 'Crime Fiction', 'Action/Adventure', 'Drama', 'Period piece', 'Heist', 'History', 'Western', 'Crime Drama']",1990,8
77674,Watch on the Rhine,1943,['United States of America'],"['Spy', 'Black-and-white', 'Thriller', 'War film', 'Drama']",1940,3
22372556,The Lost Missile,1958,['United States of America'],"['Action Thrillers', 'Science Fiction', 'Horror']",1950,8
28103641,Medea,1988,['Denmark'],"['Drama', 'Art film']",1980,8
9221129,Lady on the Bus,1978,['Brazil'],"['Drama', 'Comedy']",1970,8
9594023,A Killing Affair,1977,['United States of America'],"['Psychological thriller', 'Suspense', 'Crime Fiction', 'Thriller', 'Horror', 'Drama']",1970,7
1367581,A Civil Action,1998,['United States of America'],"['Docudrama', 'Drama', 'Courtroom Drama']",1990,8
1958642,The Night of the Generals,1967,"['United Kingdom', 'France', 'United States of America']","['Psychological thriller', 'Action', 'Mystery', 'Thriller', 'Crime Thriller', 'War film', 'Drama']",1960,7
21487707,Toronto Stories,2008,['Canada'],"['Indie', 'Comedy', 'Drama']",2000,8
9143511,Ajantha,2009,['India'],"['Musical', 'Romance Film', 'Drama']",2000,9
1677820,God of Cookery,1996,['Hong Kong'],"['Action', 'Chinese Movies', 'Comedy']",1990,6
177906,Labyrinth,1986,"['United Kingdom', 'United States of America']","['Coming of age', 'Comedy', 'Adventure', 'Family Film', 'Fantasy']",1980,6
22643842,Ciske de rat,1955,['Netherlands'],"['Black-and-white', 'Drama']",1950,5
4025067,Plunkett & Macleane,1999,"['United Kingdom', 'Czech Republic']","['Action', 'Costume Adventure', 'Crime Fiction', 'Action/Adventure', 'Buddy film', 'Comedy', 'Costume drama', 'Adventure', 'Heist']",1990,9
10850871,Steptoe and Son Ride Again,1973,['United Kingdom'],"['Drama', 'Comedy']",1970,3
8202067,Best Foot Forward,1943,['United States of America'],"['Musical', 'Comedy', 'Romance Film', 'Romantic comedy']",1940,3
296466,The Man on the Train,2002,"['Switzerland', 'United Kingdom', 'France', 'Germany']","['Drama', 'Crime Fiction', 'Thriller']",2000,2
566713,The Living Daylights,1987,['United Kingdom'],"['Action', 'Spy', 'Action Thrillers', 'Action/Adventure', 'Thriller', 'Concert film', 'Glamorized Spy Film', 'War film']",1980,7
12757559,Humanité,1999,['France'],"['Crime Fiction', 'Mystery', 'World cinema', 'Drama']",1990,9
7029299,Like Minds,2006,"['United Kingdom', 'New Zealand', 'Australia']","['Psychological thriller', 'Crime Fiction', 'Thriller', 'World cinema', 'Crime Thriller', 'Drama']",2000,6
461563,Deep Throat,1972,['United States of America'],['Pornographic movie'],1970,2
24646437,Jaganmohini,2009,[],"['Cult', 'Horror']",2000,9
14846707,The Last Chase,1981,"['Canada', 'United States of America']","['Drama', 'Doomsday film', 'Science Fiction']",1980,1
2295231,A Mom for Christmas,1990,['United States of America'],"['Comedy', 'Fantasy']",1990,0
2539874,Major Dundee,1965,['United States of America'],"['Action/Adventure', 'Western', 'Cavalry Film', 'War film', 'Costume drama', 'Adventure']",1960,5
6097565,The Manitou,1978,"['Canada', 'United States of America']","['Film adaptation', 'Drama', 'Indie', 'Horror', 'Cult', 'Natural horror films']",1970,8
14191962,Pidichirukku,2008,['India'],['Romantic drama'],2000,8
1223479,Central Station,1998,"['Brazil', 'France']","['Road movie', 'Drama', 'World cinema']",1990,8
15008129,The Brothers Rico,1957,['United States of America'],"['Film adaptation', 'Black-and-white', 'Crime Fiction', 'Gangster Film', 'Thriller', 'Film noir', 'Drama', 'Crime Drama']",1950,7
6601066,Whirly Girl,2006,['United States of America'],"['Romance Film', 'Coming of age', 'Drama']",2000,6
6820834,Dave and the Giant Pickle,1996,[],"['Musical', 'Animation', 'Short Film', ""Children's""]",1990,6
1347607,Deadlier Than the Male,1967,['United Kingdom'],"['Action', 'Spy', 'Detective fiction', 'Crime Fiction', 'Mystery', 'Action/Adventure', 'Thriller', 'Crime Thriller', 'Detective']",1960,7
11253386,Professor,1962,['India'],"['Musical', 'Bollywood', 'World cinema', 'Drama']",1960,2
22839796,The Single Girls,1974,['United States of America'],"['Mystery', 'Sexploitation', 'Comedy', 'Drama']",1970,4
348737,Mrs. Doubtfire,1993,['United States of America'],"['LGBT', 'Comedy', 'Domestic Comedy', 'Drama', 'Family Film', 'Comedy of Errors']",1990,3
4015188,Captains Courageous,1937,['United States of America'],"['Action', 'Film adaptation', 'Black-and-white', 'Action/Adventure', 'Adventure', 'Drama']",1930,7
1273619,Oh... Rosalinda!!,1955,"['United Kingdom', 'England']",['Musical'],1950,5
14233645,Flat Foot Stooges,1936,['United States of America'],"['Black-and-white', 'Short Film', 'Comedy', 'Slapstick']",1930,6
31323889,Verwirrung der Liebe,1959,['German Democratic Republic'],"['Romance Film', 'Comedy film']",1950,9
21008812,This Happy Breed,1944,"['United Kingdom', 'England']","['Period piece', 'Comedy', 'Drama']",1940,4
21219505,The Collective,2008,['United States of America'],"['Mystery', 'Indie', 'Thriller']",2000,8
17179974,Akaler Sandhane,1980,['India'],['Art film'],1980,0
5266380,Jane Eyre,2006,['United Kingdom'],"['Costume drama', 'Drama']",2000,6
19092347,Hunting Scenes From Bavaria,1969,['West Germany'],['Drama'],1960,9
10827616,Swan Lake,1981,['Japan'],"['Animation', 'Japanese Movies', 'Anime', 'Adventure', 'Family Film']",1980,1
23672869,Ek Niranjan,2009,['India'],['Music'],2000,9
22165566,Undead or Alive,2007,['United States of America'],"['Action/Adventure', 'Western', 'Horror', 'Zombie Film']",2000,7
9419443,Vaasthavam,2006,['India'],['Crime Fiction'],2000,6
754442,Beauty,1998,"['China', 'Hong Kong']","['LGBT', 'Erotic Drama', 'Romantic drama', 'Romance Film', 'Chinese Movies', 'Drama', 'Gay Themed', 'Gay', 'Gay Interest']",1990,8
25715998,Love Hotel,1995,['Japan'],"['Pinku eiga', 'Softcore Porn']",1990,5
16162546,Two of Us,1987,['United Kingdom'],"['Gay Themed', 'Romance Film', 'Drama']",1980,7
24772329,Mirror Wars,2005,"['Russia', 'United States of America']","['Action', 'Action/Adventure', 'Thriller', 'World cinema']",2000,5
18846797,Forever Amber,1947,['United States of America'],['Drama'],1940,7
8399302,I Went Down,1997,"['Spain', 'United Kingdom', 'Ireland', 'United States of America']","['Crime Fiction', 'Buddy film', 'Comedy', 'Road movie', 'Drama']",1990,7
825149,King Ralph,1991,"['United Kingdom', 'United States of America']","['Comedy', 'Comedy of manners', 'Romantic comedy', 'Family Film']",1990,1
13382767,The Illiterate One,1961,['Mexico'],"['Comedy', 'World cinema', 'Romantic comedy', 'Drama']",1960,1
27302715,The King,1995,['India'],"['Action', 'Thriller', 'Bollywood']",1990,5
30722673,Adhyayam Onnu Muthal,1985,[],['Drama'],1980,5
24666022,October 22,1998,['United States of America'],"['Thriller', 'Crime Drama', 'Crime Thriller', 'Drama']",1990,8
6333302,Blade of the Phantom Mask,2004,"['Japan', 'South Korea']","['Action', 'Animation', 'Japanese Movies', 'Adventure', 'Anime', 'Science Fiction', 'Fantasy']",2000,4
22821842,B.F.'s Daughter,1948,['United States of America'],"['Black-and-white', 'Political drama', 'Drama']",1940,8
946060,Cave Dwellers,1984,['Italy'],"['Fantasy', 'Adventure', 'Sword and sorcery']",1980,4
8356668,Tycus,1999,['United States of America'],"['Action', 'Drama', 'Indie', 'Thriller', 'Adventure', 'Disaster', 'Science Fiction']",1990,9
12466044,The Pink Chiquitas,1987,['Canada'],"['Parody', 'Satire', 'Comedy', 'Science Fiction']",1980,7
22907524,Colin,2008,['United Kingdom'],"['Creature Film', 'Psychological thriller', 'Action', 'Horror', 'B-movie', 'Zombie Film', 'Drama']",2000,8
11939381,American Pastime,2007,['United States of America'],"['Period piece', 'Sports', 'War film', 'Drama']",2000,7
11224264,Lost Continent,1951,['United States of America'],"['Thriller', 'Adventure', 'Stop motion', 'Science Fiction', 'Fantasy']",1950,1
3623294,Witness to Murder,1954,['United States of America'],"['Psychological thriller', 'Black-and-white', 'Crime Fiction', 'Thriller', 'Film noir', 'Crime Thriller', 'Drama']",1950,4
23149191,Ground Control,1998,['United States of America'],"['Action', 'Psychological thriller', 'Suspense', 'Action/Adventure', 'Thriller', 'Disaster']",1990,8
31303822,The Nutt House,1992,['United States of America'],"['Drama', 'Indie', 'Comedy', 'World cinema', 'Comedy of Errors']",1990,2
27861014,À l'aventure,2009,['France'],"['Drama', 'World cinema']",2000,9
886560,No Way Out,1987,['United States of America'],"['Psychological thriller', 'Spy', 'Mystery', 'Thriller', 'Crime Thriller', 'Suspense', 'Erotic thriller', 'Political thriller']",1980,7
2515369,Daniel Dafoe's Robinson Crusoe,1997,['United States of America'],"['Period piece', 'Film adaptation', 'Action/Adventure', 'Costume drama', 'Adventure', 'Drama']",1990,7
11188650,After This Our Exile,2006,['Hong Kong'],"['Family Drama', 'World cinema', 'Crime Drama', 'Chinese Movies', 'Drama']",2000,6
184158,Iris,2001,"['United Kingdom', 'United States of America', 'Canada']","['Film adaptation', 'LGBT', 'Biography', 'Biographical film', 'Romance Film', 'Drama']",2000,1
89629,The Castle of Cagliostro,1979,['Japan'],"['Heist', 'Animation', 'Japanese Movies', ""Children's/Family"", 'Anime', 'Adventure']",1970,9
3466894,The Christmas Blessing,2005,"['Canada', 'United States of America']","['Romance Film', 'Drama', 'Family Film']",2000,5
14312185,Great Day in the Morning,1956,['United States of America'],"['Action', 'Western', 'Adventure']",1950,6
24631427,Love Is a Funny Thing,1969,[],"['Romance Film', 'Drama', 'Comedy film']",1960,9
8513207,Mary,2006,['United States of America'],"['Thriller', 'Drama']",2000,6
13987389,Mystery of Snow,2005,['Burma'],"['Musical', 'Adventure', 'Drama']",2000,5
16543421,State Fair,1945,['United States of America'],"['Musical', 'Romance Film']",1940,5
5161871,Chickens Come Home,1931,['United States of America'],"['Black-and-white', 'Short Film', 'Comedy', 'Slapstick']",1930,1
7529573,Shock,2004,['India'],"['World cinema', 'Horror']",2000,4
4867172,The Ron Clark Story,2006,"['Canada', 'United States of America']","['Biographical film', 'Biopic [feature]', 'Television movie', 'Drama']",2000,6
22610822,Coming Back,1967,['South Korea'],['Drama'],1960,7
1968844,Throw Momma from the Train,1987,['United States of America'],"['Action', 'Parody', 'Action/Adventure', 'Comedy', 'Crime Comedy', 'Black comedy']",1980,7
1480754,My Dinner with Andre,1981,['United States of America'],"['Indie', 'Comedy', 'Experimental film', 'Comedy-drama', 'Drama']",1980,1
1661774,Zero Hour!,1957,['United States of America'],"['Action', 'Action/Adventure', 'Thriller', 'Disaster']",1950,7
4853061,Someone's Watching Me,1978,['United States of America'],"['Psychological thriller', 'Suspense', 'Thriller', 'Television movie']",1970,8
19944417,The Soldier,1982,['United States of America'],"['Action', 'Spy', 'Thriller']",1980,2
73376,Bringing up Baby,1938,['United States of America'],"['Screwball comedy', 'Comedy', 'Romance Film', 'Romantic comedy']",1930,8
2594501,One Million B.C.,1940,['United States of America'],"['Black-and-white', 'Fantasy']",1940,0
17022698,DNA,1997,"['Philippines', 'United States of America']","['Action', 'Filipino Movies', 'Science Fiction']",1990,7
25725626,Pony Soldier,1952,['United States of America'],"['Western', 'Northern']",1950,2
12465343,Seven Sinners,1940,['United States of America'],"['Romantic comedy', 'Black-and-white', 'Drama']",1940,0
733818,Nurse Betty,2000,"['Germany', 'United States of America']","['Crime Fiction', 'Indie', 'Satire', 'Thriller', 'Comedy', 'Black comedy', 'Drama', 'Romantic comedy', 'Comedy-drama']",2000,0
565318,Lost in Space,1998,"['United Kingdom', 'United States of America']","['Action', 'Time travel', 'Adventure', 'Science Fiction']",1990,8
5399016,An American Crime,2007,['United States of America'],"['Drama', 'Crime Fiction', 'Indie', 'Courtroom Drama']",2000,7
15234647,I Woke Up Early The Day I Died,1997,['United States of America'],"['Crime Fiction', 'Comedy', 'Thriller']",1990,7
4386957,Revenge of the Ninja,1983,['United States of America'],"['Action', 'Drama', 'Action Thrillers', 'Indie', 'Action/Adventure', 'Thriller', 'Martial Arts Film']",1980,3
33108995,"Oh, You Beautiful Doll",1949,['United States of America'],"['Musical', 'Biographical film', 'Biopic [feature]', 'Docudrama']",1940,9
19437715,Rangamati,2008,['India'],['Drama'],2000,8
7634397,Five Miles to Midnight,1962,"['France', 'Italy']","['Black-and-white', 'Thriller', 'World cinema', 'Drama']",1960,2
8779670,Hell's Kitchen,1939,['United States of America'],"['Black-and-white', 'Drama']",1930,9
4305043,Silence Becomes You,2005,"['Lithuania', 'United Kingdom']","['Psychological thriller', 'Suspense', 'Thriller']",2000,5
5882490,Octane,2003,"['United Kingdom', 'Luxembourg', 'United States of America']","['Action', 'Action Thrillers', 'Mystery', 'Thriller', 'Horror', 'Teen', 'Supernatural']",2000,3
2093270,The Gorgon,1964,['United Kingdom'],"['Creature Film', 'Gothic Film', 'Thriller', 'Horror', 'Costume Horror']",1960,4
15269861,K-9: P.I.,2002,['United States of America'],"['Action', 'Crime Fiction', 'Action/Adventure', 'Comedy', 'Animal Picture']",2000,2
14127574,The Scar,1976,['Poland'],"['Drama', 'World cinema']",1970,6
2254896,Helen of Troy,1956,"['France', 'Italy', 'United States of America']","['Action', 'Action/Adventure', 'Romance Film', 'Epic', 'War film', 'Adventure', 'Drama']",1950,6
3027347,Blown Away,1994,['United States of America'],"['Action', 'Action/Adventure', 'Thriller']",1990,4
8381793,Faith Like Potatoes,2006,['South Africa'],"['Christian film', 'Drama', 'World cinema']",2000,6
26391984,In His Life: The John Lennon Story,2000,['United States of America'],"['Period piece', 'Biography', 'Drama']",2000,0
3509771,The Magnificent Ambersons,1942,['United States of America'],"['Black-and-white', 'Family Drama', 'Drama']",1940,2
2262277,Salaam Bombay!,1988,"['India', 'France', 'United Kingdom']","['Existentialism', 'Bollywood', 'World cinema', 'Social problem film', 'Drama']",1980,8
23789267,Ace of Hearts,2008,[],"['Family Drama', 'Television movie', 'Family Film', 'Drama']",2000,8
8541076,Aan: Men at Work,2004,['India'],"['Action', 'Action Thrillers', 'Action/Adventure', 'Thriller', 'World cinema']",2000,4
6701429,Citizen,2001,['India'],"['Action/Adventure', 'Drama', 'World cinema']",2000,1
14737193,Out West,1947,['United States of America'],"['Short Film', 'Black-and-white', 'Comedy']",1940,7
3303226,House of Frankenstein,1944,['United States of America'],"['Creature Film', 'Black-and-white', 'Monster', 'Horror']",1940,4
2627813,-30-,1959,['United States of America'],['Drama'],1950,9
9636080,Una noche con Sabrina Love,2000,"['Spain', 'Netherlands', 'Argentina', 'France', 'Italy']","['Romantic drama', 'Comedy', 'World cinema', 'Romance Film', 'Drama', 'Coming of age', 'Romantic comedy', 'Comedy-drama', 'Road movie']",2000,0
13495676,Lovers Lane,1999,['United States of America'],"['Slasher', 'Teen', 'Horror']",1990,9
3261733,Pan's Labyrinth,2006,"['Mexico', 'Spain']","['Supernatural', 'World cinema', 'Drama', 'Period piece', 'Fairy tale', 'Horror', 'War film', 'Fantasy']",2000,6
16338862,Count Five and Die,1957,['United Kingdom'],"['Spy', 'Action', 'Drama', 'Thriller', 'War film']",1950,7
5663440,The Hound of the Baskervilles,1959,['United Kingdom'],"['Crime Fiction', 'Mystery', 'Thriller', 'Crime Thriller', 'Suspense', 'Detective', 'Horror', 'Supernatural']",1950,9
2235410,Death Machine,1994,['United Kingdom'],"['Action', 'Dystopia', 'Thriller', 'Horror', 'Science Fiction']",1990,4
1298984,Blue Skies,1946,['United States of America'],['Musical'],1940,6
33583110,Karnaa,1995,[],['Action'],1990,5
8463574,The Death Collector,1976,['United States of America'],"['Action', 'Crime Fiction', 'Drama']",1970,6
2359777,Cure,1997,['Japan'],"['Psychological thriller', 'Crime Fiction', 'Japanese Movies', 'Thriller', 'Horror', 'World cinema', 'Crime Thriller']",1990,7
3815462,The Creature Walks Among Us,1956,['United States of America'],"['Creature Film', 'Black-and-white', 'Thriller', 'Horror', 'Science Fiction']",1950,6
1069944,Tales from the Crypt,1972,"['United Kingdom', 'United States of America']","['Supernatural', 'Thriller', 'Horror']",1970,2
430788,The Emperor's Club,2002,['United States of America'],"['Period piece', 'Coming of age', 'Drama']",2000,2
2055814,Brute Force,1947,['United States of America'],"['Black-and-white', 'Crime Fiction', 'Film noir', 'Drama']",1940,7
3779953,Son in Law,1993,['United States of America'],['Comedy'],1990,3
21592734,Jau Tithe Khau,2007,['India'],"['Musical', 'Bollywood', 'World cinema', 'Drama']",2000,7
3547149,The Raspberry Reich,2004,"['Canada', 'Germany']","['LGBT', 'Art film', 'Political satire', 'Avant-garde', 'Comedy', 'World cinema', 'Drama', 'Gay Themed', 'Gay', 'Gay Interest', 'Pornographic movie', 'Experimental film', 'Political drama', 'Gay pornography', 'Sex comedy']",2000,4
9143451,Coup de foudre,1983,['France'],"['LGBT', 'Romantic drama', 'Biographical film', 'World cinema', 'Romance Film', 'Drama']",1980,3
695266,Lethal Weapon 3,1992,['United States of America'],"['Action', 'Crime Fiction', 'Action Thrillers', 'Action/Adventure', 'Buddy film', 'Thriller', 'Comedy', 'Buddy cop']",1990,2
168774,Nuns on the Run,1990,['United Kingdom'],"['Crime Fiction', 'Indie', 'Comedy', 'Slapstick']",1990,0
365025,Silent Movie,1976,['United States of America'],"['Parody', 'Comedy', 'Silent film', 'Slapstick', 'Absurdism']",1970,6
14831897,Night Trap,1993,['United States of America'],"['Mystery', 'Slasher', 'Thriller', 'Horror', 'Supernatural']",1990,3
27439204,One More Train to Rob,1971,['United States of America'],"['Action', 'Western', 'Action/Adventure']",1970,1
5113644,Kati Patang,1970,['India'],"['Musical', 'Bollywood', 'World cinema', 'Drama']",1970,0
18325540,Bulandi,2000,['India'],"['Musical', 'Crime Fiction', 'Romance Film', 'Drama']",2000,0
8390126,Opportunity Knocks,1990,['United States of America'],"['Action', 'Screwball comedy', 'Action/Adventure', 'Comedy', 'Comedy of Errors']",1990,0
10771836,Ajnabee,1974,['India'],"['Romance Film', 'Drama']",1970,4
21413341,Abe and the Amazing Promise,2009,['United States of America'],"['Musical', 'Animation', 'Short Film']",2000,9
13183259,Sällskapsresan 2 - Snowroller,1985,['Sweden'],['Comedy'],1980,5
12981754,Heavenly Daze,1948,['United States of America'],"['Black-and-white', 'Heaven-Can-Wait Fantasies', 'Short Film', 'Comedy', 'Slapstick', 'Fantasy Comedy']",1940,8
8610674,Ripper,2001,"['Canada', 'United Kingdom']","['Slasher', 'Horror']",2000,1
227231,Peter's Friends,1992,['United Kingdom'],"['Indie', 'Comedy', 'Comedy-drama', 'Drama', 'Ensemble Film']",1990,2
19839179,The Naked Brothers Band: Operation Mojo,2008,['United States of America'],"['Musical', 'Comedy', 'Family Film']",2000,8
17021034,True As Steel,1924,['United States of America'],"['Black-and-white', 'Marriage Drama', 'Silent film', 'Drama']",1920,4
35188575,Furimukeba Ai,1978,['Japan'],[],1970,8
2681496,Such a Long Journey,1998,"['Canada', 'United Kingdom']","['Period piece', 'Film adaptation', 'Drama', 'Indie', 'Historical Epic', 'Political drama']",1990,8
13544172,Iron Eagle IV,1995,"['Canada', 'United States of America']","['Action', 'Action/Adventure', 'Thriller']",1990,5
9609384,The Galloping Ghost,1931,['United States of America'],"['Action', 'Black-and-white', 'Crime Fiction', 'Mystery', 'Thriller', 'Sports', 'Adventure']",1930,1
1828843,The Legend of Bhagat Singh,2002,['India'],"['History', 'Biographical film', 'Bollywood', 'World cinema', 'Political drama', 'Drama']",2000,2
526822,Christmas on Mars,2008,['United States of America'],"['Indie', 'Musical']",2000,8
21426608,Unnaipol Oruvan,2009,['India'],['Thriller'],2000,9
10977,Fearless,1993,['United States of America'],"['Disaster', 'Action/Adventure', 'Drama']",1990,3
2360326,Judith,1966,"['United Kingdom', 'Israel', 'United States of America']","['Thriller', 'Drama']",1960,6
533767,Night Shift,1982,['United States of America'],"['Comedy', 'Sex comedy']",1980,2
5556082,Nasu: Summer in Andalusia,2003,['Japan'],"['Anime', 'Japanese Movies']",2000,3
31843970,Gangster's Den,1945,['United States of America'],"['Action', 'B-Western', 'Western', 'Action/Adventure']",1940,5
16388403,American Raspberry,1977,['United States of America'],"['Parody', 'Comedy']",1970,7
19453588,Asudem,2006,['United States of America'],"['Action', 'Thriller', 'Horror']",2000,6
6268880,On Her Majesty's Secret Service,1969,['United Kingdom'],"['Action', 'Spy', 'Action/Adventure', 'Thriller', 'Glamorized Spy Film']",1960,9
19267703,Emmanuelle,1974,['France'],"['World cinema', 'Romance Film', 'Drama', 'Softcore Porn', 'Sexploitation', 'Pornographic movie', 'Erotica', 'Adult']",1970,4
25387001,The Incredible 2-Headed Transplant,1971,['United States of America'],"['B-movie', 'Science Fiction', 'Horror']",1970,1
5612517,Corporate,2006,['India'],"['Drama', 'Bollywood', 'World cinema']",2000,6
12180811,Fire with Fire,1986,['United States of America'],"['Crime Fiction', 'Romantic drama', 'Teen', 'Romance Film', 'Melodrama', 'Drama']",1980,6
73498,Fury,1936,['United States of America'],"['Black-and-white', 'Crime Fiction', 'Film noir', 'Drama', 'Courtroom Drama']",1930,6
17548651,City Without Baseball,2008,"['China', 'Hong Kong']","['LGBT', 'Romantic drama', 'Chinese Movies', 'Drama', 'Slice of life story']",2000,8
1271405,Lust in the Dust,1985,['United States of America'],"['Action', 'Comedy Western', 'Parody', 'Action/Adventure', 'Western', 'Comedy', 'Cult']",1980,5
33502250,Ponnumani,1993,['India'],"['Romantic drama', 'World cinema', 'Romance Film', 'Drama']",1990,3
20891507,Geet,1992,['India'],"['Drama', 'World cinema']",1990,2
677920,200 Cigarettes,1999,['United States of America'],"['Indie', 'Romantic drama', 'Comedy', 'Romance Film', 'Drama', 'Period piece', 'Romantic comedy', 'Ensemble Film']",1990,9
2560314,The Mirror,1974,"['Russia', 'Soviet Union']","['Art film', 'History', 'Biography', 'World cinema', 'War film', 'Drama']",1970,4
21276522,The Only Good Indian,2009,['United States of America'],"['Period piece', 'Drama', 'Revisionist Western', 'Indie', 'Action/Adventure', 'Western']",2000,9
143814,Fools Rush In,1997,['United States of America'],"['Comedy', 'Romance Film', 'Romantic comedy', 'Drama']",1990,7
25019628,Jologs,2002,['Philippines'],"['Filipino Movies', 'Comedy', 'Teen', 'World cinema', 'Drama']",2000,2
9930507,Lickety-Splat,1961,['United States of America'],"['Animation', 'Short Film', 'Comedy', 'Family Film']",1960,1
28271211,Last Plane Out,1983,['United States of America'],"['War film', 'Thriller']",1980,3
15287430,M,2007,['South Korea'],"['Mystery', 'Thriller', 'Romance Film', 'Drama']",2000,7
2850808,Wanted,2005,[],"['Drama', 'Crime Fiction', 'Thriller']",2000,5
5970848,Apasionados,2002,['Argentina'],"['Romantic drama', 'Comedy', 'World cinema', 'Romance Film', 'Romantic comedy', 'Drama']",2000,2
15164491,Ivy,1947,['United States of America'],"['Black-and-white', 'Crime Fiction', 'Thriller', 'Film noir', 'Drama']",1940,7
22895245,The Saturday Night Kid,1929,['United States of America'],"['Romance Film', 'Comedy film']",1920,9
2687986,Little Fish,2005,['Australia'],"['Drama', 'Crime Fiction', 'Indie', 'Family Drama', 'Thriller', 'World cinema']",2000,5
26267583,Mrs. O'Malley and Mr. Malone,1950,['United States of America'],"['Mystery', 'Comedy film']",1950,0
1416847,The Power and the Glory,1933,['United States of America'],"['Black-and-white', 'Drama']",1930,3
20100567,The Magic Voyage,1994,"['Germany', 'United States of America']","['Family-Oriented Adventure', ""Children's/Family""]",1990,4
26057580,No Down Payment,1957,['United States of America'],['Drama'],1950,7
2025985,Passionada,2002,['United States of America'],"['Family Drama', 'Indie', 'Comedy', 'Romance Film', 'Romantic comedy']",2000,2
27001976,Abnormal Excitement: Nao Saejima,1989,['Japan'],"['Pinku eiga', 'Japanese Movies', 'Thriller']",1980,9
2567937,Brideless Groom,1947,['United States of America'],"['Black-and-white', 'Short Film', 'Comedy', 'Slapstick']",1940,7
15930247,Walking to the Waterline,1998,['United States of America'],['Indie'],1990,8
23451023,Swami Dada,1982,['India'],"['Drama', 'World cinema']",1980,2
10153657,Subarnarekha,1965,['India'],['Drama'],1960,5
14719603,Callas Forever,2002,"['Spain', 'Italy', 'United Kingdom', 'France', 'Romania']","['Musical', 'Biography', 'Biopic [feature]', 'Biographical film', 'World cinema', 'Musical Drama', 'Drama']",2000,2
6640544,Mayerling,1968,"['United Kingdom', 'France']","['Romance Film', 'Romantic drama', 'Drama']",1960,8
8663385,Dracula,1968,['United Kingdom'],['Horror'],1960,8
1346925,5 Card Stud,1968,['United States of America'],"['Mystery', 'Action/Adventure', 'Western', 'Thriller', 'Crime Thriller', 'Drama']",1960,8
7767619,Lost in Time,2003,"['China', 'Hong Kong']","['Drama', 'Chinese Movies', 'World cinema']",2000,3
8419685,The Motel,2006,['United States of America'],"['Coming of age', 'Indie', 'Comedy', 'Teen', 'Drama']",2000,6
30879026,My Brother's Wedding,1983,"['Germany', 'United States of America']","['Indie', 'Family Drama', 'Drama']",1980,3
2184458,Hustle & Flow,2005,['United States of America'],"['Music', 'Drama', 'Crime Fiction', 'Musical Drama', 'Indie', 'Romance Film', 'Hip hop movies']",2000,5
9136345,Bodyguard Kiba,1993,['Japan'],"['Action', 'Japanese Movies', 'Action/Adventure', 'World cinema']",1990,3
25513596,Decalogue II,1988,['Poland'],['Drama'],1980,8
36030580,Playmaker,1994,"['United Kingdom', 'United States of America']","['Drama', 'Mystery', 'Thriller']",1990,4
1882179,The Chronicles of Narnia: Prince Caspian,2008,"['Slovenia', 'United Kingdom', 'Poland', 'Czech Republic', 'United States of America']","['Fantasy Adventure', 'Action/Adventure', 'Christian film', ""Children's/Family"", 'Adventure', 'Family Film', 'Fantasy']",2000,8
2236146,Modern Girls,1986,['United States of America'],"['Indie', 'Comedy', 'Romance Film', 'Romantic comedy']",1980,6
2587262,The Two Mouseketeers,1952,['United States of America'],"['Animation', 'Short Film', 'Comedy', 'Family Film']",1950,2
1580851,Beta,1992,['India'],"['Musical', 'Comedy', 'Bollywood', 'World cinema', 'Romantic comedy', 'Drama', 'Comedy of Errors']",1990,2
4753550,12 Days of Terror,2004,['South Africa'],"['Film adaptation', 'Action/Adventure', 'Thriller', 'Docudrama', 'Disaster', 'Drama', 'Horror', 'Television movie', 'Natural horror films']",2000,4
13861681,The Devil Rides Out,1968,['United Kingdom'],"['Supernatural', 'Cult', 'Horror']",1960,8
7714023,Steal,2002,"['United Kingdom', 'France', 'Canada']","['Action', 'Crime Fiction', 'Action Thrillers', 'Action/Adventure', 'Thriller', 'World cinema', 'Heist', 'Caper story']",2000,2
8645960,Reshma Aur Shera,1971,['India'],"['Musical', 'Bollywood', 'World cinema', 'Romance Film', 'Drama']",1970,1
10175018,"Yobi, the Five Tailed Fox",2007,['South Korea'],"['Animation', 'Fantasy']",2000,7
27535031,Sleeping Beauty,1987,['United States of America'],"['Musical', 'Family Film', 'Fantasy']",1980,7
25483985,Blizzard,2003,"['Canada', 'United States of America']","['Christmas movie', 'Drama', 'Family Film']",2000,3
26274453,Oklahoma Crude,1973,['United States of America'],"['Black comedy', 'Comedy-drama', 'Satire']",1970,3
11947610,Person To Bunny,1960,['United States of America'],['Comedy'],1960,0
1364445,Sahara,1943,['United States of America'],"['War film', 'Black-and-white']",1940,3
7585324,The Weak and the Wicked,1953,['United Kingdom'],"['Prison', 'Drama', 'Biopic [feature]']",1950,3
15117778,Desperate Characters,1971,['United States of America'],"['Film adaptation', 'Marriage Drama', 'Drama']",1970,1
640260,Commissar,1967,"['Russia', 'Soviet Union']","['World cinema', 'War film', 'Political drama', 'Drama']",1960,7
25479531,"Nobody, Nobody But... Juan",2009,['Philippines'],"['Filipino Movies', 'Comedy', 'World cinema']",2000,9
4010356,Kung Fu:The Next Generation,1987,['United States of America'],"['Action', 'Drama', 'Comedy', 'Adventure', 'Science Fiction']",1980,7
16722954,New Urban Cowboy: Toward a New Pedestrianism,2008,['United States of America'],"['Indie', 'Documentary']",2000,8
8960982,White Wolves II: Legend of the Wild,1995,['United States of America'],"['Action/Adventure', 'Animal Picture', 'Family-Oriented Adventure', ""Children's/Family"", 'Adventure', 'Family Film']",1990,5
12510736,Sissi - Fateful Years of an Empress,1957,"['Austria', 'Germany']","['Romantic drama', 'Biographical film', 'World cinema', 'Romance Film', 'Drama']",1950,7
21153027,The Colossus of New York,1958,['United States of America'],"['Horror', 'Science Fiction']",1950,8
14404773,"Encore, Once More Encore!",1992,['Russia'],"['Drama', 'Comedy']",1990,2
17697199,Emma's Bliss,2006,['Germany'],"['Romantic drama', 'Comedy', 'Romance Film', 'Drama']",2000,6
61169,The Gay Divorcee,1934,['United States of America'],"['Musical', 'Black-and-white', 'Screwball comedy', 'Comedy', 'Musical comedy', 'Romance Film', 'Pre-Code', 'Comedy of Errors', 'Romantic comedy']",1930,4
84213,Decision Before Dawn,1951,['United States of America'],"['Action', 'Spy', 'Drama', 'Thriller', 'War film']",1950,1
4343392,Across the Tracks,1991,['United States of America'],"['Family Drama', 'Indie', 'Sports', 'Drama']",1990,1
2501359,Pet Shop,1995,['United States of America'],"['Science Fiction', 'Fantasy']",1990,5
30746015,Nootrukku Noor,1971,['India'],['Drama'],1970,1
640643,Frankenstein's Daughter,1958,['United States of America'],"['Creature Film', 'Black-and-white', 'Monster', 'Thriller', 'Horror', 'B-movie', 'Costume Horror']",1950,8
8964687,Dangerously Close,1986,['United States of America'],"['Action', 'Drama', 'Action Thrillers', 'Thriller']",1980,6
23606024,Beck – Spår i mörker,1997,['Sweden'],"['Mystery', 'Crime Fiction']",1990,7
30253127,Dragonfly Squadron,1954,['United States of America'],"['Combat Films', 'War film', 'Adventure', 'Drama']",1950,4
18849298,Harichandra,1997,['India'],"['Romance Film', 'Drama']",1990,7
26100091,La Muerte de Mikel,1984,['Spain'],['Drama'],1980,4
3788150,Crazy People,1990,['United States of America'],"['Parody', 'Comedy', 'Black comedy', 'Romantic comedy', 'Romance Film']",1990,0
5722849,I Have a Date with Spring,1994,['Hong Kong'],['Chinese Movies'],1990,4
1183423,Bugs Bunny Nips the Nips,1944,['United States of America'],['Propaganda film'],1940,4
2976107,The Italian Job,2003,"['United Kingdom', 'France', 'United States of America']","['Action', 'Crime Fiction', 'Action/Adventure', 'Thriller', 'Remake', 'Crime Thriller', 'Drama']",2000,3
14467499,Ek Musafir Ek Hasina,1962,['India'],"['Action', 'Mystery', 'Comedy']",1960,2
2417326,The Concorde...Airport '79,1979,['United States of America'],"['Action', 'Airplanes and airports', 'Suspense', 'Action/Adventure', 'Thriller', 'Disaster']",1970,9
399433,Pocahontas,1995,['United States of America'],"['Music', 'Musical', 'Animation', 'Romance Film', ""Children's"", 'Costume drama', 'Adventure', 'Drama', 'History', 'Family Film']",1990,5
17828345,Abandoned,1949,['United States of America'],"['Film noir', 'Black-and-white', 'Thriller']",1940,9
3510976,The Care Bears Battle the Freeze Machine,1984,['Canada'],"['Musical', 'Animation', 'Short Film', 'Fantasy']",1980,4
7874454,Frozen Land,2005,['Finland'],"['Drama', 'World cinema']",2000,5
23117688,Kulir 100°,2009,['India'],['Drama'],2000,9
3407587,Highlander: Endgame,2000,['United States of America'],"['Fantasy Adventure', 'Costume Adventure', 'Adventure', 'Fantasy']",2000,0
19939214,Kenny Begins,2009,['Sweden'],"['Action', 'Science Fiction', 'Comedy']",2000,9
6836566,Hard Luck,1921,['United States of America'],"['Black-and-white', 'Indie', 'Short Film', 'Silent film']",1920,1
7129971,"Fist of Fear, Touch of Death",1980,['United States of America'],"['Action', 'Action/Adventure', 'Adventure', 'Martial Arts Film']",1980,0
5818165,Vampire Circus,1972,['United Kingdom'],['Horror'],1970,2
2923504,Wild Women of Wongo,1958,['United States of America'],"['Fantasy', 'Comedy', 'Adventure']",1950,8
5686956,Air Raid Wardens,1943,['United States of America'],"['Black-and-white', 'Comedy', 'Satire', 'Slapstick']",1940,3
22114529,Pingami,1994,['India'],"['Action', 'Drama', 'Comedy', 'Thriller', 'Bollywood']",1990,4
12836960,A Love Story,2007,"['Macau', 'Philippines']","['Filipino Movies', 'Romance Film', 'Drama']",2000,7
23103414,Carbide and Sorrel,1963,"['Germany', 'German Democratic Republic']","['Comedy', 'World cinema']",1960,3
6017005,Anukokunda Oka Roju,2005,['India'],"['Suspense', 'Thriller', 'Horror', 'World cinema', 'Tollywood']",2000,5
76643,A Woman Under the Influence,1974,['United States of America'],"['Indie', 'Marriage Drama', 'Romance Film', 'Drama']",1970,4
15079534,Napoleon,1994,"['Japan', 'Australia', 'New Zealand', 'United States of America']","['Japanese Movies', 'Family Film', 'Adventure']",1990,4
14368280,"Where Angels Go, Trouble Follows",1968,['United States of America'],"['Comedy', 'Teen', 'Religious Film', 'Drama', 'Family Film']",1960,8
3396829,The President's Analyst,1967,['United States of America'],"['Political cinema', 'Political satire', 'Parody', 'Satire', 'Thriller', 'Comedy', 'Science Fiction']",1960,7
24827899,The Menace,1932,['United States of America'],"['Mystery', 'Drama']",1930,2
7000543,The Last Dragon,2004,"['United Kingdom', 'United States of America']",['Fantasy'],2000,4
17468008,I Love Beijing,2001,['China'],"['Romantic drama', 'World cinema', 'Romance Film', 'Chinese Movies', 'Drama']",2000,1
28784914,A Cold Wind in August,1961,['United States of America'],"['Film adaptation', 'Romantic drama', 'Indie', 'Romance Film', 'Drama']",1960,1
10396109,Maid of Salem,1937,['United States of America'],"['Period piece', 'Black-and-white', 'Historical fiction', 'Epic', 'Drama']",1930,7
4138142,The League of Extraordinary Gentlemen,2003,"['United Kingdom', 'Germany', 'Czech Republic', 'United States of America']","['Action', 'Fantasy Adventure', 'Superhero', 'Action/Adventure', 'Thriller', 'Superhero movie', 'Steampunk', 'Science Fiction', 'Fantasy']",2000,3
1317241,American Girl,2002,['United States of America'],"['Drama', 'Crime Fiction', 'Indie', 'Comedy', 'Teen', 'Black comedy']",2000,2
1430128,Carry On up the Khyber,1968,['United Kingdom'],"['Adventure Comedy', 'Parody', 'Comedy', 'War film']",1960,8
5552960,American Ninja 3: Blood Hunt,1989,"['South Africa', 'Canada', 'United States of America']","['Action', 'Martial Arts Film']",1980,9
4300597,The Rat Pack,1998,['United States of America'],"['Television movie', 'Drama', 'Biopic [feature]']",1990,8
27997402,The Fat Man,1951,['United States of America'],"['Detective fiction', 'Mystery', 'Detective', 'Drama']",1950,1
12985118,Daffy Duck Hunt,1949,['United States of America'],['Comedy'],1940,9
4578771,The Count of Monte Cristo,1934,['United States of America'],"['Black-and-white', 'Thriller', 'Costume drama', 'Adventure', 'Drama', 'Swashbuckler films']",1930,4
24342858,"Pra Frente, Brasil",1982,['Brazil'],['Drama'],1980,2
15484363,The Butterfly Murders,1979,['Hong Kong'],"['Chinese Movies', 'Thriller', 'Horror', 'Wuxia', 'Martial Arts Film', 'Natural horror films']",1970,9
5049061,Jayam,2003,['India'],"['Action', 'Comedy', 'Adventure']",2000,3
18586588,Belles on their Toes,1952,['United States of America'],"['Film adaptation', 'Family Drama', 'Comedy', 'Drama', 'Family Film']",1950,2
4538118,Shaolin and Wu Tang,1981,['Hong Kong'],"['Chinese Movies', 'Martial Arts Film']",1980,1
3312138,True Crime,1999,['United States of America'],"['Crime Fiction', 'Thriller', 'Detective', 'Drama']",1990,9
4894893,Carnosaur,1993,['United States of America'],"['Creature Film', 'Thriller', 'Horror', 'B-movie', 'Sci-Fi Horror', 'Science Fiction']",1990,3
447672,"Legally Blonde 2: Red, White & Blonde",2003,['United States of America'],"['Political satire', 'Comedy', 'Teen', 'Romance Film', 'Political cinema', 'Comedy film', 'Romantic comedy', 'Comedy of manners']",2000,3
16191901,Emanuelle Around the World,1977,['Italy'],"['Drama', 'Softcore Porn', 'Sexploitation', 'World cinema', 'Romance Film', 'Adult']",1970,7
4796062,Dark Habits,1983,['Spain'],"['LGBT', 'Satire', 'Comedy', 'World cinema', 'Black comedy', 'Drama']",1980,3
31992423,A Good Thing Going,1978,[],['Drama'],1970,8
15881464,Du Pappa,1994,['Norway'],"['Romance Film', 'Drama']",1990,4
149789,The Jolson Story,1946,['United States of America'],"['Musical', 'Biography', 'Biopic [feature]', 'Docudrama', 'Drama']",1940,6
11531498,Kamen Rider Den-O: I am Born!,2007,[],['Science Fiction'],2000,7
179326,101 Dalmatians,1996,['United States of America'],"[""Children's"", 'Comedy', 'Remake', 'Adventure', 'Drama', 'Family Film']",1990,6
23978622,Telling You,1998,['United States of America'],"['Drama', 'Indie', 'Romantic drama', 'Comedy', 'Romance Film', 'Romantic comedy']",1990,8
1261294,Road to Bali,1952,['United States of America'],"['Adventure Comedy', 'Musical', 'Action', 'Action/Adventure', 'Buddy film', 'Comedy']",1950,2
20647437,Price of Glory,2000,['United States of America'],"['Boxing', 'Sports', 'Drama']",2000,0
4842594,Dishyum,2006,['India'],"['Romance Film', 'Tamil cinema']",2000,6
11020765,Captain Hareblower,1954,['United States of America'],"['Animation', 'Short Film', 'Comedy', 'Family Film']",1950,4
850866,Full Court Miracle,2003,['United States of America'],"['Comedy-drama', ""Children's/Family"", 'Holiday Film', 'Drama', 'Family Film']",2000,3
3044606,Vendetta,1950,['United States of America'],"['Black-and-white', 'Crime Fiction', 'Drama']",1950,0
4150217,Pakeezah,1972,['India'],"['Musical', 'Romantic drama', 'Bollywood', 'World cinema', 'Romance Film', 'Drama']",1970,2
8677111,In China They Eat Dogs,1999,['Denmark'],"['Action', 'LGBT', 'Action/Adventure', 'Comedy', 'World cinema', 'Caper story', 'Comedy Thriller', 'Crime Comedy']",1990,9
2983983,Paradise Now,2005,"['Mandatory Palestine', 'Israel', 'France', 'Germany', 'Netherlands', 'Palestinian territories']","['Crime Fiction', 'Thriller', 'World cinema', 'Social problem film', 'Political drama', 'Drama']",2000,5
155921,Time After Time,1979,['United States of America'],"['Time travel', 'Thriller', 'Adventure', 'Steampunk', 'Science Fiction', 'Cult', 'Fantasy']",1970,9
5884145,The Day the Earth Froze,1959,"['Finland', 'Soviet Union']","['Fantasy Adventure', 'Mythological Fantasy', 'Fairy tale', 'Adventure', 'Science Fiction', 'Cult', 'Fantasy']",1950,9
19863623,Dharma Dorai,1991,['India'],"['Drama', 'World cinema']",1990,1
18932830,2081,2009,['United States of America'],"['Dystopia', 'Short Film', 'Science Fiction']",2000,9
9308910,Swing Shift,1984,['United States of America'],"['Period piece', 'Romantic drama', 'Romance Film', 'Drama']",1980,4
3619079,Beyond the Law,1993,['United States of America'],"['Crime Fiction', 'Indie', 'Crime Thriller', 'Drama']",1990,3
34833598,Betrayal,1978,['United States of America'],['Drama'],1970,8
4457586,Soldier,1998,['India'],['Bollywood'],1990,8
31317990,The Daredevil Men,1972,['United Kingdom'],"['Short Film', 'Documentary']",1970,2
1954311,"Silent Night, Deadly Night",1984,['United States of America'],"['Indie', 'Slasher', 'Horror']",1980,4
24381665,Mouse Wreckers,1949,['United States of America'],"['Short Film', 'Animation']",1940,9
7161386,Convict 99,1938,['United Kingdom'],"['Comedy', 'Black-and-white']",1930,8
19036260,Jeannie,1943,['England'],"['Romance Film', 'Comedy', 'Drama']",1940,3
84931,Witness,1985,['United States of America'],"['Suspense', 'Romantic drama', 'Thriller', 'Romance Film', 'Drama', 'Courtroom Drama']",1980,5
24237207,Massacre Time,1966,['Italy'],['Spaghetti Western'],1960,6
9009215,Up the Junction,1968,['United Kingdom'],['Kitchen sink realism'],1960,8
29294553,The Fabulous Journey to the Center of the Earth,1978,['Spain'],"['Action/Adventure', 'Adventure', 'World cinema']",1970,8
171562,American History X,1998,['United States of America'],"['Action', 'Drama', 'Crime Fiction', 'Coming of age', 'Indie', 'Crime Drama', 'Crime Thriller']",1990,8
19780194,Flu Bird Horror,2008,"['Germany', 'United States of America', 'Romania']","['Thriller', 'Horror', 'Teen', 'Science Fiction']",2000,8
73473,Footlight Parade,1933,['United States of America'],"['Musical', 'Black-and-white', 'Musical comedy', 'Dance', 'Pre-Code']",1930,3
6899383,The Rake's Progress,1945,['United Kingdom'],"['Black-and-white', 'Comedy', 'Drama']",1940,5
7056998,"Hey, Stop Stabbing Me!",2003,['United States of America'],"['Indie', 'Parody', 'Comedy', 'Horror']",2000,3
7293394,Boy,1969,['Japan'],"['Japanese Movies', 'Drama']",1960,9
6760470,LarryBoy and the Bad Apple,2006,['United States of America'],"['Musical', 'Animation', ""Children's""]",2000,6
2001394,Midnight Lace,1960,['United States of America'],"['Psychological thriller', 'Mystery', 'Thriller', 'Drama']",1960,0
8056384,Blaze,1989,['United States of America'],"['Romantic drama', 'Comedy', 'Romance Film', 'Political drama', 'Drama']",1980,9
17401665,Living Proof,2008,['United States of America'],"['Biography', 'Biographical film', 'Television movie', 'Drama']",2000,8
2748232,Farz,2001,['India'],[],2000,1
21563944,Nikah,1998,['Pakistan'],['Drama'],1990,8
11541829,Pulse 2: Afterlife,2008,['United States of America'],"['Psychological thriller', 'Thriller', 'Horror', 'Supernatural']",2000,8
17595675,Broken Barriers,1924,['United States of America'],"['Silent film', 'Black-and-white', 'Drama']",1920,4
15397835,Giants vs. Yanks,1923,['United States of America'],"['Black-and-white', 'Indie', 'Short Film', 'Comedy', 'Silent film', 'Family Film']",1920,3
29495341,Divorce: Not Between Husband and Wife,1995,['India'],['Family Film'],1990,5
14143380,Deadwood Dick,1940,['United States of America'],"['Black-and-white', 'Western', 'Adventure']",1940,0
12926104,A*P*E,1976,"['United States of America', 'South Korea']","['Monster', 'Horror', 'Science Fiction', 'Natural horror films']",1970,6
10873860,Kitty Foyle: The Natural History of a Woman,1940,['United States of America'],"['Black-and-white', 'Romantic drama', 'Romance Film', 'Drama']",1940,0
26941666,Tomka and His Friends,1977,['Albania'],"['Drama', 'Family Film']",1970,7
35985667,La Fonte des neiges,2008,['France'],"['Short Film', 'Drama', 'Comedy film']",2000,8
26681637,Kilukkam Kilukilukkam,2006,[],['Comedy film'],2000,6
24213437,Tomcat: Dangerous Desires,1993,"['Canada', 'United States of America']","['Creature Film', 'Psychological thriller', 'Thriller', 'Horror', 'Science Fiction', 'Drama', 'Fantasy']",1990,3
3030423,The Night of the Following Day,1968,['United States of America'],"['Drama', 'Crime Fiction']",1960,8
35340704,The Cheat,1931,['United States of America'],['Drama'],1930,1
12813525,A Letter for Evie,1946,['United States of America'],"['Black-and-white', 'Romance Film', 'Romantic comedy', 'Drama']",1940,6
306195,The Net,1995,['United States of America'],"['Action', 'Psychological thriller', 'Suspense', 'Drama', 'Thriller']",1990,5
12714295,The Last Legion,2007,"['Tunisia', 'Slovakia', 'United Kingdom', 'France', 'Italy']","['Action', 'Action/Adventure', 'Thriller', 'Sword and Sandal', 'Costume drama', 'Adventure', 'Period piece', 'Historical Epic', 'Historical fiction', 'Epic', 'War film', 'Fantasy']",2000,7
403016,Pinky,1949,['United States of America'],['Drama'],1940,9
22611532,The Sea Village,1965,['South Korea'],['Drama'],1960,5
2511741,Fist of Legend,1994,['Hong Kong'],"['Action', 'Action/Adventure', 'World cinema', 'Chinese Movies', 'Martial Arts Film']",1990,4
2600144,Idiocracy,2006,['United States of America'],"['Indie', 'Comedy', 'Thriller', 'Satire', 'Black comedy', 'Adventure', 'Political cinema', 'Time travel', 'Parody', 'Dystopia', 'Science Fiction', 'Cult']",2000,6
7106195,Warlock: The Armageddon,1993,['United States of America'],"['Teen', 'Horror', 'Supernatural', 'Cult', 'Fantasy']",1990,3
804933,Caravan of Courage: An Ewok Adventure,1984,['United States of America'],"['Adventure', 'Science Fiction', 'Family Film', 'Fantasy']",1980,4
7210182,Betty Boop's Ups and Downs,1932,['United States of America'],"['Animation', 'Short Film', 'Family Film']",1930,2
1211776,Half a Loaf of Kung Fu,1978,['Hong Kong'],"['Action', 'Action/Adventure', 'Comedy', 'World cinema', 'Chinese Movies', 'Martial Arts Film', 'Adventure']",1970,8
9216379,Only You,1994,['United States of America'],"['Romance Film', 'Comedy']",1990,4
36057875,Moovendhar,1998,['India'],['Comedy film'],1990,8
13503537,Tammy and the Bachelor,1957,['United States of America'],"['Romance Film', 'Romantic comedy', 'Comedy']",1950,7
9085771,I Stole a Million,1939,['United States of America'],"['Black-and-white', 'Crime Fiction', 'Mystery', 'Drama']",1930,9
27999190,Frankenstein 80,1972,['Italy'],"['Slasher', 'Horror']",1970,2
28679470,Nightmare in Blood,1978,['United States of America'],"['Comedy', 'Horror Comedy', 'Horror', 'B-movie']",1970,8
2201333,Dust Devil: The Final Cut,1992,"['United Kingdom', 'United States of America']","['Supernatural', 'Slasher', 'Horror']",1990,2
21577731,H,1990,['Canada'],['Drama'],1990,0
23117893,...And God Created Them,1979,['Puerto Rico'],['Comedy'],1970,9
20951888,High Tide,1987,"['New Zealand', 'Australia']","['Film noir', 'Drama', 'World cinema']",1980,7
17355548,Duh u močvari,2006,['Croatia'],['Action'],2000,6
1511826,Blind Shaft,2003,"['Hong Kong', 'Germany', 'China']","['Crime Fiction', 'Thriller', 'World cinema', 'Crime Drama', 'Crime Thriller', 'Chinese Movies', 'Drama']",2000,3
2935848,Raw Justice,1994,['United States of America'],"['Action', 'Crime Fiction', 'Action Thrillers', 'Thriller']",1990,4
3582090,A Good Lawyer's Wife,2003,['South Korea'],"['Comedy', 'Black comedy', 'Erotica', 'Drama']",2000,3
17088994,Band in a Bus,2008,['United States of America'],[],2000,8
32174547,Betty,1993,['France'],"['Drama', 'World cinema']",1990,3
26011655,Mr. Muhsin,1987,['Turkey'],['Drama'],1980,7
3819743,Il bidone,1955,"['France', 'Italy']","['Black-and-white', 'World cinema', 'Crime Drama', 'Comedy-drama', 'Drama']",1950,5
5891915,Matador,1986,['Spain'],"['Psychological thriller', 'Crime Fiction', 'Comedy', 'Thriller', 'World cinema', 'Drama']",1980,6
26612982,Bharya Swantham Suhruthu,2009,['India'],"['Drama', 'Comedy']",2000,9
1352821,The War at Home,1996,['United States of America'],"['War film', 'Drama']",1990,6
7169360,Bruce Lee's Secret,1979,['Hong Kong'],"['Action', 'Chinese Movies', 'Martial Arts Film']",1970,9
10791993,Pokkiri Raja,1982,['India'],"['Musical', 'Bollywood', 'World cinema', 'Drama']",1980,2
13032457,Hämndens pris,2001,"['Denmark', 'Sweden', 'Finland', 'Norway']","['Mystery', 'Crime Fiction']",2000,1
8013508,Malice in the Palace,1949,['United States of America'],"['Black-and-white', 'Short Film', 'Comedy', 'Slapstick']",1940,9
7249475,La Casa del Terror,1960,['Mexico'],"['Creature Film', 'Black-and-white', 'Comedy', 'Horror Comedy', 'Horror']",1960,0
16183064,The Foot Fist Way,2006,['United States of America'],"['Indie', 'Comedy', 'Black comedy', 'Sports', 'Martial Arts Film', 'Cult']",2000,6
14405752,Bunny O'Hare,1971,['United States of America'],"['Action', 'Heist', 'Action/Adventure', 'Comedy', 'Romance Film', 'Romantic comedy']",1970,1
25492486,Daniel's Daughter,2008,['Canada'],"['Romantic drama', 'Romance Film', 'Television movie', 'Drama']",2000,8
17636563,Three in the Attic,1968,['United States of America'],"['Drama', 'Comedy']",1960,8
16657224,The Big Sky,1952,['United States of America'],"['Costume Adventure', 'Black-and-white', 'Western', 'Road movie', 'Adventure']",1950,2
3242877,House of the Dead 2,2006,['United States of America'],"['Zombie Film', 'Teen', 'Horror']",2000,6
3981967,Carefree,1938,['United States of America'],"['Musical', 'Black-and-white', 'Screwball comedy', 'Romance Film']",1930,8
12555559,Half Moon Street,1986,"['United Kingdom', 'United States of America']","['Suspense', 'Mystery', 'Romantic drama', 'Thriller', 'Romance Film', 'Drama', 'Political thriller']",1980,6
25283083,A Greater Yes: The Story of Amy Newhouse,2009,[],['Drama'],2000,9
6708645,Big Bird in Japan,1989,"['Japan', 'United States of America']",['Japanese Movies'],1980,9
26534182,Pandippada,2005,['India'],['Comedy'],2000,5
8572609,That Night,1992,"['United States of America', 'France']","['Romance Film', 'Drama']",1990,2
9995174,The Return of the Tall Blond Man with One Black Shoe,1974,['France'],"['Parody', 'Comedy', 'Comedy of Errors']",1970,4
14259399,Daughters of Darkness,1971,"['West Germany', 'France', 'Belgium']","['Erotic Drama', 'Gothic Film', 'Horror', 'Erotic thriller']",1970,1
27797260,Wife Taxi: Crowded with Big Tits,2004,['Japan'],['Japanese Movies'],2000,4
31258406,James Bond,1999,[],['Comedy'],1990,9
29836847,The Night the Bridge Fell Down,1983,['United States of America'],['Action'],1980,3
2847874,Azumi,2003,['Japan'],"['Action', 'Samurai cinema', 'Japanese Movies', 'Action/Adventure', 'World cinema', 'Epic']",2000,3
25934563,Pig Hunt,2008,['United States of America'],"['Action', 'Thriller', 'Horror', 'B-movie']",2000,8
2367337,Loophole,1954,['United States of America'],"['Black-and-white', 'Crime Fiction', 'Mystery', 'Thriller', 'Film noir', 'Drama']",1950,4
24388866,Eeram,2009,['India'],"['Crime Fiction', 'Crime Thriller']",2000,9
15607846,The Onion Field,1979,['United States of America'],"['Film adaptation', 'Crime Fiction', 'Drama']",1970,9
10140793,The Green Hornet Strikes Again,1941,['United States of America'],"['Action', 'Black-and-white', 'Crime Fiction', 'Movie serial', 'Superhero movie', 'Adventure']",1940,1
459586,The Devils,1971,['United Kingdom'],"['Period piece', 'Crime Fiction', 'Thriller', 'New Hollywood', 'Horror', 'Historical fiction']",1970,1
12466125,The Amazing Spiderman,1977,['United States of America'],"['Action', 'Crime Fiction', 'Superhero movie', 'Science Fiction', 'Drama', 'Family Film', 'Fantasy']",1970,7
1244822,Owning Mahowny,2003,"['Canada', 'United Kingdom', 'England', 'United States of America']","['Period piece', 'Crime Fiction', 'Biography', 'Thriller', 'Crime Drama', 'Crime Thriller', 'Drama']",2000,3
25932667,Ma and Pa Kettle,1949,['United States of America'],['Comedy'],1940,9
26431639,Dilliwala Rajakumaran,1996,['India'],"['Action', 'Drama', 'Comedy']",1990,6
962431,Midway,1976,['United States of America'],"['Action', 'Drama', 'Action/Adventure', 'War film']",1970,6
7893461,The Girl,2001,"['France', 'United States of America']","['LGBT', 'Mystery', 'Indie', 'Romantic drama', 'Thriller', 'Romance Film', 'Drama', 'Erotic thriller']",2000,1
7070586,The Barn Dance,1929,['United States of America'],"['Black-and-white', 'Animation', 'Short Film', 'Comedy']",1920,9
12545571,Millions Like Us,1943,['United Kingdom'],"['Romantic drama', 'Romance Film', 'Propaganda film', 'War film', 'Drama']",1940,3
34272720,Evil Empire: A Talk by Chalmers Johnson,2007,['United States of America'],['Sponsored film'],2000,7
23398669,Toss,2009,['India'],[],2000,9
2742724,Ladies in Lavender,2004,['United Kingdom'],"['Film adaptation', 'Romantic drama', 'Romance Film', 'Drama', 'Period piece', 'Romantic comedy', 'Comedy-drama', 'Comedy of manners']",2000,4
22944765,Sea Devils,1953,"['United Kingdom', 'United States of America']","['Action', 'Drama', 'Adventure']",1950,3
35994049,Thaai Naadu,1989,['India'],[],1980,9
14531115,Alias Jimmy Valentine,1928,['United States of America'],"['Black-and-white', 'Detective']",1920,8
2009711,It Came from Outer Space,1953,['United States of America'],"['B-movie', 'Science Fiction', 'Horror']",1950,3
523419,Piccadilly,1929,['United Kingdom'],"['Black-and-white', 'Drama', 'Crime Fiction', 'Indie', 'Silent film', 'Crime Drama']",1920,9
2148679,Liang Po Po: The Movie,1999,['Singapore'],"['Comedy', 'Crime Fiction']",1990,9
7133888,The Lost Patrol,1934,['United States of America'],"['Action', 'Action/Adventure', 'War film']",1930,4
28118500,Sharks' Treasure,1975,['United States of America'],['Adventure'],1970,5
2947484,Mezzo Forte,2001,['Japan'],"['Action', 'Animation', 'Action/Adventure', 'Comedy', 'Thriller', 'World cinema', 'Japanese Movies', 'Anime', 'Science Fiction']",2000,1
20948069,Along the Ridge,2006,['Italy'],['Drama'],2000,6
2368143,Blacula,1972,['United States of America'],"['Blaxploitation', 'Action/Adventure', 'Horror', 'Cult']",1970,2
6023070,Hate 2 O,2006,['Italy'],"['Mystery', 'Thriller', 'Horror']",2000,6
685931,Problem Child 2,1991,['United States of America'],"['Slapstick', 'Comedy', 'Black comedy', ""Children's/Family"", 'Family Film']",1990,1
11921392,Enter the Fat Dragon,1978,['Hong Kong'],"['Action', 'Bruceploitation', 'Action/Adventure', 'Comedy', 'World cinema', 'Chinese Movies', 'Martial Arts Film', 'Parody', 'Action Comedy']",1970,8
27527158,Perfect Alibi,1995,['United States of America'],"['Thriller', 'Drama']",1990,5
1167860,Chaudhvin Ka Chand,1960,['India'],"['Musical', 'Romantic drama', 'Bollywood', 'World cinema', 'Romance Film', 'Drama']",1960,0
6265220,The Descent 2,2009,['United Kingdom'],"['Creature Film', 'Thriller', 'Horror', 'Adventure']",2000,9
11308555,Savage Grace,2007,"['France', 'Spain', 'United States of America']","['Period piece', 'Drama', 'Crime Fiction', 'Indie', 'Family Drama', 'Crime Drama', 'Docudrama']",2000,7
29970414,Bayaning 3rd World,1999,['Philippines'],['Filipino Movies'],1990,9
304392,Stolen Kisses,1968,['France'],"['Comedy', 'World cinema', 'Romance Film', 'Romantic comedy', 'Drama']",1960,8
22443525,Go Toward The Light,1988,['United States of America'],"['Drama', 'Television movie']",1980,8
4898573,Sacred Flesh,1999,['United Kingdom'],"['Psychological thriller', 'Period piece', 'Drama', 'Sexploitation', 'Indie', 'Erotic thriller', 'Romance Film']",1990,9
15516110,The Road to Wellville,1994,"['United Kingdom', 'United States of America']","['History', 'Parody', 'Screwball comedy', 'Comedy', 'Black comedy', 'Comedy-drama']",1990,4
10628948,Yejaman,1993,['India'],['Romance Film'],1990,3
14615738,I'm a Monkey's Uncle,1948,['United States of America'],"['Black-and-white', 'Short Film', 'Comedy', 'Slapstick']",1940,8
6575394,Lords of the Deep,1989,['United States of America'],"['Science Fiction', 'Thriller', 'Horror']",1980,9
5119319,The Lower Depths,1957,['Japan'],"['Art film', 'Japanese Movies', 'World cinema', 'Drama']",1950,7
5498661,Never Talk to Strangers,1995,"['Germany', 'United States of America', 'Canada']","['Psychological thriller', 'Suspense', 'Thriller', 'Erotic thriller']",1990,5
9893039,The Legendary Tai Fei,1999,['Hong Kong'],['Chinese Movies'],1990,9
2032676,Belly,1998,"['Jamaica', 'United States of America']","['Crime Fiction', 'Film noir', 'Crime Drama', 'Hip hop movies', 'Drama']",1990,8
4095645,The Girl with the Hungry Eyes,1967,['United States of America'],"['Indie', 'Black-and-white']",1960,7
6079196,The Taking of Beverly Hills,1991,['United States of America'],"['Action', 'Crime Fiction', 'Action Thrillers', 'Thriller']",1990,1
1522227,Anthropophagous,1980,"['Italy', 'United States of America']","['Slasher', 'Horror']",1980,0
234537,Equilibrium,2002,['United States of America'],"['Action', 'Dystopia', 'Future noir', 'Thriller', 'Science Fiction', 'Drama']",2000,2
2349209,The Magic Roundabout,2005,"['United Kingdom', 'France', 'United States of America']","['Animation', 'Fantasy', 'Adventure', 'Family Film', 'Computer Animation']",2000,5
20844864,Machine,2007,['United States of America'],"['Drama', 'Crime Fiction']",2000,7
15337018,Tarzan's Secret Treasure,1941,['United States of America'],"['Black-and-white', 'Adventure', 'Jungle Film']",1940,1
12224231,Elegy,2008,['United States of America'],"['Film adaptation', 'Romantic drama', 'Romance Film', 'Drama']",2000,8
5157752,Annavaram,2007,['India'],"['Action', 'Musical', 'Thriller', 'World cinema', 'Tollywood']",2000,7
2626454,In the Name of the King: A Dungeon Siege Tale,2008,"['Germany', 'United States of America', 'Canada']","['Action', 'Action/Adventure', 'World cinema', 'Sword and sorcery', 'Adventure', 'Drama', 'Fantasy']",2000,8
7488209,Mother Goose Land,1933,['United States of America'],"['Short Film', 'Animation']",1930,3
10049879,Yellow Hair,1999,['South Korea'],['Drama'],1990,9
220521,Diamonds,1975,"['Israel', 'United States of America']",['Crime Fiction'],1970,5
9475022,Off Season,2001,['United States of America'],"['Comedy', 'Drama', 'Family Film']",2000,1
1395159,Clockstoppers,2002,['United States of America'],"['Comedy', 'Thriller', 'Teen', 'Adventure', 'Science Fiction', 'Family Film']",2000,2
27994466,Fight for Us,1989,"['Philippines', 'Italy', 'United States of America']","['Action', 'Filipino Movies', 'Political drama', 'Adventure']",1980,9
26342592,High School Caesar,1960,['United States of America'],['Drama'],1960,0
1094516,Knock on Wood,1954,['United States of America'],"['Action', 'Action/Adventure', 'Comedy']",1950,4
30809577,Aan Paavam,1985,[],['Comedy film'],1980,5
4185779,Blue Spring,2001,['Japan'],"['Action', 'Action Thrillers', 'Action/Adventure', 'Thriller', 'World cinema', 'Juvenile Delinquency Film', 'Drama', 'Japanese Movies']",2000,1
32269495,Joshilaay,1989,[],"['Action', 'Drama']",1980,9
5638157,Firewalker,1986,['United States of America'],"['Adventure Comedy', 'Action', 'Action Comedy', 'Action/Adventure', 'Comedy', 'Adventure']",1980,6
13439015,The Night Stalker,1972,['United States of America'],"['Thriller', 'Horror']",1970,2
4759392,Killer Tattoo,2001,['Thailand'],"['Action', 'Crime Fiction', 'Action Comedy', 'Action/Adventure', 'Comedy', 'World cinema']",2000,1
22858004,Neelathaamara,2009,['India'],['Drama'],2000,9
6149264,Snakes on a Train,2006,['United States of America'],"['Thriller', 'Horror', 'B-movie', 'Natural horror films']",2000,6
19308865,Sur,1988,"['Argentina', 'France']","['Indie', 'Drama']",1980,8
1052133,The Machinist,2004,['Spain'],"['Psychological thriller', 'Drama', 'Mystery', 'Indie', 'Thriller', 'Horror']",2000,4
8267311,The Vigilantes Are Coming,1936,['United States of America'],"['Action', 'Black-and-white', 'Western', 'Action/Adventure', 'Adventure']",1930,6
11461593,The Adventures of Lucky Pierre,1961,['United States of America'],"['Sexploitation', 'Comedy']",1960,1
55495,Miller's Crossing,1990,['United States of America'],"['Crime Fiction', 'Gangster Film', 'Thriller', 'Crime Thriller', 'Drama']",1990,0
5090583,C.I.D.,1956,['India'],"['Musical', 'Bollywood', 'World cinema', 'Drama']",1950,6
4369608,Black Dawn,2005,['United States of America'],"['Action', 'Action Thrillers', 'Action/Adventure', 'Thriller', 'Martial Arts Film']",2000,5
1721437,Sleeping Dogs Lie,2005,['United States of America'],"['Drama', 'Crime Fiction', 'Mystery', 'Indie', 'Thriller', 'Crime Thriller']",2000,5
12128552,Dak Bangla,1987,['India'],['Horror'],1980,7
24501467,I Am My Own Woman,1994,['Germany'],"['LGBT', 'Biography', 'World cinema', 'Documentary', 'Drama']",1990,4
10407964,For the Love of Mike,1927,['United States of America'],"['Silent film', 'Black-and-white', 'Drama']",1920,7
4026639,Aina,1974,['Pakistan'],"['Musical', 'Romance Film', 'Drama']",1970,4
32808718,The Kangaroo Kid,1950,['Australia'],['Western'],1950,0
4694464,Adam & Steve,2005,['United States of America'],"['LGBT', 'Indie', 'Comedy', 'Romance Film', 'Gay Themed', 'Gay', 'Gay Interest', 'Romantic comedy']",2000,5
4597853,The Devil Wears Prada,2006,['United States of America'],"['Film adaptation', 'Parody', 'Comedy', 'Romance Film', 'Comedy-drama', 'Workplace Comedy', 'Drama']",2000,6
3024239,Shaolin Temple,1982,['Hong Kong'],"['Chinese Movies', 'Martial Arts Film']",1980,2
4410476,My Girl and I,2005,['South Korea'],['Romance Film'],2000,5
8224272,Violent is the Word for Curly,1938,['United States of America'],"['Black-and-white', 'Short Film', 'Comedy', 'Slapstick']",1930,8
2609661,Border Incident,1949,['United States of America'],"['Black-and-white', 'Crime Fiction', 'Thriller', 'Crime Drama', 'Film noir', 'Drama']",1940,9
31322526,Shadow Over The Islands,1952,['German Democratic Republic'],[],1950,2
9162180,Kremmen: The Movie,1980,['United Kingdom'],"['Science Fiction', 'Short Film', 'Comedy']",1980,0
171029,Cape Fear,1962,['United States of America'],"['Psychological thriller', 'Black-and-white', 'Crime Fiction', 'Thriller', 'Film noir', 'Crime Thriller', 'Drama']",1960,2
33117749,Three Blind Mouseketeers,1936,['United States of America'],"['Musical', 'Animation', 'Short Film', 'Comedy film', 'Family Film']",1930,6
4147193,Extremities,1986,['United States of America'],"['Crime Fiction', 'Thriller', 'Crime Thriller', 'Drama']",1980,6
30797163,Vlak u snijegu,1976,"['Croatia', 'Socialist Federal Republic of Yugoslavia']","[""Children's""]",1970,6
14420555,Locusts: The 8th Plague,2005,['United States of America'],"['Thriller', 'Horror', 'Science Fiction', 'Drama']",2000,5
27510681,Ghost Chasers,1951,['United States of America'],['Comedy film'],1950,1
5989305,Breathless,1983,['United States of America'],"['Suspense', 'Crime Fiction', 'Romantic drama', 'Remake', 'Romance Film', 'Crime Thriller', 'Drama']",1980,3
3339200,Dinner at Eight,1933,['United States of America'],"['Drama', 'Comedy']",1930,3
4767396,Saranggola,1999,['Philippines'],"['Filipino Movies', 'Family Drama', 'Childhood Drama', 'World cinema', 'Melodrama', 'Filipino', 'Drama']",1990,9
26448607,The Vampire Happening,1971,['West Germany'],"['Comedy', 'Horror']",1970,1
99464,Nicholas and Alexandra,1971,"['United Kingdom', 'United States of America']","['Biographical film', 'Drama', 'Period piece', 'History', 'Biopic [feature]', 'Historical Epic', 'Historical fiction', 'Epic', 'War film']",1970,1
4162883,The Creation of the Humanoids,1962,['United States of America'],"['Action', 'Indie', 'Science Fiction']",1960,2
11217695,Chambal Ki Kasam,1980,['India'],"['Action', 'Crime Fiction']",1980,0
22199726,Sin Nombre,2009,"['Mexico', 'United States of America']","['Crime Fiction', 'Thriller', 'Adventure', 'Drama']",2000,9
3683823,The World of Henry Orient,1964,['United States of America'],"['Coming of age', 'Comedy', 'Comedy of manners', 'Romantic comedy', 'Romance Film', 'Comedy-drama', 'Drama']",1960,4
6156767,Golden Chicken,2002,['Hong Kong'],"['Romantic comedy', 'Chinese Movies', 'Comedy']",2000,2
11142423,Vishnu Vijayam,1974,['India'],[],1970,4
8500485,Babes in Toyland,1986,"['West Germany', 'United States of America']","['Family Film', 'Fantasy']",1980,6
9054462,Pitbullterje,2005,['Norway'],['Comedy'],2000,5
15777230,The Horsemen,2008,['United States of America'],"['Psychological thriller', 'Slasher', 'Thriller', 'Crime Thriller']",2000,8
30603944,Pyasi Aatma,1998,[],[],1990,8
10133217,Lakeview Terrace,2008,['United States of America'],"['Psychological thriller', 'Thriller', 'Crime Thriller', 'Drama']",2000,8
450634,Pleasantville,1998,['United States of America'],"['Period piece', 'Dystopia', 'Family Drama', 'Comedy', 'Drama', 'Family Film', 'Fantasy']",1990,8
2103762,Fire Maidens from Outer Space,1956,['United Kingdom'],"['Science Fiction', 'Adventure', 'Horror']",1950,6
17050837,Suez,1938,['United States of America'],"['Black-and-white', 'Biopic [feature]', 'Adventure', 'Drama']",1930,8
13449620,The Defender,1994,['Hong Kong'],"['Action', 'Action/Adventure', 'Thriller', 'World cinema', 'Chinese Movies', 'Martial Arts Film']",1990,4
20874072,The Rebel,1993,['Italy'],['Drama'],1990,3
12596488,Rabbit Every Monday,1951,['United States of America'],"['Animation', 'Short Film', 'Comedy', 'Family Film']",1950,1
12594256,Minister Fatakeshto,2007,['India'],"['Action', 'Crime Fiction']",2000,7
77856,Mary Poppins,1964,['United States of America'],"['Musical', ""Children's Fantasy"", 'Comedy', ""Children's/Family"", 'Drama', 'Family Film', 'Fantasy']",1960,4
161334,Un chien andalou,1929,['France'],"['Surrealism', 'Black-and-white', 'Art film', 'Indie', 'Satire', 'Avant-garde', 'World cinema', 'Drama', 'Short Film', 'Experimental film', 'Silent film', 'Cult', 'Fantasy']",1920,9
26003791,Judgement,1999,['South Korea'],"['Short Film', 'Drama']",1990,9
4642099,Agent for H.A.R.M.,1966,['United States of America'],"['Action', 'Spy', 'Parody', 'Comedy', 'Adventure', 'Science Fiction']",1960,6
1079963,A Short Film About Love,1988,['Poland'],"['Romantic drama', 'World cinema', 'Romance Film', 'Drama']",1980,8
24828564,La Belle Verte,1996,['France'],['Comedy'],1990,6
25216011,Uncivilised,1937,['Australia'],['Adventure'],1930,7
828218,The Singing Detective,1986,"['England', 'Australia']","['Musical', 'Mystery', 'Thriller', 'Film noir', 'Drama']",1980,6
19115862,Letter from an Unknown Woman,1948,['United States of America'],"['Musical', 'Black-and-white', 'Romance Film', 'Drama']",1940,8
17687538,Death of a Salesman,1985,"['Germany', 'United States of America', 'West Germany']","['Film adaptation', 'Television movie', 'Drama']",1980,5
4186829,Senseless,1998,['United States of America'],"['Romantic comedy', 'Comedy']",1990,8
3824986,Once Upon a Time in High School,2004,['South Korea'],['Martial Arts Film'],2000,4
3186725,The Outsiders,1983,['United States of America'],"['Period piece', 'Film adaptation', 'Coming of age', 'Teen', 'Drama']",1980,3
456587,Videodrome,1983,['Canada'],"['Mystery', 'Thriller', 'Horror', 'Science Fiction']",1980,3
1665781,So Dear to My Heart,1949,['United States of America'],"['Animation', 'Childhood Drama', 'Animal Picture', ""Children's/Family""]",1940,9
7513196,The Watermelon Woman,1996,['United States of America'],"['LGBT', 'Indie', 'Comedy', 'Romance Film', 'Drama', 'Gay Themed', 'Gay', 'Gay Interest', 'Romantic comedy']",1990,6
27537840,Reign of the Gargoyles,2007,['United States of America'],"['Action', 'Television movie', 'Science Fiction']",2000,7
4069518,The Abominable Snowman,1957,['United Kingdom'],"['Monster movie', 'Horror']",1950,7
9129839,Mentor,2006,['United States of America'],"['Indie', 'Drama']",2000,6
3586028,Django,1966,"['Spain', 'Italy']","['Action', 'Action/Adventure', 'Western', 'World cinema', 'Spaghetti Western']",1960,6
29891231,September Storm,1960,['United States of America'],['Adventure'],1960,0
23396276,River's End,2005,['United States of America'],"['Action', 'Crime Fiction', 'Coming of age', 'Indie', 'Adventure', 'Drama']",2000,5
10393653,The Man from Yesterday,1932,['United States of America'],"['Black-and-white', 'War film', 'Drama']",1930,2
9459686,The Sea Chase,1955,['United States of America'],"['Action', 'Chase Movie', 'Action/Adventure', 'Adventure', 'War film']",1950,5
11932765,The Courtship of Eddie's Father,1963,['United States of America'],"['Comedy', 'Romance Film', 'Romantic comedy', 'Drama', 'Family Film']",1960,3
396607,The Lord of the Rings,1978,['United States of America'],"['Fantasy Adventure', 'Animation', 'Fantasy', 'Drama', 'Family Film', 'Sword and sorcery films']",1970,8
2290453,Knockaround Guys,2002,"['Canada', 'United States of America']","['Action', 'Crime Fiction', 'Gangster Film', 'Action/Adventure', 'Comedy', 'Thriller', 'Crime Thriller']",2000,2
26202408,When My Baby Smiles at Me,1948,['United States of America'],['Musical'],1940,8
10673063,The Adventurers,1970,['United States of America'],"['Film adaptation', 'Political drama', 'Drama']",1970,0
22271666,The Mexican Dream,2003,['United States of America'],"['Short Film', 'Comedy film']",2000,3
3505515,The Fast Lady,1962,['United Kingdom'],"['Comedy', 'Crime Fiction']",1960,2
26003458,Chandamama,1999,['India'],"['Drama', 'Bollywood', 'Comedy film']",1990,9
24572100,His Secretary,1925,[],"['Silent film', 'Romance Film', 'Comedy']",1920,5
25982831,Nocturna: Granddaughter of Dracula,1979,['United States of America'],"['Comedy', 'Horror']",1970,9
8167617,10 Items or Less,2006,['United States of America'],"['Drama', 'Indie', 'Comedy', 'Romance Film', 'Comedy-drama', 'Road movie', 'Slice of life story']",2000,6
24865200,Eastern Plays,2009,['Bulgaria'],"['Religious Film', 'Drama', 'World cinema']",2000,9
17377846,Alien invasion arizona,2005,['United States of America'],"['Thriller', 'Horror', 'Alien Film', 'Science Fiction']",2000,5
1707516,Escape from Alcatraz,1979,['United States of America'],"['Action', 'Suspense', 'Prison', 'Escape Film', 'Action/Adventure', 'Thriller', 'Drama']",1970,9
25074031,The Human Monster,1939,['United Kingdom'],"['Crime Fiction', 'Mystery', 'Thriller', 'Horror', 'Crime Thriller']",1930,9
7487497,Betty Boop's Birthday Party,1933,['United States of America'],"['Animation', 'Short Film', 'Comedy', 'Family Film']",1930,3
32799763,J-ok'el,2007,['Mexico'],"['B-movie', 'Thriller', 'Horror']",2000,7
4277421,Chamatkar,1992,['India'],"['Comedy', 'Bollywood', 'Drama', 'Fantasy']",1990,2
1198629,Aces High,1976,['United Kingdom'],"['Action', 'Film adaptation', 'Drama', 'War film', 'Adventure']",1970,6
9475801,The Giant Claw,1957,['United States of America'],"['Creature Film', 'Horror', 'Alien Film', 'Science Fiction']",1950,7
8830696,Hatley High,2003,['Canada'],"['Coming of age', 'Comedy', 'Teen', 'Romantic comedy', 'Family Film']",2000,3
23302133,Mr. Troop Mom,2009,['United States of America'],"[""Children's/Family"", 'Comedy', 'Family Film']",2000,9
8982096,Texas Across the River,1966,['United States of America'],"['Comedy Western', 'Western', 'Comedy']",1960,6
6389690,American Friends,1991,['United Kingdom'],"['Indie', 'Satire', 'Comedy', 'Romance Film', 'Romantic comedy', 'Costume drama', 'Sex comedy']",1990,1
25350982,Without Consent,1994,['United States of America'],['Drama'],1990,4
22637746,Pippi Longstocking,1969,"['Sweden', 'West Germany']","['Comedy', 'Adventure', ""Children's"", 'Drama', 'Family Film']",1960,9
21472296,The Set-Up,1988,['United States of America'],"['Thriller', 'Crime Fiction']",1980,8
4209429,Buzz Lightyear of Star Command: The Adventure Begins,2000,['United States of America'],"['Animation', 'Comedy', ""Children's/Family"", 'Adventure', 'Family Film']",2000,0
25754522,Enrai,1981,[],['Drama'],1980,1
171559,Affliction,1998,['United States of America'],"['Crime Fiction', 'Indie', 'Drama']",1990,8
29239928,The Wizard of Loneliness,1988,[],['Drama'],1980,8
740824,The Quick and the Dead,1995,"['Japan', 'United States of America']","['Action', 'Japanese Movies', 'Action/Adventure', 'Western', 'Thriller', 'Adventure', 'Drama']",1990,5
17440633,One Two Three,2008,['India'],"['Action', 'Musical', 'Comedy', 'Bollywood', 'World cinema', 'Drama', 'Comedy of Errors', 'Crime Comedy']",2000,8
3448857,Mr. Magoo,1997,['United States of America'],"['Slapstick', 'Comedy', 'Romance Film', ""Children's/Family"", 'Adventure', 'Family Film']",1990,7
2970596,To Grandmother's House We Go,1992,['United States of America'],"['Christmas movie', 'Comedy', 'Family-Oriented Adventure', ""Children's/Family"", 'Adventure', 'Family Film']",1990,2
10811085,Lava Kusha,1963,['India'],['World cinema'],1960,3
5686822,Reeker,2005,['United States of America'],"['Slasher', 'Horror']",2000,5
101954,The English Patient,1996,"['United Kingdom', 'United States of America']","['Period piece', 'Film adaptation', 'Romantic drama', 'Romance Film', 'War film', 'Drama']",1990,6
19012797,The Marsh,2006,"['Canada', 'United States of America']","['Psychological thriller', 'Thriller', 'Horror', 'Supernatural']",2000,6
15842539,Ecstasy of the Angels,1972,['Japan'],"['Action/Adventure', 'Avant-garde', 'World cinema', 'Drama', 'Japanese Movies', 'Experimental film', 'Pinku eiga', 'Erotica']",1970,2
1472865,Telokhranitel,1979,['Soviet Union'],['Action'],1970,9
10776414,Snuff Bottle Connection,1977,"['Hong Kong', 'Taiwan']","['Action', 'Spy', 'Chinese Movies', 'Martial Arts Film']",1970,7
4848522,Gorillas in the Mist: The Story of Dian Fossey,1988,['United States of America'],"['Period piece', 'Biography', 'Biographical film', 'Drama']",1980,8
31481839,Puthooramputhri Unniyarcha,2002,[],['Drama'],2000,2
24166322,The Whole Truth,1958,['United Kingdom'],['Drama'],1950,8
9612861,Disorderlies,1987,['United States of America'],"['Indie', 'Slapstick', 'Comedy']",1980,7
8026248,Bardaasht,2004,['India'],"['Drama', 'World cinema']",2000,4
1483067,David and Lisa,1962,['United States of America'],"['Romance Film', 'Romantic drama', 'Drama']",1960,2
31477549,Disturbed,1990,[],['Horror'],1990,0
9890196,Has Anybody Seen My Gal?,1952,['United States of America'],"['Musical', 'Comedy', 'Musical comedy']",1950,2
6205079,Scooby-Doo and the Monster of Mexico,2003,['United States of America'],"['Animation', 'Family-Oriented Adventure', ""Children's/Family"", 'Adventure']",2000,3
24742937,Edges of Darkness,2009,['United States of America'],"['Horror', 'Zombie Film', 'Sci-Fi Horror', 'Science Fiction']",2000,9
10797643,Mon Meilleur Ami,2006,['France'],"['Comedy', 'World cinema']",2000,6
7398083,Lost & Found,1996,['Hong Kong'],"['Romantic drama', 'World cinema', 'Romance Film', 'Chinese Movies', 'Drama']",1990,6
3130366,Blame it on Rio,1984,['United States of America'],"['Indie', 'Comedy', 'Romance Film', 'Romantic comedy', 'Sex comedy']",1980,4
6720263,Living It Up,1954,['United States of America'],"['Musical', 'Comedy']",1950,4
25001598,Last Cowboy Standing,2009,"['Finland', 'Germany']",['Drama'],2000,9
10943778,Love's Long Journey,2005,['United States of America'],"['Action/Adventure', 'Western', 'Adventure', 'Christian film', 'Drama']",2000,5
253834,The Mummy,1959,['United Kingdom'],"['Monster movie', 'Archaeology', 'Horror']",1950,9
21287052,Relentless 3,1993,['United States of America'],"['Crime Thriller', 'Thriller', 'Horror']",1990,3
2285878,Legend of Earthsea,2004,['United States of America'],"['Television movie', 'Adventure', 'Drama', 'Fantasy']",2000,4
3328529,Moon Over Parador,1988,['United States of America'],"['Political cinema', 'Screwball comedy', 'Political satire', 'Comedy', 'Romance Film', 'Romantic comedy']",1980,8
23974329,His Double Life,1933,['United States of America'],"['Mystery', 'Comedy', 'Drama']",1930,3
5070177,On The Border Of Hopetown,1992,['Australia'],"['Short Film', 'Drama']",1990,2
16230319,Train,2009,['United States of America'],"['Psychological thriller', 'Slasher', 'Thriller', 'Horror', 'Teen']",2000,9
6934510,The Stupids,1996,"['United Kingdom', 'United States of America']","['Slapstick', 'Comedy', 'Domestic Comedy', 'Family Film']",1990,6
15234055,Madame Freedom,1956,['South Korea'],['Drama'],1950,6
6183212,Towed in a Hole,1932,['United States of America'],"['Black-and-white', 'Short Film', 'Comedy', 'Slapstick']",1930,2
8503874,Thérèse Desqueyroux,1962,['France'],"['Marriage Drama', 'Drama']",1960,2
670407,Harry Potter and the Order of the Phoenix,2007,"['United Kingdom', 'United States of America']","['Fantasy Adventure', 'Mystery', 'Adventure', 'Family Film', 'Fantasy']",2000,7
957359,The Mummy Returns,2001,['United States of America'],"['Action', 'Adventure Comedy', 'Costume Adventure', 'Action/Adventure', 'Thriller', 'Costume drama', 'Adventure', 'Creature Film', 'Monster movie', 'Horror', 'Supernatural', 'Fantasy']",2000,1
17617782,Andy Hardy's Private Secretary,1941,['United States of America'],"['Comedy film', 'Romance Film', 'Romantic comedy', 'Comedy-drama', 'Family Film']",1940,1
31667867,Nairu Pidicha Pulivalu,1958,[],[],1950,8
26244363,Palletoori Pilla,1950,['India'],"['Action', 'Drama', 'Comedy film', 'Adventure']",1950,0
13291547,Alles is Liefde,2007,['Netherlands'],"['Romantic comedy', 'Comedy-drama', 'Holiday Film', 'Ensemble Film']",2000,7
25752711,Ensayo de un crimen,1955,['Mexico'],"['Crime Fiction', 'Comedy', 'Satire', 'Crime Comedy', 'Black comedy']",1950,5
1873112,Who's That Knocking at My Door,1967,['United States of America'],"['Romance Film', 'Romantic drama', 'Drama']",1960,7
3150811,Drip-Along Daffy,1951,['United States of America'],"['Animation', 'Western', 'Short Film', 'Comedy', 'Family Film']",1950,1
13998321,Roxy Hunter and the Mystery of the Moody Ghost,2007,['Canada'],"['Mystery', 'Family Film']",2000,7
89631,The Goonies,1985,['United States of America'],"['Adventure Comedy', ""Children's"", 'Comedy film', 'Teen', 'Family-Oriented Adventure', 'Family Film', 'Adventure']",1980,5
14202380,Lillian Russell,1940,['United States of America'],"['Musical', 'Period piece', 'Black-and-white', 'Biography', 'Biopic [feature]', 'Biographical film', 'Drama']",1940,0
4712026,Die Legende von Paul und Paula,1973,['Germany'],"['Romantic drama', 'World cinema', 'Romance Film', 'Political drama', 'Drama']",1970,3
27525573,The Sell-Out,1976,"['United Kingdom', 'Israel', 'Italy']","['Action', 'Action/Adventure', 'Thriller']",1970,6
12303686,The Home Song Stories,2007,['Australia'],"['Family Drama', 'Drama']",2000,7
2072768,The Sound Barrier,1952,['United Kingdom'],"['Action', 'Drama', 'Romantic drama', 'Romance Film', 'War film']",1950,2
8155618,Naruto the Movie 4,2007,['Japan'],"['Action', 'Animation', 'Japanese Movies', 'Anime', 'Fantasy']",2000,7
2692160,Divine Secrets of the Ya-Ya Sisterhood,2002,['United States of America'],"['Film adaptation', 'Family Drama', 'Comedy', 'Americana', 'Drama', 'Period piece', 'Comedy-drama', 'Ensemble Film']",2000,2
2200771,Macao,1952,['United States of America'],"['Black-and-white', 'Crime Fiction', 'Romantic drama', 'Thriller', 'Film noir', 'Romance Film', 'Adventure', 'Drama']",1950,2
6669665,Japan Sinks,2006,['Japan'],"['Tokusatsu', 'Japanese Movies', 'Thriller', 'World cinema', 'Natural disaster', 'Doomsday film', 'Disaster']",2000,6
8406407,Beautiful People,1999,['United Kingdom'],"['Indie', 'Comedy', 'Black comedy', 'War film', 'Drama']",1990,9
25298252,Gypsy,1993,['United States of America'],"['Musical', 'Period piece', 'Biography', 'Television movie', 'Drama']",1990,3
28293207,Daybreak,1948,['United Kingdom'],['Film noir'],1940,8
32783094,"100,000 Cobbers",1942,[],['Short Film'],1940,2
21504426,What Have You Done to Solange?,1972,['Italy'],"['Giallo', 'Thriller', 'Horror', 'World cinema']",1970,2
25965187,Nandanam,2002,['India'],"['Musical', 'Comedy film', 'Drama', 'Fantasy']",2000,2
1190115,Imagining Argentina,2003,"['United Kingdom', 'Spain', 'United States of America']","['Supernatural', 'Film adaptation', 'Family Drama', 'Romantic drama', 'Thriller', 'World cinema', 'Drama', 'Period piece', 'Political drama']",2000,3
4398477,Kebab Connection,2005,['Germany'],"['Comedy', 'Comedy of manners', 'World cinema', 'Black comedy']",2000,5
2477211,Hell Comes to Frogtown,1987,['United States of America'],"['Action/Adventure', 'Satire', 'Comedy', 'Disaster', 'Parody', 'Doomsday film', 'Science Fiction', 'Cult']",1980,7
83497,The Wise Little Hen,1934,['United States of America'],['Short Film'],1930,4
24926538,Poor Little Rich Girl,1936,['United States of America'],"['Musical', 'Black-and-white']",1930,6
5205275,Jesse James Meets Frankenstein's Daughter,1966,['United States of America'],"['Creature Film', 'Monster', 'Action/Adventure', 'Western', 'Hybrid Western', 'Horror', 'B-movie']",1960,6
835620,The Rat Race,1960,['United States of America'],"['Romantic drama', 'Comedy', 'Romance Film', 'Romantic comedy', 'Drama']",1960,0
4702155,The Forbidden Dance,1990,['United States of America'],"['Musical', 'Drama', 'Indie', 'Romantic drama', 'Dance', 'Romance Film']",1990,0
3584478,His Kind of Woman,1951,['United States of America'],"['Black-and-white', 'Crime Fiction', 'Romantic drama', 'Thriller', 'Film noir', 'Romance Film', 'Crime Thriller', 'Drama']",1950,1
24821605,The High and the Flighty,1956,[],"['Animation', 'Short Film', 'Comedy film', 'Family Film']",1950,6
35002530,Phoolon Ki Sej,1964,['India'],"['Romance Film', 'Drama']",1960,4
725892,Young Adam,2003,"['United Kingdom', 'France']","['Film adaptation', 'Crime Fiction', 'Erotic Drama', 'Mystery', 'Thriller', 'Crime Thriller', 'Drama', 'Period piece']",2000,3
15070503,Baby Face Nelson,1957,['United States of America'],['Film noir'],1950,7
805097,School of Rock,2003,"['Germany', 'United States of America']","['Musical', 'Comedy', 'Musical comedy', 'Family Film']",2000,3
9142893,I Thank a Fool,1962,['United Kingdom'],"['Crime Fiction', 'Mystery', 'Drama']",1960,2
15477242,National Lampoon's Adam & Eve,2005,['United States of America'],"['Romance Film', 'Romantic comedy', 'Comedy']",2000,5
5884329,Dramatic School,1938,['United States of America'],"['Black-and-white', 'Romantic drama', 'Romance Film', 'Drama']",1930,8
24139538,An Alligator Named Daisy,1955,['United Kingdom'],"['Musical', 'Comedy', 'Animal Picture', 'Romance Film', 'Comedy of Errors']",1950,5
5178996,Parvarish,1977,['India'],"['Action/Adventure', 'Comedy', 'World cinema', 'Drama']",1970,7
2428326,Baazigar,1993,['India'],"['Musical', 'Crime Fiction', 'Thriller', 'Bollywood', 'World cinema', 'Crime Thriller', 'Drama', 'Suspense', 'Melodrama']",1990,3
33414827,Charno Ki Saugandh,1988,['India'],"['Action', 'Drama', 'World cinema', 'Family Film']",1980,8
2558669,The Memory of a Killer,2003,"['Netherlands', 'Belgium']","['Action', 'Psychological thriller', 'Crime Fiction', 'Thriller', 'World cinema', 'Crime Thriller', 'Drama']",2000,3
8706945,Désengagement,2007,['France'],"['Drama', 'World cinema']",2000,7
26990325,The Shadow on the Window,1957,['United States of America'],"['Drama', 'Crime Fiction']",1950,7
9773964,Lansky,1999,['United States of America'],"['Suspense', 'Crime Fiction', 'Gangster Film', 'Thriller', 'Television movie', 'Crime Thriller', 'Drama']",1990,9
703687,Monster's Ball,2001,['United States of America'],"['Romantic drama', 'Indie', 'Romance Film', 'Melodrama', 'Drama']",2000,1
26109442,Holy Lola,2004,['France'],['Drama'],2000,4
15452919,Carny,1980,['United States of America'],['Drama'],1980,0
6483271,Chromophobia,2005,"['United Kingdom', 'France', 'United States of America']","['Family Drama', 'Drama']",2000,5
384045,"Death, Deceit and Destiny Aboard the Orient Express",2000,"['Bulgaria', 'United States of America', 'Canada']",['Action'],2000,0
1606601,Little Black Book,2004,['United States of America'],"['Comedy', 'Media Satire', 'Black comedy', 'Romance Film', 'Drama', 'Parody', 'Romantic comedy', 'Workplace Comedy']",2000,4
2118149,Lajja,2001,['India'],"['Musical', 'Bollywood', 'World cinema', 'Drama']",2000,1
19609298,A Aa E Ee,2009,['India'],['Family Film'],2000,9
2580504,The Limping Man,1953,['United Kingdom'],['Film noir'],1950,3
1131323,The Dagger of Kamui,1985,['Japan'],"['Animation', 'Action/Adventure', 'World cinema', 'Martial Arts Film', 'Japanese Movies', 'Western', 'Anime', 'Science Fiction']",1980,5
5721950,3 Deewarein,2003,['India'],"['Drama', 'World cinema']",2000,3
2223589,3 Ninjas,1992,['United States of America'],"['Action', 'Action/Adventure', 'Comedy', ""Children's/Family"", 'Martial Arts Film', 'Adventure', 'Action Comedy', 'Sports', 'Family Film']",1990,2
11952589,Redline,1997,"['Canada', 'Netherlands']","['Action', 'Action/Adventure', 'Science Fiction', 'Thriller', 'Crime Thriller']",1990,7
1157124,Bridget Jones: The Edge of Reason,2004,"['United Kingdom', 'United States of America']","['Romance Film', 'Romantic comedy', 'Comedy']",2000,4
8888296,Season,1989,['India'],"['Crime Fiction', 'Thriller']",1980,9
24507791,The Yankee Clipper,1927,['United States of America'],"['Period piece', 'Silent film', 'Adventure', 'Drama']",1920,7
22221886,Solla Solla Inikkum,2009,['India'],"['Action', 'Romance Film', 'Drama']",2000,9
9524860,The Kite Runner,2007,"['China', 'United States of America']","['Romance Film', 'Drama', 'Chinese Movies']",2000,7
12423448,Off the Ledge,2007,['United States of America'],"['Drama', 'Indie', 'Comedy', 'Comedy-drama']",2000,7
30475824,Sathi Murali,1941,[],[],1940,1
32792131,Emotional Backgammon,2003,['United Kingdom'],"['Romantic drama', 'Indie', 'Comedy', 'Romance Film', 'Drama']",2000,3
6039456,Eight Days a Week,1999,['United States of America'],"['Comedy', 'Teen', 'Romance Film', 'Romantic comedy']",1990,9
13158735,Juninatten,1940,['Sweden'],"['Black-and-white', 'Drama', 'World cinema']",1940,0
11669482,Ed Gein: The Butcher of Plainfield,2007,['United States of America'],"['Slasher', 'Horror']",2000,7
22169427,Ente Sooryaputhrikku,1991,['India'],"['Romance Film', 'Drama', 'Comedy film']",1990,1
497737,Weapons of Mass Distraction,1997,['United States of America'],"['Parody', 'Comedy', 'Black comedy', 'Media Satire', 'Television movie']",1990,7
6415722,O Pai Tirano,1941,['Portugal'],['Black-and-white'],1940,1
9525919,Atrapadas,1984,['Argentina'],['Drama'],1980,4
6058079,Satan's Playground,2006,['United States of America'],"['Horror', 'B-movie']",2000,6
14158218,Naug Ma Kja Kyay,2004,['Burma'],"['Musical', 'Drama']",2000,4
7153190,Puppet Master II,1991,['United States of America'],"['Cult', 'Horror']",1990,1
28344566,How Sleep the Brave,1984,['United Kingdom'],"['Action', 'Drama', 'War film']",1980,4
5683191,American Ninja V,1993,['United States of America'],"['Action', 'Action/Adventure', 'Thriller', 'Martial Arts Film']",1990,3
11227634,Battle of the Worlds,1961,['Italy'],"['Science Fiction', 'Thriller', 'Adventure', 'Cult']",1960,1
24657771,Swing,2003,['United States of America'],"['Romance Film', 'Romantic drama', 'Drama']",2000,3
8915061,Grimm,2003,['Netherlands'],"['Comedy', 'Drama', 'World cinema']",2000,3
1349086,The Departed,2006,"['Hong Kong', 'United States of America']","['Action', 'Crime Fiction', 'Gangster Film', 'Mystery', 'Thriller', 'Remake', 'Crime Thriller', 'Chinese Movies', 'Drama']",2000,6
4262697,The Wild Stallion,2009,['United States of America'],"['Coming of age', 'Family Drama', 'Family-Oriented Adventure', ""Children's/Family"", 'Adventure', 'Drama', 'Family Film']",2000,9
3873713,Lee Dae-ro Can't Die,2005,['South Korea'],"['Action', 'Comedy']",2000,5
5107856,Killer Bash,2005,['United States of America'],"['Slasher', 'B-movie', 'Horror']",2000,5
9155539,Funeral in Berlin,1966,['United Kingdom'],"['Action', 'Spy', 'Action/Adventure', 'Thriller', 'World cinema', 'Drama', 'Political thriller']",1960,6
2964227,The World's Fastest Indian,2005,"['Switzerland', 'Japan', 'New Zealand', 'United States of America']","['Indie', 'Biographical film', 'World cinema', 'Adventure', 'Drama', 'Japanese Movies', 'Biopic [feature]', 'Road movie', 'Sports']",2000,5
6451274,National Lampoon's Dorm Daze 2,2006,['United States of America'],"['Comedy', 'Teen', 'Sex comedy']",2000,6
8889105,Hong Kong 1941,1984,['Hong Kong'],"['Period piece', 'World cinema', 'Chinese Movies', 'War film', 'Drama']",1980,4
331586,Crocodile Dundee,1986,"['New Zealand', 'Australia', 'United States of America']","['Adventure Comedy', 'Action', 'Action/Adventure', 'Comedy', 'World cinema', 'Adventure']",1980,6
17685541,Me and Orson Welles,2009,"['United Kingdom', 'United States of America']","['Period piece', 'Romantic drama', 'Romance Film', 'Drama']",2000,9
5247666,The Princess Comes Across,1936,['United States of America'],"['Black-and-white', 'Mystery', 'Comedy', 'Whodunit']",1930,6
5561909,Jambhavan,2006,['India'],"['Musical', 'Action/Adventure', 'Tamil cinema', 'World cinema']",2000,6
11662268,A Bear For Punishment,1951,['United States of America'],"['Comedy', 'Family Film']",1950,1
8579904,Convicts 4,1962,['United States of America'],"['Black-and-white', 'Biographical film']",1960,2
20890580,Devan,2002,['India'],"['Drama', 'World cinema']",2000,2
5897288,Head Over Heels,2001,"['United Kingdom', 'United States of America', 'Canada']","['Animation', 'Short Film', 'Comedy', 'Romance Film', 'Romantic comedy']",2000,1
27267871,Manivathoorile Aayiram Sivarathrikal,1987,['India'],"['Romance Film', 'Drama']",1980,7
170194,The Dam Busters,1954,['United Kingdom'],"['Action', 'Action/Adventure', 'Thriller', 'Docudrama', 'War film']",1950,4
52389,Independence Day,1996,['United States of America'],"['Action', 'Action/Adventure', 'Science Fiction', 'Thriller']",1990,6
11227335,Aap Kaa Surroor – The Moviee – The Real Luv Story,2007,['India'],"['Romantic drama', 'World cinema', 'Romance Film', 'Drama']",2000,7
33151195,Kabei - Our Mother,2008,['Japan'],"['Japanese Movies', 'Drama', 'World cinema']",2000,8
23995955,Midnight Bayou,2009,['United States of America'],"['Film adaptation', 'Romantic drama', 'Romance Film', 'Television movie', 'Drama']",2000,9
8152894,The Visitation,2006,['United States of America'],"['Psychological thriller', 'Thriller', 'Horror', 'Christian film', 'Supernatural', 'Science Fiction']",2000,6
1702976,Desperately Seeking Brandi,2000,[],['Short Film'],2000,0
1045034,The Forgotten,2004,['United States of America'],"['Psychological thriller', 'Mystery', 'Thriller', 'Science Fiction', 'Drama']",2000,4
12761613,The Queen's Sister,2000,['United Kingdom'],"['Comedy', 'Drama', 'Biographical film']",2000,0
1620219,Popeye the Sailor Meets Sindbad the Sailor,1936,['United States of America'],['Short Film'],1930,6
5443971,The Room,2003,['United States of America'],"['Indie', 'Comedy', 'Black comedy', 'Drama', 'Cult']",2000,3
26147349,Saigon,1948,['United States of America'],['Drama'],1940,8
1426122,Straight Time,1978,['United States of America'],"['Film adaptation', 'Crime Fiction', 'Crime Drama', 'Drama']",1970,8
5467991,Seema,1955,['India'],"['Bollywood', 'World cinema']",1950,5
21260121,Kickboxer 3,1992,['United States of America'],"['Action', 'Action/Adventure', 'Thriller', 'Martial Arts Film']",1990,2
16877039,Lizzie,1957,['United States of America'],"['Black-and-white', 'Drama']",1950,7
7984838,Semi-Pro,2008,['United States of America'],"['Period piece', 'Parody', 'Comedy', 'Sports']",2000,8
30855651,Les Paumées du Petit Matin,1981,['France'],"['Crime Fiction', 'Drama', 'Fantasy']",1980,1
34732968,Murder by Natural Causes,1979,['United States of America'],"['Mystery', 'Drama']",1970,9
17967428,Strictly Dishonorable,1931,['United States of America'],"['Romantic comedy', 'Black-and-white']",1930,1
19165774,The Wreck of the Mary Deare,1959,"['United Kingdom', 'United States of America']","['Action', 'Courtroom Drama', 'Film adaptation', 'Action/Adventure', 'Thriller', 'Adventure', 'Drama']",1950,9
5641391,Tinker Bell,2008,['United States of America'],"['Animation', ""Children's/Family"", 'Adventure', 'Computer Animation', 'Fairy tale', ""Children's Fantasy"", 'Family Film', 'Fantasy']",2000,8
24301630,Pirates of the Great Salt Lake,2006,['United States of America'],"['Action', 'Indie', 'Action/Adventure', 'Comedy']",2000,6
9477743,Stop-Loss,2008,['United States of America'],"['War film', 'Drama']",2000,8
27997835,Voyage of the Rock Aliens,1984,[],"['Musical', 'Science Fiction', 'Comedy film']",1980,4
20475330,Undertow,1949,['United States of America'],"['Black-and-white', 'Thriller']",1940,9
2774378,The Invisible Ray,1936,['United States of America'],"['Black-and-white', 'Thriller', 'Horror', 'Science Fiction']",1930,6
9384481,Count Your Blessings,1959,['United States of America'],"['Drama', 'Comedy']",1950,9
8980330,WALL-E,2008,['United States of America'],"['Adventure Comedy', 'Animation', 'Satire', 'Comedy', 'Romance Film', 'Sci-Fi Adventure', 'Adventure', 'Computer Animation', 'Romantic comedy', 'Doomsday film', 'Science Fiction', 'Family Film', 'Fantasy']",2000,8
25879929,Captain Hima,2008,['Egypt'],"['Musical', 'Comedy']",2000,8
9577780,Sakkarakatti,2007,['India'],"['Musical', 'Romance Film']",2000,7
993226,Ray,2004,['United States of America'],"['Musical', 'Musical Drama', 'Biography', 'Biopic [feature]', 'Drama']",2000,4
9389099,Nepali,2007,['India'],['Romance Film'],2000,7
7966676,Touch Me in the Morning,2005,['United States of America'],['Indie'],2000,5
25397721,5150 Elm's Way,2009,['Canada'],"['Psychological thriller', 'Thriller', 'Horror', 'Drama']",2000,9
1946017,Talk to Her,2002,['Spain'],"['Black-and-white', 'LGBT', 'Indie', 'Romantic drama', 'Comedy', 'World cinema', 'Romance Film', 'Drama', 'Medical fiction', 'Silent film', 'Melodrama']",2000,2
534812,Child's Play 2,1990,['United States of America'],"['Slasher', 'Comedy', 'Thriller', 'Horror', 'Supernatural', 'Cult']",1990,0
12932687,Kolomba Sanniya,1976,['Sri Lanka'],['Comedy'],1970,6
29381935,Agniputra,2000,['India'],['Action'],2000,0
2236014,"Sexo, pudor y lágrimas",1999,['Mexico'],"['Romantic drama', 'Comedy', 'World cinema', 'Romance Film', 'Romantic comedy', 'Comedy-drama', 'Drama']",1990,9
14193289,Wild Oranges,1924,['United States of America'],"['Black-and-white', 'Drama', 'Indie', 'Silent film', 'Adventure']",1920,4
2241842,"Lucía, Lucía",2003,"['Argentina', 'Spain', 'Mexico']","['Mystery', 'Romantic drama', 'Comedy', 'Thriller', 'World cinema', 'Romance Film', 'Drama', 'Comedy Thriller', 'Romantic comedy']",2000,3
11567553,Our Blushing Brides,1930,['United States of America'],"['Black-and-white', 'Romance Film', 'Pre-Code', 'Drama']",1930,0
5349121,The Legend of Rita,2000,['Germany'],"['LGBT', 'History', 'Thriller', 'World cinema', 'Romance Film', 'Political drama', 'Drama']",2000,0
10007089,Rosarigasinos,2001,['Argentina'],"['Drama', 'Crime Fiction', 'Indie', 'Comedy', 'World cinema', 'Crime Drama']",2000,1
1591945,The Roman Spring of Mrs. Stone,1961,['United Kingdom'],"['Romance Film', 'Film adaptation', 'Drama']",1960,1
22153949,Romantic Comedy,1983,['United States of America'],"['Film adaptation', 'Comedy', 'Romance Film', 'Romantic comedy', 'Drama']",1980,3
7871980,Call Me Claus,2001,['United States of America'],"['Family Drama', ""Children's/Family"", 'Holiday Film', 'Christmas movie', 'Drama', 'Family Film']",2000,1
12234096,Night of the Blood Beast,1958,['United States of America'],"['Black-and-white', 'Horror', 'B-movie', 'Alien Film', 'Science Fiction']",1950,8
8499338,Charlie's Death Wish,2005,['United States of America'],"['Action', 'Crime Fiction', 'Action/Adventure', 'Comedy', 'Thriller', 'Drama', 'Action Comedy', 'Horror', 'Erotic thriller']",2000,5
22734911,The Helicopter Spies,1968,['United States of America'],"['Action', 'Spy', 'Action Thrillers', 'Glamorized Spy Film']",1960,8
19390842,The Seven of Daran: Battle of Pareo Rock,2008,['Netherlands'],"['Adventure', 'Family Film']",2000,8
9917462,Clancy of the Mounted,1933,['United States of America'],"['Action', 'Black-and-white', 'Adventure']",1930,3
6882241,Bunny Chow,2006,"['United States of America', 'South Africa']","['Indie', 'Short Film', 'Comedy', 'World cinema']",2000,6
12207260,RocknRolla,2008,"['United Kingdom', 'United States of America']","['Action', 'Crime Fiction', 'Gangster Film', 'Action/Adventure', 'Comedy', 'Thriller', 'Black comedy', 'Crime Thriller', 'Action Comedy', 'Caper story']",2000,8
5455191,...First Do No Harm,1997,['United States of America'],"['Drama', 'Television movie']",1990,7
82390,Dirty Weekend,1993,['United Kingdom'],"['Thriller', 'Drama']",1990,3
5396167,Happy Anniversary,1959,['United States of America'],"['Black-and-white', 'Comedy', 'Comedy of Errors']",1950,9
17372357,Eldorado,2008,"['France', 'Canada', 'Belgium']","['Surrealism', 'Comedy', 'World cinema', 'Comedy-drama', 'Road movie', 'Drama', 'Absurdism']",2000,8
1518813,The Whole Wide World,1996,['United States of America'],"['Film adaptation', 'Indie', 'Biography', 'Romantic drama', 'Biographical film', 'Romance Film', 'Drama', 'Period piece', 'Biopic [feature]']",1990,6
7529425,Piriyadha Varam Vendum,2001,['India'],"['Musical', 'Romance Film', 'Comedy']",2000,1
10731817,Surakshaa,1979,['India'],['Thriller'],1970,9
21435501,Walk Into Paradise,1956,['Australia'],['Adventure'],1950,6
1273747,Six-String Samurai,1998,['United States of America'],"['Action', 'Musical', 'Indie', 'Action/Adventure', 'Satire', 'Comedy', 'Apocalyptic and post-apocalyptic fiction', 'Martial Arts Film', 'Time travel', 'Road movie', 'Doomsday film', 'Science Fiction']",1990,8
210224,Love with the Proper Stranger,1963,['United States of America'],"['Black-and-white', 'Romantic drama', 'Social problem film', 'Romance Film', 'Comedy-drama', 'Drama']",1960,3
14229474,They Stooge To Conga,1943,['United States of America'],"['Black-and-white', 'Short Film', 'Comedy', 'Slapstick']",1940,3
35012445,Natale a Rio,2008,"['Brazil', 'Italy']",['Comedy film'],2000,8
13780019,Not the Brady's,2007,['United States of America'],"['Comedy', 'Adult']",2000,7
41881,All About Eve,1950,['United States of America'],"['Black-and-white', 'LGBT', 'Black comedy', 'Comedy-drama', 'Drama']",1950,0
15668629,Boarding Gate,2007,"['France', 'Hong Kong']","['Thriller', 'World cinema', 'Erotic thriller', 'Crime Thriller', 'Chinese Movies']",2000,7
21532083,Padai Veetu Amman,2002,['India'],['Tamil cinema'],2000,2
23922445,Assault! Jack the Ripper,1976,['Japan'],"['Japanese Movies', 'Horror', 'World cinema', 'Pinku eiga', 'Pornographic movie', 'Erotica']",1970,6
9459814,Jet Pilot,1957,['United States of America'],"['Action', 'Action/Adventure', 'Comedy', 'Romantic comedy', 'War film', 'Drama']",1950,7
876516,This Island Earth,1955,['United States of America'],"['Science Fiction', 'Adventure']",1950,5
24894176,The Chairman,1964,['Soviet Union'],['Drama'],1960,4
949131,Sister Act 2: Back in the Habit,1993,['United States of America'],"['Musical', 'Comedy']",1990,3
2322629,Baby Geniuses,1999,['United States of America'],"['Action', 'Comedy', 'Family-Oriented Adventure', ""Children's/Family"", 'Adventure', 'Family Film']",1990,9
5178262,Podium,2004,['France'],"['Comedy', 'Fantasy']",2000,4
24607608,A Perfect Fit,2005,['United States of America'],"['Romance Film', 'Crime Fiction', 'Drama']",2000,5
5707603,Crocodile,2000,['United States of America'],"['Action', 'Action/Adventure', 'Thriller', 'Horror', 'Teen', 'Natural horror films']",2000,0
31207174,Cage,1989,[],"['Action', 'Crime Fiction', 'Action Thrillers', 'Action/Adventure', 'Thriller', 'Crime Thriller', 'Martial Arts Film', 'Sports']",1980,9
2997355,It Could Happen to You,1994,['United States of America'],"['Comedy', 'Romance Film', 'Romantic comedy', 'Comedy-drama', 'Drama']",1990,4
13018737,Inaam Dus Hazaar,1987,['India'],"['Action/Adventure', 'World cinema']",1980,7
5184523,My Friend Irma,1949,['United States of America'],"['Comedy', 'Comedy-drama']",1940,9
7162122,Night Train to Venice,1993,['Germany'],"['Suspense', 'Mystery', 'Thriller', 'World cinema', 'Crime Thriller']",1990,3
2102508,Foxes,1980,['United States of America'],"['Drama', 'Coming of age', 'Teen']",1980,0
14143223,Flying G-Men,1939,['United States of America'],"['Adventure', 'Black-and-white']",1930,9
27149347,Black,2004,['India'],"['Action', 'Crime Fiction', 'Thriller']",2000,4
4198198,Kissed,1997,['Canada'],"['Romantic drama', 'Indie', 'Romance Film', 'Drama']",1990,7
18502369,99 and 44/100% Dead,1974,['United States of America'],"['Action', 'Crime Fiction']",1970,4
1317604,Crimson Tide,1995,['United States of America'],"['Action', 'Action Thrillers', 'Action/Adventure', 'Thriller', 'War film', 'Drama']",1990,5
3448877,Moon Zero Two,1969,['United Kingdom'],"['Action', 'Crime Fiction', 'Western', 'Hybrid Western', 'Adventure', 'Space western', 'Science Fiction']",1960,9
1598456,"Goodbye, Dragon Inn",2004,"['China', 'Taiwan']","['Comedy', 'Comedy of manners', 'World cinema', 'Comedy-drama', 'Chinese Movies', 'Drama']",2000,4
6425079,Who'll Stop the Rain,1978,['United States of America'],"['Action', 'Film adaptation', 'Crime Fiction', 'Action/Adventure', 'Thriller', 'Crime Thriller', 'Drama', 'War film']",1970,8
11004726,The Big Lift,1950,['United States of America'],"['Action', 'Black-and-white', 'Drama']",1950,0
25742466,Standing Room Only,2004,"['United Kingdom', 'Australia', 'United States of America']","['Short Film', 'Drama']",2000,4
2257924,Country Dance,1970,"['United Kingdom', 'United States of America']",['Drama'],1970,0
1844724,Wild Zero,2001,['Japan'],"['LGBT', 'Comedy', 'Horror Comedy', 'World cinema', 'Zombie Film', 'Biker Film', 'Japanese Movies', 'Horror']",2000,1
61062,The Smiling Lieutenant,1931,['United States of America'],"['Musical', 'Black-and-white', 'Comedy', 'Romance Film', 'Romantic comedy', 'Pre-Code']",1930,1
30651508,State Property,2002,['United States of America'],"['Action', 'Drama', 'Crime Fiction', 'Indie', 'Action/Adventure']",2000,2
8388862,Deadly Desire,1991,['United States of America'],"['Psychological thriller', 'Thriller', 'Horror', 'Drama']",1990,1
957331,The Mummy - Tomb of the Dragon Emperor,2008,"['Germany', 'China', 'United States of America']","['Action', 'Action/Adventure', 'Thriller', 'Chinese Movies', 'Adventure', 'Horror', 'Archaeology', 'Fantasy']",2000,8
20110015,Kochu Kochu Santhoshangal,2000,['India'],"['Drama', 'Comedy']",2000,0
19989319,Esther and the King,1960,"['Italy', 'United States of America']","['Period piece', 'Epic', 'Drama']",1960,0
5122403,Doña Bárbara,1943,['Mexico'],"['Black-and-white', 'Drama']",1940,3
24582045,Exit Smiling,1926,['United States of America'],"['Silent film', 'Comedy-drama']",1920,6
3450569,A Star Is Born,1937,['United States of America'],"['Musical', 'Romantic drama', 'Romance Film', 'Drama']",1930,7
8453956,The Third Miracle,1999,"['Canada', 'United States of America']","['Period piece', 'Drama']",1990,9
5148614,Roman,2006,['United States of America'],"['Psychological thriller', 'Suspense', 'Thriller', 'Crime Thriller', 'Drama']",2000,6
2707684,Supernova,2000,"['Switzerland', 'United States of America']","['Thriller', 'Horror', 'Adventure', 'Science Fiction']",2000,0
1331978,Smokey and the Bandit II,1980,['United States of America'],"['Action', 'Crime Fiction', 'Chase Movie', 'Action Comedy', 'Action/Adventure', 'Comedy', 'Adventure']",1980,0
1685440,Men of Honor,2000,['United States of America'],"['Drama', 'Biography', 'Biopic [feature]']",2000,0
24585368,Portrait of a Hitman,1977,['United States of America'],"['Action', 'Drama']",1970,7
1403925,Akele Hum Akele Tum,1995,['India'],"['Drama', 'Bollywood', 'World cinema']",1990,5
60169,The Red Shoes,1948,['United Kingdom'],"['Music', 'Musical', 'Romantic drama', 'Dance', 'Romance Film', 'Roadshow theatrical release', 'Drama']",1940,8
26508388,"Nefertiti, figlia del sole",1994,"['Russia', 'France', 'Italy']",['Romantic drama'],1990,4
2571604,The Exorcism of Emily Rose,2005,['United States of America'],"['Crime Fiction', 'Thriller', 'Horror', 'Supernatural', 'Drama', 'Courtroom Drama']",2000,5
5162132,Return of the Blind Dead,1973,['Spain'],"['Zombie Film', 'World cinema', 'Horror']",1970,3
12422748,Khulay Aasman Ke Neechay,2008,['Pakistan'],['Romance Film'],2000,8
7463646,Royal Kill,2008,['United States of America'],"['Action', 'Psychological thriller', 'Action/Adventure', 'Thriller', 'Martial Arts Film']",2000,8
10358723,The Vagabond King,1930,['United States of America'],['Musical'],1930,0
5318640,Treehouse Hostage,1999,['United States of America'],"['Comedy', 'Family Film', 'Adventure']",1990,9
2564151,Loser,2000,['United States of America'],"['Comedy', 'Teen', 'Romance Film', 'Romantic comedy']",2000,0
16056205,El Lute II: Tomorrow I'll be Free,1988,['Spain'],"['Biography', 'Biographical film', 'Drama']",1980,8
3310853,Sadomania,1981,"['Germany', 'Spain']","['Drama', 'Sexploitation', 'World cinema', 'Romance Film', 'Adult', 'Women in prison films']",1980,1
9880833,The Tell-Tale Heart,1960,['United Kingdom'],"['Black-and-white', 'Indie', 'Horror']",1960,0
4498928,Basket Case 3: The Progeny,1992,['United States of America'],"['Monster movie', 'Slasher', 'Comedy', 'Horror', 'Horror Comedy', 'B-movie', 'Cult']",1990,2
10492456,The Rings,1985,['Iran'],"['Mystery', 'Horror']",1980,5
9808896,Uyir,2006,['India'],['Romantic comedy'],2000,6
10405434,Al-Tareeq al-Masdood,1958,['Egypt'],"['Romance Film', 'Drama']",1950,8
18813705,Drifting,1983,['Israel'],['Drama'],1980,3
3555245,The Cool and the Crazy,1958,['United States of America'],"['Black-and-white', 'Melodrama', 'Drama']",1950,8
3509282,Dulhan hum le jayenge,2000,['India'],"['Romantic drama', 'World cinema', 'Romance Film', 'Drama']",2000,0
26165142,Circumstantial Evidence,1945,['United States of America'],"['Film noir', 'Crime Fiction', 'Drama']",1940,5
2952273,Danger: Diabolik,1968,"['Italy', 'United States of America']","['Action', 'Crime Fiction', 'Superhero', 'Action/Adventure', 'Thriller', 'World cinema', 'Master Criminal Films', 'Caper story', 'Superhero movie']",1960,8
15569761,Thangam,2008,['India'],"['Action', 'Comedy']",2000,8
5565401,Hobson's Choice,1954,['United Kingdom'],"['Drama', 'Comedy']",1950,4
19495316,Raja Makutam,1959,['India'],"['Action', 'Romance Film', 'Drama']",1950,9
3881551,Aces Go Places 2,1983,['Hong Kong'],"['Action/Adventure', 'Comedy', 'World cinema', 'Chinese Movies']",1980,3
3827920,Doll Master,2004,['South Korea'],['Horror'],2000,4
6533368,Garv: Pride and Honour,2004,['India'],"['Action', 'Drama', 'Action/Adventure', 'World cinema']",2000,4
415074,Thomas and the Magic Railroad,2000,"['United Kingdom', 'United States of America']","[""Children's Fantasy"", ""Children's"", 'Family-Oriented Adventure', ""Children's/Family"", 'Adventure', 'Family Film']",2000,0
23494156,Everything Goes Wrong,1960,['Japan'],"['Black-and-white', 'Japanese Movies', 'Drama']",1960,0
25162941,The Speckled Band,1931,['United Kingdom'],"['Detective fiction', 'Mystery', 'Detective']",1930,1
7138412,Jayam,2002,['India'],['Drama'],2000,2
3381142,The Fox,1967,"['Canada', 'United States of America']","['LGBT', 'Indie', 'Romantic drama', 'Romance Film', 'Drama']",1960,7
12787080,Katyń,2007,['Poland'],"['History', 'World cinema', 'War film', 'Drama']",2000,7
900231,Team America: World Police,2004,"['Germany', 'United States of America']","['Action', 'Adventure Comedy', 'Musical', 'Political satire', 'Supermarionation', 'Satire', 'Comedy', 'Black comedy', 'Adventure', 'Political cinema', 'Parody', 'Cult']",2000,4
612642,The Funeral,1984,['Japan'],"['Japanese Movies', 'Comedy', 'World cinema']",1980,4
29077073,Pauran,2005,['India'],"['Crime Fiction', 'Thriller', 'Romance Film', 'Drama']",2000,5
3555900,A Perfect World,1993,['United States of America'],"['Period piece', 'Suspense', 'Crime Fiction', 'Crime Drama', 'Crime Thriller', 'Americana', 'Drama']",1990,3
21322428,Kaalbela,2007,['India'],['Drama'],2000,7
2851505,Hare Trigger,1945,['United States of America'],"['Animation', 'Short Film', 'Comedy', 'Family Film']",1940,5
16874270,Dizzy Dishes,1930,['United States of America'],"['Black-and-white', 'Animation', 'Short Film']",1930,0
11794135,Marker,2008,['United States of America'],"['Action', 'Crime Fiction', 'Coming of age', 'Action Thrillers', 'Action/Adventure', 'Thriller', 'Fantasy']",2000,8
725459,The Exorcist,1973,['United States of America'],"['Psychological thriller', 'Demonic child', 'New Hollywood', 'Horror', 'Supernatural', 'Drama', 'Cult']",1970,3
1068888,Dead Zone,1989,['Japan'],"['Action', 'Animation', 'Comedy', 'World cinema', 'Martial Arts Film', ""Children's"", 'Adventure', 'Japanese Movies', 'Anime', 'Science Fiction', 'Fantasy']",1980,9
28799266,I'll Give a Million,1936,['Italy'],['Comedy film'],1930,6
511351,Thunderpants,2002,"['Netherlands', 'United Kingdom', 'France', 'Germany', 'Italy', 'United States of America']","['Comedy', 'Family Film']",2000,2
22415383,Tully,2002,['United States of America'],"['Indie', 'Drama']",2000,2
5296875,Which Way Is Up?,1977,['United States of America'],"['Blaxploitation', 'Political cinema', 'Comedy']",1970,7
7526274,Appu,2000,['India'],"['Action', 'Drama', 'Bollywood', 'Romance Film']",2000,0
210998,The Matrix Revolutions,2003,"['United States of America', 'Australia']","['Action', 'Action/Adventure', 'Thriller', 'Adventure', 'Martial Arts Film', 'Science Fiction']",2000,3
189776,Underground,1995,"['Bulgaria', 'Yugoslavia', 'Serbia and Montenegro', 'Serbia', 'France', 'Germany', 'Hungary']","['Comedy', 'World cinema', 'Political drama', 'Black comedy', 'War film', 'Drama']",1990,5
11612413,Valley of the Dolls,1967,['United States of America'],"['Music', 'Film adaptation', 'Romance Film', 'Drama', 'Cult']",1960,7
2398807,The Last Supper,1995,['United States of America'],"['Black comedy', 'Parody', 'Comedy']",1990,5
6581470,Broadway Damage,1997,['United States of America'],"['Gay Themed', 'LGBT', 'Gay', 'Gay Interest', 'Comedy', 'Romance Film', 'Romantic comedy']",1990,7
14539048,My Sweet Charlie,1970,['United States of America'],"['Drama', 'Television movie']",1970,0
231486,Sweet Home Alabama,2002,['United States of America'],"['Comedy', 'Romance Film', 'Romantic comedy', 'Drama']",2000,2
5906516,"Silent Night, Deadly Night 5: The Toy Maker",1991,['United States of America'],['Horror'],1990,1
29584795,Picture Mommy Dead,1966,['United States of America'],"['Thriller', 'Horror']",1960,6
1239400,The Land Before Time,1988,"['Ireland', 'United States of America']","['Animation', 'Comedy', ""Children's/Family"", ""Children's"", 'Costume drama', 'Adventure', ""Children's Fantasy"", 'Coming of age', 'Family Film', 'Fantasy']",1980,8
26462209,The Revengers,1972,"['Mexico', 'United States of America']",['Western'],1970,2
9513537,Criminal,1995,['India'],"['Action', 'Thriller']",1990,5
26279540,Growth,2009,['United States of America'],['Horror'],2000,9
3625394,Brave Story,2006,['Japan'],"['Fantasy Adventure', 'Animation', 'Japanese Movies', 'Mystery', 'World cinema', 'Anime', 'Fantasy']",2000,6
1668076,A Little Romance,1979,"['France', 'United States of America']","['Coming of age', 'Comedy', 'Teen', 'Romance Film', 'Romantic comedy']",1970,9
19812020,The Pied Piper of Hamelin,1957,['United States of America'],"['Musical', 'Family Film', 'Fantasy']",1950,7
1813096,A Grande Arte,1991,"['Brazil', 'United States of America']","['Thriller', 'Drama']",1990,1
13539119,Chicago Overcoat,2009,['United States of America'],"['Action', 'Crime Fiction', 'Gangster Film', 'Action/Adventure', 'Thriller']",2000,9
932297,The Road to El Dorado,2000,['United States of America'],"['Animation', 'Buddy film', 'Comedy', 'Family-Oriented Adventure', ""Children's/Family"", 'Costume drama', 'Adventure', 'Family Film', 'Fantasy']",2000,0
10090763,Buck Rogers,1939,['United States of America'],"['Action', 'Black-and-white', 'Adventure', 'Science Fiction']",1930,9
31198949,Ormakalundayirikkanam,1995,[],['Drama'],1990,5
535969,Paulie,1998,['United States of America'],"['Adventure Comedy', 'Buddy film', 'Comedy', 'Family-Oriented Adventure', ""Children's/Family"", 'Adventure', 'Animal Picture', 'Family Film']",1990,8
37068,The War Game,1965,['United Kingdom'],"['Short Film', 'Doomsday film', 'War film', 'Drama']",1960,5
3458487,Demolition University,1997,['United States of America'],"['Action', 'Crime Fiction', 'Action Thrillers', 'Indie', 'Action/Adventure', 'Thriller', 'Teen']",1990,7
26418564,Megasandesam,2001,['India'],"['Romance Film', 'Comedy', 'Drama']",2000,1
6804043,Gladiator,1992,['United States of America'],"['Boxing', 'Crime Fiction', 'Teen', 'Sports', 'Drama']",1990,2
10703375,Lal Patthar,1971,['India'],"['Romance Film', 'Family Film']",1970,1
7572313,Intermedio,2005,['United States of America'],"['Thriller', 'Horror', 'B-movie', 'Supernatural']",2000,5
17793649,Trance,1999,['United States of America'],"['Erotica', 'Indie', 'Horror']",1990,9
8376274,Prince Charming,2001,['United States of America'],"['Comedy', 'Romance Film', 'Romantic comedy', 'Television movie', 'Costume drama', 'Fantasy']",2000,1
9158552,Gryphon,2007,['United States of America'],"['Childhood Drama', 'Adventure', 'Television movie', ""Children's/Family"", 'Science Fiction', 'Fantasy']",2000,7
2061037,Raw Deal,1948,['United States of America'],"['Black-and-white', 'Crime Fiction', 'Thriller', 'Film noir', 'Drama']",1940,8
10987841,The Chain,1984,['United Kingdom'],"['Drama', 'Comedy']",1980,4
253833,The Mummy,1932,['United States of America'],"['Monster movie', 'Black-and-white', 'Horror', 'Archaeology', 'Pre-Code']",1930,2
3720859,The Wrecking Crew,1969,['United States of America'],"['Action', 'Spy', 'Parody', 'Action/Adventure', 'Comedy', 'Thriller']",1960,9
12161577,Grey Knight,1993,['United States of America'],"['Action', 'Combat Films', 'Period piece', 'Western', 'Horror', 'Zombie Film', 'Supernatural']",1990,3
12930887,Not on the Lips,2003,"['Switzerland', 'France']","['Musical', 'Romantic drama', 'Comedy', 'World cinema', 'Romance Film', 'Drama', 'Romantic comedy', 'Comedy-drama']",2000,3
12332639,Ice Angel,2000,"['Canada', 'United States of America']","['Comedy', 'Drama', 'Family Film', 'Fantasy']",2000,0
19786684,Chompa Toung,1974,['Cambodia'],"['Fantasy', 'Natural horror films', 'Horror']",1970,4
20672385,For the Love of Dolly,2006,['United States of America'],"['Film & Television History', 'Biography', 'Documentary', 'Film', 'Culture & Society']",2000,6
19271269,Gharjamai,2008,['India'],"['Action', 'Romance Film', 'Drama']",2000,8
6520092,Dreadnaught,1981,['Hong Kong'],"['Action', 'Action/Adventure', 'World cinema', 'Chinese Movies', 'Martial Arts Film']",1980,1
24486281,Scared to Death,1981,['United States of America'],"['Science Fiction', 'Drama', 'Horror']",1980,1
1368434,The Fog of War: Eleven Lessons from the Life of Robert S. McNamara,2003,['United States of America'],"['Political cinema', 'War film', 'Documentary']",2000,3
3085910,Legend of the Dragon,1990,['Hong Kong'],"['Chinese Movies', 'Comedy']",1990,0
17790039,Divorce American Style,1967,['United States of America'],"['Comedy', 'Satire', 'Black comedy', 'Domestic Comedy']",1960,7
3555884,Eine Liebe in Deutschland,1983,"['France', 'Germany', 'Poland', 'West Germany']",['Drama'],1980,3
23786849,Diagnosis: Death,2009,['New Zealand'],"['Parody', 'Comedy', 'Horror Comedy', 'Horror', 'World cinema']",2000,9
28649111,The Locket,2002,['United States of America'],"['Film adaptation', 'Crime Fiction', 'Romantic drama', 'Romance Film', 'Television movie', 'Drama']",2000,2
32456582,Professor Mamlock,1961,['German Democratic Republic'],['Drama'],1960,1
471544,Blade,1998,['United States of America'],"['Action', 'Action/Adventure', 'Thriller', 'Horror', 'Superhero movie', 'Archives and records', 'Fantasy']",1990,8
14353049,Max & Co,2008,"['France', 'Belgium']","['Stop motion', 'Animation']",2000,8
26902650,Samayou Yaiba,2009,[],"['Thriller', 'Drama']",2000,9
7422533,Father Hood,1993,['United States of America'],"['Action', 'Family Drama', 'Action/Adventure', 'Comedy', 'Road movie', 'Family Film']",1990,3
12848109,Imitation General,1958,['United States of America'],"['War film', 'Comedy']",1950,8
240376,Only When I Laugh,1981,['United States of America'],"['Family Drama', 'Comedy-drama']",1980,1
649716,Carmen: A Hip Hopera,2001,['United States of America'],"['Musical', 'Drama']",2000,1
15873820,Tight Spot,1955,['United States of America'],"['Film noir', 'Black-and-white', 'Crime Fiction']",1950,5
10970230,Women of the Prehistoric Planet,1966,['United States of America'],"['Action', 'Science Fiction', 'Adventure']",1960,6
14107102,The Fugitive Kind,1959,['United States of America'],"['Melodrama', 'Drama']",1950,9
26004874,Dial D for Demons,2000,['Hong Kong'],"['Chinese Movies', 'World cinema', 'Horror']",2000,0
15144724,Tumbling Tumbleweeds,1935,['United States of America'],"['Musical', 'Black-and-white', 'Action/Adventure', 'Western']",1930,5
25642032,KimmyDora,2009,['Philippines'],"['Filipino Movies', 'Romantic drama', 'Comedy', 'World cinema', 'Romance Film', 'Romantic comedy', 'Drama']",2000,9
5988879,In the Land of Women,2007,['United States of America'],"['Romantic drama', 'Coming of age', 'Romance Film', 'Comedy-drama', 'Drama']",2000,7
7949088,The Story of Woo Viet,1981,['Hong Kong'],['Chinese Movies'],1980,1
9425018,Two Weeks,2006,['United States of America'],"['Indie', 'Comedy', 'Drama']",2000,6
31114082,Thachiledathu Chundan,1999,[],"['Thriller', 'Drama']",1990,9
13977325,The Adventures of Greyfriars Bobby,2005,['United Kingdom'],"['Period piece', 'Crime Fiction', 'Family Drama', 'Adventure', 'Drama', 'Family Film']",2000,5
16633798,The Case,2007,['China'],"['Black comedy', 'Chinese Movies', 'Comedy']",2000,7
29118656,Pinjra,1972,['India'],['Drama'],1970,2
15726729,The Heavenly Body,1944,['United States of America'],"['Black-and-white', 'Comedy', 'Romance Film', 'Romantic comedy']",1940,4
10970272,Catalina Caper,1967,['United States of America'],"['Musical', 'Mystery', 'Comedy']",1960,7
25915133,Aakasha Ganga,1999,['India'],['Horror'],1990,9
4111583,Lucky 13,2005,['United States of America'],"['Romance Film', 'Romantic comedy', 'Comedy']",2000,5
6619704,Patient Porky,1940,['United States of America'],"['Short Film', 'Comedy']",1940,0
3621799,Platinum Blonde,1931,['United States of America'],"['Black-and-white', 'Screwball comedy', 'Comedy', 'Romance Film', 'Romantic comedy', 'Pre-Code']",1930,1
13198624,Chain Kulii Ki Main Kulii,2007,['India'],"['Musical', 'Bollywood', 'World cinema', ""Children's"", 'Drama']",2000,7
1744593,Miss Congeniality 2: Armed and Fabulous,2005,['United States of America'],"['Action', 'Action/Adventure', 'Comedy', 'Romantic comedy']",2000,5
25174389,Kush,2007,['United States of America'],"['Crime Fiction', 'Stoner film', 'Indie', 'Crime Thriller', 'Drama']",2000,7
6331676,From Noon Till Three,1976,['United States of America'],"['Action/Adventure', 'Romantic drama', 'Comedy', 'Romance Film', 'Drama', 'Comedy Western', 'Western', 'Romantic comedy']",1970,6
970201,Edge of Darkness,1943,['United States of America'],"['Black-and-white', 'War film', 'Drama']",1940,3
15067690,The Kitten from the Lizukov street,1988,['Soviet Union'],"['Short Film', 'Animation']",1980,8
36025899,In the Name of Love: A Texas Tragedy,1995,['United States of America'],['Drama'],1990,5
10605031,Chinatown Kid,1977,['China'],"['Action', 'Drama', 'Chinese Movies', 'Martial Arts Film']",1970,7
15317103,Udaan,1997,['India'],"['Action', 'Drama', 'Crime Fiction', 'Thriller']",1990,7
9175052,Mr. Romeo,1996,['India'],"['Action', 'Crime Fiction', 'Comedy film', 'Romance Film']",1990,6
10791913,Aval Appadithan,1978,['India'],['Drama'],1970,8
5021219,La Tragedia di un uomo ridicolo,1981,['Italy'],"['Drama', 'Comedy']",1980,1
27763405,You'll Like My Mother,1972,['United States of America'],"['Psychological thriller', 'Thriller']",1970,2
4253757,The Secret,2006,"['United States of America', 'Australia']",['Documentary'],2000,6
29829978,Hum Se Na Takrana,1990,['India'],"['Action', 'Crime Fiction', 'Drama']",1990,0
30607472,Breathless,2008,['South Korea'],"['Crime Fiction', 'Drama', 'World cinema']",2000,8
13359313,Movers & Shakers,1985,['United States of America'],['Comedy'],1980,5
2267635,How to Murder Your Wife,1965,['United States of America'],"['Comedy', 'Satire', 'Black comedy', 'Romantic comedy', 'Romance Film']",1960,5
9674567,Paragraph 78,2007,['Russia'],"['Action', 'Science Fiction', 'Thriller']",2000,7
4173885,The Woman Chaser,1999,['United States of America'],"['Crime Fiction', 'Parody', 'Comedy', 'Black comedy', 'Comedy-drama', 'Drama']",1990,9
916546,The Mountain Eagle,1926,"['United Kingdom', 'Germany', 'Weimar Republic']","['Silent film', 'Black-and-white']",1920,6
8608462,Desamuduru,2007,['India'],"['Musical', 'Romantic drama', 'Action/Adventure', 'Bollywood', 'World cinema', 'Romance Film', 'Drama']",2000,7
1863523,The Enforcer,1951,['United States of America'],"['Film noir', 'Crime Fiction', 'Drama']",1950,1
1586718,Martin,1978,['United States of America'],"['Crime Fiction', 'Horror', 'Drama', 'Cult']",1970,8
26337809,Struck by Lightning,1990,['Australia'],"['Sports', 'Drama']",1990,0
18973109,Employees' Entrance,1933,['United States of America'],"['Comedy-drama', 'Workplace Comedy', 'Pre-Code']",1930,3
10203219,The Mysterious Mr. M,1946,['United States of America'],"['Action', 'Black-and-white', 'Crime Fiction', 'Adventure']",1940,6
16167897,Thithikudhe,2003,['India'],[],2000,3
21333149,Fiebre de Amor,1985,['Mexico'],"['Musical', 'Romance Film', 'Drama']",1980,5
77605,One Foot in Heaven,1941,['United States of America'],"['Black-and-white', 'Biographical film', 'Drama']",1940,1
30273080,Atlantic Flight,1937,[],"['Action', 'Drama', 'Action/Adventure', 'Adventure']",1930,7
5968326,Michael Clayton,2007,['United States of America'],"['Crime Fiction', 'Mystery', 'Thriller', 'Crime Thriller', 'Drama', 'Courtroom Drama']",2000,7
17484649,The Son of Tarzan,1920,['United States of America'],"['Action', 'Black-and-white', 'Action/Adventure', 'Jungle Film', 'Silent film', 'Adventure', 'Drama']",1920,0
3418900,Cast a Giant Shadow,1966,['United States of America'],"['Action', 'Action/Adventure', 'Biopic [feature]', 'War film', 'Adventure', 'Drama']",1960,6
11069054,Hey Babu Riba,1985,"['Yugoslavia', 'Socialist Federal Republic of Yugoslavia']","['Coming of age', 'Romantic drama', 'World cinema', 'Romance Film', 'Drama']",1980,5
7541886,Betty Boop and Little Jimmy,1936,['United States of America'],"['Animation', 'Short Film', 'Comedy', 'Family Film']",1930,6
30317436,Searching for the Elephant,2009,['South Korea'],['Drama'],2000,9
11604569,I Live My Life,1935,['United States of America'],"['Black-and-white', 'Romantic drama', 'Romance Film', 'Comedy-drama', 'Drama']",1930,5
4469806,Solid Geometry,2002,['United Kingdom'],"['Mystery', 'Short Film', 'Drama']",2000,2
11027747,Bachelor Party 2: The Last Temptation,2008,['United States of America'],"['Comedy', 'Sex comedy']",2000,8
29195648,Blind Corner,1963,[],"['Drama', 'Crime Fiction', 'Thriller']",1960,3
3061610,Brilliantovaya ruka,1968,"['Russia', 'Soviet Union']","['Comedy', 'World cinema']",1960,8
511228,The Poseidon Adventure,1972,['United States of America'],"['Action', 'Action/Adventure', 'Thriller', 'Adventure', 'Disaster', 'Drama']",1970,2
528472,Frankenweenie (1984),1984,['United States of America'],['Short Film'],1980,4
12260598,Ice Age: Dawn of the Dinosaurs,2009,['United States of America'],"['Action', 'Animation', 'Comedy', 'Romance Film', 'Family-Oriented Adventure', ""Children's/Family"", 'Adventure', 'Family Film']",2000,9
2400693,The Sword and the Sorcerer,1982,['United States of America'],"['Fantasy Adventure', 'Indie', 'Action/Adventure', 'Costume drama', 'Adventure', 'Sword and sorcery films', 'Sword and sorcery', 'Fantasy']",1980,2
2292451,Devil's Pond,2003,['United States of America'],"['Suspense', 'Thriller']",2000,3
10673891,Always: Sunset on Third Street,2005,['Japan'],"['Japanese Movies', 'Drama', 'World cinema']",2000,5
16490795,Rasikkum Seemane,2008,['India'],['Thriller'],2000,8
11478593,Taming of the Fire,1972,['Soviet Union'],"['Drama', 'Biographical film']",1970,2
2117053,Le weekend,1967,"['France', 'Italy']","['Surrealism', 'Dystopia', 'World cinema', 'Drama']",1960,7
6574608,Dil,2003,['India'],"['Musical', 'Romantic drama', 'Bollywood', 'World cinema', 'Romance Film', 'Drama']",2000,3
4868441,Les Filles du Botaniste,2006,"['Canada', 'France']","['LGBT', 'Comedy', 'Romantic comedy', 'Drama']",2000,6
34525346,The Trouble Shooter,1924,['United States of America'],"['Western', 'Silent film']",1920,4
3819797,And the Ship Sails on,1983,"['France', 'Italy']","['Music', 'Art film', 'Satire', 'Comedy', 'World cinema', 'Drama', 'Period piece', 'War film', 'Comedy of manners']",1980,3
18832639,The Romanovs: An Imperial Family,2000,['Russia'],"['History', 'Biographical film', 'Drama']",2000,0
29123823,Dancing at the Harvest Moon,2002,['United States of America'],"['Romance Film', 'Drama']",2000,2
1693867,Get Carter,2000,['United States of America'],"['Action', 'Crime Fiction', 'Gangster Film', 'Action/Adventure', 'Thriller', 'Crime Thriller']",2000,0
1828157,The Beast with Five Fingers,1946,['United States of America'],"['Horror', 'Natural horror films']",1940,6
30980238,Mississippi Damned,2009,['United States of America'],"['LGBT', 'Family Drama', 'Melodrama', 'Drama']",2000,9
21853854,Nietzsche,2003,['United States of America'],"['Short Film', 'Drama']",2000,3
14746962,Husbands Beware,1956,['United States of America'],"['Short Film', 'Black-and-white', 'Comedy']",1950,6
30366958,Public Cowboy No. 1,1937,['United States of America'],"['Musical', 'Western', 'Action/Adventure']",1930,7
198313,Willow,1988,['United States of America'],"['Action', 'Fantasy Adventure', 'Action/Adventure', 'Comedy', 'Romance Film', 'Costume drama', 'Adventure', 'Sword and sorcery films', 'Drama', 'Sword and sorcery', 'Stop motion', 'Family Film', 'Fantasy']",1980,8
13015706,Speedy Gonzales,1955,['United States of America'],"['Animation', 'Short Film', 'Comedy film', 'Family Film']",1950,5
24138832,The Beachcomber,1954,['United Kingdom'],"['Drama', 'Comedy']",1950,4
2782741,The Glass Wall,1953,['United States of America'],"['Film noir', 'Drama']",1950,3
3860879,Dance with the Wind,2004,['South Korea'],['Romantic comedy'],2000,4
26012898,Cheppu,1987,['India'],['Drama'],1980,7
5738987,The Man I Love,1946,['United States of America'],['Film noir'],1940,6
16207125,Mother Krause's Journey to Happiness,1929,['Germany'],['Drama'],1920,9
2064955,A travers la forêt,2005,['France'],['Drama'],2000,5
16644875,Hunting and Gathering,2007,['France'],"['Romantic comedy', 'Comedy']",2000,7
3150514,Long-Haired Hare,1949,['United States of America'],"['Animation', 'Short Film', 'Family Film']",1940,9
11788249,Deadbeat at Dawn,1988,['United States of America'],"['Action', 'Crime Fiction', 'Gangster Film', 'Indie', 'Action/Adventure', 'Action Thrillers', 'Thriller']",1980,8
4625600,Shaukeen,1981,['India'],"['Comedy', 'World cinema']",1980,1
19539381,Doghouse,2009,['United Kingdom'],"['Slasher', 'Horror Comedy', 'Comedy', 'Horror', 'Black comedy', 'Zombie Film']",2000,9
908505,In Which Annie Gives it Those Ones,1989,['India'],['Comedy'],1980,9
2782570,Garam Masala,2005,['India'],"['Comedy', 'Bollywood', 'World cinema']",2000,5
4446720,Paradise,1991,['United States of America'],"['Film adaptation', 'Family Drama', 'Romantic drama', 'Romance Film', 'Drama', 'Family Film']",1990,1
3562095,"Water, Water Every Hare",1952,['United States of America'],"['Animation', 'Short Film', 'Comedy', 'Family Film']",1950,2
1621849,The Curse of the Cat People,1944,['United States of America'],"['Black-and-white', 'Childhood Drama', 'Horror', ""Children's/Family"", 'Fantasy']",1940,4
14306303,Intergirl,1989,['Soviet Union'],"['Romance Film', 'Drama']",1980,9
25012415,Echoes of a Summer,1976,['United States of America'],"['Family Drama', 'Drama']",1970,6
29324670,Background,1953,['United Kingdom'],['Drama'],1950,3
3941009,The Man They Could Not Hang,1939,['United States of America'],"['Black-and-white', 'Horror']",1930,9
5651517,Return of the Living Dead: Rave from the Grave,2005,['United States of America'],"['Horror', 'Zombie Film']",2000,5
25375805,Livestock,2009,['United States of America'],['Horror'],2000,9
12064781,This Way Please,1937,['United States of America'],"['Musical', 'Black-and-white', 'Comedy']",1930,7
14711303,The Irony of Fate 2,2007,['Russia'],"['Romantic comedy', 'Comedy', 'Drama']",2000,7
15260151,Guests Who Arrived on the Last Train,1967,['South Korea'],['Drama'],1960,7
1703805,The Stendhal Syndrome,1996,['Italy'],"['Psychological thriller', 'Crime Fiction', 'Slasher', 'Thriller', 'Horror', 'World cinema', 'Cult']",1990,6
5125717,Pick Me Up,2006,"['Canada', 'United States of America']","['Slasher', 'Horror', 'Television movie', 'Cult']",2000,6
1693894,Kansas City,1996,"['United States of America', 'France']","['Music', 'Musical', 'Crime Fiction', 'Thriller', 'Film noir', 'Drama', 'Period piece', 'Crime Drama', 'Ensemble Film']",1990,6
29260795,Dangerous Medicine,1938,['United Kingdom'],"['Drama', 'Crime Fiction']",1930,8
26039161,Troublesome Night 10,2001,['Hong Kong'],"['Chinese Movies', 'Comedy', 'Horror']",2000,1
6506395,The Goddess,1934,"['China', 'Taiwan']","['Black-and-white', 'Drama', 'Indie', 'Silent film', 'Chinese Movies']",1930,4
22417540,The Courageous Heart of Irena Sendler,2009,['United States of America'],"['Period piece', 'Television movie', 'Drama']",2000,9
17909208,The Courtneys of Curzon Street,1947,['United Kingdom'],"['Black-and-white', 'Drama']",1940,7
787704,Arsenic and Old Lace,1944,['United States of America'],"['Screwball comedy', 'Mystery', 'Comedy', 'Thriller', 'Film noir', 'Black comedy']",1940,4
5533519,The Crocodile Hunter: Collision Course,2002,"['New Zealand', 'Australia', 'United States of America']","['Adventure Comedy', 'Action', 'Action/Adventure', 'Comedy', 'World cinema', 'Family-Oriented Adventure', 'Adventure', 'Animal Picture', 'Family Film']",2000,2
29003237,Mission in Tangier,1949,['France'],['Drama'],1940,9
26858630,This Thing Called Love,1929,['United States of America'],['Silent film'],1920,9
6518422,Blue Moon,2006,['Philippines'],"['Filipino Movies', 'Romantic drama', 'World cinema', 'Romance Film', 'Drama']",2000,6
23813576,Dead In The Water,2002,['United States of America'],"['Psychological thriller', 'Suspense', 'Mystery', 'Indie', 'Thriller', 'Erotic thriller', 'Crime Thriller']",2000,2
8037429,The Andromeda Nebula,1967,['Soviet Union'],['Science Fiction'],1960,7
6218427,Moving McAllister,2007,['United States of America'],"['Indie', 'Comedy', 'Romance Film', 'Romantic comedy', 'Road movie']",2000,7
20952105,Homesdale,1971,['Australia'],"['Drama', 'Comedy film']",1970,1
3955038,Kafka,1991,"['France', 'United States of America']","['Period piece', 'Gothic Film', 'Biographical film', 'Kafkaesque', 'Biopic [feature]', 'Science Fiction', 'Drama']",1990,1
10616333,Dostana,1980,['India'],['Bollywood'],1980,0
3657604,The Defector,1966,"['France', 'Germany', 'West Germany']","['Spy', 'Drama', 'Thriller']",1960,6
13788689,Everybody Says I'm Fine!,2001,['India'],"['Romantic drama', 'Fantasy Comedy', 'World cinema', 'Romance Film', 'Romantic comedy', 'Comedy-drama', 'Drama']",2000,1
22815884,Black Widow,1954,['United States of America'],"['Crime Fiction', 'Mystery', 'Thriller', 'Film noir', 'Crime Thriller', 'Drama']",1950,4
887164,The Assassination Bureau,1969,['United Kingdom'],"['Action', 'Crime Fiction', 'Action/Adventure', 'Comedy', 'Thriller', 'Black comedy', 'Crime Thriller', 'Comedy Thriller', 'Crime Comedy']",1960,9
26156614,Chrystal,2004,['United States of America'],"['Indie', 'Drama']",2000,4
4442904,A Place to Be Loved,1993,['United States of America'],"['Drama', 'Biographical film']",1990,3
414368,Golden Yeggs,1950,['United States of America'],"['Animation', 'Short Film', 'Comedy film', 'Family Film']",1950,0
639319,You Got Served,2004,['United States of America'],"['Musical', 'Musical Drama', 'Comedy', 'Teen', 'Hip hop movies', 'Drama', 'Dance', 'Comedy-drama', 'Sports', 'Family Film']",2000,4
3831594,Criminal,2004,['United States of America'],"['Heist', 'Crime Fiction', 'Indie', 'Drama', 'Comedy', 'Thriller', 'Crime Thriller']",2000,4
4866615,The Student Prince,1954,['United States of America'],['Musical'],1950,4
2889835,Whispering City,1947,['Canada'],"['Psychological thriller', 'Thriller', 'Film noir', 'Crime Thriller']",1940,7
4190400,Home Room,2002,['United States of America'],"['Drama', 'Crime Fiction', 'Indie', 'Teen']",2000,2
2648235,"Rita, Sue and Bob Too",1987,"['United Kingdom', 'England']","['Comedy', 'Drama', 'Sex comedy']",1980,7
1190626,Operation Pacific,1951,['United States of America'],"['Action', 'Combat Films', 'Action/Adventure', 'Comedy', 'Romance Film', 'War film', 'Drama']",1950,1
442308,Once Upon a Time in America,1984,"['Italy', 'United States of America']","['Film adaptation', 'Period piece', 'Crime Fiction', 'Gangster Film', 'Drama', 'Ensemble Film']",1980,4
13389642,Hallowed Ground,2007,['United States of America'],"['B-movie', 'Thriller', 'Horror']",2000,7
3787080,Redeye,2005,['South Korea'],"['World cinema', 'Horror']",2000,5
22242521,The Miracle,1991,"['United Kingdom', 'Ireland', 'United States of America']",['Drama'],1990,1
19106264,The Gamma People,1956,['United Kingdom'],"['Action', 'Horror', 'Adventure', 'Science Fiction']",1950,6
10131149,"Beep, Beep",1952,['United States of America'],"[""Children's/Family"", 'Comedy', 'Comedy of Errors']",1950,2
20940489,The Christmas Shoes,2002,"['Canada', 'United States of America']",['Drama'],2000,2
5277590,The Legend of Simon Conjurer,2006,['United States of America'],"['Action', 'Thriller']",2000,6
28155057,Nine Men,1943,['United Kingdom'],['War film'],1940,3
20259032,The Children,2008,['United Kingdom'],['Horror'],2000,8
25001635,Stealing Heaven,1988,"['Yugoslavia', 'United Kingdom']","['Historical fiction', 'Romantic drama', 'Drama']",1980,8
2425302,The Omen,2006,['United States of America'],"['Demonic child', 'Thriller', 'Horror', 'Supernatural', 'Cult']",2000,6
6262095,Watermelon,2003,"['Ireland', 'United Kingdom']",['Drama'],2000,3
29110209,News,1989,[],"['Action', 'Mystery', 'Thriller']",1980,9
3119806,Antarctic Journal,2005,['South Korea'],"['Psychological thriller', 'Mystery', 'Horror']",2000,5
3371895,Drum,2004,"['United States of America', 'South Africa']","['Drama', 'Indie', 'Thriller', 'Political drama']",2000,4
1475272,Bad Boy Bubby,1993,"['Italy', 'Australia']","['Crime Fiction', 'Comedy', 'World cinema', 'Black comedy', 'Drama']",1990,3
24104388,Bhole Shankar,2008,['India'],"['Musical', 'Drama', 'Family Film']",2000,8
22016216,Odaruthammava Aalariyam,1984,['India'],['Comedy'],1980,4
26800570,The Living Ghost,1942,['United States of America'],"['Mystery', 'Thriller', 'Horror']",1940,2
25193897,Let's Go Collegiate,1941,['United States of America'],"['Musical', 'Comedy', 'Musical comedy', 'Romantic comedy']",1940,1
3408276,Song of Freedom,1936,['United Kingdom'],"['Musical', 'Black-and-white', 'Musical Drama', 'Drama']",1930,6
24158189,Winter People,1989,['United States of America'],"['Period piece', 'Romantic drama', 'Family Drama', 'Romance Film', 'Drama']",1980,9
21878654,SpongeBob vs. The Big One,2009,['United States of America'],['Short Film'],2000,9
1394037,Guest House Paradiso,1999,['United Kingdom'],['Black comedy'],1990,9
1729915,Nowhere in Africa,2001,['Germany'],"['Period piece', 'Family Drama', 'Biography', 'Biographical film', 'World cinema', 'Drama']",2000,1
957942,Tequila Sunrise,1988,['United States of America'],"['Crime Fiction', 'Romantic drama', 'Action/Adventure', 'Thriller', 'Crime Drama', 'Drama']",1980,8
16195082,Kantri,2008,['India'],"['Drama', 'World cinema']",2000,8
1135297,13 Ghosts,1960,['United States of America'],['Horror'],1960,0
4088797,The Ghosts of Edendale,2003,['United States of America'],"['Psychological thriller', 'Western', 'Thriller', 'Horror']",2000,3
4183527,Madeline: Lost in Paris,1999,['United States of America'],"['Family Film', 'Animation']",1990,9
1670884,Mission Stardust,1967,"['Spain', 'Italy']","['Science Fiction', 'Adventure']",1960,7
3022675,The Final Cut,1995,[],[],1990,5
1385804,Pigs Is Pigs,1937,['United States of America'],"['Animation', 'Short Film', 'Comedy film', 'Family Film']",1930,7
12583457,The Accompanist,1992,['France'],"['Period piece', 'Marriage Drama', 'Drama']",1990,2
17129542,"Circe, the Enchantress",1924,['United States of America'],"['Silent film', 'Black-and-white', 'Drama']",1920,4
33152192,Niloofar,2008,"['France', 'Lebanon', 'Iran']",['Drama'],2000,8
15397748,Boys to Board,1923,['United States of America'],"['Black-and-white', 'Indie', 'Short Film', 'Comedy', 'Silent film', 'Family Film']",1920,3
18656759,Steam,2007,['United States of America'],"['LGBT', 'Indie', 'Romantic drama', 'Romance Film', 'Drama']",2000,7
28645422,Mardi Gras Massacre,1978,['United States of America'],"['Crime Thriller', 'Horror']",1970,8
22374429,A Secret,2008,['France'],"['Drama', 'World cinema']",2000,8
865607,The Quatermass Xperiment,1955,['United Kingdom'],"['Black-and-white', 'Thriller', 'Horror', 'Alien Film', 'Sci-Fi Horror', 'Science Fiction']",1950,5
28214407,Daddy,1991,['United States of America'],"['Film adaptation', 'Romantic drama', 'Romance Film', 'Television movie', 'Drama']",1990,1
2792590,Mouna Raagam,1986,['India'],"['Romance Film', 'Drama']",1980,6
7302636,The 10th Victim,1965,"['France', 'Italy']","['Film adaptation', 'Parody', 'Comedy', 'World cinema', 'Black comedy', 'Science Fiction', 'Drama']",1960,5
25019575,Tanging Yaman,2001,['Philippines'],"['Filipino Movies', 'Drama', 'World cinema']",2000,1
17370984,Krakatoa,1933,['United States of America'],"['Short Film', 'Documentary']",1930,3
397753,The Texas Chainsaw Massacre Part 2,1986,['United States of America'],"['Slasher', 'Satire', 'Comedy', 'Horror', 'Road-Horror', 'Cult']",1980,6
13225630,King of California,2007,['United States of America'],"['Indie', 'Comedy', 'Drama']",2000,7
2673183,Memoirs of an Invisible Man,1992,"['France', 'United States of America']","['Action', 'Action/Adventure', 'Comedy', 'Superhero movie', 'Science Fiction', 'Drama', 'Fantasy']",1990,2
25098571,The Bargee,1964,['United Kingdom'],"['Romance Film', 'Comedy']",1960,4
1324852,Cloak & Dagger,1984,['United States of America'],"['Action', 'Spy', 'Mystery', 'Family Drama', 'Thriller', 'Adventure', 'Drama', 'Family Film']",1980,4
1358857,Vanishing Point,1971,"['United Kingdom', 'United States of America']","['Action', 'Action/Adventure', 'Existentialism', 'Thriller', 'Road movie', 'Drama', 'Cult']",1970,1
7938927,The Hoose-Gow,1929,['United States of America'],"['Short Film', 'Black-and-white', 'Comedy']",1920,9
3462620,The Land Before Time VII: The Stone of Cold Fire,2000,['United States of America'],"['Animated cartoon', 'Animation', 'Family-Oriented Adventure', ""Children's/Family"", 'Adventure', 'Family Film', 'Fantasy']",2000,0
31630826,Swapnadanam,1976,[],['Drama'],1970,6
3150991,The Horn Blows at Midnight,1945,['United States of America'],"['Heavenly Comedy', 'Comedy', 'Fantasy Comedy', 'Fantasy']",1940,5
6692620,Money From Home,1953,['United States of America'],"['Musical', 'Screwball comedy', 'Comedy', 'Slapstick']",1950,3
11891977,Embrace Me Tightly,2001,['Mexico'],['World cinema'],2000,1
91133,The Karate Kid,1984,"['Japan', 'United States of America']","['Action', 'Family Drama', 'Action/Adventure', 'Teen', 'Romance Film', 'Martial Arts Film', 'Adventure', 'Drama', 'Sports', 'Japanese Movies', 'Coming of age', 'Family Film']",1980,4
4163786,Hexen bis aufs Blut gequält,1970,"['Germany', 'West Germany']","['Supernatural', 'Horror']",1970,0
1625624,Year of the Dragon,1985,['United States of America'],"['Action', 'Crime Fiction', 'Action Thrillers', 'Gangster Film', 'Action/Adventure', 'Thriller', 'Drama']",1980,5
5662308,Kill Me Later,2001,['United States of America'],"['Action', 'Suspense', 'Drama', 'Thriller', 'Crime', 'Romance Film']",2000,1
3667704,The Force,1994,['United States of America'],"['Thriller', 'Drama']",1990,4
16676210,The Incredible Journey of Doctor Meg Laurel,1979,['United States of America'],"['Adventure', 'Drama']",1970,9
8845785,Ibn al-Nile,1951,['Egypt'],['Drama'],1950,1
19233962,Journey to the End of the Night,2006,"['Brazil', 'Germany', 'United States of America']","['Crime Fiction', 'Indie', 'Thriller', 'Crime Thriller', 'Drama']",2000,6
3304471,The Eel,1997,['Japan'],"['Japanese Movies', 'Drama', 'World cinema']",1990,7
21089512,Virgin on Bourbon Street,2009,['United States of America'],"['Screwball comedy', 'Comedy']",2000,9
2259649,Maniac Cop,1988,['United States of America'],"['Action', 'Indie', 'Action/Adventure', 'Slasher', 'Thriller', 'Horror']",1980,8
869181,Quatermass 2,1957,['United Kingdom'],"['Black-and-white', 'Science Fiction', 'Horror']",1950,7
19101562,Midas Run,1969,['United States of America'],"['Crime Fiction', 'Comedy', 'Crime Drama', 'Adventure']",1960,9
9459355,Cahill U.S. Marshal,1973,['United States of America'],"['Action', 'Western', 'Action/Adventure']",1970,3
34147300,Frisco Sally Levy,1927,['United States of America'],"['Romance Film', 'Comedy']",1920,7
9807797,Strähl,2004,['Switzerland'],"['Drama', 'Crime Fiction']",2000,4
7579751,What Becomes of the Broken Hearted?,1999,['New Zealand'],"['Family Drama', 'Drama']",1990,9
33149657,Night of Terror,1933,[],['Horror'],1930,3
1232511,Sugar & Spice,2001,['United States of America'],"['Action', 'Crime Fiction', 'Action/Adventure', 'Comedy', 'Teen', 'Black comedy', 'Heist', 'Crime Comedy']",2000,1
21072520,The Garden,1995,"['France', 'Slovakia', 'Slovak Republic']",['Comedy'],1990,5
18284640,The End of Agent W4C,1967,['Czechoslovakia'],['Comedy'],1960,7
5720237,Elaan,2005,['India'],"['Action', 'Crime Fiction', 'Romantic drama', 'Action/Adventure', 'Thriller', 'World cinema', 'Romance Film', 'Crime Thriller', 'Drama']",2000,5
24291753,The Careless Years,1957,['United States of America'],"['Musical', 'Romantic drama', 'Romance Film', 'Drama']",1950,7
2350188,7½ Phere,2005,['India'],"['Drama', 'Comedy', 'Bollywood']",2000,5
18618476,The Hearse,1980,['United States of America'],"['Psychological thriller', 'Indie', 'Thriller', 'Horror']",1980,0
570743,Down to Earth,2001,"['Canada', 'Australia', 'Germany', 'United States of America']","['Comedy', 'Romance Film', 'Romantic comedy', 'Fantasy']",2000,1
950929,The Haunting,1963,"['United Kingdom', 'United States of America']","['Drama', 'Psychological horror', 'Horror']",1960,3
16725177,Gone,2007,"['United Kingdom', 'New Zealand', 'Australia']","['Psychological thriller', 'Suspense', 'Thriller', 'World cinema', 'Crime Thriller', 'Drama']",2000,7
129368,Rain Man,1988,['United States of America'],"['Family Drama', 'Melodrama', 'Road movie', 'Drama']",1980,8
3520860,Quints,2000,"['Canada', 'United States of America']","['Comedy', 'Family Film']",2000,0
3634311,United 93,2006,"['United Kingdom', 'France', 'United States of America']","['Crime Fiction', 'History', 'Docudrama', 'Drama']",2000,6
33289788,Sailaab,1990,[],"['Romance Film', 'Drama', 'Thriller']",1990,0
24440630,Venezzia,2009,[],['War film'],2000,9
7766381,Gallant Bess,1947,['United States of America'],"['Animal Picture', 'Comedy-drama', 'War film', 'Drama']",1940,7
1122030,Midnight Run,1988,['United States of America'],"['Action', 'Airplanes and airports', 'Crime Fiction', 'Action/Adventure', 'Buddy film', 'Thriller', 'Comedy']",1980,8
6691690,The Tooth Fairy,2006,['United States of America'],"['Thriller', 'Horror']",2000,6
646454,Nirvana,1997,"['United Kingdom', 'France', 'Italy']","['Psychological thriller', 'Thriller', 'World cinema', 'Crime Thriller', 'Science Fiction']",1990,7
24190384,The Crime Patrol,1936,['United States of America'],"['Crime Fiction', 'Mystery', 'Romance Film', 'Drama']",1930,6
17006178,The Thing Below,2004,['Canada'],"['Creature Film', 'Science Fiction', 'Horror']",2000,4
26212916,"How to Be Very, Very Popular",1955,['United States of America'],['Comedy'],1950,5
25047588,The Prisoner,1955,['United Kingdom'],"['Drama', 'Political drama']",1950,5
5495081,The Crawling Hand,1963,['United States of America'],"['Thriller', 'Horror', 'B-movie', 'Science Fiction']",1960,3
28192736,Amma,2003,['India'],"['Drama', 'Crime Fiction']",2000,3
8311612,Tiga Abdul,1964,['Malaysia'],"['Musical', 'Comedy']",1960,4
18089789,Belle Toujours,2006,"['Portugal', 'France']","['Musical', 'Surrealism', 'Art film', 'Erotic Drama', 'Romantic drama', 'World cinema', 'Romance Film', 'Drama']",2000,6
11706092,"Zontar, The Thing from Venus",1966,['United States of America'],"['Horror', 'B-movie', 'Alien Film', 'Science Fiction']",1960,6
5188359,The Cabinet of Dr. Caligari,2005,['United States of America'],"['Psychological thriller', 'Mystery', 'Indie', 'Thriller', 'Horror', 'Crime Thriller']",2000,5
24463571,La Valentina,1966,['Mexico'],"['War film', 'Comedy', 'Adventure']",1960,6
5664063,Recess: Taking the Fifth Grade,2003,['United States of America'],"['Animation', 'Comedy', 'Family Film']",2000,3
3201938,Nous irons tous au paradis,1977,['France'],"['Sex comedy', 'Comedy', 'Ensemble Film']",1970,7
7489581,Body of Evidence,1993,"['Germany', 'United States of America']","['Romance Film', 'Drama', 'Thriller']",1990,3
9857107,Notte prima degli esami,2006,['Italy'],['Comedy'],2000,6
2526781,Trancers,1985,['United States of America'],"['Action', 'Time travel', 'Indie', 'Adventure', 'Science Fiction', 'Cult']",1980,5
22376055,Die Pratermizzi,1927,['Austria'],['Silent film'],1920,7
22833707,Mother,2009,['South Korea'],"['Crime Fiction', 'Mystery', 'Thriller', 'World cinema', 'Crime Thriller', 'Drama']",2000,9
30282860,The Crucifix,1934,[],['Drama'],1930,4
12243701,D,2005,['India'],"['Crime Fiction', 'Thriller', 'World cinema', 'Crime Thriller', 'Drama']",2000,5
4261392,Phat Girlz,2006,['United States of America'],"['Comedy', 'Romance Film', 'Romantic comedy', 'Drama']",2000,6
1634239,Saathiya,2002,['India'],"['Musical', 'Romantic drama', 'Bollywood', 'World cinema', 'Romance Film', 'Drama']",2000,2
8055250,Snow White,2001,"['Germany', 'United States of America', 'Canada']","['Television movie', 'Family Film', 'Costume drama', 'Drama', 'Fantasy']",2000,1
24642367,Beggars in Ermine,1934,['United States of America'],"['Film adaptation', 'Drama', 'Thriller']",1930,4
7328023,Mere Yaar Ki Shaadi Hai,2002,['India'],"['Musical', 'Romantic drama', 'Comedy', 'Bollywood', 'World cinema', 'Romance Film', 'Drama', 'Romantic comedy']",2000,2
9127916,Lyubimetz 13,1958,['Bulgaria'],['Comedy'],1950,8
18935404,Thiruvannamalai,2008,['India'],['Action'],2000,8
2313750,Four Brothers,2005,['United States of America'],"['Action', 'Crime Fiction', 'Family Drama', 'Action/Adventure', 'Thriller', 'Crime Drama', 'Drama']",2000,5
527169,Schizopolis,1996,['United States of America'],"['Indie', 'Parody', 'Satire', 'Comedy', 'Media Satire', 'Black comedy', 'Workplace Comedy']",1990,6
2378208,Narc,2002,"['Canada', 'United States of America']","['Action', 'Crime Fiction', 'Mystery', 'Action/Adventure', 'Thriller', 'Crime Thriller', 'Drama']",2000,2
27345864,Mongo's Back in Town - Tv Film,1971,['United States of America'],"['Drama', 'Crime Fiction']",1970,1
20734302,Kasethan Kadavulada,1972,['India'],['Comedy'],1970,2
2503448,Lola,1981,"['Germany', 'West Germany']","['Art film', 'Comedy', 'World cinema', 'Drama']",1980,1
1307241,Sphere,1998,['United States of America'],"['Film adaptation', 'Mystery', 'Thriller', 'Sci-Fi Adventure', 'Adventure', 'Drama', 'Horror', 'Alien Film', 'Science Fiction']",1990,8
590598,Straight to Hell,1987,['United Kingdom'],"['Crime Fiction', 'Parody', 'Action/Adventure', 'Western', 'Comedy', 'Adventure', 'Absurdism']",1980,7
7725336,Cherish,2002,['United States of America'],"['Crime Fiction', 'Mystery', 'Indie', 'Comedy', 'Thriller', 'Romantic drama', 'Romance Film', 'Black comedy', 'Drama', 'Comedy Thriller', 'Romantic comedy', 'Comedy-drama']",2000,2
3093796,Milou en mai,1990,"['France', 'Italy']","['Romance Film', 'Satire', 'Comedy']",1990,0
6109736,Her Minor Thing,2005,['United States of America'],"['Indie', 'Comedy', 'Romance Film', 'Romantic comedy']",2000,5
15451897,Shikari,2000,['India'],"['Suspense', 'Gangster Film', 'Mystery', 'Thriller', 'Bollywood', 'World cinema', 'Crime Thriller']",2000,0
20903035,Call Girl,1974,['India'],"['Romantic drama', 'World cinema', 'Romance Film', 'Drama']",1970,4
3417075,Surviving The Game,1994,['United States of America'],"['Action', 'Crime Fiction', 'Action Thrillers', 'Action/Adventure', 'Thriller', 'Adventure', 'Drama', 'Chase Movie']",1990,4
7444907,Poison,1991,['United States of America'],"['LGBT', 'Drama', 'Indie', 'Satire', 'Horror', 'Experimental film', 'Science Fiction']",1990,1
13579944,Maha-Sangram,1990,['India'],['Romance Film'],1990,0
3607647,Just Write,1997,['United States of America'],"['Indie', 'Comedy', 'Romance Film', 'Romantic comedy', 'Comedy of Errors']",1990,7
101914,Dog Day Afternoon,1975,['United States of America'],"['Crime Fiction', 'LGBT', 'New Hollywood', 'Crime Drama', 'Docudrama', 'Drama']",1970,5
4367877,Private,2004,['Italy'],"['World cinema', 'War film', 'Political drama', 'Drama']",2000,4
26119173,Velugu Needalu,1961,['India'],['Drama'],1960,1
15041008,Aag Andhi Aur Toofan,1994,['India'],"['Action', 'Thriller']",1990,4
149928,Zardoz,1974,['United Kingdom'],"['Fantasy Adventure', 'Action/Adventure', 'Thriller', 'Apocalyptic and post-apocalyptic fiction', 'Adventure', 'Dystopia', 'Science Fiction', 'Fantasy']",1970,4
23017170,Ishq Ishq Ishq,1974,['India'],"['Romance Film', 'Drama', 'Family Film']",1970,4
17874554,Vadakku Nooki Yanthram,1989,['India'],"['Drama', 'Comedy']",1980,9
26350895,Boston Kickout,1996,['United Kingdom'],['Drama'],1990,6
7148117,Rio Rita,1942,['United States of America'],"['Comedy', 'Black-and-white']",1940,2
27747327,Backwoods Bunny,1959,['United States of America'],"['Animation', 'Short Film', 'Family Film']",1950,9
8852973,Saint Clara,1996,['Israel'],"['Romantic drama', 'Comedy', 'Childhood Drama', 'World cinema', 'Romance Film', ""Children's/Family"", 'Drama', ""Children's Fantasy"", 'Fantasy']",1990,6
3373525,Cinderfella,1960,['United States of America'],"['Comedy', 'Satire', 'Romance Film', 'Romantic comedy', 'Fantasy Comedy']",1960,0
10142267,Adam Had Four Sons,1941,['United States of America'],"['Black-and-white', 'Romantic drama', 'Family Drama', 'Romance Film', 'Drama']",1940,1
805496,The Black Cauldron,1985,['United States of America'],"['Action', 'Fantasy Adventure', 'Animation', ""Children's/Family"", 'Costume drama', 'Adventure', 'Sword and sorcery films', 'Sword and sorcery', 'Family Film', 'Fantasy']",1980,5
12294476,Pray,2005,['Japan'],"['Japanese Movies', 'Thriller', 'Horror', 'World cinema', 'Supernatural']",2000,5
12780416,Un maledetto imbroglio,1959,['Italy'],"['Black-and-white', 'Crime Fiction', 'Mystery']",1950,9
12160883,The Bank Job,2008,"['United Kingdom', 'United States of America']","['Action', 'Drama', 'Crime Fiction', 'Thriller']",2000,8
4125216,Anahat,2003,['India'],['Drama'],2000,3
29416595,Another Day,2001,"['Canada', 'United States of America']","['Romantic drama', 'Romance Film', 'Television movie', 'Drama']",2000,1
4196336,Cinderella II: Dreams Come True,2002,['United States of America'],"['Fairy tale', 'Animation', ""Children's/Family"", ""Children's"", 'Family Film']",2000,2
2179507,Sister My Sister,1995,"['United Kingdom', 'United States of America']","['Period piece', 'Suspense', 'LGBT', 'Drama', 'Indie', 'Erotic thriller']",1990,5
2678322,Lapin kullan kimallus,1999,['Finland'],['Drama'],1990,9
23382222,The Thirteenth Guest,1932,['United States of America'],"['Black-and-white', 'Mystery', 'Comedy Thriller', 'Thriller', 'Crime Thriller', 'Whodunit']",1930,2
26134241,Vampire Vs. Vampire,1989,['Hong Kong'],"['Action', 'Action/Adventure', 'Comedy', 'Horror Comedy', 'World cinema', 'Chinese Movies', 'Martial Arts Film', 'Creature Film', 'Horror']",1980,9
5579355,Digimon: The Movie,2000,"['Japan', 'United States of America']","['Action', 'Fantasy Adventure', 'Animation', 'Thriller', 'World cinema', ""Children's/Family"", ""Children's"", 'Adventure', ""Children's Fantasy"", 'Japanese Movies', 'Anime', 'Family Film', 'Fantasy']",2000,0
21966094,Return of Mr. Superman,1960,['India'],"['Action', 'Drama', 'Adventure', 'Crime', 'Science Fiction']",1960,0
29052102,Savithriyude Aranjanam,2002,['India'],['Drama'],2000,2
7100278,I Was A Teenage Frankenstein's Roommate,2002,['United States of America'],"['Science Fiction', 'Comedy', 'Horror']",2000,2
13392017,Nights in Rodanthe,2008,"['United States of America', 'Australia']","['Film adaptation', 'Romantic drama', 'Romance Film', 'Melodrama', 'Drama']",2000,8
7406112,The Beast and the Beauty,2005,['South Korea'],"['Comedy', 'Comedy film', 'Romance Film', 'Melodrama']",2000,5
4724962,The Last Winter,2007,['United States of America'],"['Psychological thriller', 'Thriller', 'Horror', 'Supernatural']",2000,7
5221680,"Twinkle, Twinkle Lucky Stars",1985,['Hong Kong'],"['Action', 'Comedy', 'Chinese Movies', 'Martial Arts Film']",1980,5
26976169,Ilavelpu,1956,['India'],['Drama'],1950,6
6129545,The Scream Team,2002,['United States of America'],"['Mystery', ""Children's"", 'Comedy']",2000,2
13971966,Choking Man,2006,['United States of America'],"['Drama', 'Romantic drama', 'Indie', 'Comedy']",2000,6
11966220,La Muchacha de las Bragas de Oro,1980,['Spain'],['Drama'],1980,0
129312,Hope and Glory,1987,"['United Kingdom', 'United States of America']","['Period piece', 'Comedy', 'Childhood Drama', 'Comedy-drama', 'War film', 'Drama']",1980,7
18333832,The Last Mistress,2007,"['France', 'Italy']","['Period piece', 'Erotic Drama', 'Romantic drama', 'World cinema', 'Romance Film', 'Erotica', 'Drama']",2000,7
7322866,Ash Wednesday,2002,['United States of America'],"['Period piece', 'Drama', 'Crime Fiction', 'Gangster Film', 'Indie', 'Mystery']",2000,2
13463159,Lost in Beijing,2007,"['China', 'Hong Kong']","['Romantic drama', 'World cinema', 'Black comedy', 'Romance Film', 'Chinese Movies', 'Drama', 'Domestic Comedy', 'Melodrama']",2000,7
1996645,Old Gringo,1989,['United States of America'],"['Film adaptation', 'Romantic drama', 'Action/Adventure', 'Romance Film', 'Adventure', 'Drama', 'Period piece', 'Western']",1980,9
20363463,Virgil,2005,['France'],"['Sports', 'Drama', 'Comedy film']",2000,5
33124,Wild Strawberries,1957,['Sweden'],"['Black-and-white', 'Art film', 'World cinema', 'Drama']",1950,7
26443837,Annihilation Earth,2009,[],"['Action', 'Science Fiction']",2000,9
2419947,Sword of Gideon,1986,"['France', 'United States of America', 'Canada']","['Action', 'Spy', 'Film adaptation', 'Crime Fiction', 'Action/Adventure', 'Thriller', 'Crime Thriller', 'Drama', 'Political drama', 'Political thriller']",1980,6
32056279,Sara Akash,1969,['India'],"['Drama', 'World cinema']",1960,9
23587208,Les Innocents,1987,['France'],['Drama'],1980,7
73488,Frankenstein,1931,['United States of America'],"['Black-and-white', 'Monster', 'Horror', 'Science Fiction']",1930,1
30863360,Nazar Ke Samne,1994,[],['Family Film'],1990,4
15476834,I See a Dark Stranger,1946,['United Kingdom'],"['Spy', 'Black-and-white', 'Parody', 'Thriller']",1940,6
14220618,Night Visitor,1989,['United States of America'],"['Psychological thriller', 'Mystery', 'Slasher', 'Thriller', 'Horror']",1980,9
8698208,The Happy Time,1952,['United States of America'],"['Black-and-white', 'Family Drama', 'Comedy', 'Comedy-drama', 'Drama', 'Family Film']",1950,2
2812718,Saving Face,2004,['United States of America'],"['LGBT', 'Drama', 'Indie', 'Comedy', 'Romance Film', 'Romantic comedy']",2000,4
1323663,Merlin,1998,['United States of America'],"['Costume drama', 'Sword and sorcery']",1990,8
11657836,Tera Mera Saath Rahen,2001,['India'],['Drama'],2000,1
22727,Otaku no Video,1991,['Japan'],"['Animation', 'Comedy', 'Drama']",1990,1
5099007,The Fish That Saved Pittsburgh,1979,['United States of America'],"['Sports', 'Comedy', 'Fantasy']",1970,9
25626519,The Iron Gate,1958,['Egypt'],"['Crime Fiction', 'World cinema', 'Tragicomedy', 'Slice of life story', 'Drama', 'Ensemble Film']",1950,8
2441439,Two Moon Junction,1988,['United States of America'],"['Softcore Porn', 'Romantic drama', 'Indie', 'Thriller', 'Romance Film', 'Erotica', 'Drama']",1980,8
1789671,The Ghost and Mr. Chicken,1966,['United States of America'],"['Comedy', 'Drama', 'Family Film']",1960,6
161901,Charly,1968,['United States of America'],"['Film adaptation', 'Romantic drama', 'Romance Film', 'Science Fiction', 'Drama']",1960,8
18546797,Before the Rains,2007,"['United Kingdom', 'India', 'United States of America']","['Period piece', 'Romantic drama', 'Romance Film', 'Drama']",2000,7
3681345,Maurice,1987,['United Kingdom'],"['Film adaptation', 'LGBT', 'Indie', 'Romantic drama', 'Romance Film', 'Drama', 'Period piece', 'Gay Themed', 'Gay', 'Gay Interest']",1980,7
7480987,White Bird with Black Mark,1972,"['Ukrainian SSR', 'Soviet Union']","['War film', 'Drama']",1970,2
612840,If...,1968,['United Kingdom'],"['Surrealism', 'LGBT', 'Coming of age', 'Satire', 'Drama']",1960,8
8084939,La Passante du Sans-Souci,1982,"['France', 'West Germany']","['Action', 'Spy', 'Drama']",1980,2
4149808,The Sleeping City,1950,['United States of America'],"['Film noir', 'Black-and-white', 'Crime Fiction']",1950,0
8270869,The Night Flier,1997,['United States of America'],"['Film adaptation', 'Slasher', 'Horror']",1990,7
23654302,Henequen,1997,['South Korea'],"['Historical fiction', 'Drama']",1990,7
5085987,Tuck Everlasting,2002,['United States of America'],"['Film adaptation', 'Family Drama', 'Teen', 'Romance Film', 'Costume drama', 'Drama', 'Coming of age', 'Family Film', 'Fantasy']",2000,2
13623073,Cut,2000,"['Australia', 'Germany', 'New Zealand', 'United States of America']","['Slasher', 'Comedy', 'Thriller', 'Horror']",2000,0
12319780,Rakhi Aur Hathkadi,1972,['India'],"['Action', 'Drama', 'Action/Adventure', 'World cinema']",1970,2
497890,The Adventures of Milo and Otis,1989,['Japan'],"['Comedy', 'Family-Oriented Adventure', ""Children's/Family"", ""Children's"", 'Adventure', 'Drama', 'Japanese Movies', 'Animal Picture', 'Family Film']",1980,9
16877825,L'As Des As,1982,"['France', 'Germany']","['Adventure Comedy', 'Comedy', 'Adventure']",1980,2
33580698,Sidewalks of New York,1931,['United States of America'],"['Comedy', 'Crime Fiction']",1930,1
2678295,The 13th Letter,1951,['United States of America'],"['Psychological thriller', 'Mystery', 'Film noir', 'Whodunit']",1950,1
15945843,The Cannibal Man,1974,['Spain'],"['World cinema', 'Horror']",1970,4
2853320,Kannathil Muthamittal,2002,['India'],"['Family Drama', 'Bollywood', 'World cinema', 'War film', 'Drama']",2000,2
14998554,A Connecticut Yankee in King Arthur's Court,1949,['United States of America'],"['Musical', 'Time travel', 'Comedy', 'Adventure', 'Fantasy']",1940,9
8448301,A Family Thing,1996,['United States of America'],"['Family Drama', 'Drama']",1990,6
23631832,Anger Management,2003,['United States of America'],"['Black comedy', 'Slapstick', 'Comedy']",2000,3
22612034,Shaadi,1962,['India'],"['Action', 'Drama', 'Comedy', 'Romance Film']",1960,2
2405606,Seven Swords,2005,"['Hong Kong', 'South Korea', 'China']","['Action', 'Action/Adventure', 'World cinema', 'Wuxia', 'Chinese Movies', 'Martial Arts Film', 'Drama']",2000,5
16437578,Broken,2007,['United States of America'],"['Crime Fiction', 'Indie', 'Thriller', 'Drama']",2000,7
80916,Battleground,1949,['United States of America'],"['Action', 'Drama', 'War film']",1940,9
2403302,D3: The Mighty Ducks,1996,['United States of America'],"['Comedy', 'Comedy-drama', ""Children's/Family"", 'Sports', 'Family Film']",1990,6
12705564,Feline Frame-Up,1954,['United States of America'],"['Animation', 'Short Film', 'Comedy', 'Family Film']",1950,4
5330318,The Reluctant Astronaut,1967,['United States of America'],"['Adventure Comedy', 'Comedy', 'Family Film', 'Adventure', 'Comedy of Errors']",1960,7
20095138,Nightworld: Lost Souls,1998,"['Luxembourg', 'Canada']","['Mystery', 'Thriller', 'Horror', 'Science Fiction', 'Drama']",1990,8
7565198,Daas,2005,['India'],['Romance Film'],2000,5
24511591,Love Has No Language,2008,['India'],['Romance Film'],2000,8
26137128,The Bone Snatcher,2003,"['England', 'South Africa', 'Canada']",['Horror'],2000,3
11957789,Sky Lovers,2002,"['China', 'Hong Kong']","['Drama', 'Chinese Movies', 'World cinema']",2000,2
2911536,Nella stretta morsa del ragno,1971,"['France', 'West Germany', 'Italy']","['Thriller', 'Horror', 'World cinema', 'Supernatural']",1970,1
23699707,The Man Who Cheated Himself,1950,['United States of America'],"['Black-and-white', 'Crime Fiction', 'Mystery', 'Thriller', 'Film noir', 'Crime Thriller', 'Drama']",1950,0
4672611,Teen Witch,1989,['United States of America'],"['Comedy', 'Teen', 'Romance Film', 'Fantasy Comedy', 'Fantasy']",1980,9
4085736,The Caretakers,1963,['United States of America'],"['Black-and-white', 'Drama']",1960,3
1209883,The Colditz Story,1954,['United Kingdom'],"['Drama', 'War film', 'Escape Film']",1950,4
2976028,Dreamer,2005,['United States of America'],"['Sports', 'Drama', 'Family Film']",2000,5
23449348,The Night Visitor,1970,"['Sweden', 'United States of America']","['Psychological thriller', 'Suspense', 'Thriller', 'World cinema']",1970,0
3864340,Tol'able David,1921,['United States of America'],"['Black-and-white', 'Drama', 'Indie', 'Silent film']",1920,1
1971622,The Heckling Hare,1941,['United States of America'],"['Animation', 'Short Film', 'Comedy', 'Family Film']",1940,1
26588096,Hailesa,2009,['India'],['Comedy'],2000,9
2614254,Takeshis',2005,['Japan'],"['Japanese Movies', 'Black comedy', 'Media Satire', 'Comedy-drama']",2000,5
24191870,Eyewitness,1956,['United Kingdom'],['Thriller'],1950,6
4041425,The Pope of Greenwich Village,1984,['United States of America'],"['Action', 'Crime Fiction', 'Gangster Film', 'Coming of age', 'Comedy', 'Crime Drama', 'Drama']",1980,4
34250790,Peau d'Ange,2002,['France'],"['Musical', 'Romance Film', 'Drama']",2000,2
1678722,Attack of the Giant Leeches,1959,['United States of America'],"['Black-and-white', 'Monster', 'Horror']",1950,9
4052442,Sunset,1988,['United States of America'],"['Mystery', 'Action/Adventure', 'Buddy film', 'Thriller', 'Comedy', 'Crime Thriller', 'Parody', 'Western']",1980,8
28996097,One More Chance,1983,['United States of America'],['Drama'],1980,3
2503050,Bush Christmas,1983,['Australia'],['Drama'],1980,3
3258336,Heartbeat,2000,['India'],"['Musical', 'Romantic drama', 'Bollywood', 'World cinema', 'Romance Film', 'Melodrama', 'Drama']",2000,0
17241973,Ang Tanging Ina Ninyong Lahat,2008,['Philippines'],"['Filipino Movies', 'Comedy', 'World cinema', 'Romantic comedy']",2000,8
27576303,Blood Night: The Legend of Mary Hatchet,2009,['United States of America'],"['Slasher', 'Horror']",2000,9
2001250,There's No Business Like Show Business,1954,['United States of America'],"['Musical', 'Backstage Musical', 'Comedy', 'Musical comedy', 'Drama']",1950,4
1644192,Lady in the Water,2006,['United States of America'],"['Psychological thriller', 'Mystery', 'Comedy', 'Thriller', 'Supernatural', 'Fantasy']",2000,6
10301701,The Wrestlers,2000,['India'],"['Thriller', 'Drama']",2000,0
10658851,Anbulla Rajinikanth,1984,['India'],['Drama'],1980,4
24811390,I've Been Waiting for You,1998,['United States of America'],"['Slasher', 'Teen', 'Horror']",1990,8
17988463,Do Re Mi Fa So La Ti Do,2008,['South Korea'],"['Romance Film', 'Drama']",2000,8
4403025,The Wrong Guy,1997,"['Canada', 'United States of America']","['Action', 'Indie', 'Action/Adventure', 'Comedy', 'Crime Comedy', 'Black comedy', 'Comedy of Errors']",1990,7
13987282,Rainbow,1996,"['Canada', 'United Kingdom']","['Adventure', 'Fantasy']",1990,6
630393,The Beat Generation,1959,['United States of America'],"['Detective fiction', 'Crime Fiction', 'Mystery', 'Detective', 'Film noir', 'Drama']",1950,9
26724867,Curse of the Swamp Creature,1966,['United States of America'],"['Monster movie', 'B-movie', 'Horror']",1960,6
14582785,Donald's Dilemma,1947,['United States of America'],"['Animation', 'Short Film', 'Comedy', 'Family Film']",1940,7
14708426,Under the Raven's Wing,2007,['United States of America'],"['Psychological thriller', 'Horror']",2000,7
1235054,Across 110th Street,1972,['United States of America'],"['Action', 'Blaxploitation', 'Film adaptation', 'Crime Fiction', 'Gangster Film', 'Action/Adventure', 'Thriller', 'Crime Thriller', 'Drama']",1970,2
13702809,The End of the Affair,1999,"['United Kingdom', 'United States of America']","['Period piece', 'Crime Fiction', 'Romantic drama', 'Romance Film', 'War film', 'Drama']",1990,9
3203385,Elmo Saves Christmas,1996,['United States of America'],"[""Children's"", 'Family Film']",1990,6
31692693,C.I.D.,1955,[],['Drama'],1950,5
4780869,Ghilli,2004,['India'],"['Action', 'Comedy', 'Tamil cinema', 'Romance Film', 'Sports']",2000,4
27606728,Thodu Dongalu,1954,['India'],['Drama'],1950,4
15661703,Pourudu,2008,['India'],['Action'],2000,8
2375811,Jason Goes To Hell: The Final Friday,1993,['United States of America'],"['Slasher', 'Teen', 'Horror', 'Cult']",1990,3
18268263,Excessive Force,1993,['United States of America'],"['Action', 'Crime Fiction', 'Gangster Film', 'Action/Adventure', 'Thriller', 'Martial Arts Film']",1990,3
25593267,Janwar,1965,['India'],"['Musical', 'Romance Film']",1960,5
13605482,Holly,2007,['United States of America'],"['Indie', 'Drama']",2000,7
29417879,Xenoa,2007,[],['Action'],2000,7
13837314,Winky's Horse,2005,"['Netherlands', 'Belgium']","['Holiday Film', ""Children's/Family""]",2000,5
20401848,Mary and Max,2009,"['New Zealand', 'Australia']","['Animation', 'Indie', 'Comedy', 'World cinema', 'Black comedy', 'Clay animation', 'Tragicomedy', 'Drama', 'Period piece', 'Comedy-drama', 'Stop motion']",2000,9
3152882,Delirious,1991,['United States of America'],"['Parody', 'Comedy', 'Romance Film', 'Romantic comedy', 'Fantasy']",1990,1
21180308,Rainbow Kids,1991,['Japan'],"['Crime Fiction', 'Japanese Movies', 'Comedy', 'World cinema']",1990,1
8422674,Yaraana,1995,['India'],"['Romantic drama', 'Bollywood', 'World cinema', 'Romance Film', 'Drama']",1990,5
29672807,Chore Chore Mastuto Bhai,2005,[],"['Drama', 'Comedy film']",2000,5
10792004,Enkeyo Ketta Kural,1982,['India'],"['Drama', 'World cinema']",1980,2
13837148,Pipo en de p-p-Parelridder,2003,['Netherlands'],"[""Children's"", 'Family Film']",2000,3
30581608,Ma and Pa Kettle at Waikiki,1955,['United States of America'],"['Domestic Comedy', 'Crime Fiction', 'Comedy']",1950,5
11750190,King of the Congo,1952,['United States of America'],"['Action', 'Black-and-white', 'Superhero movie', 'Adventure']",1950,2
4540924,The Dead Hate the Living!,2000,['United States of America'],"['B-movie', 'Zombie Film', 'Horror']",2000,0
1105278,Birth,2004,"['Germany', 'United States of America']","['Mystery', 'Indie', 'Thriller', 'Romance Film', 'Drama']",2000,4
1128661,Tears of the Sun,2003,['United States of America'],"['Action', 'Action Thrillers', 'Action/Adventure', 'Thriller', 'Jungle Film', 'War film', 'Drama']",2000,3
5081408,The Caddy,1953,['United States of America'],"['Slapstick', 'Comedy']",1950,3
18615823,Three Can Play That Game,2007,['United States of America'],"['Romance Film', 'Romantic comedy', 'Comedy']",2000,7
4937583,The Householder,1963,['India'],"['Drama', 'Indie', 'Marriage Drama', 'Comedy', 'World cinema', 'Comedy-drama']",1960,3
10382438,Drive-Thru,2007,['United States of America'],"['Comedy', 'Teen', 'Horror', 'Slasher', 'B-movie']",2000,7
3377729,Luckytown,2000,['United States of America'],"['Crime Fiction', 'Gangster Film', 'Indie', 'Crime Drama', 'Drama']",2000,0
12995615,The Zombie Diaries,2007,['United Kingdom'],"['Creature Film', 'Action', 'Indie', 'Action/Adventure', 'Thriller', 'Horror', 'Zombie Film']",2000,7
2265669,The Roaring Twenties,1939,['United States of America'],"['Period piece', 'Black-and-white', 'Crime Fiction', 'Drama']",1930,9
28797593,Dublin Nightmare,1958,['United Kingdom'],['Thriller'],1950,8
1917925,What Ever Happened to Baby Jane?,1962,['United States of America'],"['Psychological thriller', 'Thriller', 'Horror', 'Drama']",1960,2
675790,Teen Wolf,1985,['United States of America'],"['Comedy', 'Teen', 'Cult', 'Coming of age', 'Parody', 'Horror', 'Fantasy Comedy', 'Family Film', 'Fantasy']",1980,5
22077153,Five Minutes of Heaven,2009,"['United Kingdom', 'Ireland', 'United States of America']","['Crime Fiction', 'Indie', 'Thriller', 'Political drama', 'Drama']",2000,9
4876364,True Believer,1989,['United States of America'],"['Drama', 'Crime Fiction']",1980,9
27446582,Sole Survivor,2000,['Canada'],"['Drama', 'Mystery', 'Thriller']",2000,0
17927503,Three Idiots,2009,['India'],"['Musical', 'Comedy', 'Bollywood', 'World cinema', 'Romance Film', 'Drama']",2000,9
10956431,Flight of the Red Balloon,2007,['France'],"['Art film', 'World cinema', 'Family Film', 'Drama']",2000,7
19876308,She Fought Alone,1995,['United States of America'],"['Romance Film', 'Television movie', 'Drama']",1990,5
10555927,Souten,1983,['India'],"['Musical', 'Romance Film', 'Drama']",1980,3
77643,The Talk of the Town,1942,['United States of America'],"['Black-and-white', 'Screwball comedy', 'Comedy', 'Romance Film', 'Romantic comedy']",1940,2
30232525,Jeevitha Nouka,1951,['India'],"['Action', 'Mystery', 'Drama']",1950,1
3412203,Zombie High,1987,['United States of America'],"['Zombie Film', 'Teen', 'Horror']",1980,7
2931530,Halloweentown High,2004,['United States of America'],"['Comedy', 'Teen', ""Children's"", 'Fantasy Comedy', 'Fantasy']",2000,4
4846576,American Psycho,2000,['United States of America'],"['Psychological thriller', 'Film adaptation', 'Crime Fiction', 'Comedy', 'Satire', 'Thriller', 'Black comedy', 'Crime Thriller', 'Drama', 'Period piece', 'Slasher', 'Horror']",2000,0
23631611,The Plumber,1979,['Australia'],"['Thriller', 'Horror']",1970,9
60293,Chasing Amy,1997,['United States of America'],"['LGBT', 'Indie', 'Comedy', 'Romance Film', 'Drama', 'Romantic comedy', 'Comedy-drama', 'Sex comedy']",1990,7
5564313,Civil Brand,2003,['United States of America'],"['Prison', 'Crime Fiction', 'Drama', 'Feminist Film']",2000,3
10495987,Yeh Hai Jalwa,2002,"['India', 'United Kingdom', 'Australia']","['Musical', 'Comedy', 'Bollywood', 'World cinema']",2000,2
12540084,Northwest Mounted Police,1940,"['Canada', 'United States of America']","['Action', 'Western', 'Northern', 'Adventure', 'Epic', 'Drama']",1940,0
1222552,Dunkirk,1958,['United Kingdom'],['War film'],1950,8
3685714,"Yor, the Hunter from the Future",1983,['Italy'],"['Mythological Fantasy', 'Time travel', 'Sword and sorcery films', 'Science Fiction', 'Fantasy']",1980,3
9833485,Story of Women,1988,"['China', 'France']","['World cinema', 'Crime Drama', 'Docudrama', 'Chinese Movies', 'Drama']",1980,8
18719108,Sundo,2009,['Philippines'],"['Filipino Movies', 'Thriller', 'Horror', 'World cinema', 'Drama']",2000,9
13848220,Great Decisive Battle! The Super 8 Ultra Brothers,2008,['Japan'],['Japanese Movies'],2000,8
7325516,Raja,1995,['India'],['Bollywood'],1990,5
8344046,Burn After Reading,2008,"['United Kingdom', 'France', 'United States of America']","['Crime Fiction', 'Parody', 'Comedy', 'Black comedy', 'Drama', 'Ensemble Film']",2000,8
17183671,Kings and Queen,2004,['France'],"['Family Drama', 'Comedy', 'World cinema', 'Romance Film', 'Melodrama', 'Comedy-drama', 'Drama']",2000,4
19078678,Dumkata,2007,['India'],['Comedy'],2000,7
35205034,Kappalottiya Thamizhan,1961,['India'],['Historical fiction'],1960,1
7569293,Half Ticket,1962,['India'],"['Comedy', 'World cinema']",1960,2
183741,To Each His Own,1946,['United States of America'],"['Black-and-white', 'War film', 'Drama']",1940,6
16178751,Calcutta News,2008,['India'],"['Crime Fiction', 'Thriller', 'Romance Film', 'Drama']",2000,8
24050247,International Crime,1938,['United States of America'],"['Detective fiction', 'Black-and-white', 'Crime Fiction', 'Mystery', 'Detective']",1930,8
31769768,Badai Pasti Berlalu,1977,[],['Drama'],1970,7
15007082,The Lodger,1944,['United States of America'],"['Film adaptation', 'Black-and-white', 'Mystery', 'Thriller', 'Film noir', 'Drama', 'Suspense', 'Horror']",1940,4
23553986,Christmas Who,2000,['United States of America'],"['Animated cartoon', 'Television movie', 'Short Film']",2000,0
19144521,Love,2008,['India'],['Romance Film'],2000,8
9114950,Fight Club - Members Only,2006,['India'],"['Action', 'Drama', 'Action/Adventure', 'Comedy', 'World cinema']",2000,6
9650305,Subway Stories,1997,['United States of America'],"['Drama', 'Slice of life story']",1990,7
11252321,Bhavna,1984,['India'],"['Bollywood', 'Drama']",1980,4
1665824,Night Moves,1975,['United States of America'],"['Suspense', 'Detective fiction', 'Crime Fiction', 'Mystery', 'Thriller', 'Detective', 'Crime Thriller']",1970,5
14533242,Coast to Coast,1987,['United Kingdom'],"['Drama', 'Comedy']",1980,7
19271127,The Gift,2009,['United States of America'],"['Suspense', 'Action', 'Action Thrillers', 'Chase Movie', 'Action/Adventure', 'Thriller', 'Political thriller']",2000,9
7018098,Wanda,1970,"['Spain', 'England', 'United States of America']","['Drama', 'Indie', 'Crime', 'Road movie', 'Feminist Film']",1970,0
19740040,Lady Godiva,2008,['United Kingdom'],"['Romance Film', 'Romantic comedy']",2000,8
8223379,One Touch of Venus,1948,['United States of America'],"['Musical', 'Romantic drama', 'Comedy', 'Romance Film', 'Romantic comedy', 'Drama', 'Fantasy']",1940,8
24706441,Twilight: Los Angeles,2000,['United States of America'],"['Culture & Society', 'Concert film']",2000,0
488210,One Perfect Day,2004,['Australia'],"['Drama', 'Indie', 'Romantic drama', 'Musical Drama', 'World cinema', 'Romance Film']",2000,4
92684,Anatomy of a Murder,1959,['United States of America'],"['Black-and-white', 'Mystery', 'Thriller', 'Crime Thriller', 'Drama', 'Courtroom Drama']",1950,9
10992573,Love's Abiding Joy,2006,['United States of America'],"['Film adaptation', 'Inspirational Drama', 'Action/Adventure', 'Family Drama', 'Romantic drama', 'Romance Film', 'Christian film', 'Drama', 'Period piece', 'Western']",2000,6
28820585,Counsel's Opinion,1933,['United Kingdom'],['Comedy film'],1930,3
23700292,Radio,2009,"['India', 'United States of America']","['Musical', 'Romance Film', 'Drama']",2000,9
14416614,Lonesome Ghosts,1937,['United States of America'],"['Animation', 'Short Film', 'Comedy', 'Family Film']",1930,7
5227029,The Birds II: Land's End,1994,['United States of America'],"['Horror', 'Natural horror films']",1990,4
4747302,Pokiri,2006,['India'],"['Action', 'Crime Fiction', 'Gangster Film', 'Action/Adventure', 'Thriller', 'World cinema']",2000,6
10405777,Ammai Bagundi,2006,['India'],"['Drama', 'World cinema']",2000,6
7280802,Wolfman,1979,['United States of America'],"['Horror', 'B-movie']",1970,9
33109159,Lakirein,1954,[],"['Drama', 'Family Film']",1950,4
13027958,Selling Innocence,2005,"['Canada', 'United States of America']","['Drama', 'Television movie']",2000,5
5901847,Bhuvan Shome,1969,['India'],['Drama'],1960,9
8932874,The Tesseract,2003,"['United Kingdom', 'Japan', 'Thailand']","['Action', 'Psychological thriller', 'Crime Fiction', 'Thriller', 'World cinema', 'Crime Thriller', 'Drama', 'Japanese Movies', 'Ensemble Film']",2000,3
5735396,Invasion of the Body Snatchers,1978,['United States of America'],"['Thriller', 'Remake', 'New Hollywood', 'Doomsday film', 'Science Fiction']",1970,8
4714494,Mindripper,1995,['United States of America'],['Horror'],1990,5
1118809,Crocodile Dundee II,1988,"['United States of America', 'Australia']","['Action', 'Adventure Comedy', 'Action/Adventure', 'Comedy', 'Adventure']",1980,8
13074907,Desperadas,2008,['Philippines'],"['Filipino Movies', 'Comedy', 'World cinema', 'Drama']",2000,8
20878070,Alien Siege,2005,['United States of America'],"['Television movie', 'Science Fiction', 'Horror']",2000,5
21980093,Stepfather III,1992,"['United Kingdom', 'United States of America']","['Thriller', 'Horror']",1990,2
976989,The Doom Generation,1995,"['United States of America', 'France']","['Action', 'Crime Fiction', 'LGBT', 'Indie', 'Comedy', 'Teen', 'Thriller', 'Black comedy', 'Drama', 'Gay Themed', 'Gay', 'Gay Interest', 'Road movie', 'Cult']",1990,5
12186365,God's Gun,1976,"['Israel', 'Italy']","['Western', 'Spaghetti Western']",1970,6
2925273,The Dentist,1996,['United States of America'],"['Slasher', 'Horror']",1990,6
13650628,Khaled,2002,['Canada'],['Drama'],2000,2
17607307,Outside These Walls,1939,['United States of America'],['Drama'],1930,9
99463,The French Connection,1971,['United States of America'],"['Action', 'Detective fiction', 'Crime Fiction', 'Action Thrillers', 'Mystery', 'Thriller', 'Drama', 'Chase Movie']",1970,1
3111465,Another Man's Poison,1952,['United Kingdom'],"['Suspense', 'Black-and-white', 'Crime Fiction', 'Thriller', 'Melodrama', 'Crime Thriller', 'Drama']",1950,2
5068113,Imjaeobtneun naleutbae,1932,['South Korea'],"['Silent film', 'Drama']",1930,2
13494664,We'll Meet Again,1943,['United Kingdom'],['Musical'],1940,3
3955890,Tripfall,2000,['United States of America'],"['Psychological thriller', 'Suspense', 'Thriller', 'Crime Thriller']",2000,0
751724,I Spit On Your Grave,1978,['United States of America'],"['Cult', 'Slasher', 'Horror']",1970,8
34856041,Gangavataran,1937,['India'],['Mythological Fantasy'],1930,7
5261186,Vetri Kodi Kattu,2000,['India'],['Comedy'],2000,0
27622839,The Last of the Finest,1990,['United States of America'],"['Action', 'Action Thrillers', 'Political thriller']",1990,0
748953,Brother,2000,"['United Kingdom', 'Japan', 'United States of America']","['Crime Fiction', 'Japanese Movies', 'Action/Adventure', 'Thriller', 'World cinema', 'Crime Thriller', 'Drama']",2000,0
2600572,3 Men and a Little Lady,1990,['United States of America'],"['Buddy film', 'Comedy', 'Family Film']",1990,0
5646957,Carpool,1996,['United States of America'],"['Comedy', 'Family Film']",1990,6
23295531,The Swimsuit Issue,2008,['Sweden'],"['LGBT', 'Comedy', 'World cinema', 'Sports']",2000,8
8977466,Gurudev,1993,['India'],['Romance Film'],1990,3
181229,The Great Escape,1963,['United States of America'],"['Action', 'Drama', 'History', 'War film', 'Adventure']",1960,3
6289269,Kuroneko,1968,['Japan'],"['Japanese Movies', 'Horror', 'World cinema', 'Costume Horror', 'Supernatural']",1960,8
20579732,Chetna,1970,['India'],['Action'],1970,0
5998618,Aankhen,2002,['India'],['Bollywood'],2000,2
4848263,Skinwalkers,2006,"['Germany', 'United States of America', 'Canada']","['Action', 'Thriller', 'Horror', 'Fantasy']",2000,6
31041630,The Young Warriors,1967,['United States of America'],"['War film', 'Drama']",1960,7
6780205,Lone Star,1952,['United States of America'],"['Western', 'Black-and-white']",1950,2
16737036,A Feud There Was,1938,['United States of America'],"['Musical', 'Animation', 'Short Film', 'Comedy', 'Family Film']",1930,8
20981544,My Secret Cache,1997,['Japan'],"['Crime Fiction', 'Japanese Movies', 'Action/Adventure', 'Comedy', 'World cinema']",1990,7
29994610,Trinity Is STILL My Name!,1972,['Italy'],"['Action', 'Action/Adventure', 'Western', 'Comedy', 'World cinema', 'Spaghetti Western']",1970,2
3082021,The Presidio,1988,['United States of America'],"['Action', 'Suspense', 'Crime Fiction', 'Mystery', 'Thriller', 'Crime Thriller', 'Drama']",1980,8
26344544,Adulterous Wife: Dizzy,2002,['Japan'],['Japanese Movies'],2000,2
7362626,On the Occasion of Remembering the Turning Gate,2002,['South Korea'],"['Drama', 'World cinema']",2000,2
1190590,Thirty Seconds over Tokyo,1944,['United States of America'],"['Combat Films', 'Black-and-white', 'War film', 'Drama']",1940,4
20169447,Dance Flick,2009,['United States of America'],"['Action', 'Musical', 'Parody', 'Comedy', 'Dance']",2000,9
485540,Mortal Kombat: Annihilation,1997,['United States of America'],"['Action', 'Fantasy Adventure', 'Action/Adventure', 'Thriller', 'Martial Arts Film', 'Adventure', 'Science Fiction', 'Fantasy']",1990,7
2546472,Friday the 13th Part VII: The New Blood,1988,['United States of America'],"['Slasher', 'Teen', 'Horror', 'Cult']",1980,8
20532977,Stage Hoax,1952,['United States of America'],"['Animation', 'Short Film', 'Western', 'Comedy film', 'Family Film']",1950,2
31828890,The Shortcut,2009,['United States of America'],"['Psychological thriller', 'Suspense', 'Thriller', 'Horror', 'Crime Thriller']",2000,9
561934,Bus Stop,1956,['United States of America'],"['Musical', 'Romance Film']",1950,6
6526603,Cruel Doubt,1992,['United States of America'],"['Crime Drama', 'Crime Fiction', 'Drama']",1990,2
18768287,Crooks Anonymous,1962,['United Kingdom'],"['Comedy', 'Crime Comedy']",1960,2
24079358,Daddy Cool: Join the Fun,2009,['India'],"['Comedy', 'Bollywood', 'World cinema', 'Drama']",2000,9
22914756,Aasma: The Sky Is the Limit,2009,['India'],"['Musical', 'Bollywood', 'World cinema', 'Drama']",2000,9
73440,Duck Soup,1933,['United States of America'],"['Musical', 'Political cinema', 'Black-and-white', 'Satire', 'Comedy', 'Pre-Code']",1930,3
10640970,Viduthalai,1986,['India'],[],1980,6
2914492,Room Service,2007,"['Mexico', 'United States of America']","['Romantic comedy', 'Short Film', 'Drama']",2000,7
5439220,AVPR: Aliens vs Predator - Requiem,2007,['United States of America'],"['Action', 'Monster movie', 'Action/Adventure', 'Thriller', 'Horror', 'Science Fiction']",2000,7
14166698,Surfer Dude,2008,['United States of America'],"['Sports', 'Comedy', 'Slice of life story']",2000,8
24484283,Tiger,2007,['India'],"['Action', 'Thriller']",2000,7
2205675,Merlin's Apprentice,2006,"['Canada', 'United States of America']","['Fantasy', 'Adventure', 'Sword and sorcery']",2000,6
13677861,Code Name: Heraclitus,1967,['United States of America'],"['Action', 'Spy', 'Adventure', 'Science Fiction']",1960,7
1263372,The Red Squirrel,1993,['Spain'],"['Music', 'Comedy', 'Romance Film', 'Drama']",1990,3
7406534,Sad Movie,2005,['South Korea'],"['Romantic comedy', 'Comedy', 'Ensemble Film']",2000,5
9765304,Fantômas contre Scotland Yard,1967,['France'],"['Crime Fiction', 'Parody', 'Comedy Thriller', 'Thriller', 'Comedy', 'Master Criminal Films', 'Adventure']",1960,7
4936087,Saint Ralph,2004,['Canada'],"['Period piece', 'Drama', 'Indie', 'Coming of age', 'Comedy', 'Comedy-drama', 'Sports']",2000,4
3684509,L'Empire des loups,2005,['France'],"['Action/Adventure', 'Thriller', 'World cinema', 'Crime Thriller']",2000,5
21747675,Dragonquest,2009,['United States of America'],"['Action', 'Fantasy Adventure', 'Indie', 'Adventure', 'Science Fiction', 'Fantasy']",2000,9
1444040,The Mambo Kings,1992,"['United States of America', 'France']","['Musical', 'Period piece', 'Film adaptation', 'Musical Drama', 'Drama']",1990,2
8703251,Confidential Agent,1945,['United States of America'],"['Spy', 'Action', 'Black-and-white', 'Political thriller']",1940,5
25250585,Ang Tanging Pamilya: A Marry Go Round,2009,['Philippines'],"['Filipino Movies', 'Comedy']",2000,9
3613070,The Man Who Would Be King,1975,"['United Kingdom', 'United States of America']","['Action', 'Period piece', 'Film adaptation', 'Adventure']",1970,5
6250055,Yo Yo,1965,['France'],"['Comedy', 'Black-and-white']",1960,5
321496,Pirates of the Caribbean: The Curse of the Black Pearl,2003,['United States of America'],"['Adventure Comedy', 'Fantasy Adventure', 'Action', 'Action/Adventure', 'Comedy', 'Swashbuckler films', 'Adventure', 'Fantasy']",2000,3
26153222,Bed & Breakfast,1992,['United States of America'],['Romantic comedy'],1990,2
23576946,The Collector,2009,['United States of America'],"['Suspense', 'Crime Fiction', 'Slasher', 'Thriller', 'Horror']",2000,9
18849338,Andhaman Kaidhi,1952,['India'],['Drama'],1950,2
5437598,Air Force,1943,['United States of America'],"['Action', 'Combat Films', 'Black-and-white', 'Action/Adventure', 'War film', 'Drama']",1940,3
1768129,Fear and Trembling,2003,"['France', 'Japan']","['Japanese Movies', 'Comedy', 'World cinema', 'Drama']",2000,3
10853164,Bhookailas,1958,['India'],"['Musical', 'Drama']",1950,8
7810848,A Chef in Love,1996,['Georgia'],"['Comedy', 'Romance Film', 'Romantic comedy', 'Drama']",1990,6
8181039,Duet,1997,['India'],['Musical'],1990,7
25499986,Ghost Game,2005,['United States of America'],['Comedy horror'],2000,5
20891648,A Life of Her Own,1950,[],"['Black-and-white', 'Romance Film', 'Melodrama', 'Drama']",1950,0
16340604,Through the Eyes of a Killer,1992,['United States of America'],"['Psychological thriller', 'Thriller']",1990,2
3014342,Red Corner,1997,['United States of America'],"['Courtroom Drama', 'Crime Fiction', 'Thriller', 'Crime Thriller', 'Political drama', 'Drama', 'Political thriller']",1990,7
14143673,The Valley of Vanishing Men,1942,['United States of America'],"['Adventure', 'Black-and-white']",1940,2
21212206,Charlie & Me,2008,['United States of America'],"['Coming of age', 'Family Drama', 'Drama', 'Family Film']",2000,8
10198460,Let's Talk,2002,['India'],"['Musical', 'Drama', 'Indie', 'Marriage Drama', 'World cinema', 'Experimental film']",2000,2
16005645,The Dark Backward,1991,['United States of America'],"['Indie', 'Parody', 'Satire', 'Comedy', 'Black comedy']",1990,1
10245832,Butch and Sundance: The Early Days,1979,['United States of America'],"['Crime Fiction', 'Comedy Western', 'Action/Adventure', 'Western', 'Buddy film']",1970,9
16483133,D.O.A.: A Rite of Passage,1980,['United States of America'],['Documentary'],1980,0
16527949,Rock Monster,2008,['United States of America'],"['Adventure', 'Television movie', 'Science Fiction', 'Fantasy']",2000,8
2509613,The Lost World,1925,['United States of America'],"['Thriller', 'Horror', 'Adventure', 'Silent film', 'Science Fiction', 'Fantasy']",1920,5
854942,Freeway,1996,['United States of America'],"['Drama', 'Crime Fiction', 'Indie', 'Comedy', 'Thriller', 'Black comedy', 'Crime Thriller']",1990,6
1162528,Closer,2004,"['United Kingdom', 'United States of America']","['Film adaptation', 'Romantic drama', 'Romance Film', 'Drama']",2000,4
23687657,Les Miracles n'ont lieu qu'une fois,1951,"['France', 'Italy']",['Comedy-drama'],1950,1
19074682,The Firefly,1937,['United States of America'],"['Action', 'Musical', 'Spy', 'Black-and-white', 'Musical Drama', 'Short Film', 'Romance Film']",1930,7
5055043,Daffy Duck's Fantastic Island,1983,['United States of America'],"['Family Film', 'Animation']",1980,3
15167672,Sapne Sajan Ke,1992,['India'],['Romance Film'],1990,2
1628268,Thunderbolt,1995,['Hong Kong'],"['Action', 'Auto racing', 'Action/Adventure', 'World cinema', 'Chinese Movies', 'Martial Arts Film']",1990,5
32555044,A Message to Garcia,1936,['United States of America'],['Drama'],1930,6
1688037,The Street Fighter,1974,['Japan'],"['Action', 'Japanese Movies', 'Action/Adventure', 'World cinema', 'Martial Arts Film']",1970,4
19141239,Premer Kahini,2008,['India'],['Romance Film'],2000,8
6584608,Lady in White,1988,['United States of America'],"['Psychological thriller', 'Mystery', 'Thriller', 'Childhood Drama', 'Teen', 'Crime Thriller', 'Horror', 'Supernatural']",1980,8
4185840,Stewardess School,1986,['United States of America'],"['Action', 'Parody', 'Comedy']",1980,6
25517416,Chloe,2009,"['France', 'United States of America', 'Canada']","['Thriller', 'Drama']",2000,9
32137225,Bhai Bhauja,1967,['India'],['Drama'],1960,7
362719,Superman,1978,"['United Kingdom', 'United States of America']","['Action', 'Action/Adventure', 'Adventure', 'Superhero movie', 'Science Fiction', 'Family Film']",1970,8
1627058,How to Steal a Million,1966,['United States of America'],"['Heist', 'Crime Fiction', 'Caper story', 'Comedy', 'Crime Comedy', 'Romantic comedy', 'Romance Film']",1960,6
11117337,Of Fox and Hounds,1940,['United States of America'],"['Animation', 'Short Film', 'Comedy', 'Family Film']",1940,0
33248178,Dakshayagnam,1938,['India'],['Drama'],1930,8
36035416,Decoy,1995,"['Canada', 'United States of America']",['Action'],1990,5
528069,The Corruptor,1999,['United States of America'],"['Action', 'Drama', 'Crime Fiction', 'Mystery', 'Thriller']",1990,9
18954071,Lady Godiva of Coventry,1955,['United States of America'],['Drama'],1950,5
5512611,Yakeen,1969,['India'],"['Musical', 'Bollywood', 'World cinema', 'Drama']",1960,9
54175,Saturday Night Fever,1977,['United States of America'],"['Musical', 'Coming of age', 'Musical Drama', 'Dance', 'Romance Film', 'Drama']",1970,7
7987599,Hello Pop!,1933,['United States of America'],"['Short Film', 'Comedy film']",1930,3
11206971,"To Sir, with Love",2006,['South Korea'],"['Slasher', 'Thriller', 'Horror', 'World cinema', 'Crime Thriller', 'Supernatural']",2000,6
19802671,The World is Big and Salvation Lurks Around the Corner,2008,"['Bulgaria', 'Slovenia', 'Germany', 'Hungary']","['Drama', 'World cinema']",2000,8
2217587,800 Bullets,2002,['Spain'],"['Action', 'LGBT', 'Action/Adventure', 'Western', 'Comedy', 'World cinema', 'Spaghetti Western']",2000,2
31155644,Karutha Rathrikal,1968,['India'],['Science Fiction'],1960,8
14624892,The Purchase Price,1932,['United States of America'],"['Black-and-white', 'Romantic drama', 'Comedy-drama', 'Pre-Code', 'Drama']",1930,2
906173,Dentist on the Job,1961,['United Kingdom'],['Comedy'],1960,1
7922200,The Outfit,1973,['United States of America'],"['Crime Fiction', 'Mystery', 'Thriller']",1970,3
3737862,The Next Best Thing,2000,['United States of America'],"['LGBT', 'Comedy', 'Romance Film', 'Melodrama', 'Comedy-drama', 'Drama']",2000,0
19940455,Dangerous Curves,1929,['United States of America'],['Black-and-white'],1920,9
633692,Silver Streak,1976,['United States of America'],"['Action', 'Crime Fiction', 'Mystery', 'Action/Adventure', 'Comedy', 'Thriller']",1970,6
27413062,Star Maps,1997,['United States of America'],"['Coming of age', 'Family Drama', 'Drama']",1990,7
14693181,Of Human Bondage,1964,['United Kingdom'],"['Black-and-white', 'Drama']",1960,4
11105092,Vanina Vanini,1961,"['France', 'Italy']","['Period piece', 'Romantic drama', 'Romance Film', 'Drama']",1960,1
16627853,Cadillac Records,2008,['United States of America'],"['Musical', 'Period piece', 'History', 'Musical Drama', 'Biographical film', 'Romance Film', 'Drama']",2000,8
28826687,"Minotaur, the Wild Beast of Crete",1960,['Italy'],['Adventure'],1960,0
1960507,Small Time Crooks,2000,['United States of America'],"['Heist', 'Crime Fiction', 'Indie', 'Comedy', 'Crime Comedy', 'Comedy of manners']",2000,0
7207496,The Substitute Wife,1925,['United States of America'],"['Black-and-white', 'Indie', 'Action/Adventure', 'Romantic drama', 'Romance Film', 'Drama', 'Period piece', 'Western', 'Silent film', 'Television movie']",1920,5
33270,When Harry Met Sally...,1989,['United States of America'],"['Comedy', 'Romance Film', 'Romantic comedy', 'Drama']",1980,9
2945187,In Dreams,1999,['United States of America'],"['Suspense', 'Psychological thriller', 'Thriller', 'Horror', 'Crime Thriller', 'Supernatural', 'Drama']",1990,9
24079822,Back to the Secret Garden,2001,"['United Kingdom', 'Germany', 'United States of America']","[""Children's Fantasy"", 'Coming of age', 'Family-Oriented Adventure', 'Adventure', 'Family Film', 'Fantasy']",2000,1
7323790,Take Me Up to the Ball Game,1980,['Canada'],"['Animation', 'Science Fiction', 'Fantasy']",1980,0
9285648,The Prisoner of Zenda,1937,"['United States of America', 'Australia']","['Black-and-white', 'Animation', 'Swashbuckler films', 'Adventure']",1930,7
15433209,A Distant Trumpet,1964,['United States of America'],"['Cavalry Film', 'Western', 'Drama']",1960,4
10590520,Twins Mission,2007,['Hong Kong'],"['Action', 'Action/Adventure', 'World cinema', 'Chinese Movies', 'Martial Arts Film', 'Science Fiction']",2000,7
32076526,Jaag Utha Insan,1984,[],"['Drama', 'Family Film']",1980,4
11448183,Bindiya Chamkegi,1984,['India'],"['Comedy', 'Family Film']",1980,4
2462130,Back to the Beach,1987,['United States of America'],"['Musical', 'Parody', 'Comedy', 'Musical comedy', 'Beach Film']",1980,7
26735228,Kanichukulangarayil CBI,2008,['India'],['Drama'],2000,8
20828775,Aloo Chaat,2009,['India'],"['Musical', 'Comedy', 'Bollywood', 'World cinema']",2000,9
6846215,Inkheart,2008,"['United Kingdom', 'Germany', 'United States of America']","['Fantasy Adventure', 'Film adaptation', ""Children's/Family"", 'Adventure', 'Drama', ""Children's Fantasy"", 'Science Fiction', 'Family Film', 'Fantasy']",2000,8
12760089,"Oh, God! Book II",1980,['United States of America'],"['Heavenly Comedy', 'Comedy', 'Religious Film', 'Fantasy Comedy', 'Fantasy']",1980,0
13614787,Guide de la Petite Vengeance,2006,['Canada'],"['Drama', 'Comedy', 'Thriller']",2000,6
1614096,Hating Alison Ashley,2005,['Australia'],"['Comedy', 'Family Film']",2000,5
7580904,Kadhal Desam,1996,['India'],"['Action', 'Drama', 'Comedy', 'Romance Film']",1990,6
2046735,Fatal Instinct,1993,['United States of America'],"['Parody', 'Comedy']",1990,3
30600310,Strike Commando,1987,['Italy'],['Action'],1980,7
15248353,My Brilliant Career,1979,"['New Zealand', 'Australia']","['Romantic drama', 'World cinema', 'Romance Film', 'Drama', 'Feminist Film', 'Period piece', 'Coming of age', 'Biopic [feature]']",1970,9
25788511,Perdóname Todo,1995,['Mexico'],['Drama'],1990,5
3982642,The Undercover Man,1949,['United States of America'],"['Black-and-white', 'Crime Fiction', 'Thriller', 'Film noir', 'Drama']",1940,9
29280904,Oru Thalai Raagam,1980,['India'],"['Romance Film', 'Drama']",1980,0
22982069,An Inconvenient Penguin,2008,['United States of America'],"['Short Film', 'Comedy']",2000,8
18343159,Konchem Koththaga,2008,['India'],"['Romance Film', 'Thriller']",2000,8
8809291,Sometimes They Come Back,1991,['United States of America'],"['Film adaptation', 'Horror', 'Television movie', 'Drama']",1990,1
17922606,Aram + Aram = Kinnaram,1985,['India'],['Comedy'],1980,5
22628938,The Rescue,1988,['United States of America'],"['Action', 'Drama', 'Adventure']",1980,8
24292307,H.O.T.S.,1979,['United States of America'],"['Gross out', 'Gross-out film', 'Comedy', 'Sex comedy']",1970,9
20912915,First Day High,2006,['Philippines'],"['Filipino Movies', 'Comedy', 'World cinema']",2000,6
2255603,The Pirate Movie,1982,['Australia'],"['Musical', 'Romantic drama', 'Action/Adventure', 'Comedy', 'World cinema', 'Romance Film', 'Adventure', 'Drama', 'Family Film', 'Fantasy']",1980,2
21250249,War Paint,1953,['United States of America'],"['Action', 'Western', 'War film', 'Adventure']",1950,3
2434659,Very Important Person,1961,['United Kingdom'],"['Escape Film', 'War film', 'Comedy']",1960,1
28838468,The Pagan Queen,2009,"['Czech Republic', 'United States of America']","['Historical drama', 'Adventure', 'Romance Film', 'Science Fiction', 'Fantasy']",2000,9
10219034,Mixed Company,1974,['United States of America'],"['Drama', 'Indie', 'Comedy', 'Sports']",1970,4
24029843,Sophie's Revenge,2009,"['China', 'South Korea']","['Romantic drama', 'Comedy', 'World cinema', 'Romance Film', 'Romantic comedy', 'Chinese Movies', 'Drama']",2000,9
17736304,The Longshots,2008,['United States of America'],"['Coming of age', 'Comedy-drama', 'Sports', 'Drama']",2000,8
17665499,The Fall,2006,"['United Kingdom', 'India', 'United States of America']","['Period piece', 'Adventure', 'Drama', 'Fantasy']",2000,6
406917,The Tall Guy,1990,['United Kingdom'],"['Slapstick', 'Comedy', 'Satire', 'Romance Film', 'Romantic comedy', 'Comedy of Errors']",1990,0
23524252,Dante's Inferno,1924,['United States of America'],"['Silent film', 'Black-and-white', 'Horror']",1920,4
29489928,Mickey's Touchdown,1933,['United States of America'],['Short Film'],1930,3
918886,All the Queen's Men,2001,"['Austria', 'Australia', 'Germany', 'Hungary', 'United States of America']","['Period piece', 'Action', 'Action/Adventure', 'Comedy', 'Comedy-drama', 'War film', 'Drama']",2000,1
28300006,Jahan Jaaeyega Hamen Paaeyega,2007,['India'],"['Action', 'Drama', 'Crime Fiction', 'Thriller']",2000,7
24289263,Pyaar Jhukta Nahin,1985,['India'],['Bollywood'],1980,5
844331,Seduction: The Cruel Woman,1985,['Germany'],"['LGBT', 'Softcore Porn', 'World cinema', 'Adult', 'Drama']",1980,5
7764212,Freedom Writers,2007,"['Germany', 'United States of America']","['Crime Fiction', 'Biography', 'Teen', 'Drama']",2000,7
25432337,Paleri Manikyam: Oru Pathirakolapathakathinte Katha,2009,['India'],"['Crime Fiction', 'Mystery', 'History', 'Drama']",2000,9
34710145,Les Petites vacances,2006,['France'],"['Drama', 'Comedy film']",2000,6
145640,The Gospel According to St. Matthew,1964,"['France', 'Italy']","['Art film', 'Historical drama', 'Biographical film', 'World cinema', 'Christian film', 'Costume drama', 'Drama', 'Hagiography']",1960,4
24282243,Yaya and Angelina: The Spoiled Brat Movie,2009,['Philippines'],"['Filipino Movies', 'Comedy', 'World cinema', ""Children's/Family"", 'Family Film']",2000,9
17275536,Two Men in Town,1973,"['France', 'Italy']","['Crime Fiction', 'Thriller', 'World cinema', 'Crime Drama', 'Crime Thriller', 'Drama']",1970,3
27338431,The Third Jihad,2008,['United States of America'],"['Political cinema', 'Short Film', 'Documentary', 'War film', 'Culture & Society']",2000,8
5881470,The Secret Lives of Dentists,2003,['United States of America'],"['Film adaptation', 'Drama', 'Indie', 'Marriage Drama', 'Comedy', 'Comedy-drama', 'Tragicomedy']",2000,3
18673005,Hollywood & Wine,2009,['United States of America'],"['Gangster Film', 'Comedy']",2000,9
29024029,Ente Mohangal Poovaninju,1982,['India'],"['Romance Film', 'Drama']",1980,2
1030073,Meteor,1979,['United States of America'],"['Action/Adventure', 'Science Fiction', 'Thriller', 'Doomsday film', 'Disaster']",1970,9
13822832,Medal for the General,1944,['United Kingdom'],"['Film adaptation', 'Black-and-white', 'War film', 'Drama']",1940,4
2236141,Son of Paleface,1952,['United States of America'],"['Action', 'Comedy Western', 'Action/Adventure', 'Western', 'Satire', 'Comedy', 'Comedy of Errors']",1950,2
1611590,Call Northside 777,1948,['United States of America'],"['Black-and-white', 'Crime Fiction', 'Thriller', 'Crime Drama', 'Film noir', 'Drama']",1940,8
14671962,When Willie Comes Marching Home,1950,['United States of America'],"['Black-and-white', 'Comedy', 'War film', 'Adventure']",1950,0
14684012,Space Ship Sappy,1957,['United States of America'],"['Black-and-white', 'Short Film', 'Comedy', 'Adventure', 'Science Fiction']",1950,7
13296475,Albert Fish,2007,['United States of America'],"['Crime Fiction', 'Slasher', 'Horror', 'Documentary', 'Culture & Society']",2000,7
22503227,Pendragon: Sword of His Father,2008,['United States of America'],"['Christian film', 'Action/Adventure', 'Fantasy']",2000,8
1788761,Mickey's Once Upon a Christmas,1999,['United States of America'],"['Animation', ""Children's/Family"", 'Holiday Film', 'Christmas movie']",1990,9
5434432,Edge of Seventeen,1999,['United States of America'],"['LGBT', 'Comedy', 'Teen', 'Drama', 'Gay Themed', 'Gay', 'Coming of age', 'Gay Interest', 'Comedy-drama']",1990,9
8522084,Atlantic,1930,['United Kingdom'],"['Black-and-white', 'Disaster', 'Drama']",1930,0
2243626,"Bell, Book and Candle",1958,['United States of America'],"['Comedy', 'Romance Film', 'Romantic comedy', 'Fantasy Comedy', 'Fantasy']",1950,8
17062866,Times and Winds,2006,['Turkey'],['Drama'],2000,6
12240169,Female Prisoner #701: Scorpion,1972,['Japan'],"['Action', 'Crime Fiction', 'Action/Adventure', 'Thriller', 'World cinema', 'Drama', 'Women in prison films', 'Japanese Movies', 'Erotica']",1970,2
25153225,Claustrophobia,2008,"['China', 'Hong Kong']","['Romantic drama', 'World cinema', 'Romance Film', 'Chinese Movies', 'Drama']",2000,8
10416401,Kami,1982,['Malaysia'],['Drama'],1980,2
19525319,Absolute Zero,2005,['Canada'],"['Action/Adventure', 'Thriller', 'Television movie', 'Disaster', 'Science Fiction', 'Drama']",2000,5
4860532,Duke and the Great Pie War,2004,[],"['Musical', 'Animation', 'Short Film', 'Family Film']",2000,4
3670013,Harlow,1965,['United States of America'],"['Black-and-white', 'Biography', 'Biographical film', 'Drama']",1960,5
30955314,The Happy Life,2007,['South Korea'],['Comedy'],2000,7
28913353,The Fur Collar,1962,['United Kingdom'],['Thriller'],1960,2
2951887,Un buit qui rend fou,1995,"['France', 'Switzerland', 'Belgium']","['Crime Fiction', 'Mystery', 'Thriller', 'Drama']",1990,5
4608195,Get up!,2003,['Japan'],"['Action', 'Musical', 'Drama', 'Japanese Movies', 'Comedy']",2000,3
2121431,The House of Yes,1997,['United States of America'],"['Film adaptation', 'Drama', 'Indie', 'Comedy', 'Black comedy', 'Cult', 'Sex comedy']",1990,7
22915236,Wings Of The Navy,1939,['United States of America'],"['Romantic drama', 'Romance Film', 'War film', 'Drama']",1930,9
11585379,Storm catcher,1999,['United States of America'],"['Action', 'Crime Fiction', 'Action Thrillers', 'Indie', 'Action/Adventure', 'Thriller', 'Crime Thriller', 'Television movie']",1990,9
8920425,Oh Darling! Yeh Hai India,1995,['India'],"['Musical', 'Parody']",1990,5
10404856,Le Professionnel,1981,['France'],"['Action', 'Action Thrillers', 'Action/Adventure', 'Thriller', 'World cinema', 'Political thriller']",1980,1
8772083,Tiger Bay,1959,['United Kingdom'],"['Suspense', 'Black-and-white', 'Crime Fiction', 'Thriller', 'Drama']",1950,9
6887098,Fanfan la Tulipe,1952,"['France', 'Italy']","['Action', 'Art film', 'Action/Adventure', 'Comedy', 'World cinema', 'Swashbuckler films', 'Adventure', 'Drama']",1950,2
10139367,Sabrina: Friends Forever,2002,['United States of America'],"['Animated cartoon', 'Animation', 'Adventure', 'Family Film', 'Fantasy']",2000,2
18757595,Nabi,2001,['South Korea'],['Science Fiction'],2000,1
8081101,The Call of the River,2004,['Philippines'],"['Filipino Movies', 'Romantic drama', 'World cinema', 'Romance Film', 'War film', 'Drama']",2000,4
4841276,G@me,2003,['Japan'],"['Japanese Movies', 'Thriller']",2000,3
19162701,Tokyo Gore Police,2008,"['Japan', 'United States of America']","['Action', 'Action Thrillers', 'Action/Adventure', 'Thriller', 'World cinema', 'Sci-Fi Horror', 'Japanese Movies', 'Horror', 'Science Fiction']",2000,8
171047,Restoration,1995,"['United Kingdom', 'United States of America']","['Period piece', 'Romantic drama', 'Biographical film', 'Romance Film', 'Historical fiction', 'Costume drama', 'Drama']",1990,5
12095072,House of Cards,1993,['United States of America'],['Drama'],1990,3
25501212,Changes,1991,['United States of America'],"['Romantic drama', 'Romance Film', 'Television movie', 'Drama']",1990,1
24159123,Shadow of Doubt,1998,['United States of America'],"['Suspense', 'Mystery', 'Indie', 'Thriller', 'Crime Thriller']",1990,8
3229481,Balzac and the Little Chinese Seamstress,2002,"['China', 'France']","['Romantic drama', 'World cinema', 'Romance Film', 'Chinese Movies', 'Drama', 'Period piece', 'Coming of age', 'Comedy-drama']",2000,2
13347259,The Tic Code,2000,['United States of America'],"['Musical', 'Drama', 'Family Drama', 'Indie', 'Romantic drama', 'Romance Film']",2000,0
4647640,Brave New World,1998,['United States of America'],"['Science Fiction', 'Dystopia']",1990,8
12842485,Woman of Breakwater,2004,['Philippines'],"['Filipino Movies', 'Drama', 'World cinema']",2000,4
22559651,Splendor in the Grass,1981,['United States of America'],['Drama'],1980,1
2390108,The Happiest Days of Your Life,1950,['United Kingdom'],['Comedy'],1950,0
4954419,Angela,1995,['United States of America'],"['Indie', 'Drama']",1990,5
33932729,A Night to Dismember,1983,['United States of America'],['Horror'],1980,3
3822455,Love in the City,2007,['Hong Kong'],['Chinese Movies'],2000,7
25304227,Flowing Gold,1940,['United States of America'],"['Adventure', 'Drama']",1940,0
8776310,Crazy Love,1987,['Belgium'],"['Romantic drama', 'Comedy', 'World cinema', 'Romance Film', 'Romantic comedy', 'Drama']",1980,7
12287154,Calendar Girl Murders,1984,['United States of America'],"['Suspense', 'Crime Fiction', 'Mystery', 'Thriller', 'Television movie', 'Crime Thriller']",1980,4
18089458,The Knot,2006,['China'],"['Romance Film', 'Chinese Movies', 'War film', 'Drama']",2000,6
973077,An American Tail,1986,['United States of America'],"['Musical', 'Animation', 'Animated Musical', 'Comedy', 'Romance Film', 'Family-Oriented Adventure', ""Children's/Family"", 'Adventure', 'Drama', ""Children's Fantasy"", 'Family Film']",1980,6
5242839,Mera Saaya,1966,['India'],['World cinema'],1960,6
14291259,Fog Over Frisco,1934,['United States of America'],"['Black-and-white', 'Crime Fiction', 'Mystery', 'Melodrama', 'Crime Thriller', 'Drama']",1930,4
22578090,The Swinging Cheerleaders,1974,['United States of America'],"['Sexploitation', 'Comedy', 'Comedy-drama', 'Cult', 'Sex comedy']",1970,4
1740284,Gigi,1958,['United States of America'],"['Musical', 'Comedy', 'Romance Film', 'Romantic comedy']",1950,8
4387674,Drugstore girl,2003,['Japan'],"['Comedy', 'Japanese Movies']",2000,3
32161426,Avenging Waters,1936,[],['Western'],1930,6
4568737,Guddi,1971,['India'],"['Musical', 'Romantic drama', 'Comedy', 'Bollywood', 'World cinema', 'Romance Film', 'Drama']",1970,1
15828749,Sick Girl,2007,['United States of America'],"['Indie', 'Slasher', 'Teen', 'Horror', 'Drama']",2000,7
3894001,Little Red Riding Rabbit,1944,['United States of America'],"['Fairy tale', 'Parody', 'Comedy']",1940,4
24261120,Yeh Mera India,2009,['India'],"['Drama', 'World cinema']",2000,9
10771697,Prem Kahani,1975,['India'],"['Drama', 'World cinema']",1970,5
8575331,Mortal Thoughts,1991,['United States of America'],"['Psychological thriller', 'Suspense', 'Mystery', 'Marriage Drama', 'Thriller']",1990,1
974837,Old School,2003,['United States of America'],"['Slapstick', 'Comedy', 'Cult']",2000,3
4954437,Shallow Ground,2005,['United States of America'],"['Detective fiction', 'Slasher', 'Detective', 'Horror', 'Supernatural']",2000,5
3607032,Hammett,1982,['United States of America'],"['Film adaptation', 'Neo-noir', 'Crime Fiction', 'Mystery', 'Biography', 'Biographical film', 'Thriller', 'Crime Thriller', 'Drama', 'Period piece', 'Biopic [feature]']",1980,2
7074043,Misery,1990,['United States of America'],"['Psychological thriller', 'Suspense', 'Film adaptation', 'Thriller', 'Black comedy']",1990,0
4389169,Hornblower: The Examination for Lieutenant,1998,['United Kingdom'],['Costume drama'],1990,8
17182332,National Lampoon's Van Wilder: The Rise of Taj,2002,['United States of America'],"['Gross out', 'Gross-out film', 'Comedy', 'Teen', 'Sex comedy']",2000,2
2218967,Raspberry & Lavender,2004,['United States of America'],"['Music', 'Musical', 'Mystery', 'Romance Film', 'Drama', 'Fantasy']",2000,4
5989608,Wild Things 2,2004,['United States of America'],"['Erotic thriller', 'Action Thrillers', 'Thriller']",2000,4
3386834,Shalimar,1978,['India'],"['Action', 'Crime Fiction', 'Thriller', 'Adventure', 'Drama', 'Family Film']",1970,8
280976,The Skin Game,1931,['United Kingdom'],"['Suspense', 'Black-and-white', 'Drama']",1930,1
7086738,Rogue,2007,"['New Zealand', 'Australia']","['Psychological thriller', 'Thriller', 'Horror', 'World cinema', 'Natural horror films']",2000,7
27381669,Kula Gothralu,1962,['India'],['Drama'],1960,2
1167483,Stigmata,1999,['United States of America'],"['Psychological thriller', 'Thriller', 'Horror', 'Supernatural', 'Cult']",1990,9
6772810,Macho Dancer,1988,['Philippines'],"['Filipino Movies', 'Gay Themed', 'LGBT', 'Gay', 'Gay Interest', 'World cinema', 'Drama']",1980,8
1310614,Get Ready to be Boyzvoiced,2000,['Norway'],"['Music', 'Comedy']",2000,0
1710652,G.I. Blues,1960,['United States of America'],"['Musical', 'Romance Film', 'Romantic comedy']",1960,0
14731245,Virtue,1932,['United States of America'],"['Romance Film', 'Black-and-white', 'Drama']",1930,2
21248487,Donsol,2006,['Philippines'],"['Filipino Movies', 'Drama']",2000,6
5479712,Tarzan and the Mermaids,1948,['United States of America'],"['Action', 'Drama', 'Jungle Film', 'Adventure']",1940,8
179825,Top Gun,1986,['United States of America'],"['Action', 'Airplanes and airports', 'Romantic drama', 'Action/Adventure', 'Romance Film', 'War film', 'Drama']",1980,6
142780,The Circus,1928,['United States of America'],"['Black-and-white', 'Comedy', 'Romance Film', 'Slapstick', 'Adventure', 'Drama', 'Silent film', 'Romantic comedy', 'Family Film']",1920,8
23418073,Tess of the d'Urbervilles,1924,['United States of America'],"['Silent film', 'Black-and-white', 'Drama']",1920,4
18012070,Stalin,1992,"['Hungary', 'United States of America']","['Drama', 'Biographical film']",1990,2
3380491,"Jo Jo Dancer, Your Life Is Calling",1986,['United States of America'],"['Comedy-drama', 'Drama']",1980,6
18017583,Love Before Breakfast,1936,['United States of America'],"['Black-and-white', 'Comedy', 'Romance Film', 'Romantic comedy']",1930,6
1452319,Coup de Torchon,1981,['France'],"['Crime Fiction', 'Satire', 'Comedy', 'Crime Comedy', 'World cinema', 'Black comedy', 'Drama']",1980,1
7086744,Hwangsanbul,2003,['South Korea'],"['Comedy', 'World cinema']",2000,3
7284999,Aapathbandhavudu,1992,['India'],"['Musical', 'Drama', 'Family Film']",1990,2
28198625,The Maker,1997,['United States of America'],"['Drama', 'Crime Fiction', 'Indie', 'Teen', 'Crime Drama', 'Juvenile Delinquency Film']",1990,7
3715696,Spencer's Mountain,1963,['United States of America'],"['Family Drama', 'Western', 'Comedy', 'Comedy-drama', 'Americana', 'Drama', 'Family Film']",1960,3
30199617,Left in Darkness,2006,['United States of America'],"['Horror', 'B-movie']",2000,6
5891241,Brown's Requiem,1998,['United States of America'],"['Film adaptation', 'Detective fiction', 'Crime Fiction', 'Gangster Film', 'Mystery', 'Thriller', 'Crime Thriller', 'Drama', 'Detective']",1990,8
202133,The Rules of the Game,1939,['France'],"['Black-and-white', 'Romantic drama', 'Comedy', 'World cinema', 'Romance Film', 'Drama']",1930,9
3927116,G Men,1935,['United States of America'],"['Black-and-white', 'Crime Fiction', 'Drama']",1930,5
22076195,"Léon Morin, Priest",1961,"['France', 'Italy']","['Drama', 'World cinema']",1960,1
24526951,Angshumaner Chhobi,2009,[],['Drama'],2000,9
3781605,The Bitter Tea of General Yen,1933,['United States of America'],"['Black-and-white', 'Romantic drama', 'Romance Film', 'War film', 'Pre-Code', 'Drama']",1930,3
32852772,Roarin' Lead,1936,[],"['Western', 'Action/Adventure', 'Adventure']",1930,6
28471842,The Ghosts of Berkeley Square,1947,['United Kingdom'],"['Comedy film', 'Fantasy']",1940,7
18419529,The Inheritance,2007,['United Kingdom'],['Drama'],2000,7
28820727,Sanning eller konsekvens,1997,"['Finland', 'Sweden']",['Family Drama'],1990,7
2969042,The Land Before Time V: The Mysterious Island,1997,['United States of America'],"['Animation', 'Family-Oriented Adventure', ""Children's/Family"", 'Adventure', 'Family Film']",1990,7
6515400,The Man with a Cloak,1951,['United States of America'],"['Black-and-white', 'Mystery', 'Thriller', 'Drama']",1950,1
1250126,Bugs Bunny Gets the Boid,1942,['United States of America'],[],1940,2
10822225,Golden Swallow,1968,['Hong Kong'],"['Action', 'Wuxia', 'Romance Film', 'Chinese Movies', 'Martial Arts Film', 'Adventure', 'Drama']",1960,8
2740181,I'll Remember April,1999,['United States of America'],"['Drama', 'Indie', ""Children's""]",1990,9
23837198,Golden Horseshoes,1989,['Tunisia'],['Drama'],1980,9
4051128,I Was Born But...,1932,['Japan'],"['Music', 'Black-and-white', 'Art film', 'Indie', 'Comedy', 'Avant-garde', 'World cinema', 'Drama', 'Culture & Society', 'Japanese Movies', 'Experimental film', 'Silent film']",1930,2
4954684,Have No Fear: The Life of Pope John Paul II,2005,"['Italy', 'United States of America']","['Biography', 'Biographical film', 'Biopic [feature]', 'Television movie', 'Hagiography', 'Drama']",2000,5
5221717,'Salem's Lot,2004,['United States of America'],"['Film adaptation', 'Mystery', 'Thriller', 'Horror', 'Television movie', 'Drama']",2000,4
20001994,El Dorado,1921,['France'],['Silent film'],1920,1
12451919,Scent of Love,2003,['South Korea'],"['Drama', 'Tragedy']",2000,3
16089447,Jocks,1987,['United States of America'],"['Sexploitation', 'Comedy', 'Teen', 'Sports']",1980,7
7682768,Efectos secundarios,2006,['Mexico'],"['Romantic drama', 'Satire', 'Comedy', 'World cinema', 'Romance Film', 'Romantic comedy', 'Drama']",2000,6
14387171,Phone Call from a Stranger,1952,['United States of America'],"['Black-and-white', 'Drama']",1950,2
3284613,Comic Book Confidential,1988,"['Canada', 'United States of America']","['Language & Literature', 'History', 'Biography', 'Documentary']",1980,8
8983787,The Perfect Game,2009,['United States of America'],"['Sports', 'Inspirational Drama', 'Docudrama', ""Children's/Family"", 'Drama', 'Family Film']",2000,9
22697633,Ek Vivaah... Aisa Bhi,2008,['India'],"['Musical', 'Bollywood', 'World cinema', 'Romance Film', 'Drama']",2000,8
10296498,The Nutcracker Prince,1990,['Canada'],"['Musical', 'Animation', ""Children's/Family"", 'Holiday Film', 'Adventure', ""Children's Fantasy"", 'Coming of age', 'Family Film', 'Fantasy']",1990,0
10772263,Sanyasi,1975,['India'],['Bollywood'],1970,5
23941708,2001: A Space Odyssey,1968,"['United Kingdom', 'United States of America']","['Surrealism', 'Airplanes and airports', 'Mystery', 'Thriller', 'Adventure', 'Roadshow theatrical release', 'Science Fiction']",1960,8
978631,Pork Chop Hill,1959,['United States of America'],"['Combat Films', 'Action', 'Action/Adventure', 'War film']",1950,9
35545950,Yoroi: The Samurai Zombie,2008,['Japan'],"['Action', 'Japanese Movies', 'Action/Adventure', 'World cinema', 'Horror', 'Martial Arts Film']",2000,8
28006483,Dhanwan,1981,['India'],['Bollywood'],1980,1
20548857,The Gay Anties,1947,['United States of America'],"['Animation', 'Short Film', 'Comedy', 'Romance Film', 'Family Film']",1940,7
4086565,Red Water,2003,['United States of America'],"['Creature Film', 'Action', 'Action/Adventure', 'Thriller', 'Horror', 'Television movie', 'Natural horror films']",2000,3
3844278,The Greatest Expectation,2003,['South Korea'],"['Romantic comedy', 'Comedy']",2000,3
24980213,The Journey,1959,['United States of America'],"['Romance Film', 'Drama']",1950,9
129602,Awakenings,1990,['United States of America'],"['Docudrama', 'Drama', 'Medical fiction']",1990,0
17061845,Business and Pleasure,1932,['United States of America'],"['Comedy', 'Black-and-white']",1930,2
4556471,Their Standing Points,1999,['Japan'],"['Japanese Movies', 'Animation', 'Short Film', 'Drama']",1990,9
163482,Mobile Suit Gundam: Char's Counterattack,1988,['Japan'],"['Action', 'Animation', 'Action/Adventure', 'World cinema', 'Adventure', 'Japanese Movies', 'Anime', 'Science Fiction']",1980,8
31887851,Dharmputra,1961,['India'],['Drama'],1960,1
24235184,Swami Vivekananda,1998,['India'],['Historical drama'],1990,8
2443552,Roma,2004,"['Argentina', 'Spain']","['Indie', 'Drama', 'World cinema']",2000,4
9584958,Nagin,1976,['India'],"['Bollywood', 'Horror']",1970,6
3077184,Poolhall Junkies,2002,['United States of America'],"['Drama', 'Crime Fiction', 'Indie', 'Thriller', 'Crime Drama', 'Crime Thriller', 'Sports']",2000,2
5326603,Avvai Shanmugi,1996,['India'],"['Screwball comedy', 'Comedy', 'World cinema', 'Tamil cinema', 'Romance Film', 'Romantic comedy', 'Family Film']",1990,6
11395322,The Last Sin Eater,2007,['United States of America'],"['Period piece', 'Film adaptation', 'Drama', 'Indie', 'Inspirational Drama', 'Christian film']",2000,7
19490640,Ce qu'il faut pour vivre,2008,['Canada'],"['Indie', 'Drama', 'World cinema']",2000,8
4469910,The White Dragon,2004,['Hong Kong'],"['Action', 'Romantic drama', 'Action/Adventure', 'Comedy', 'World cinema', 'Romance Film', 'Chinese Movies', 'Martial Arts Film', 'Drama', 'Wuxia', 'Romantic comedy']",2000,4
4440221,Zoey 101: Spring Break-Up,2006,['United States of America'],"['Short Film', 'Comedy', 'Television movie', ""Children's/Family"", 'Drama', 'Family Film']",2000,6
24106823,Dirty Diaries,2009,['Sweden'],"['Pornography', 'Erotic Drama', 'Adult']",2000,9
6571060,The Unknown Purple,1923,['United States of America'],"['Black-and-white', 'Indie', 'Silent film', 'Science Fiction']",1920,3
26332602,Safe in Hell,1931,['United States of America'],"['Crime Drama', 'Crime Fiction', 'Pre-Code']",1930,1
370227,Young Törless,1966,"['France', 'Germany', 'West Germany']","['Period piece', 'Film adaptation', 'Black-and-white', 'Thriller', 'World cinema', 'Drama']",1960,6
5537069,Momo,1986,"['Germany', 'West Germany', 'Italy']","['Animation', 'Fantasy']",1980,6
3947,Blue Velvet,1986,['United States of America'],"['Crime Fiction', 'Mystery', 'Thriller']",1980,6
32817713,Red Sky at Morning,1944,[],['Drama'],1940,4
29133505,The Vulture,1937,"['United Kingdom', 'United States of America']","['Comedy film', 'Crime Fiction']",1930,7
5878044,Picnic at Hanging Rock,1975,['Australia'],"['LGBT', 'Mystery', 'Thriller', 'World cinema', 'Drama', 'Period piece', 'Coming of age', 'Horror', 'Supernatural']",1970,5
4112888,Stick It,2006,"['Germany', 'United States of America']","['Comedy', 'Teen', 'Comedy-drama', 'Sports']",2000,6
1047712,The Big Boss,1971,['Hong Kong'],"['Action', 'Crime Fiction', 'Action/Adventure', 'Thriller', 'World cinema', 'Chinese Movies', 'Martial Arts Film', 'Drama', 'Political drama']",1970,1
67414,Marked for Death,1990,['United States of America'],"['Action', 'Crime Fiction', 'Action/Adventure', 'Thriller', 'Martial Arts Film']",1990,0
1666594,Billy Budd,1962,['United Kingdom'],"['Action', 'Film adaptation', 'Drama', 'Action/Adventure', 'Adventure']",1960,2
740276,Heavy Traffic,1973,['United States of America'],"['Action', 'Animation', 'Indie', 'Satire', 'Comedy', 'Adventure', 'Comedy-drama', 'Cult']",1970,3
8717016,Alambrado,1991,"['Argentina', 'Italy']","['Indie', 'Drama']",1990,1
33493993,A Fighting Choice,1986,['United States of America'],[],1980,6
2094975,Arizona Dream,1993,"['France', 'Yugoslavia', 'United States of America']","['Indie', 'Romantic drama', 'Comedy', 'Romance Film', 'Adventure', 'Drama', 'Comedy-drama', 'Fantasy']",1990,3
302970,Edward Scissorhands,1990,['United States of America'],"['Romantic fantasy', 'Comedy', 'Teen', 'Romance Film', 'Drama', 'Comedy-drama', 'Fantasy Comedy', 'Fantasy']",1990,0
14747692,Play It to the Bone,1999,['United States of America'],"['Comedy', 'Buddy film', 'Comedy-drama', 'Sports', 'Drama']",1990,9
23126212,Raise The Titanic,1980,"['United Kingdom', 'United States of America']","['Indie', 'Adventure', 'Drama']",1980,0
1577389,The Remains of the Day,1993,"['United Kingdom', 'United States of America']","['Period piece', 'Film adaptation', 'Romantic drama', 'Romance Film', 'Drama']",1990,3
1364192,Johnny Eager,1941,['United States of America'],"['Black-and-white', 'Crime Fiction', 'Crime Drama', 'Film noir', 'Melodrama', 'Drama']",1940,1
74018,His Girl Friday,1940,['United States of America'],"['Workplace Comedy', 'Screwball comedy', 'Comedy', 'Media Satire', 'Romantic comedy', 'Romance Film', 'Drama']",1940,0
5124993,Incident On and Off a Mountain Road,2005,[],"['Slasher', 'Horror', 'Television movie', 'Cult']",2000,5
11632280,Tall in the Trap,1962,['United States of America'],"['Animation', 'Western', 'Short Film', 'Comedy', 'Family Film']",1960,2
17705173,On the Doll,2008,['United States of America'],"['Crime Fiction', 'Indie', 'Erotic thriller', 'Drama']",2000,8
1833819,Red Desert,1964,"['France', 'Italy']","['Art film', 'Drama', 'World cinema']",1960,4
34606575,I Found Joe Barton,1952,['Australia'],"['Short Film', 'Drama']",1950,2
24259105,The Honky Problem,1991,['United States of America'],"['Animation', 'Short Film', 'Comedy film']",1990,1
129524,Field of Dreams,1989,['United States of America'],"['Film adaptation', 'Family Drama', 'Baseball', 'Americana', 'Drama', 'Sports', 'Family Film', 'Fantasy']",1980,9
9458737,The Cabinet of Caligari,1962,"['United Kingdom', 'United States of America']","['Psychological thriller', 'Black-and-white', 'Horror']",1960,2
24342730,Ondu Muttina Kathe,1987,['India'],['Drama'],1980,7
8201962,Humoresque,1946,['United States of America'],"['Film adaptation', 'Black-and-white', 'Drama']",1940,6
7594122,Kismet,1944,['United States of America'],['Drama'],1940,4
36018357,Yodelin' Kid from Pine Ridge,1937,['United States of America'],['Western'],1930,7
16456355,I Will Survive,1993,['South Korea'],['Historical drama'],1990,3
2328364,Friday the 13th: A New Beginning,1985,['United States of America'],"['Slasher', 'Teen', 'Horror', 'Cult']",1980,5
3182419,Hanuman,2005,['India'],"['Animation', 'Bollywood', 'World cinema']",2000,5
29269806,The Singing Cop,1938,['United Kingdom'],['Musical'],1930,8
26280582,On Board,1998,['Turkey'],['Drama'],1990,8
3836795,Souls for Sale,1923,['United States of America'],"['Black-and-white', 'Crime Fiction', 'Drama', 'Indie', 'Comedy', 'Silent film']",1920,3
5767035,Welcome,2007,['India'],"['Musical', 'Crime Fiction', 'Romantic drama', 'Comedy', 'Bollywood', 'World cinema', 'Romance Film', 'Drama', 'Romantic comedy']",2000,7
28926374,Pettson och Findus - Kattonauten,2000,['Sweden'],"['Family Film', 'Animation']",2000,0
2051594,The Hour-Glass Sanatorium,1973,['Poland'],['Surrealism'],1970,3
5113430,Pumpkinhead 4: Blood Feud,2007,"['United Kingdom', 'United States of America']","['Monster movie', 'Supernatural', 'Horror']",2000,7
23467297,Perfect Mismatch,2009,"['India', 'United States of America']","['Romantic drama', 'Comedy', 'World cinema', 'Romance Film', 'Romantic comedy', 'Drama']",2000,9
11305221,Koper,2006,['Indonesia'],['Drama'],2000,6
20053344,The Parson's Widow,1920,['Sweden'],"['Drama', 'Comedy film']",1920,0
6449695,On the 2nd Day of Christmas,1997,['United States of America'],"['Comedy', 'Drama', 'Family Film']",1990,7
7029001,Ooh… You Are Awful,1972,['United Kingdom'],"['Indie', 'Comedy']",1970,2
6071821,Bug,1975,['United States of America'],"['Horror', 'Natural horror films']",1970,5
14910247,Krazzy 4,2008,['India'],"['Musical', 'Comedy', 'Bollywood', 'World cinema']",2000,8
30531735,Surviving: A Family in Crisis,1985,['United States of America'],"['Family Drama', 'Drama']",1980,5
627935,Mark of the Vampire,1935,['United States of America'],"['Detective fiction', 'Black-and-white', 'Mystery', 'Gothic Film', 'Thriller', 'Detective', 'Horror']",1930,5
36956792,The Water Horse: Legend of the Deep,2007,"['United Kingdom', 'New Zealand', 'United States of America']","['Adventure', ""Children's"", 'Family Film', 'Fantasy']",2000,7
17484707,Five,1951,['United States of America'],"['Black-and-white', 'Action/Adventure', 'Apocalyptic and post-apocalyptic fiction', 'Doomsday film', 'Disaster', 'Science Fiction']",1950,1
18165727,So Well Remembered,1947,['United Kingdom'],['Drama'],1940,7
563040,Hopscotch,1980,['United States of America'],"['Action', 'Spy', 'Chase Movie', 'Action/Adventure', 'Comedy Thriller', 'Thriller', 'Comedy']",1980,0
6627556,Jab Pyaar Kisise Hota Hai,1998,['India'],"['Musical', 'Bollywood', 'World cinema', 'Drama']",1990,8
1416397,Hot Shots! Part Deux,1993,['United States of America'],"['Action', 'Screwball comedy', 'Parody', 'Action/Adventure', 'Comedy', 'War film', 'Absurdism']",1990,3
1156559,The Station Agent,2003,['United States of America'],"['Indie', 'Comedy', 'Comedy-drama', 'Tragicomedy', 'Drama']",2000,3
9875325,Black Roses,1988,['United States of America'],"['Horror', 'B-movie']",1980,8
5266260,These Glamour Girls,1939,['United States of America'],"['Black-and-white', 'Satire', 'Comedy', 'Comedy-drama', 'Drama']",1930,9
18640531,Raid on Rommel,1971,['United States of America'],"['Combat Films', 'Action/Adventure', 'World cinema', 'War film']",1970,1
1242607,Tobruk,1967,['United States of America'],"['War film', 'Drama']",1960,7
2291243,Gay Purr-ee,1962,['United States of America'],"['Music', 'Musical', 'Animation', 'Animated Musical', 'Comedy', 'Romance Film', ""Children's"", 'Drama', 'Family Film']",1960,2
1997163,The Man Without a Past,2002,"['France', 'Finland', 'Germany']","['Musical', 'Crime Fiction', 'Romantic drama', 'Comedy', 'Thriller', 'World cinema', 'Romance Film', 'Drama', 'Romantic comedy', 'Comedy-drama', 'Comedy of manners']",2000,2
30865078,The Crime of Monsieur Lange,1935,['France'],"['Black-and-white', 'Satire', 'World cinema', 'Drama']",1930,5
11006751,The Man from Planet X,1951,['United States of America'],"['Black-and-white', 'Science Fiction', 'Zombie Film', 'Alien Film', 'Cult']",1950,1
31871402,"Sweet Emma, Dear Böbe",1992,"['Hungary', 'Germany']","['Drama', 'World cinema']",1990,2
633411,The Avengers,1998,['United States of America'],"['Action', 'Spy', 'Action/Adventure', 'Comedy', 'Thriller', 'Adventure']",1990,8
9029417,Max Dugan Returns,1983,['United States of America'],"['Comedy', 'Domestic Comedy', 'Comedy-drama', 'Drama']",1980,3
28817360,"Charlie, the Lonesome Cougar",1967,['United States of America'],"['Adventure', 'Drama', 'Family Film']",1960,7
21258335,Loving Leah,2009,['United States of America'],"['Romantic drama', 'Marriage Drama', 'Romance Film', 'Television movie', 'Drama']",2000,9
19435516,Tollywood Focus,2008,['India'],['Drama'],2000,8
2728721,Tanguy,2001,['France'],['Comedy'],2000,1
807842,Beverly Hills Cop II,1987,['United States of America'],"['Action', 'Crime Fiction', 'Action Comedy', 'Action/Adventure', 'Buddy film', 'Comedy']",1980,7
13966551,Jeremy,1973,['United States of America'],"['Romance Film', 'Drama', 'Teen']",1970,3
24757550,The Greenery and the Road,1962,['India'],['World cinema'],1960,2
5083764,Lying,2006,['United States of America'],"['Indie', 'Drama']",2000,6
3819896,La voce della luna,1990,"['France', 'Italy']","['Surrealism', 'Mystery', 'Fantasy Comedy', 'Comedy', 'Romance Film', 'Adventure', 'Drama']",1990,0
6523280,Coven,1997,['United States of America'],"['Short Film', 'Adult']",1990,7
33167476,Small Voices: The Stories of Cambodia's Children,2008,['United States of America'],['Documentary'],2000,8
3831825,The Freshman,1925,['United States of America'],"['Black-and-white', 'Indie', 'Comedy', 'Silent film']",1920,5
24726116,Isabel,1968,['Canada'],"['Psychological thriller', 'Crime Fiction', 'Mystery', 'Thriller', 'Romance Film', 'Crime Thriller', 'Drama']",1960,8
8415205,The Female Prince,1964,['Hong Kong'],"['Musical', 'Chinese Movies']",1960,4
4738411,Sailor Moon R: The Movie,1993,"['Japan', 'United States of America']","['Japanese Movies', 'Comedy film', 'Romance Film', 'Anime', 'Adventure', 'Drama', 'Fantasy']",1990,3
11011055,Flowers in the Attic,1987,['United States of America'],"['Film adaptation', 'Mystery', 'Thriller', 'Horror', 'Drama']",1980,7
8295055,Death Train,1993,"['United Kingdom', 'Croatia', 'United States of America']","['Action', 'Action/Adventure', 'Thriller']",1990,3
28524329,Mortal Transfer,2001,"['France', 'Germany']","['Crime Fiction', 'Comedy', 'Thriller', 'World cinema']",2000,1
24763523,Raising Flagg,2006,['United States of America'],"['Indie', 'Comedy']",2000,6
10499250,Man Hunt,1941,['United States of America'],"['Film adaptation', 'Black-and-white', 'Political thriller', 'Thriller', 'War film', 'Drama']",1940,1
1714278,The End of Evangelion,1997,['Japan'],"['Animation', 'Drama', 'Doomsday film', 'Japanese Movies', 'Coming of age', 'Anime', 'Science Fiction', 'Fantasy']",1990,7
27420129,Operator 13,1934,['United States of America'],"['Action', 'Spy', 'Adventure']",1930,4
8815987,Yakuza Demon,2003,['Japan'],"['Action', 'Crime Fiction', 'Gangster Film', 'Action/Adventure', 'Thriller', 'World cinema', 'Crime Thriller', 'Japanese Movies']",2000,3
20382734,Duel to the Death,1983,['Hong Kong'],"['Action', 'Action/Adventure', 'World cinema', 'Wuxia', 'Chinese Movies', 'Martial Arts Film', 'Drama']",1980,3
31657529,Confessions of Boston Blackie,1941,['United States of America'],"['Crime Fiction', 'Mystery', 'Drama']",1940,1
2510465,The Undead,1957,['United States of America'],"['Psychological thriller', 'Black-and-white', 'Mystery', 'Horror', 'Historical fiction', 'Supernatural']",1950,7
10140541,Junior G-Men,1940,['United States of America'],"['Action', 'Black-and-white', 'Crime Fiction', 'Adventure']",1940,0
3053338,BigLove,2001,['United States of America'],"['Short Film', 'Comedy', 'Drama']",2000,1
15433387,Paraya Dhan,1971,['India'],"['Drama', 'World cinema']",1970,1
10791794,Avargal,1977,['India'],[],1970,7
6244632,Crossover,2006,['United States of America'],"['Action', 'Drama', 'Coming of age', 'Teen', 'Sports']",2000,6
15912486,Solino,2002,"['Germany', 'Italy']","['Drama', 'Comedy']",2000,2
1653423,Sliding Doors,1998,"['United Kingdom', 'United States of America']","['Romantic fantasy', 'Comedy', 'Romance Film', 'Comedy-drama', 'Fantasy Comedy', 'Drama', 'Fantasy']",1990,8
12577414,Ain't That Ducky,1945,['United States of America'],"['Comedy', 'Animation']",1940,5
17148591,Night Train,2009,"['Germany', 'United States of America', 'Romania']","['Action', 'Action/Adventure', 'Thriller', 'Crime Thriller']",2000,9
19671399,Class of 1999,1990,['United States of America'],"['Action', 'Drama', 'Indie', 'Thriller', 'Horror', 'Science Fiction']",1990,0
29002296,Beyond the Pale,2000,['United States of America'],['Drama'],2000,0
1428952,Performance,1970,['United Kingdom'],"['Musical', 'Crime Fiction', 'Gangster Film', 'Experimental film', 'Drama']",1970,0
3297470,Pirates,1986,"['France', 'Tunisia']","['Comedy', 'Swashbuckler films', 'Adventure', 'Family Film']",1980,6
381006,Semi-Tough,1977,['United States of America'],"['Buddy film', 'Satire', 'Comedy', 'Romantic comedy', 'Romance Film', 'Comedy-drama', 'Sports']",1970,7
2610735,Highlander: Vengeance,2007,['United States of America'],"['Action', 'Animation', 'Anime', 'Fantasy']",2000,7
16192023,La Femme de l'hôtel,1984,['Canada'],['Drama'],1980,4
31638293,Sleepless Town,1998,"['Hong Kong', 'Japan']","['Crime Fiction', 'Japanese Movies', 'Action/Adventure', 'World cinema', 'Crime Thriller', 'Chinese Movies', 'Martial Arts Film']",1990,8
17218725,Sad Pastorale,1960,['South Korea'],"['Romance Film', 'Drama']",1960,0
22378288,Istoria mias zois,1965,['Greece'],['Drama'],1960,5
12153345,A mi madre le gustan las mujeres,2002,['Spain'],"['LGBT', 'Comedy', 'World cinema', 'Gay Themed', 'Gay', 'Gay Interest', 'Romantic comedy', 'Sex comedy']",2000,2
20381190,Bhaiyya,1961,['India'],"['Drama', 'Family Film']",1960,1
15247877,Esperando la carroza,1985,['Argentina'],['Comedy film'],1980,5
7813879,Life at the Top,1965,['United Kingdom'],"['Black-and-white', 'Marriage Drama', 'Drama']",1960,5
34990446,Samson and the 7 Miracles of the World,1961,"['France', 'Italy']","['Action', 'Drama', 'Action/Adventure', 'World cinema', 'Adventure']",1960,1
13458785,Oil's Well That Ends Well,1958,['United States of America'],"['Black-and-white', 'Short Film', 'Comedy', 'Slapstick']",1950,8
20982151,Murder Seen,2000,['Canada'],"['Psychological thriller', 'Drama', 'Thriller']",2000,0
19522919,The Steam Experiment,2009,['United States of America'],"['Suspense', 'Drama', 'Crime Fiction', 'Indie', 'Thriller', 'Crime Thriller']",2000,9
7047441,Billy's Dad is a Fudgepacker,2004,['United States of America'],"['Short Film', 'Black-and-white', 'Comedy']",2000,4
20406604,Dachimawa Lee,2008,['South Korea'],"['Action', 'Spy', 'Action/Adventure', 'Comedy', 'World cinema', 'Adventure']",2000,8
12328292,Ek Rishtaa: The Bond of Love,2001,['India'],"['Drama', 'Family Film', 'World cinema']",2000,1
15652207,Dark rising,2007,['Canada'],"['Action', 'Action/Adventure', 'Comedy', 'Horror Comedy', 'Horror']",2000,7
3062551,Wizard of Oz,1925,['United States of America'],"['Black-and-white', 'Coming of age', 'Indie', 'Comedy', 'Silent film', 'Adventure', 'Fantasy']",1920,5
701781,Rob Roy,1995,"['United Kingdom', 'United States of America']","['Action', 'Action/Adventure', 'Biographical film', 'Romance Film', 'Costume drama', 'Swashbuckler films', 'Drama', 'Period piece', 'History', 'War film']",1990,5
19793772,Movie... In Your Face,1990,[],['Comedy'],1990,0
30212893,Bhishma,1996,[],['Action'],1990,6
9890983,Drohkaal,1994,['India'],['Bollywood'],1990,4
35013635,"Natacha Atlas, la rose pop du Caire",2007,"['France', 'Egypt']",['Documentary'],2000,7
11998,Godzilla vs. Megalon,1973,['Japan'],"['Creature Film', 'Monster', 'Japanese Movies', 'Science Fiction', 'Horror', 'Fantasy']",1970,3
13508300,Home Sweet Home,1981,['United States of America'],"['Crime Fiction', 'Mystery', 'Slasher', 'Thriller', 'Horror']",1980,1
20851014,LBJ: The Early Years,1987,['United States of America'],"['Period piece', 'Biography', 'Biopic [feature]', 'Docudrama', 'Television movie', 'Political drama', 'Drama']",1980,7
3850284,The Guinea Pig,1948,['United Kingdom'],['Drama'],1940,8
13974931,Egg,2007,"['Turkey', 'Greece']","['Drama', 'World cinema']",2000,7
8472095,The Convent,1995,"['Portugal', 'France']","['Mystery', 'Thriller', 'World cinema', 'Drama']",1990,5
14637197,The Van,1996,"['United Kingdom', 'Ireland', 'United States of America']","['Drama', 'Comedy']",1990,6
2217409,Brothers and Sisters of the Toda Family,1941,['Japan'],['Japanese Movies'],1940,1
19002818,You Got Me!,2007,['Philippines'],"['Filipino Movies', 'Romantic drama', 'World cinema', 'Romance Film', 'Romantic comedy', 'Drama']",2000,7
23600255,Hitler,1996,['India'],"['Action', 'Comedy', 'Bollywood', 'Drama']",1990,6
5473121,The Luck of Ginger Coffey,1964,"['Canada', 'United States of America']",['Drama'],1960,4
19874993,The Best Little Girl in the World,1981,['United States of America'],"['Drama', 'Medical fiction']",1980,1
6173336,You're an Education,1938,['United States of America'],"['Musical', 'Animation', 'Short Film', 'Comedy', 'Family Film']",1930,8
22265588,Arappatta Kettiya Gramathil,1986,['India'],[],1980,6
1191380,Wilde,1997,"['Japan', 'Kingdom of Great Britain', 'United Kingdom', 'Germany', 'England']","['Film adaptation', 'LGBT', 'Biography', 'Biographical film', 'Romance Film', 'Drama', 'Period piece', 'Gay Themed', 'Gay', 'History', 'Japanese Movies', 'Gay Interest', 'Biopic [feature]']",1990,7
34237533,Siddharth-The Prisoner,2009,['India'],"['Crime Fiction', 'Thriller', 'Crime', 'Drama']",2000,9
15693005,Soul,1981,"['Russia', 'Soviet Union']","['Musical', 'Tragedy', 'Horror']",1980,1
23168201,Ravager,1997,['United States of America'],['Horror'],1990,7
232291,Saagara Sangamam,1983,['India'],"['Musical', 'Romance Film', 'Drama']",1980,3
13805353,Companions in Nightmare,1968,['United States of America'],"['Crime Fiction', 'Crime Thriller', 'Drama']",1960,8
34150058,The Callahans and the Murphys,1927,['United States of America'],"['Comedy', 'Comedy film', 'Romance Film', 'Drama']",1920,7
4305192,Ghosts... of the Civil Dead,1988,['Australia'],"['Prison', 'Crime Fiction', 'Horror', 'Crime Drama', 'Drama']",1980,8
31970809,Duniya,1968,['India'],"['Musical', 'Romantic drama', 'Bollywood', 'World cinema', 'Romance Film', 'Drama']",1960,8
2256097,The Girl Hunters,1963,"['United Kingdom', 'United States of America']","['Crime Fiction', 'Mystery', 'Thriller', 'Drama']",1960,3
12432189,Assassination,1987,['United States of America'],"['Action', 'Action/Adventure', 'Thriller', 'Political thriller']",1980,7
22342112,Petersen,1974,['Australia'],['Drama'],1970,4
5570661,"Duck, Duck, Goose!",2005,['United States of America'],"['Romance Film', 'Short Film', 'Comedy film']",2000,5
36136594,Kai Koduttha Dheivam,1964,['India'],[],1960,4
8943615,Ground Truth,2006,['United States of America'],"['Political cinema', 'War film', 'Documentary']",2000,6
9038806,Eddie and the Cruisers II: Eddie Lives,1989,"['Canada', 'United States of America']","['Musical', 'Indie', 'Thriller', 'Romance Film', 'Drama']",1980,9
2004939,Glory Road,2006,['United States of America'],"['Period piece', 'Docudrama', 'Sports', 'Drama']",2000,6
26131280,Njangal Santhushtaranu,1999,['India'],"['Drama', 'Comedy']",1990,9
3625867,Dosti: Friends Forever,2005,['India'],"['Drama', 'Bollywood', 'World cinema']",2000,5
10087767,Beau James,1957,['United States of America'],"['Biographical film', 'Biopic [feature]', 'Docudrama', 'Drama']",1950,7
1851703,Snow Falling on Cedars,1999,['United States of America'],"['Film adaptation', 'Crime Fiction', 'Mystery', 'Romantic drama', 'Thriller', 'Romance Film', 'Drama', 'Courtroom Drama', 'Period piece']",1990,9
8396653,Ahmad Albab,1968,['Malaysia'],"['Musical', 'Family Film']",1960,8
14538051,Hum Aapke Dil Mein Rehte Hain,1999,['India'],"['Musical', 'Romantic drama', 'Comedy', 'Bollywood', 'World cinema', 'Romance Film', 'Drama', 'Romantic comedy']",1990,9
12698154,Mina Tannenbaum,1994,"['France', 'Netherlands']",['Drama'],1990,4
2439340,Moving Violations,1985,['United States of America'],['Comedy'],1980,5
16164212,I'm Going Home,2001,"['Portugal', 'France']","['Comedy', 'World cinema', 'Comedy-drama', 'Drama']",2000,1
2184209,Don't Be Afraid of the Dark,1973,['United States of America'],['Horror'],1970,3
15107155,Akui ggot,1961,['South Korea'],['Horror'],1960,1
10131468,Hot Rod and Reel!,1959,['United States of America'],"['Animation', 'Short Film', 'Comedy', 'Family Film']",1950,9
4180502,Schizoid,1980,['United States of America'],"['Action', 'Psychological thriller', 'Mystery', 'Thriller', 'Horror']",1980,0
3056072,Run Ronnie Run,2003,['United States of America'],"['Parody', 'Slapstick', 'Comedy']",2000,3
4569282,Andha Kanoon,1983,['India'],"['Musical', 'Bollywood', 'World cinema', 'Drama']",1980,3
18138846,Tru Loved,2007,['United States of America'],"['LGBT', 'Indie', 'Comedy', 'Teen', 'Gay Themed', 'Gay', 'Gay Interest', 'Comedy-drama']",2000,7
5102319,Vacancy,2007,['United States of America'],"['Psychological thriller', 'Thriller', 'Horror']",2000,7
4731909,Imitation of Life,1959,['United States of America'],"['Romance Film', 'Drama']",1950,9
3997734,Little Man,2006,"['Canada', 'United States of America']","['Crime Fiction', 'Slapstick', 'Comedy']",2000,6
16001951,Crossfire Trail,2001,['United States of America'],"['Film adaptation', 'Romantic drama', 'Action/Adventure', 'Romance Film', 'Costume drama', 'Drama', 'Western', 'Television movie']",2000,1
31481682,Vakkalathu Narayanankutty,2001,[],['Drama'],2000,1
17512929,Shiva,2006,['India'],"['Action', 'Drama']",2000,6
19861095,Hell on Heels: The Battle of Mary Kay,2002,"['Canada', 'United States of America']","['Biography', 'Comedy', 'Biographical film', 'Television movie', 'Drama']",2000,2
32741807,2033,2009,['Mexico'],"['Science Fiction', 'World cinema']",2000,9
21621727,Agni Pariksha,1954,['India'],"['Romance Film', 'Drama']",1950,4
46387,Incubus,1965,['United States of America'],"['Black-and-white', 'Horror']",1960,5
19030640,The Little Bear Movie,2001,['Canada'],"[""Children's"", 'Animation']",2000,1
1241944,Yu-Gi-Oh! The Movie: Pyramid of Light,2004,"['Japan', 'United States of America']","['Action', 'Fantasy Adventure', 'Animation', 'Family-Oriented Adventure', ""Children's"", 'Adventure', 'Japanese Movies', 'Action Comedy', 'Anime', 'Fantasy']",2000,4
113549,Scream,1996,['United States of America'],"['Crime Fiction', 'Mystery', 'Horror']",1990,6
10510399,The Lucky Star,1997,['Spain'],['Drama'],1990,7
14170318,Macabre,1958,['United States of America'],['Horror'],1950,8
16178815,Joot,2004,['India'],"['Action/Adventure', 'Drama', 'World cinema']",2000,4
977671,Sommersby,1993,"['France', 'United States of America']","['Period piece', 'Mystery', 'Romantic drama', 'Thriller', 'Romance Film', 'Drama']",1990,3
11595327,Jamaica Motel,2006,['United States of America'],"['Short Film', 'Drama']",2000,6
14517173,Jaagruti,1992,['India'],['Musical'],1990,2
10229188,Yakuza Graveyard,1976,['Japan'],"['Action', 'Japanese Movies', 'Action/Adventure', 'World cinema', 'Crime Drama']",1970,6
1615355,Much Ado About Nothing,1993,"['United Kingdom', 'England', 'United States of America']","['Romantic drama', 'Comedy', 'Romance Film', 'Costume drama', 'Drama', 'Period piece', 'Romantic comedy', 'War film']",1990,3
74537,Brazil,1985,['United Kingdom'],"['Comedy', 'Satire', 'Kafkaesque', 'Black comedy', 'Drama', 'Dystopia', 'Future noir', 'Science Fiction', 'Cult', 'Fantasy']",1980,5
22031391,Mega Shark Vs. Giant Octopus,2009,['United States of America'],"['Action', 'Horror', 'Sci-Fi Horror', 'Science Fiction']",2000,9
624896,The Titfield Thunderbolt,1953,['United Kingdom'],"['Ealing Comedies', 'Comedy', 'Satire', 'Comedy of manners']",1950,3
12346194,The Dark Side of the Sun,1988,"['United States of America', 'Yugoslavia', 'Canada']","['Romantic drama', 'Drama', 'Medical fiction']",1980,8
980439,It Happened Here,1966,['United Kingdom'],"['Dystopia', 'War film', 'Science Fiction', 'Drama']",1960,6
22309052,Hero Among Heroes,1993,"['China', 'Hong Kong']","['Action', 'Period piece', 'Action/Adventure', 'World cinema', 'Chinese Movies', 'Martial Arts Film']",1990,3
22037963,Small Town Saturday Night,2009,['United States of America'],"['Indie', 'Drama']",2000,9
3365397,The Last Remake of Beau Geste,1977,['United States of America'],"['Foreign legion', 'Parody', 'Comedy']",1970,7
20518520,After the Ball,1956,['United States of America'],"['Animation', 'Short Film', 'Comedy film', 'Family Film']",1950,6
10359672,Kantoku · Banzai!,2007,['Japan'],"['Art film', 'Japanese Movies', 'Comedy', 'World cinema', 'Drama']",2000,7
27958820,Saeta rubia,1956,['Spain'],['Biographical film'],1950,6
8994,Das Boot,1981,"['Germany', 'West Germany']","['Action', 'History', 'Action/Adventure', 'Thriller', 'World cinema', 'War film', 'Drama']",1980,1
21034985,Prayers for Bobby,2009,['United States of America'],"['LGBT', 'Biography', 'Docudrama', 'Drama', 'Gay Themed', 'Gay', 'Gay Interest', 'Television movie']",2000,9
342741,Road to Perdition,2002,['United States of America'],"['Film adaptation', 'Crime Fiction', 'Gangster Film', 'Family Drama', 'Action/Adventure', 'Thriller', 'Drama', 'Period piece', 'Coming of age', 'Crime Drama']",2000,2
10494803,The Well,1997,"['New Zealand', 'Australia']","['Psychological thriller', 'Crime Fiction', 'Indie', 'Thriller', 'World cinema', 'Crime Thriller', 'Drama', 'Supernatural']",1990,7
4678118,The Toast of New York,1937,['United States of America'],"['Black-and-white', 'Biographical film', 'Biopic [feature]', 'Drama']",1930,7
1011854,Little Nicky,2000,['United States of America'],"['Comedy', 'Romance Film', 'Romantic comedy', 'Slapstick', 'Fantasy']",2000,0
26022636,Injakkadan Mathai & Sons,1993,['India'],"['Action', 'Drama', 'Comedy']",1990,3
34203491,Hidden Pleasures,1977,['Spain'],['Drama'],1970,7
2932827,Gridlock'd,1997,['United States of America'],"['Comedy', 'Black comedy', 'Comedy-drama', 'Addiction Drama', 'Drama']",1990,7
15672850,The Perils of Pauline,1947,['United States of America'],"['Silent film', 'Comedy']",1940,7
5203014,Naked in New York,1993,['United States of America'],"['Romance Film', 'Romantic comedy', 'Comedy']",1990,3
248222,The Fast and the Furious,2001,"['Germany', 'United States of America']","['Action', 'Auto racing', 'Crime Fiction', 'Action/Adventure', 'Thriller', 'Sports']",2000,1
4467620,Marebito,2004,['Japan'],"['Japanese Movies', 'Horror', 'World cinema', 'Supernatural']",2000,4
14230475,Goodnight Mister Tom,1998,['United Kingdom'],"['Period piece', 'Film adaptation', 'Childhood Drama', 'Television movie', 'Drama']",1990,8
13991714,Robot Wars,1993,['United States of America'],"['Action', 'Science Fiction', 'Thriller']",1990,3
35733178,The Tommy Steele Story,1957,['United Kingdom'],"['Drama', 'Biographical film']",1950,7
4681364,Street Smart,1987,['United States of America'],"['Crime Fiction', 'Thriller', 'Crime Drama', 'Drama']",1980,7
564966,And God Created Woman,1956,"['France', 'Italy']","['Romantic drama', 'World cinema', 'Romance Film', 'Drama']",1950,6
1055198,Paper Moon,1973,['United States of America'],"['Black-and-white', 'Crime Fiction', 'Comedy', 'Black comedy', 'Drama', 'Period piece', 'New Hollywood', 'Comedy-drama', 'Road movie']",1970,3
6085875,Bloodsport 4: The Dark Kumite,1999,['United States of America'],"['Action', 'Prison', 'Action/Adventure', 'Thriller', 'Martial Arts Film']",1990,9
61071,Lady for a Day,1933,['United States of America'],"['Black-and-white', 'Comedy', 'Comedy-drama', 'Comedy of manners', 'Drama']",1930,3
12233773,Aasra,1961,['India'],"['Drama', 'Family Film']",1960,1
10377101,Counsellor at Law,1933,['United States of America'],"['Black-and-white', 'Pre-Code', 'Drama']",1930,3
3647125,Elephant Walk,1954,['United States of America'],"['Action', 'Film adaptation', 'Romantic drama', 'Marriage Drama', 'Romance Film', 'Adventure', 'Drama']",1950,4
5984146,Beau-père,1981,['France'],"['Romantic drama', 'World cinema', 'Romance Film', 'Melodrama', 'Comedy-drama', 'Drama']",1980,1
15131958,The Nest,1988,['United States of America'],"['Indie', 'Horror', 'B-movie', 'Science Fiction']",1980,8
19537146,Mr Funtoosh,2008,['India'],['Action'],2000,8
14602109,Aga Bai Arrecha,2004,['India'],"['Musical', 'Comedy', 'Bollywood', 'World cinema', 'Family Film']",2000,4
1880660,"The Chronicles of Narnia: The Lion, the Witch and the Wardrobe",2005,"['United Kingdom', 'New Zealand', 'United States of America']","['Fantasy Adventure', ""Children's Fantasy"", 'Christian film', ""Children's/Family"", 'Adventure', 'Family Film', 'Fantasy']",2000,5
28173490,When Were You Born,1938,['United States of America'],"['Mystery', 'Romance Film']",1930,8
3729054,Time to Leave,2006,['France'],"['Gay Themed', 'LGBT', 'Family Drama', 'World cinema', 'Drama']",2000,6
1584791,CQ,2001,"['Luxembourg', 'France', 'Italy', 'United States of America']","['Period piece', 'Comedy', 'Science Fiction', 'Drama']",2000,1
460442,A Bug's Life,1998,['United States of America'],"['Animation', 'Comedy', 'Family-Oriented Adventure', ""Children's/Family"", 'Adventure', 'Computer Animation', ""Children's Fantasy"", 'Family Film', 'Fantasy']",1990,8
933060,One Hour Photo,2002,['United States of America'],"['Psychological thriller', 'Suspense', 'Crime Fiction', 'Thriller', 'Crime Thriller', 'Drama']",2000,2
27852719,To exypno pouli,1961,['Greece'],"['Romance Film', 'Comedy']",1960,1
26067101,Siam Sunset,1999,"['New Zealand', 'Australia']","['Indie', 'Comedy', 'World cinema', 'Romance Film', 'Romantic comedy']",1990,9
3723947,Ocean's Thirteen,2007,['United States of America'],"['Crime Fiction', 'Caper story', 'Comedy', 'Thriller', 'Master Criminal Films', 'Ensemble Film']",2000,7
21683540,Nil Nirjane,2003,['India'],"['Musical', 'Bollywood', 'World cinema', 'Drama']",2000,3
11214013,Dreamz,2000,['India'],[],2000,0
13099032,Forbidden Priests,1973,['France'],['Drama'],1970,3
14166395,Senki,2007,['Republic of Macedonia'],"['Thriller', 'World cinema', 'Supernatural', 'Drama']",2000,7
3579037,A Question of Attribution,1991,['England'],"['Psychological thriller', 'Spy', 'Crime Fiction', 'Biopic [feature]', 'Drama']",1990,1
28967923,The Flesh and Blood Show,1972,"['United Kingdom', 'United States of America']","['Slasher', 'Thriller', 'Horror', 'B-movie']",1970,2
6304360,Ask the Dust,2006,['United States of America'],"['Period piece', 'Film adaptation', 'Romantic drama', 'Romance Film', 'Drama']",2000,6
3421818,Unknown,2006,['United States of America'],"['Crime Fiction', 'Mystery', 'Thriller', 'Crime Thriller', 'Drama']",2000,6
12530079,The Prince and the Pauper,1990,['United States of America'],"['Animation', 'Short Film', 'Comedy film', 'Family Film']",1990,0
12319656,Paint Your Wagon,1969,['United States of America'],"['Musical', 'Film adaptation', 'Western', 'Action/Adventure', 'Comedy', 'Roadshow theatrical release', 'Drama']",1960,9
3161589,Strapless,1989,['United Kingdom'],"['Romantic drama', 'Indie', 'Romance Film', 'Drama']",1980,9
2873267,Porky Pig's Feat,1943,['United States of America'],"['Animation', 'Short Film', 'Comedy film', 'Family Film']",1940,3
12912926,The Shrink Is In,2001,['United States of America'],"['Indie', 'Comedy', 'Romance Film', 'Romantic comedy']",2000,1
6000525,Sailor Beware,1952,['United States of America'],"['Musical', 'Comedy', 'Slapstick', 'Adventure']",1950,2
22302663,Tales of Vesperia: The First Strike,2009,['Japan'],"['Animation', 'Japanese Movies', 'Anime']",2000,9
14001518,Nari Nari Naduma Murari,1990,['India'],"['Comedy', 'Family Film']",1990,0
80944,Father of the Bride,1950,['United States of America'],"['Comedy', 'Romance Film', 'Romantic comedy', 'Drama', 'Family Film']",1950,0
12196686,I'm Reed Fish,2007,['United States of America'],"['Indie', 'Comedy', 'Romance Film', 'Romantic comedy']",2000,7
3394539,Jazzin' for Blue Jean,1984,['United Kingdom'],"['Musical', 'Short Film']",1980,4
11143089,Japanil Kalyanaraman,1985,['India'],"['Action', 'Drama', 'Comedy film']",1980,5
1374201,Saving Silverman,2001,"['United States of America', 'Australia']","['Gross out', 'Crime Fiction', 'Gross-out film', 'Screwball comedy', 'Buddy film', 'Comedy', 'Black comedy', 'Romance Film', 'Romantic comedy']",2000,1
27488027,Gaayam,1993,['India'],"['Drama', 'Crime Fiction', 'Thriller']",1990,3
2381687,Slightly Scarlet,1956,['United States of America'],"['Crime Fiction', 'Mystery', 'Action/Adventure', 'Thriller', 'Film noir', 'Drama']",1950,6
12191850,Outward Bound,1930,['United States of America'],"['Black-and-white', 'Drama', 'Fantasy']",1930,0
12219972,Aap Aye Bahaar Ayee,1971,['India'],"['Family Drama', 'Comedy', 'Romance Film', 'Drama']",1970,1
29148033,So Evil My Love,1948,"['United Kingdom', 'United States of America']","['Crime Fiction', 'Mystery', 'Film noir', 'Drama']",1940,8
27545586,American Vampire,1997,['United States of America'],"['Comedy', 'Horror']",1990,7
25125971,The Wife,1995,['United States of America'],"['Romantic drama', 'Indie', 'Romance Film', 'Black comedy', 'Drama']",1990,5
1972001,Wabbit Twouble,1941,['United States of America'],['Comedy'],1940,1
2326278,Let the Love Begin,2005,['Philippines'],"['Filipino Movies', 'Romantic drama', 'World cinema', 'Romance Film', 'Filipino', 'Drama']",2000,5
74913,Love Me Tonight,1932,['United States of America'],"['Musical', 'Black-and-white', 'Operetta', 'Comedy', 'Romance Film', 'Romantic comedy', 'Pre-Code']",1930,2
22178122,That Lady in Ermine,1948,['United States of America'],"['Musical', 'Comedy', 'Fantasy']",1940,8
14767600,Aashayein,2008,['India'],"['Musical', 'Bollywood', 'World cinema', 'Drama', 'Medical fiction']",2000,8
11141604,Soora Samhaaram,1988,['India'],['Action'],1980,8
956598,The Haunting,1999,['United States of America'],"['Supernatural', 'Horror']",1990,9
21674699,When the Trees Were Tall,1962,['Soviet Union'],"['Romance Film', 'Drama']",1960,2
5984648,The Children's Hour,1961,['United States of America'],"['Film adaptation', 'Black-and-white', 'LGBT', 'Drama']",1960,1
1290182,Everybody Has a Little Secret,2004,['South Korea'],"['Romance Film', 'Comedy']",2000,4
9404578,The Lady Vanishes,1938,['United Kingdom'],"['Psychological thriller', 'Spy', 'Black-and-white', 'Mystery', 'Comedy', 'Thriller']",1930,8
20869935,Battle Planet,2008,['United States of America'],['Science Fiction'],2000,8
36454546,Northanger Abbey,2007,['United Kingdom'],"['Period piece', 'Film adaptation', 'Romantic drama', 'Romance Film', 'Television movie', 'Costume drama', 'Drama']",2000,7
15453826,Snowbeast,1977,['United States of America'],"['Creature Film', 'Television movie', 'Horror']",1970,7
1602624,Peking Opera Blues,1986,['Hong Kong'],"['Comedy', 'Comedy-drama', 'Chinese Movies', 'War film', 'Drama']",1980,6
11069187,Firepower,1979,['United Kingdom'],"['Action', 'Thriller', 'Drama']",1970,9
3734733,Addams Family Reunion,1998,['United States of America'],"['Black comedy', 'Comedy', 'Horror Comedy']",1990,8
13075708,The Wackiest Ship In the Army,1960,['United States of America'],"['War film', 'Comedy', 'Family Film']",1960,0
14289279,The Love of a Man,1997,['Spain'],"['LGBT', 'Comedy', 'World cinema', 'Romantic comedy', 'Drama', 'Sex comedy']",1990,7
34772248,Rats: Night Of Terror,1983,"['France', 'Italy']",['Horror'],1980,3
10940708,Earth vs. the Spider,1958,['United States of America'],"['Monster', 'Horror', 'Science Fiction', 'Natural horror films']",1950,8
26921164,Raja Aur Runk,1968,['India'],"['Musical', 'Bollywood', 'World cinema', 'Drama', 'Family Film']",1960,8
28091282,All the Way to Paris,1965,['South Africa'],"['Comedy', 'World cinema']",1960,5
33382526,Kony,1984,['India'],"['Musical', 'Bollywood', 'World cinema', 'Drama']",1980,4
5995658,Main Tulsi Tere Aangan Ki,1978,['India'],"['Drama', 'Bollywood', 'World cinema']",1970,8
27122688,When Eagles Strike,2003,['United States of America'],"['Action', 'Action Thrillers', 'Action/Adventure', 'Thriller']",2000,3
22277481,Irumbu Kottai Murattu Singam,2009,['India'],['Comedy'],2000,9
23255,Paths of Glory,1957,['United States of America'],"['Anti-war', 'Black-and-white', 'Anti-war film', 'Existentialism', 'War film', 'Drama']",1950,7
5812997,Summer City,1977,['Australia'],"['Crime Fiction', 'World cinema', 'Drama', 'Ensemble Film']",1970,7
1259297,Onegin,1999,"['United Kingdom', 'United States of America']","['Period piece', 'Romantic drama', 'Indie', 'Romance Film', 'Drama']",1990,9
17594022,Ten North Frederick,1958,['United States of America'],"['Romance Film', 'Black-and-white', 'Drama']",1950,8
92608,Witness for the Prosecution,1958,"['United Kingdom', 'United States of America']","['Black-and-white', 'Crime Fiction', 'Mystery', 'Thriller', 'Crime Thriller', 'Drama', 'Courtroom Drama']",1950,8
27816569,Blessed,2008,['United Kingdom'],['Drama'],2000,8
2088328,Teachers,1984,['United States of America'],"['Coming of age', 'Comedy', 'Comedy-drama', 'Drama']",1980,4
8729015,The Seventh Cross,1944,['United States of America'],"['Black-and-white', 'Drama', 'Escape Film']",1940,4
17188583,My Father's Glory,1991,['France'],"['Family Drama', 'Comedy', 'World cinema', 'Drama', 'Family Film']",1990,1
4099355,Keeping the Promise,1997,"['Canada', 'United States of America']","['Family Drama', 'Childhood Drama', 'Family-Oriented Adventure', ""Children's/Family"", 'Adventure', 'Drama', 'Period piece', 'Television movie', 'Family Film']",1990,7
26315413,Plaguers,2008,['United States of America'],"['Horror', 'B-movie', 'Zombie Film', 'Science Fiction']",2000,8
4195398,The Mountain Road,1961,['United States of America'],"['War film', 'Drama']",1960,1
12442942,The Last Man,2000,['United States of America'],"['Action', 'Indie', 'Comedy', 'Thriller', 'Romance Film', 'Disaster', 'Drama', 'Science Fiction', 'Sex comedy']",2000,0
3468976,Danger!! Death Ray,1967,['Italy'],"['Science Fiction', 'Spy']",1960,7
5672796,Lone Wolf and Cub: Baby Cart in Land of Demons,1973,['Japan'],"['Japanese Movies', 'Action/Adventure', 'World cinema']",1970,3
26461312,"Darling, How Could You!",1951,['United States of America'],['Comedy'],1950,1
6066495,Black Eagle,1988,['United States of America'],"['Action', 'Martial Arts Film', 'Thriller']",1980,8
18234993,The Astroduck,1966,['United States of America'],"['Animation', 'Short Film', 'Comedy', 'Family Film']",1960,6
28932258,Up In Smoke,1957,['United States of America'],['Comedy film'],1950,7
19984296,...and they dared to dream,2002,['India'],"['Mystery', 'Drama', 'Fantasy']",2000,2
10386266,Ator l'invincible,1982,['Italy'],"['Action/Adventure', 'World cinema', 'Adventure', 'Superhero movie', 'Fantasy']",1980,2
607444,13 Going on 30,2004,['United States of America'],"['Coming of age', 'Comedy', 'Romantic comedy', 'Romance Film', 'Fantasy Comedy', 'Fantasy']",2000,4
10916155,Civic Duty,2007,"['United Kingdom', 'United States of America', 'Canada']","['Psychological thriller', 'Indie', 'Thriller', 'Crime Thriller']",2000,7
30253701,Shapath,1997,[],"['Action', 'Drama']",1990,7
155271,Three Colors: White,1994,"['France', 'Poland']","['Mystery', 'Romantic drama', 'Comedy', 'World cinema', 'Black comedy', 'Romance Film', 'Drama']",1990,4
2216254,Jefferson in Paris,1995,"['United Kingdom', 'France', 'United States of America']","['Biography', 'Romantic drama', 'Romance Film', 'Costume drama', 'Drama', 'Period piece', 'Historical fiction', 'Political drama']",1990,5
22966339,Tobruk,2008,"['Slovakia', 'Czech Republic', 'Slovak Republic']","['History', 'War film']",2000,8
28312226,Peyton Place: The Next Generation,1985,['United States of America'],"['Romance Film', 'Drama']",1980,5
905483,Chopper,2000,['Australia'],"['Crime Fiction', 'Comedy', 'Biographical film', 'Drama']",2000,0
22680762,Vincere,2009,"['France', 'Italy']","['Biographical film', 'Thriller', 'World cinema', 'Romance Film', 'Drama', 'Biopic [feature]', 'Historical Epic', 'Melodrama', 'Historical fiction', 'Political drama']",2000,9
14683800,Guns a Poppin!,1957,['United States of America'],"['Short Film', 'Black-and-white', 'Comedy']",1950,7
17031454,La vie promise,2002,['France'],"['Family Drama', 'World cinema', 'Crime Drama', 'Drama']",2000,2
2009257,House of Bamboo,1955,['United States of America'],"['Detective fiction', 'Crime Fiction', 'Thriller', 'Crime Drama', 'Film noir', 'Drama']",1950,5
5884079,Bangkok Dangerous,2008,['United States of America'],"['Action', 'Crime Fiction', 'Gangster Film', 'Action/Adventure', 'Thriller', 'Crime Thriller']",2000,8
14149884,Bernard and Doris,2008,"['United Kingdom', 'United States of America']","['Biographical film', 'Biopic [feature]', 'Television movie', 'Comedy-drama', 'Drama']",2000,8
18901478,Butterfly Effect: Revelation,2009,['United States of America'],"['Mystery', 'Thriller', 'Horror', 'Crime Thriller', 'Science Fiction']",2000,9
4428038,Saigon Love Story,2005,['United States of America'],"['Musical', 'Drama']",2000,5
3584031,Longinus,2004,['Japan'],"['Japanese Movies', 'Short Film', 'Horror', 'War film']",2000,4
13084794,Adoration,2008,['Canada'],"['Indie', 'Drama']",2000,8
26365132,Terribly Happy,2008,['Denmark'],"['Detective fiction', 'Mystery', 'Thriller', 'Detective', 'World cinema', 'Drama']",2000,8
16676995,Wedlock,1991,['United States of America'],"['Action', 'Drama', 'Crime Fiction', 'Thriller', 'Science Fiction']",1990,1
32632090,Cry Baby Lane,2000,['United States of America'],['Horror'],2000,0
8562686,Bimbo's Initiation,1931,['United States of America'],"['Animation', 'Short Film', 'Comedy', 'Family Film', 'Fantasy']",1930,1
5604231,Wrong Again,1929,['United States of America'],"['Black-and-white', 'Indie', 'Short Film', 'Comedy', 'Slapstick', 'Silent film', 'Comedy of Errors']",1920,9
4671604,Boys,2003,['India'],"['Musical', 'Romantic drama', 'World cinema', 'Tamil cinema', 'Romance Film', 'Tollywood', 'Drama']",2000,3
7127336,Wendigo,2001,['United States of America'],"['Creature Film', 'Horror']",2000,1
21314980,Big Bad Love,2002,['United States of America'],"['Film adaptation', 'Indie', 'Comedy', 'Marriage Drama', 'Drama']",2000,2
241482,American Wedding,2003,"['Germany', 'United States of America']","['Gross out', 'Gross-out film', 'Comedy', 'Teen', 'Romance Film', 'Sex comedy']",2000,3
24160654,House Calls,1978,['United States of America'],"['Romance Film', 'Romantic comedy', 'Comedy']",1970,8
2546429,Friday the 13th: The Final Chapter,1984,['United States of America'],"['Slasher', 'Teen', 'Horror', 'Cult']",1980,4
957928,Halloween H20: 20 Years Later,1998,['United States of America'],"['Slasher', 'Teen', 'Horror', 'Drama', 'Cult']",1990,8
2269393,Night on Earth,1991,"['Japan', 'United Kingdom', 'France', 'Germany', 'United States of America']","['Drama', 'Japanese Movies', 'Indie', 'Comedy', 'Comedy of manners', 'Black comedy']",1990,1
1982699,The Miracle of Bern,2003,['Germany'],"['Sports', 'Comedy', 'Drama']",2000,3
415156,XXX,2002,['United States of America'],"['Action', 'Crime Fiction', 'Action/Adventure', 'Thriller', 'Adventure']",2000,2
5884748,E,2006,['India'],"['Action', 'Drama', 'Thriller', 'Tamil cinema']",2000,6
3777574,Charlotte's Web,1973,['United States of America'],"['Music', 'Musical', 'Animation', 'Family Drama', ""Children's"", 'Drama', 'Family Film']",1970,3
3395527,Mickey's Magical Christmas: Snowed in at the House of Mouse,2001,['United States of America'],"['Animated cartoon', 'Animation', 'Comedy', ""Children's/Family"", 'Family Film', 'Computer Animation']",2000,1
8425661,Mamma Mia!,2008,"['United Kingdom', 'Germany', 'United States of America']","['Musical', 'Comedy', 'Musical comedy', 'Romance Film', 'Romantic comedy']",2000,8
99015,Doctor Dolittle,1967,['United States of America'],"['Music', 'Musical', 'Comedy', 'Family-Oriented Adventure', ""Children's/Family"", ""Children's"", 'Drama', 'Period piece', ""Children's Fantasy"", 'Family Film', 'Fantasy']",1960,7
25413191,End of the World,1977,['United States of America'],"['Sci-Fi Thriller', 'Mystery', 'Thriller', 'Science Fiction', 'Fantasy']",1970,7
25705811,"The Actress, the Dollars and the Transylvanians",1979,['Romania'],['Western'],1970,9
2861645,Smash Palace,1982,"['New Zealand', 'Australia']","['Drama', 'Indie', 'Marriage Drama', 'World cinema']",1980,2
2260396,The Last Horror Film,1982,['United States of America'],"['Slasher', 'B-movie', 'Horror']",1980,2
5035407,MVP: Most Valuable Primate,2000,['United States of America'],"['Sports', 'Comedy', 'Animal Picture', ""Children's/Family"", ""Children's"", 'Drama', 'Family Film']",2000,0
204809,A Chinese Ghost Story,1987,['Hong Kong'],"['Action', 'Romantic fantasy', 'Fantasy Adventure', 'Action/Adventure', 'Comedy', 'World cinema', 'Romance Film', 'Chinese Movies', 'Martial Arts Film', 'Horror', 'Fantasy']",1980,7
7462680,I Died a Thousand Times,1955,['United States of America'],"['Crime Fiction', 'Thriller', 'Crime Drama', 'Romance Film', 'Film noir', 'Drama']",1950,5
7501481,Fingers,1978,['United States of America'],"['Crime Fiction', 'Gangster Film', 'Drama']",1970,8
1924012,Who Dares Wins,1982,"['United Kingdom', 'Switzerland']","['Action', 'Spy', 'Film adaptation', 'Action Thrillers', 'Action/Adventure', 'Thriller', 'Adventure', 'Drama', 'Political thriller']",1980,2
1828869,Dhoom,2004,['India'],"['Action', 'Musical', 'Action/Adventure', 'Thriller', 'Bollywood', 'World cinema', 'Crime Thriller', 'Buddy cop', 'Heist', 'Chase Movie']",2000,4
30639935,Rangoon Radha,1956,['India'],['Drama'],1950,6
28178332,Small Hotel,1957,[],['Comedy film'],1950,7
12099919,Purana mandir,1984,['India'],"['World cinema', 'Horror']",1980,4
32889015,Carmen on Ice,1990,['Germany'],"['Music', 'Drama']",1990,0
8326730,Night of the Eagle,1962,['United Kingdom'],"['Film adaptation', 'Black-and-white', 'Gothic Film', 'Horror', 'Supernatural', 'Drama']",1960,2
29172522,Rag Doll,1961,[],"['Drama', 'Crime Fiction']",1960,1
12746610,Two Years Before the Mast,1946,['United States of America'],"['Black-and-white', 'Adventure', 'Drama']",1940,6
23650349,Soul Mates,1925,['United States of America'],"['Silent film', 'Black-and-white', 'Drama']",1920,5
10065556,Anatomy 2,2003,['Germany'],"['Psychological thriller', 'Thriller', 'Horror', 'World cinema']",2000,3
3287871,Phir Bhi Dil Hai Hindustani,2000,['India'],"['Musical', 'Romantic drama', 'Bollywood', 'World cinema', 'Romance Film', 'Drama']",2000,0
2962639,Twice Upon a Time,1983,['United States of America'],"['Stop motion', 'Comedy', 'Fantasy']",1980,3
3486717,Bug,2006,['United States of America'],"['Psychological thriller', 'Indie', 'Thriller', 'Horror']",2000,6
10065066,Sublime,2007,['United States of America'],"['Psychological thriller', 'Thriller', 'Horror']",2000,7
11937544,Cowboys and Angels,2003,"['United Kingdom', 'Germany', 'Ireland']","['Gay Themed', 'LGBT', 'Drama', 'Indie', 'Comedy', 'Romance Film', 'Romantic comedy']",2000,3
20699250,Where God Left His Shoes,2007,['United States of America'],"['Inspirational Drama', 'Family Drama', 'Indie', 'Social problem film', 'Drama']",2000,7
2430261,White Squall,1996,['United States of America'],"['Coming of age', 'Action/Adventure', 'Adventure', 'Disaster', 'Drama']",1990,6
690918,The Entity,1982,['United States of America'],"['Psychological thriller', 'Mystery', 'Thriller', 'Drama', 'Haunted House Film', 'Horror', 'Supernatural', 'Science Fiction', 'Fantasy']",1980,2
29100093,Abhinandana,1988,['India'],['Musical'],1980,8
12219523,Aamne Samne,1967,['India'],"['Drama', 'World cinema']",1960,7
10124804,Night Riders,1981,['Czechoslovakia'],['Drama'],1980,1
101935,Network,1976,['United States of America'],"['Parody', 'Satire', 'New Hollywood', 'Black comedy', 'Drama']",1970,6
185264,The Star Wars Holiday Special,1978,['United States of America'],"['Musical', 'Animation', 'Comedy', 'Adventure', 'Holiday Film', 'Science Fiction']",1970,8
26006769,Sol Madrid,1968,['United States of America'],"['Action', 'Drama', 'Crime Fiction', 'Mystery']",1960,8
4278708,Zamaana Deewana,1995,['India'],['World cinema'],1990,5
8705786,Heartbreakers,1984,['United States of America'],['Drama'],1980,4
6987479,School for Scoundrels,2006,['United States of America'],"['Romance Film', 'Romantic comedy', 'Comedy']",2000,6
30864957,Guyver: Dark Hero,1994,['United States of America'],"['Action', 'Horror', 'Superhero movie', 'Martial Arts Film', 'Science Fiction']",1990,4
28623,Salò o le 120 giornate di Sodoma,1975,"['France', 'Italy']","['Crime Fiction', 'Art film', 'Thriller', 'World cinema', 'War film', 'Drama']",1970,5
1930290,Barbarella,1968,"['France', 'Italy']","['Fantasy Adventure', 'Superhero', 'Satire', 'Comedy', 'World cinema', 'Adventure', 'Parody', 'Superhero movie', 'Science Fiction', 'Cult', 'Fantasy']",1960,8
35755987,Ruma Maida,2009,['Indonesia'],['Drama'],2000,9
6809387,Poovellam Kettuppar,1999,['India'],"['Romantic drama', 'World cinema', 'Romance Film', 'Drama']",1990,9
483745,Real Genius,1985,['United States of America'],"['Coming of age', 'Indie', 'Comedy', 'Teen', 'Romantic comedy', 'Science Fiction', 'Cult']",1980,5
6300110,Americano,2005,"['Spain', 'United States of America']","['Romantic drama', 'Comedy', 'Romance Film', 'Drama']",2000,5
5251390,Getting Played,2005,['United States of America'],"['Romance Film', 'Romantic comedy', 'Comedy']",2000,5
14857092,The Man Who Wasn't There,1983,['United States of America'],"['Action', 'Action/Adventure', 'Comedy', 'Fantasy']",1980,3
25589916,Harmony Cats,1993,['Canada'],"['Musical', 'Indie', 'Comedy', 'Romance Film', 'Romantic comedy']",1990,3
26731539,Mayabazar,2009,['India'],"['Romance Film', 'Drama']",2000,9
6080132,Cotton Mary,1999,"['United Kingdom', 'France']","['British Empire Film', 'Period piece', 'Drama']",1990,9
883446,The Angry Red Planet,1959,['United States of America'],"['Creature Film', 'Horror', 'Adventure', 'Science Fiction', 'Cult']",1950,9
2255067,Vegas Vacation,1997,['United States of America'],"['Slapstick', 'Comedy']",1990,7
524139,Bottle Rocket,1996,['United States of America'],"['Crime Fiction', 'Coming of age', 'Indie', 'Buddy film', 'Comedy', 'Cult']",1990,6
22858261,Too Hot to Handle,1938,['United States of America'],"['Romantic comedy', 'Adventure', 'Drama']",1930,8
10072466,Tim Tyler's Luck,1937,['United States of America'],"['Action', 'Black-and-white', 'Crime Fiction', 'Adventure']",1930,7
18020900,Minnaminnikoottam,2008,['India'],"['Romance Film', 'Thriller']",2000,8
21152826,Bottoms Up,1934,['United States of America'],"['Musical', 'Drama']",1930,4
473253,Anna and the King,1999,['United States of America'],"['Period piece', 'Film adaptation', 'Romantic drama', 'Romance Film', 'Epic', 'Costume drama', 'Drama']",1990,9
6958567,Naram Garam,1981,['India'],"['Drama', 'Comedy']",1980,1
2151087,Shri 420,1955,['India'],"['Musical', 'Romantic drama', 'Bollywood', 'World cinema', 'Romance Film', 'Drama']",1950,5
3909547,Infection,2004,['Japan'],"['Japanese Movies', 'Horror', 'World cinema', 'Natural horror films']",2000,4
11063523,Even Money,2007,['United States of America'],"['Crime Fiction', 'Indie', 'Drama']",2000,7
2091547,Mystery of the Wax Museum,1933,['United States of America'],"['Mystery', 'Thriller', 'Horror', 'Pre-Code']",1930,3
77460,Boxing Helena,1993,['United States of America'],"['Psychological thriller', 'Erotic Drama', 'Indie', 'Romantic drama', 'Romance Film', 'Drama', 'Suspense', 'Erotic thriller']",1990,3
4333214,I'll Always Know What You Did Last Summer,2006,['United States of America'],"['Psychological thriller', 'Slasher', 'Teen', 'Horror', 'Supernatural']",2000,6
4035081,The War Zone,1999,"['United Kingdom', 'England', 'Italy']","['Coming of age', 'Family Drama', 'Indie', 'Drama']",1990,9
3551202,Butterfly,2004,['Hong Kong'],"['LGBT', 'Drama', 'Chinese Movies']",2000,4
17702522,Resisting Enemy Interrogation,1944,['United States of America'],"['Black-and-white', 'Propaganda film', 'Documentary']",1940,4
3520849,Rip Girls,2000,"['United States of America', 'Australia']",['Family Film'],2000,0
7534925,Johns,1996,['United States of America'],"['Gay Themed', 'LGBT', 'Gay', 'Drama', 'Indie', 'Gay Interest', 'Romance Film']",1990,6
27622180,The Singer and the Dancer,1977,['Australia'],['Drama'],1970,7
1141483,Bonjour tristesse,1958,['United States of America'],['Drama'],1950,8
13745576,Daresalam,2000,"['Burkina Faso', 'France']","['World cinema', 'War film', 'Political drama', 'Drama']",2000,0
16285823,Kailashey Kelenkari,2007,['India'],"['Musical', 'Thriller', 'Bollywood', 'World cinema']",2000,7
1836615,Through a Glass Darkly,1961,['Sweden'],"['Black-and-white', 'Art film', 'World cinema', 'Drama']",1960,1
19772822,Circus,2009,['India'],['Thriller'],2000,9
15799422,Branded,1950,['United States of America'],"['Action/Adventure', 'Western']",1950,0
1514718,The Wash,2001,['United States of America'],"['Action', 'Action/Adventure', 'Comedy', 'Thriller']",2000,1
21132240,Teeth,2007,['United States of America'],"['Comedy', 'Thriller', 'Horror', 'Black comedy', 'Cult', 'Natural horror films']",2000,7
24160634,Hearts of the West,1975,['United States of America'],"['Western', 'Comedy']",1970,5
25684136,Basement Jack,2009,['United States of America'],"['Slasher', 'Horror']",2000,9
673694,Young Guns,1988,['United States of America'],"['Action', 'Crime Fiction', 'Western', 'Comedy', 'Thriller']",1980,8
14123005,I Live in Grosvenor Square,1945,['United Kingdom'],"['Black-and-white', 'War film', 'Comedy']",1940,5
8455434,Desmond & the Swamp Barbarian Trap,2006,['Sweden'],['Stop motion'],2000,6
5526916,Naked Weapon,2002,['Hong Kong'],"['Action', 'Action Thrillers', 'Action/Adventure', 'Thriller', 'World cinema', 'Romance Film', 'Chinese Movies', 'Martial Arts Film', 'Drama']",2000,2
6558617,Dreams That Money Can Buy,1947,['United States of America'],"['Experimental film', 'Surrealism', 'Avant-garde']",1940,7
6102364,The Brave Little Toaster to the Rescue,1999,['United States of America'],"['Animation', ""Children's"", 'Comedy', 'Family-Oriented Adventure', ""Children's/Family"", 'Adventure', 'Family Film']",1990,9
30217005,Beware of Pity,1946,['United Kingdom'],['Drama'],1940,6
4862696,Dudley Do-Right,1999,"['Canada', 'United States of America']","['Slapstick', 'Comedy', 'Romance Film', 'Adventure', 'Family Film']",1990,9
6168251,Downhill Racer,1969,['United States of America'],"['Sports', 'Drama']",1960,9
11346977,Jaal,1952,['India'],"['Mystery', 'Musical']",1950,2
8455316,Bratz: The Movie,2007,['United States of America'],"['Music', 'Comedy', 'Family Film']",2000,7
1365985,Bob & Carol & Ted & Alice,1969,['United States of America'],"['Satire', 'Comedy', 'Romance Film', 'Drama', 'Parody', 'Romantic comedy', 'Comedy-drama', 'Comedy of manners', 'Sex comedy']",1960,9
1210303,Constantine,2005,"['Germany', 'United States of America']","['Action', 'Drama', 'Mystery', 'Horror', 'Fantasy']",2000,5
9246010,The Revolt of Mamie Stover,1956,['United States of America'],"['Romance Film', 'Romantic drama', 'Drama']",1950,6
23223276,Women Talking Dirty,1999,['United Kingdom'],"['Drama', 'Indie', 'Romantic drama', 'Comedy', 'Romance Film', 'Romantic comedy']",1990,9
2414949,Death Watch,1980,"['France', 'Scotland', 'West Germany']","['Future noir', 'Science Fiction']",1980,0
3143823,Prisoner of Honor,1991,['United Kingdom'],"['Period piece', 'Television movie', 'Political drama', 'Drama', 'Courtroom Drama']",1990,1
1031545,Bushido Blade,1981,"['United Kingdom', 'United States of America']","['Period piece', 'Samurai cinema', 'Action/Adventure', 'Political drama', 'Martial Arts Film', 'Adventure', 'Drama']",1980,1
803276,Gwendoline,1984,['France'],"['Action', 'Film adaptation', 'Action/Adventure', 'Thriller', 'World cinema', 'Drama', 'Sexploitation', 'Erotic thriller']",1980,4
5507687,Straight from the Barrio,2008,['Puerto Rico'],"['Crime Fiction', 'World cinema', 'Crime Drama', 'Drama']",2000,8
19998249,Saathi,1968,['India'],"['Romance Film', 'Drama']",1960,8
1488619,Killdozer,1974,['United States of America'],"['Horror', 'Science Fiction']",1970,4
9795798,In Love and War,1958,['United States of America'],"['Film adaptation', 'Romantic drama', 'Romance Film', 'War film', 'Drama']",1950,8
18691454,One Meat Brawl,1947,['United States of America'],"['Short Film', 'Comedy']",1940,7
6179073,Less Than Zero,1987,['United States of America'],"['Crime Fiction', 'Teen', 'Romance Film', 'Drama']",1980,7
26358856,Judaai,1980,['India'],['Bollywood'],1980,0
163438,Ronin,1998,"['United Kingdom', 'United States of America']","['Action', 'Spy', 'Crime Fiction', 'Action Thrillers', 'Chase Movie', 'Thriller']",1990,8
1069758,The Toy,1982,['United States of America'],"['Coming of age', 'Slapstick', 'Buddy film', 'Comedy', 'Family Film']",1980,2
13174839,Eye in the Sky,2007,"['China', 'Hong Kong']","['Action', 'Action Thrillers', 'Action/Adventure', 'Thriller', 'World cinema', 'Crime Thriller', 'Chinese Movies']",2000,7
14461347,Made of Honor,2008,"['United Kingdom', 'United States of America']","['Romance Film', 'Romantic comedy', 'Comedy']",2000,8
3050069,Rosewood,1997,['United States of America'],"['Action', 'Crime Fiction', 'History', 'Docudrama', 'Political drama', 'Drama']",1990,7
31268917,Victim of Love,1991,['United States of America'],"['Psychological thriller', 'Mystery', 'Thriller', 'Romance Film', 'Drama', 'Suspense', 'Erotic thriller', 'Television movie']",1990,1
2339186,A Tale of Two Sisters,2003,['South Korea'],"['Psychological thriller', 'Mystery', 'Horror', 'World cinema', 'Drama']",2000,3
393505,The Great Rock 'n' Roll Swindle,1980,['United Kingdom'],"['Music', 'Rockumentary', 'Mockumentary', 'Biography', 'Documentary', 'Punk rock']",1980,0
7075890,Train of Life,1998,"['France', 'Romania', 'Belgium']","['Comedy', 'Romance Film', 'Comedy-drama', 'Tragicomedy', 'War film']",1990,8
26333494,The Hawk's Nest,1928,['United States of America'],"['Action', 'Crime Fiction', 'Drama']",1920,8
4852050,Sachein,2005,['India'],"['Musical', 'Romantic drama', 'Bollywood', 'World cinema', 'Romance Film', 'Drama']",2000,5
24784399,Hadersfild,2007,['Serbia'],['Drama'],2000,7
534792,Child's Play,1988,['United States of America'],"['Psychological thriller', 'Mystery', 'Indie', 'Slasher', 'Horror', 'Supernatural', 'Cult']",1980,8
27375017,The Good Guys and the Bad Guys,1969,['United States of America'],"['Action/Adventure', 'Western', 'Comedy', 'Drama']",1960,9
26039774,Troublesome Night 13,2002,['Hong Kong'],"['Chinese Movies', 'Horror']",2000,2
30988459,The Sorrow of Mrs. Schneider,2008,"['Albania', 'Czech Republic']","['Romance Film', 'Drama']",2000,8
19492718,Love Aaj Kal,2009,['India'],"['Musical', 'Romantic drama', 'Comedy', 'Bollywood', 'World cinema', 'Romance Film', 'Drama']",2000,9
18826666,We Married Margo,2000,['United States of America'],"['Indie', 'Buddy film', 'Comedy', 'Romance Film', 'Romantic comedy']",2000,0
25896239,Tora-san's Song of Love,1983,['Japan'],['Japanese Movies'],1980,3
3645302,Deadline Auto Theft,1983,['United States of America'],['Comedy'],1980,3
7361776,Ils se marièrent et eurent beaucoup d'enfants,2004,['France'],"['Romantic drama', 'Comedy', 'World cinema', 'Romance Film', 'Romantic comedy', 'Comedy-drama', 'Drama']",2000,4
8115952,The Soong Sisters,1997,['Hong Kong'],"['Romantic drama', 'Biographical film', 'World cinema', 'Romance Film', 'Docudrama', 'Chinese Movies', 'Drama', 'Biopic [feature]', 'Melodrama', 'Historical fiction', 'Political drama']",1990,7
29677803,Chal Chala Chal,2009,['India'],"['Musical', 'Romantic drama', 'Comedy', 'Bollywood', 'World cinema', 'Romance Film', 'Drama']",2000,9
35408676,The Beautiful City,2004,['Iran'],['Drama'],2000,4
24742411,The Missing Person,2009,['United States of America'],"['Detective fiction', 'Crime Fiction', 'Mystery', 'Indie', 'Comedy', 'Thriller', 'Crime Thriller', 'Drama', 'Detective']",2000,9
18724599,Annychka,1969,['Ukraine'],['Drama'],1960,9
9366011,Harriet the Spy,1996,['United States of America'],"['Spy', 'Comedy', 'Comedy-drama', 'Adventure', 'Drama', 'Family Film']",1990,6
3636498,Saw III,2006,"['Canada', 'United States of America']","['Psychological thriller', 'Crime Fiction', 'Slasher', 'Thriller', 'Horror']",2000,6
1191975,Urban Cowboy,1980,['United States of America'],"['Romantic drama', 'Marriage Drama', 'Romance Film', 'Drama']",1980,0
32561435,Don't Play the Fool,1997,[],"['Crime Fiction', 'Adventure', 'Comedy film']",1990,7
5139144,Torture Garden,1967,['United Kingdom'],"['Thriller', 'Horror']",1960,7
27088127,Sanam,1997,['India'],"['Romance Film', 'Drama']",1990,7
1832104,The Unfaithful Wife,1969,['France'],"['Marriage Drama', 'Thriller', 'World cinema', 'Crime Drama', 'Drama']",1960,9
27748210,Danger Route,1967,['United Kingdom'],"['Action', 'Spy', 'Film adaptation', 'Action/Adventure', 'Thriller', 'Drama']",1960,7
410036,Dante's Peak,1997,['United States of America'],"['Action', 'Action/Adventure', 'Thriller', 'Doomsday film', 'Disaster', 'Adventure']",1990,7
4806367,Trishul,1978,['India'],"['Drama', 'Bollywood', 'World cinema']",1970,8
10554740,Carmen Jones,1954,['United States of America'],"['Musical', 'Romance Film', 'Drama']",1950,4
2209301,Beyond the Mat,1999,['United States of America'],"['Documentary', 'Extreme Sports', 'Sports', 'Culture & Society']",1990,9
31079361,Wings of the Morning,1937,['United Kingdom'],"['Romance Film', 'Drama']",1930,7
6688421,Nobody's Perfect,1968,['United States of America'],['Comedy'],1960,8
29836661,Snatched,1973,['United States of America'],[],1970,3
1751093,Kid Galahad,1962,['United States of America'],"['Musical', 'Boxing', 'Sports']",1960,2
5979008,The Hitcher 2,2003,['United States of America'],"['Psychological thriller', 'Suspense', 'Thriller', 'Crime Thriller']",2000,3
16794053,Quarantine,2008,['United States of America'],"['Mystery', 'Thriller', 'Horror', 'Zombie Film', 'Disaster', 'Science Fiction']",2000,8
1621292,Mighty Joe Young,1949,['United States of America'],"['Black-and-white', 'Stop motion', 'Drama', 'Fantasy']",1940,9
24555544,Alice Solves the Puzzle,1925,['United States of America'],"['Animation', 'Short Film', 'Family Film']",1920,5
1931336,The Last Time I Committed Suicide,1997,['United States of America'],"['Period piece', 'Indie', 'Biography', 'Biopic [feature]', 'Drama']",1990,7
769066,Alice in Wonderland,1951,['United States of America'],"['Music', 'Animation', ""Children's"", 'Costume drama', 'Adventure', 'Drama', 'Family Film', 'Fantasy']",1950,1
26991731,Mother Teresa: In the Name of God's Poor,1997,"['United Kingdom', 'Germany', 'United States of America']","['Biography', 'Biographical film', 'Docudrama', 'Hagiography', 'Drama']",1990,7
1907778,H2O,2004,['Canada'],['Drama'],2000,4
9807152,Secret of the Incas,1954,['United States of America'],"['Action/Adventure', 'Adventure']",1950,4
25526651,Casablanca Express,1988,['Italy'],"['Action', 'Drama', 'Action/Adventure', 'World cinema', 'War film']",1980,8
16167808,Kovilpatti Veeralakshmi,2003,['India'],[],2000,3
14616734,The Pit,1981,['Canada'],"['Mystery', 'Thriller', 'Horror', 'Science Fiction']",1980,1
3395805,Blackmail,1939,['United States of America'],"['Black-and-white', 'Crime Fiction', 'Drama']",1930,9
20581186,Hulchul,1971,['India'],"['Thriller', 'World cinema']",1970,1
7392111,Mad Monster Party,1969,['United States of America'],"['Animation', 'Monster', 'Satire', 'Comedy', 'Stop motion', ""Children's/Family"", 'Cult', 'Drama', 'Creature Film', 'Monster movie', 'Parody', 'Horror', 'Science Fiction', 'Family Film']",1960,9
4041456,Can Of Worms,1999,['United States of America'],"['Family-Oriented Adventure', 'Science Fiction']",1990,9
358367,Pete's Dragon,1977,['United States of America'],"['Musical', 'Fantasy Adventure', 'Animation', ""Children's/Family"", 'Adventure', ""Children's Fantasy"", 'Family Film', 'Fantasy']",1970,7
30975925,Lady Cocoa,1975,['United States of America'],"['Blaxploitation', 'Crime Fiction', 'Drama']",1970,5
26709815,Dirty Work,1934,['United Kingdom'],"['Romance Film', 'Crime Fiction', 'Comedy']",1930,4
31155043,Laila Majnu,1962,[],['Romance Film'],1960,2
11437460,Main Yuvraj,2008,['India'],"['Musical', 'Romantic drama', 'Bollywood', 'World cinema', 'Drama']",2000,8
2396120,The Man,2005,"['Germany', 'United States of America']","['Action', 'Crime Fiction', 'Action/Adventure', 'Buddy film', 'Comedy']",2000,5
2250713,'68,1988,"['Hungary', 'United States of America']","['Period piece', 'Coming of age', 'Family Drama', 'Drama']",1980,8
12800965,The Last Minute,2001,"['United Kingdom', 'United States of America']","['Drama', 'Mystery', 'Thriller']",2000,1
1743769,The League of Gentlemen's Apocalypse,2005,"['United Kingdom', 'United States of America']","['Black comedy', 'Comedy', 'Horror Comedy']",2000,5
19413701,Scandalo Segreto,1989,['Italy'],"['Marriage Drama', 'Drama']",1980,9
32374620,Sthreedhanam,1993,[],"['Drama', 'Family Film']",1990,3
12117643,The Signal,2007,['United States of America'],"['Psychological thriller', 'Indie', 'Action/Adventure', 'Thriller', 'Black comedy', 'Zombie Film', 'Disaster', 'Horror', 'Doomsday film', 'Science Fiction', 'Cult']",2000,7
7874798,The Widowmaker,1990,[],['Drama'],1990,0
3132962,Burnt by the Sun,1994,"['Russia', 'France']","['History', 'Family Drama', 'Comedy', 'World cinema', 'Political drama', 'Drama', 'Tragedy']",1990,4
10542419,Love and Duty,1931,['China'],"['Black-and-white', 'Indie', 'Silent film', 'Chinese Movies']",1930,1
16036533,Anna M.,2007,['France'],"['Thriller', 'Drama']",2000,7
2727959,Brokedown Palace,1999,['United States of America'],"['Prison', 'Crime Fiction', 'Thriller', 'Melodrama', 'Drama', 'Courtroom Drama']",1990,9
376920,Bandini,1963,['India'],"['Musical', 'Art film', 'Thriller', 'Bollywood', 'World cinema', 'Drama']",1960,3
18006073,Daisy,1988,['India'],"['Musical', 'Romance Film']",1980,8
19968061,Dear Lemon Lima,2009,['United States of America'],"['Drama', 'Indie', 'Short Film', 'Comedy', 'Teen', 'Comedy-drama']",2000,9
19799403,Chinta,1948,['Malaysia'],['Romance Film'],1940,8
19460334,The Key,1958,['United Kingdom'],"['Black-and-white', 'Romantic drama', 'Romance Film', 'War film', 'Drama']",1950,8
26014548,Insan,2005,['India'],"['Action/Adventure', 'World cinema', 'War film', 'Drama']",2000,5
26104950,Pelli Chesi Choodu,1952,['India'],"['Drama', 'Comedy film']",1950,2
8605097,Prête-moi ta main,2006,['France'],"['Romantic drama', 'Comedy', 'World cinema', 'Romance Film', 'Romantic comedy', 'Drama']",2000,6
26183882,A Cricket in the Ear,1976,['Bulgaria'],['Comedy film'],1970,6
8592074,The Yacoubian Building,2006,['Egypt'],"['LGBT', 'World cinema', 'Comedy-drama', 'Drama', 'Slice of life story']",2000,6
15465392,Underworld: Rise of the Lycans,2009,"['New Zealand', 'United States of America']","['Action', 'Action/Adventure', 'Gothic Film', 'Thriller', 'Costume Horror', 'Period piece', 'Horror', 'Fantasy']",2000,9
8757507,Surge of Power: The Stuff of Heroes,2004,['United States of America'],['Comedy'],2000,4
186856,The Omen,1976,"['United Kingdom', 'United States of America']","['Psychological thriller', 'Mystery', 'Demonic child', 'Horror', 'Supernatural', 'Cult']",1970,6
2533372,The Heroic Trio,1993,['Hong Kong'],"['Action', 'Fantasy Adventure', 'Superhero', 'Action/Adventure', 'World cinema', 'Chinese Movies', 'Martial Arts Film', 'Adventure', 'Superhero movie', 'Science Fiction', 'Fantasy']",1990,3
9060639,Wolf Girl,2001,"['Canada', 'Romania']","['Teen', 'Horror']",2000,1
685938,It,1990,"['Canada', 'United States of America']","['Mystery', 'Thriller', 'Horror', 'Stop motion', 'Supernatural', 'Drama']",1990,0
746845,Cliffhanger,1993,"['France', 'Italy', 'United States of America']","['Action', 'Action Thrillers', 'Action/Adventure', 'Thriller', 'Sports']",1990,3
12245150,Dosar,2006,['India'],"['Musical', 'Art film', 'Bollywood', 'World cinema', 'Drama']",2000,6
9197200,Strange Culture,2006,['United States of America'],"['Social issues', 'Law & Crime', 'Political cinema', 'Biography', 'Indie', 'Documentary', 'Culture & Society']",2000,6
8948572,The Sea Wolf,1941,['United States of America'],"['Adventure', 'Black-and-white']",1940,1
8943536,For Love of Ivy,1968,['United States of America'],"['Blaxploitation', 'Indie', 'Romantic drama', 'Comedy', 'Romance Film', 'Drama', 'Romantic comedy', 'Comedy-drama']",1960,8
7154611,The Man in Grey,1943,"['United Kingdom', 'England']","['Black-and-white', 'Romance Film', 'Melodrama', 'Drama']",1940,3
9248665,The Devils Nightmare,1971,"['Italy', 'Belgium']","['Horror', 'B-movie']",1970,1
32415578,The Eden Formula,2006,[],"['Thriller', 'Television movie', 'Science Fiction', 'Drama']",2000,6
3643855,The Bowery,1933,['United States of America'],"['Action', 'Black-and-white', 'Biopic [feature]', 'Pre-Code', 'Adventure', 'Drama']",1930,3
10387052,Without Reservations,1946,['United States of America'],"['Black-and-white', 'Comedy', 'Romance Film', 'Romantic comedy']",1940,6
3772864,The Great Water,2004,"['Republic of Macedonia', 'Germany', 'Czech Republic', 'United States of America']","['Childhood Drama', 'World cinema', 'War film', 'Political drama', 'Drama']",2000,4
10210570,UnCivil Liberties,2006,['United States of America'],"['Action', 'Action/Adventure', 'Thriller', 'Political thriller']",2000,6
907949,Bulworth,1998,['United States of America'],"['Political satire', 'Satire', 'Comedy', 'Media Satire', 'Romance Film', 'Americana', 'Drama', 'Political cinema', 'Parody', 'Political drama']",1990,8
24816719,The Jerusalem File,1972,['United States of America'],"['War film', 'Drama', 'Political drama']",1970,2
27744247,Happy New Year,1987,['United States of America'],"['Drama', 'Comedy']",1980,7
1751944,Lady Vengeance,2005,['South Korea'],"['Thriller', 'World cinema', 'Crime Thriller', 'Martial Arts Film', 'Drama']",2000,5
5416352,The Hidden II,1993,['United States of America'],"['Crime Fiction', 'Indie', 'Horror', 'Science Fiction']",1990,3
3951786,A Dog's Breakfast,2006,"['Canada', 'United States of America']","['Indie', 'Comedy', 'Comedy Thriller', 'Black comedy']",2000,6
92689,Nausicaä of the Valley of the Wind,1984,['Japan'],"['Action', 'Animation', 'Japanese Movies', 'Adventure', 'Anime', 'Science Fiction', 'Fantasy']",1980,4
8801140,Andha Yudh,1983,['India'],['Bollywood'],1980,3
21333650,Delincuente,1984,['Mexico'],"['Musical', 'Romance Film']",1980,4
1853749,Frankenstein Conquers the World,1965,['Japan'],"['Japanese Movies', 'World cinema', 'Horror', 'Costume Horror', 'Science Fiction', 'Drama']",1960,5
4777324,Itty Bitty Titty Committee,2007,['United States of America'],"['LGBT', 'Indie', 'Satire', 'Comedy', 'Romance Film', 'Gay Themed', 'Gay', 'Gay Interest']",2000,7
7057376,Magma Head,2003,['United States of America'],"['Short Film', 'Comedy', 'Horror']",2000,3
28332360,Zítra vstanu a opařím se čajem,1977,[],"['Science Fiction', 'Comedy film']",1970,7
4908122,A Thousand Acres,1997,['United States of America'],"['Courtroom Drama', 'Family Drama', 'Drama']",1990,7
31572382,Code of the Secret Service,1939,['United States of America'],"['Crime Fiction', 'Crime Thriller', 'Adventure']",1930,9
33899575,Raja,1999,['India'],"['Romance Film', 'Drama', 'Family Film']",1990,9
1856550,Priest,1994,['United Kingdom'],"['LGBT', 'Drama', 'Indie']",1990,4
6795776,Cage Without a Key,1975,['United States of America'],"['Crime Drama', 'Prison', 'Drama']",1970,5
13149824,Bloodstone,1988,"['India', 'United States of America']","['Action', 'Indie', 'Action/Adventure', 'Comedy', 'Adventure']",1980,8
5683112,American Ninja 4: The Annihilation,1990,['United States of America'],"['Action', 'Spy', 'Action/Adventure', 'Thriller', 'Martial Arts Film']",1990,0
19102889,Sikandar,2009,['India'],"['Thriller', 'World cinema', 'Political drama', 'Drama', 'Political thriller']",2000,9
13832907,Bondage,2006,['United States of America'],"['Crime Fiction', 'Indie', 'Drama']",2000,6
21395816,Chasing a Dream,2009,['United States of America'],"['Sports', 'Indie', 'Drama']",2000,9
30626576,Taqdeerwala,1995,['India'],"['Comedy', 'World cinema']",1990,5
997918,Ransom,1996,['United States of America'],"['Crime Fiction', 'Thriller']",1990,6
1399119,Assault on Precinct 13,1976,['United States of America'],"['Action', 'Suspense', 'Crime Fiction', 'Indie', 'Action/Adventure', 'Thriller']",1970,6
8432831,Undoing,2006,['United States of America'],"['Crime Fiction', 'Indie', 'Thriller', 'Crime Thriller', 'Drama']",2000,6
6563913,Prom Night II,1987,['Canada'],"['Indie', 'Slasher', 'Teen', 'Horror']",1980,7
16490854,Padikkadavan,2008,['India'],['Action'],2000,8
14826059,Encore,1951,['United Kingdom'],"['Film adaptation', 'Black-and-white', 'Romantic drama', 'Romance Film', 'Drama']",1950,1
23299465,Never Forget Me,1976,['South Korea'],"['Romance Film', 'Drama']",1970,6
10272267,The Babe,1992,['United States of America'],"['Period piece', 'Sports', 'Biography', 'Biographical film', 'Biopic [feature]', 'Drama']",1990,2
3804955,Gold Diggers of 1935,1935,['United States of America'],"['Musical', 'Black-and-white', 'Comedy', 'Musical comedy']",1930,5
25917990,Curse of the Forty-Niner,2003,['United States of America'],"['Slasher', 'Horror']",2000,3
16927051,Small Town Girl,1953,['United States of America'],"['Musical', 'Romance Film']",1950,3
12572406,Code Name Phoenix,2000,['United States of America'],"['Action', 'Crime Fiction', 'Science Fiction']",2000,0
22362799,A Broken Leghorn,1959,['United States of America'],"['Animation', 'Short Film', 'Comedy', 'Family Film']",1950,9
26164642,Vice Raid,1960,['United States of America'],"['Crime Fiction', 'Gangster Film', 'Drama']",1960,0
19063422,Tatsu,1994,"['Russia', 'United Kingdom']",['Drama'],1990,4
25929225,Malootty,1992,['India'],"['Drama', 'Comedy film']",1990,2
1495192,The Heart of the World,2000,['Canada'],"['Black-and-white', 'Indie', 'Short Film', 'Avant-garde', 'Experimental film', 'Silent film']",2000,0
32270127,Long Gone,1987,['United States of America'],"['Comedy film', 'Romance Film', 'Sports', 'Drama']",1980,7
29016432,Adaminte Vaariyellu,1983,['India'],['Drama'],1980,3
25781195,Son Osmanlı Yandım Ali,2007,['Turkey'],['Action'],2000,7
11586224,Path of Hope,1950,['Italy'],['Drama'],1950,0
21843327,The Damned Rain,2009,['India'],"['Drama', 'Comedy film']",2000,9
11853812,The Lathe of Heaven,1980,['United States of America'],"['Dystopia', 'Thriller', 'Science Fiction', 'Fantasy']",1980,0
3997113,The Resurrection of Broncho Billy,1970,['United States of America'],"['Short Film', 'Western']",1970,0
14343606,Nicholas Nickleby,1947,['United Kingdom'],"['Period piece', 'Film adaptation', 'Black-and-white', 'Drama']",1940,7
19175262,Bewafa Sanam,1995,['India'],['Drama'],1990,5
8407414,Dr. Devil and Mr. Hare,1964,['United States of America'],"['Animation', 'Short Film', 'Family Film']",1960,4
74293,The Mexican,2001,['United States of America'],"['Action', 'Crime Fiction', 'Action/Adventure', 'Comedy', 'Adventure', 'Crime Comedy', 'Romantic comedy', 'Road movie']",2000,1
2400089,Mickey's House of Villains,2002,['United States of America'],"['Animated cartoon', 'Animation', 'Comedy', 'Family-Oriented Adventure', ""Children's/Family"", 'Family Film']",2000,2
17951322,The Bat Whispers,1930,['United States of America'],"['Black-and-white', 'Mystery', 'Thriller', 'Horror', 'Haunted House Film']",1930,0
67417,Under Siege,1992,"['France', 'United States of America']","['Action', 'Action/Adventure', 'Thriller', 'Martial Arts Film']",1990,2
4286401,Mantrap,1983,['United Kingdom'],['Short Film'],1980,3
27004377,Storm Tracker,1999,['United States of America'],"['Action', 'Action/Adventure', 'Thriller', 'Disaster']",1990,9
3680204,Tarzan and His Mate,1934,['United States of America'],"['Black-and-white', 'Jungle Film', 'Adventure', 'Pre-Code']",1930,4
3000097,Winning London,2001,['United States of America'],"['Comedy', 'Teen', ""Children's/Family"", 'Family Film']",2000,1
19437340,Raktamukhi Neela,2008,['India'],['Thriller'],2000,8
10273045,The Street Fighter's Last Revenge,1974,['Japan'],"['Action', 'Crime Fiction', 'Action/Adventure', 'Thriller', 'World cinema', 'Martial Arts Film', 'Drama', 'Japanese Movies']",1970,4
10138363,Old Bones of the River,1938,['United Kingdom'],"['Comedy', 'Black-and-white']",1930,8
2173985,The Cheap Detective,1978,['United States of America'],"['Detective fiction', 'Crime Fiction', 'Mystery', 'Comedy', 'Thriller', 'Crime Thriller', 'Parody', 'Detective', 'Crime Comedy']",1970,8
689980,Mercury Rising,1998,['United States of America'],"['Action', 'Suspense', 'Action/Adventure', 'Thriller', 'Political thriller']",1990,8
28425804,Take Off,2009,['South Korea'],"['Sports', 'Drama']",2000,9
17618782,The Class,2008,['France'],"['Drama', 'World cinema']",2000,8
32151115,Arundhati,1967,['India'],['Musical'],1960,7
11686066,King of the Gypsies,1978,['United States of America'],"['Film adaptation', 'Drama']",1970,8
25081461,Defenseless,1991,['United States of America'],"['Suspense', 'Crime Fiction', 'Mystery', 'Thriller', 'Drama', 'Courtroom Drama']",1990,1
12384257,Sagebrush Trail,1933,['United States of America'],"['Action', 'B-Western', 'Black-and-white', 'Action/Adventure', 'Western']",1930,3
894764,Sweet November,2001,['United States of America'],"['Romantic drama', 'Romance Film', 'Romantic comedy', 'Drama']",2000,1
24877081,Orphans,1987,['United States of America'],['Drama'],1980,7
4423146,The Green Ray,1986,['France'],"['Romantic drama', 'World cinema', 'Romance Film', 'Drama']",1980,6
9545952,Night Nurse,1931,['United States of America'],"['Black-and-white', 'Crime Fiction', 'Gangster Film', 'Mystery', 'Pre-Code', 'Drama']",1930,1
8662846,Talaash: The Hunt Begins...,2003,['India'],"['Action', 'Musical', 'Action/Adventure', 'Thriller', 'Bollywood', 'World cinema', 'Romance Film']",2000,3
22332882,The Prime of Miss Jean Brodie,1969,['United Kingdom'],"['Period piece', 'Film adaptation', 'Coming of age', 'Drama']",1960,9
277158,America's Sweethearts,2001,['United States of America'],"['Romance Film', 'Romantic comedy', 'Comedy']",2000,1
1994850,Three... Extremes,2004,"['Hong Kong', 'South Korea', 'China', 'Japan']","['Psychological thriller', 'Chinese Movies', 'Japanese Movies', 'Horror', 'World cinema']",2000,4
1233247,Uzumaki,2000,['Japan'],"['Japanese Movies', 'Horror', 'World cinema', 'Science Fiction']",2000,0
5843609,Duel at Diablo,1966,['United States of America'],"['Action/Adventure', 'Western']",1960,6
9846863,Black Aura on an Angel,2004,['United States of America'],['Thriller'],2000,4
14173282,Soch,2002,['India'],"['Drama', 'World cinema']",2000,2
17971369,Choices of the Heart,1983,['United States of America'],['Drama'],1980,3
19285459,Admiral,2008,['Russia'],"['Period piece', 'Biographical film', 'Biopic [feature]', 'Romance Film', 'Historical fiction', 'War film', 'Drama']",2000,8
2552310,Jis Desh Mein Ganga Behti Hai,1960,['India'],"['Musical', 'Bollywood', 'World cinema', 'Drama']",1960,0
12256535,Wishmaster 2: Evil Never Dies,1999,['United States of America'],"['Creature Film', 'Supernatural', 'Horror']",1990,9
26108223,The Yellow Handkerchief,2009,['United States of America'],"['Film adaptation', 'Romantic drama', 'Indie', 'Romance Film', 'Drama']",2000,9
12752223,The New Adventures of the Elusive Avengers,1968,"['Russia', 'Soviet Union']","['Action', 'Action/Adventure', 'Comedy', 'World cinema']",1960,8
1330774,Thief,1981,['United States of America'],"['Action', 'Neo-noir', 'Crime Fiction', 'Gangster Film', 'Action/Adventure', 'Thriller', 'Crime Thriller', 'Heist']",1980,1
18050522,Baghead,2008,['United States of America'],"['Mumblecore', 'Indie', 'Comedy', 'Horror Comedy', 'Horror', 'Black comedy']",2000,8
31782191,Killer,1991,['India'],"['Action', 'Thriller']",1990,1
5893524,The Warrior And The Sorceress,1984,"['Argentina', 'United States of America']","['Fantasy Adventure', 'Action/Adventure', 'Sword and sorcery', 'Adventure', 'Sword and sorcery films', 'Fantasy']",1980,4
6006861,All Roads Lead Home,2006,[],"['Coming of age', 'Family Drama', 'Drama', 'Family Film']",2000,6
3540132,"Yes, But...",2001,['France'],"['Comedy', 'World cinema']",2000,1
3303044,Son of Dracula,1943,['United States of America'],"['Black-and-white', 'Horror']",1940,3
15771860,Thotta,2008,['India'],[],2000,8
73432,The Docks of New York,1928,['United States of America'],"['Black-and-white', 'Drama', 'Indie', 'Silent film']",1920,8
27738177,Company President's Secretary: Hunting Big Tit Sexual Harassment,2007,['Japan'],['Japanese Movies'],2000,7
27804251,The Hunger,1986,['Egypt'],"['Romance Film', 'Drama']",1980,6
35225167,Kizhakku Mugam,1996,['India'],[],1990,6
4207564,Twelve and Holding,2006,['United States of America'],"['Coming of age', 'Indie', 'Drama']",2000,6
14843008,In the Nick of Time,1991,['United States of America'],"['Comedy', 'Family Film', 'Fantasy']",1990,1
6334524,Moondance Alexander,2007,['United States of America'],"['Family Drama', 'Teen', ""Children's/Family"", 'Adventure', 'Drama', 'Sports', 'Coming of age', 'Animal Picture', 'Comedy-drama', 'Family Film']",2000,7
2375110,The Last Journey,1935,['United Kingdom'],"['Black-and-white', 'Crime Fiction', 'Drama']",1930,5
155997,Boyz N the Hood,1991,['United States of America'],"['Crime Fiction', 'Coming of age', 'Teen', 'Drama']",1990,1
15828540,John Rabe,2009,"['France', 'Germany', 'China']","['Chinese Movies', 'History', 'World cinema', 'Docudrama', 'Drama']",2000,9
20288060,Mastan,2004,['India'],['Thriller'],2000,4
3619129,Evelyn,2002,"['United Kingdom', 'Germany', 'Ireland', 'Netherlands', 'United States of America']","['Period piece', 'Family Drama', 'World cinema', 'Drama', 'Courtroom Drama']",2000,2
2542332,Serial Lover,1998,['France'],"['Black comedy', 'Comedy', 'Thriller']",1990,8
593921,The Pillow Book,1996,"['Luxembourg', 'Japan', 'United Kingdom', 'France', 'England', 'Netherlands']","['LGBT', 'Erotic Drama', 'Indie', 'Romantic drama', 'Avant-garde', 'World cinema', 'Romance Film', 'Drama', 'Japanese Movies', 'Experimental film']",1990,6
2020413,Savage Dawn,1985,['United States of America'],"['Action', 'Drama', 'Indie', 'Action/Adventure', 'Thriller']",1980,5
14812463,A Man's Gotta Do,2004,['Australia'],"['Crime Fiction', 'Comedy', 'Crime Comedy', 'Drama']",2000,4
21114814,A Ripple in the Pond,1952,"['Greece', 'Egypt']",['Comedy'],1950,2
5170425,Haqeeqat,1964,['India'],"['Bollywood', 'War film']",1960,4
13401806,Too Much Sex,2000,['Canada'],"['Romantic comedy', 'Comedy', 'Sex comedy']",2000,0
4662798,Naan Kadavul,2009,['India'],"['Action/Adventure', 'World cinema']",2000,9
36344884,Zamana,1985,['India'],"['Action', 'Drama', 'Crime Fiction', 'Thriller', 'Romance Film']",1980,5
27746362,Older Office Lady: Using Her Seductive Tongue,2005,['Japan'],['Japanese Movies'],2000,5
12147856,Shark!,1969,"['Mexico', 'United States of America']","['Action', 'Action Thrillers', 'Indie', 'Action/Adventure', 'Thriller', 'Adventure']",1960,9
21545922,About Elly,2009,['Iran'],"['Mystery', 'Drama', 'World cinema']",2000,9
31419907,Kasargod Khader Bhai,1992,[],['Comedy film'],1990,2
1405697,Don't Look Now,1973,"['United Kingdom', 'Italy']","['Psychological thriller', 'Mystery', 'Thriller', 'Drama', 'Suspense', 'Horror', 'Erotica', 'Supernatural']",1970,3
24019441,Dark Streets,2008,['United States of America'],"['Neo-noir', 'Drama', 'Crime Fiction', 'Indie', 'Film noir']",2000,8
18679622,Poverty and Nobility,1954,['Italy'],['Comedy'],1950,4
7283294,The Lighthorsemen,1987,['Australia'],"['Action', 'Docudrama', 'War film', 'Adventure', 'Drama']",1980,7
1688109,White Mischief,1987,"['United Kingdom', 'England', 'United States of America']","['British Empire Film', 'Period piece', 'Crime Fiction', 'Thriller', 'Romance Film', 'Drama']",1980,7
11608397,Hare Lift,1952,['United States of America'],"['Comedy', 'Family Film']",1950,2
32655212,On Our Selection,1932,[],['Comedy film'],1930,2
11022379,How Tasty Was My Little Frenchman,1971,['Brazil'],"['Comedy', 'Horror', 'World cinema', 'Historical fiction', 'Adventure', 'Drama']",1970,1
23269349,The Eliminator,2004,['United States of America'],"['Action', 'Action/Adventure', 'Thriller']",2000,4
34296753,Jaan Tere Naam,1992,['India'],['Romance Film'],1990,2
12751960,The Deal,2008,"['South Africa', 'Canada', 'United States of America']","['Film adaptation', 'Drama', 'Indie', 'Parody', 'Satire', 'Comedy', 'Romance Film']",2000,8
2561519,Sole Sisters,2003,['France'],['Comedy'],2000,3
703807,Mighty Morphin' Power Rangers: The Movie,1995,"['Japan', 'United States of America']","['Action', 'Thriller', 'Teen', 'Adventure', 'Japanese Movies', 'Science Fiction', 'Family Film', 'Fantasy']",1990,5
1589945,The Care Bears Adventure in Wonderland,1987,['Canada'],"['Musical', 'Animation', 'Fantasy']",1980,7
4102520,Secret Agent,1947,['Soviet Union'],['Spy'],1940,7
3728120,Aathi,2006,['India'],"['Action', 'Musical', 'Romantic drama', 'Thriller', 'World cinema', 'Tamil cinema', 'Romance Film', 'Drama']",2000,6
28026828,Irresistible,2006,['Australia'],"['Psychological thriller', 'Mystery', 'Thriller', 'World cinema', 'Drama']",2000,6
18952889,"It's a Mad, Mad, Mad, Mad World",1963,['United States of America'],"['Action', 'Crime Fiction', 'Chase Movie', 'Comedy', 'Adventure', 'Family Film', 'Ensemble Film']",1960,3
12815919,El hombre que se quiso matar,1942,['Spain'],"['Comedy', 'Black-and-white']",1940,2
16690127,Tum Teav,2003,['Cambodia'],"['Romance Film', 'Tragedy']",2000,3
23927178,You Will Be Mine,2009,['France'],"['Music', 'LGBT', 'Drama']",2000,9
24810964,Retour à l'aube,1938,['France'],"['Romance Film', 'Drama']",1930,8
25751867,Kuttettan,1990,['India'],"['Action', 'Comedy-drama']",1990,0
2159835,Girls Just Want to Have Fun,1985,['United States of America'],"['Musical', 'Indie', 'Comedy', 'Teen']",1980,5
31607,The Day After,1983,['United States of America'],"['Television movie', 'Science Fiction', 'Drama']",1980,3
26220990,The Immersion,1979,['India'],['Drama'],1970,9
1214211,Notre musique,2004,"['Switzerland', 'France']","['Essay Film', 'Art film', 'Avant-garde', 'World cinema', 'Experimental film', 'Drama']",2000,4
931311,Reign: The Conqueror,1997,"['Hong Kong', 'South Korea', 'Japan']","['Action', 'Chinese Movies', 'Drama', 'Period piece', 'Japanese Movies', 'Short Film', 'Historical Epic', 'Anime', 'Fantasy']",1990,7
10628870,Valli,1993,['India'],[],1990,3
27306414,Pancho Barnes,1988,['United States of America'],"['Action', 'Drama', 'Adventure']",1980,8
10979337,Live!,2007,['United States of America'],"['Suspense', 'Drama', 'Indie', 'Comedy', 'Media Satire', 'Mockumentary']",2000,7
2724358,Brown Sugar,2002,['United States of America'],"['Musical', 'Coming of age', 'Comedy', 'Romantic comedy', 'Romance Film', 'Drama']",2000,2
32775316,Dharti Kahe Pukar Ke,2006,[],"['Drama', 'Family Film']",2000,6
6770577,Sweet Land,2005,['United States of America'],"['Period piece', 'Romantic drama', 'Indie', 'Romance Film', 'Drama']",2000,5
7529510,Thamizh,2002,['India'],"['Romantic drama', 'World cinema', 'Romance Film', 'Drama']",2000,2
9055525,Manevri na petiya etazh,1985,['Bulgaria'],['Comedy'],1980,5
15545307,Annabelle's Wish,1997,['United States of America'],"['Animated Musical', 'Family-Oriented Adventure', ""Children's/Family"", 'Holiday Film']",1990,7
22491933,The Water,2009,['Canada'],"['Short Film', 'Drama']",2000,9
699609,John Carpenter's Escape from L.A.,1996,['United States of America'],"['Action', 'Dystopia', 'Action/Adventure', 'Science Fiction', 'Thriller', 'Cult']",1990,6
474031,Laurel Canyon,2002,['United States of America'],"['Music', 'Musical', 'Erotic Drama', 'Indie', 'Drama']",2000,2
2292441,Tokyo Drifter,1966,['Japan'],"['Action', 'Drama', 'Crime Fiction', 'Thriller']",1960,6
11539531,Aaghaaz,2000,['India'],"['Action', 'Crime Fiction', 'Gangster Film', 'Romance Film', 'Drama']",2000,0
390867,UHF,1989,['United States of America'],"['Indie', 'Parody', 'Satire', 'Comedy', 'Media Satire', 'Absurdism']",1980,9
3606943,Blue Steel,1934,['United States of America'],"['Western', 'Black-and-white', 'Action/Adventure']",1930,4
13129799,Bulldog Drummond Strikes Back,1947,['United States of America'],"['Black-and-white', 'Mystery', 'Comedy', 'Adventure']",1940,7
3192886,All about the Benjamins,2002,"['Germany', 'United States of America']","['Action', 'Crime Fiction', 'Action/Adventure', 'Buddy film', 'Comedy', 'Heist', 'Action Comedy', 'Crime Comedy']",2000,2
30160141,Future Zone,1990,['United States of America'],"['Science Fiction', 'Time travel']",1990,0
6149341,Behind Enemy Lines: Axis of Evil,2006,['United States of America'],"['Action', 'Action/Adventure', 'Thriller']",2000,6
1172207,Voodoo Academy,2000,['United States of America'],"['Indie', 'Teen', 'Horror', 'B-movie', 'Supernatural']",2000,0
2569670,Hanussen,1988,['Hungary'],['Drama'],1980,8
22348093,Nelly's Folly,1961,['United States of America'],"['Animation', 'Short Film', 'Family Film']",1960,1
1144172,Sideways,2004,['United States of America'],"['Road movie', 'Buddy film', 'Comedy', 'Romance Film', 'Romantic comedy', 'Comedy-drama', 'Drama']",2000,4
4825726,Rosario Tijeras,2005,"['Brazil', 'Spain', 'Mexico', 'Colombia']","['Crime Fiction', 'Action/Adventure', 'Thriller', 'World cinema', 'Crime Thriller']",2000,5
9497934,I Was Monty's Double,1958,['United Kingdom'],"['History', 'Biopic [feature]', 'Comedy-drama', 'War film', 'Drama']",1950,8
23552894,Bed and Sofa,1927,['Soviet Union'],"['Satire', 'Comedy film', 'Silent film', 'Drama']",1920,7
16718585,Armored,2009,['United States of America'],"['Action', 'Heist', 'Drama', 'Thriller', 'Crime Thriller']",2000,9
5189834,The Reckoning,2003,"['United Kingdom', 'Spain']","['Period piece', 'Film adaptation', 'Crime Fiction', 'Mystery', 'Thriller', 'Crime Thriller', 'Drama']",2000,3
11677522,Madman,1982,['United States of America'],"['Indie', 'Slasher', 'Teen', 'Horror', 'Cult']",1980,2
990764,The Wild Thornberrys Movie,2002,['United States of America'],"['Adventure Comedy', 'Animated cartoon', 'Animation', 'Comedy', 'Family-Oriented Adventure', ""Children's/Family"", 'Adventure']",2000,2
32075870,Hum Se Hai Zamana,1983,['India'],"['Drama', 'World cinema']",1980,3
3030582,The Scarlet Letter,1995,['United States of America'],"['Period piece', 'Film adaptation', 'Romantic drama', 'Romance Film', 'Costume drama', 'Drama']",1990,5
2698372,Eight Below,2006,['United States of America'],"['Romance Film', 'Family-Oriented Adventure', 'Adventure', 'Drama', 'Family Film']",2000,6
14672065,Mother Wore Tights,1947,['United States of America'],['Musical'],1940,7
4409112,Quinceañera,2006,['United States of America'],"['LGBT', 'Drama', 'Indie']",2000,6
34506695,Housewives on the Job,1973,['West Germany'],"['Erotica', 'Comedy film', 'Adult']",1970,3
17256886,Keoma,1976,['Italy'],"['Action/Adventure', 'Western', 'World cinema', 'Spaghetti Western']",1970,6
18552901,Ramji Rao Speaking,1989,['India'],['Comedy'],1980,9
4217293,Bloodbath at the House of Death,1984,['United Kingdom'],"['Parody', 'Horror Comedy', 'Comedy', 'Horror', 'Haunted House Film']",1980,4
2103169,Red Scorpion,1989,"['United States of America', 'South Africa']","['Action', 'Action Thrillers', 'Action/Adventure', 'Thriller']",1980,9
30741260,Stage Mother,1933,['United States of America'],"['Musical', 'Musical Drama', 'Drama']",1930,3
23123057,Fanfan,1993,['France'],"['Romance Film', 'Romantic comedy', 'Comedy']",1990,3
25584574,The Inspector,1962,"['United Kingdom', 'United States of America']","['Thriller', 'Drama']",1960,2
25697925,Rangula Ratnam,1966,['India'],['Drama'],1960,6
5694083,"Hard Days, Hard Nights",1989,['West Germany'],['Drama'],1980,9
9014571,At Midnight I'll Take Your Soul,1963,['Brazil'],"['Black-and-white', 'Supernatural', 'Horror']",1960,3
36449472,Madly in Love,1981,['Italy'],"['Romance Film', 'Comedy film']",1980,1
24759133,Desatanakkili Karayarilla,1986,[],['Drama'],1980,6
23624370,Pressure Point,1962,['United States of America'],['Drama'],1960,2
27213793,Raising a Riot,1955,['United Kingdom'],['Comedy'],1950,5
31434543,The Belly Dancer and the Politician,1990,['Egypt'],['Drama'],1990,0
3521389,Quel maledetto treno blindato,1978,['Italy'],"['Action', 'Exploitation', 'Heist', 'Action/Adventure', 'Thriller', 'World cinema', 'War film']",1970,8
3492280,Drive Me Crazy,1999,['United States of America'],"['Comedy', 'Teen', 'Romance Film', 'Romantic comedy', 'Comedy-drama']",1990,9
26084240,Brushfire,1962,['United States of America'],"['Adventure', 'Drama']",1960,2
8247418,Thillu Mullu,1981,['India'],"['Comedy', 'World cinema']",1980,1
19269176,The Outside Man,1972,"['France', 'Italy', 'United States of America']","['Crime Fiction', 'Action Thrillers', 'Gangster Film', 'Thriller', 'Crime Thriller']",1970,2
4502456,Hunk,1987,['United States of America'],"['Indie', 'Comedy', 'Romance Film', 'Romantic comedy', 'Fantasy']",1980,7
7526692,Ironheart,1992,['United States of America'],"['Action', 'Crime Fiction', 'Martial Arts Film', 'Adventure']",1990,2
4926317,Arch of Triumph,1985,['United Kingdom'],"['Romantic drama', 'Remake', 'Romance Film', 'Political drama', 'Drama']",1980,5
23972445,My Dear Secretary,1948,['United States of America'],"['Black-and-white', 'Comedy', 'Romance Film', 'Drama']",1940,8
19744076,Chintamani,1937,['India'],['Romance Film'],1930,7
21475159,Khel,2003,['India'],"['Action/Adventure', 'World cinema']",2000,3
29196894,The New Age,1994,['United States of America'],"['Parody', 'Comedy', 'Black comedy', 'Drama']",1990,4
21584569,Amma,1949,['Sri Lanka'],['Drama'],1940,9
12739295,The Grand,2008,['United States of America'],"['Parody', 'Ensemble Film', 'Comedy', 'Mockumentary']",2000,8
5689695,The Bullfighters,1945,['United States of America'],"['Satire', 'Slapstick', 'Comedy']",1940,5
3814288,Face,2004,['South Korea'],"['World cinema', 'Horror']",2000,4
284676,Once Upon a Time in the West,1968,"['Italy', 'United States of America']","['Action', 'Revisionist Western', 'Action/Adventure', 'World cinema', 'Spaghetti Western', 'Epic Western', 'Western', 'Ensemble Film']",1960,8
1881893,Monster-in-Law,2005,"['Germany', 'United States of America']","['Romance Film', 'Romantic comedy', 'Comedy']",2000,5
516463,The Return of the King,1980,"['Japan', 'United States of America']","['Fantasy Adventure', 'Animation', 'Adventure', 'Drama', 'Sword and sorcery films', ""Children's Fantasy"", 'Japanese Movies', 'Family Film', 'Fantasy']",1980,0
31706613,A Ticklish Affair,1963,['United States of America'],"['Romantic drama', 'Comedy', 'Romance Film', 'Romantic comedy', 'Drama']",1960,3
4431656,Take the Lead,2006,['United States of America'],"['Musical', 'Biopic [feature]', 'Dance', 'Drama']",2000,6
19196701,My Heroes Have Always Been Cowboys,1991,['United States of America'],"['Indie', 'Western', 'Drama']",1990,1
8013123,Zwarte Zwanen,2005,['Netherlands'],['Drama'],2000,5
1134100,Hell Divers,1931,['United States of America'],"['Action', 'Black-and-white', 'War film', 'Adventure', 'Drama']",1930,1
11696301,Deathdream,1974,"['United Kingdom', 'United States of America', 'Canada']","['Creature Film', 'Indie', 'Slasher', 'Horror', 'Zombie Film']",1970,4
6425379,Night Of A 1000 Cats,1972,['Mexico'],"['Crime Fiction', 'Slasher', 'Thriller', 'Horror', 'Teen', 'Supernatural', 'Adventure']",1970,2
16327739,Counter-Attack,1945,['United States of America'],"['War film', 'Black-and-white']",1940,5
6452715,Císařův pekař a pekařův císař,1952,['Czechoslovakia'],['Comedy'],1950,2
6980450,Emotional Arithmetic,2008,"['Canada', 'United States of America']","['Period piece', 'Film adaptation', 'Drama']",2000,8
1549293,"Hitler, Beast of Berlin",1939,['United States of America'],"['Propaganda film', 'Drama']",1930,9
479457,Eraser,1996,['United States of America'],"['Action', 'Action Thrillers', 'Chase Movie', 'Action/Adventure', 'Thriller']",1990,6
9653770,We're Not Married!,1952,['United States of America'],"['Black-and-white', 'Comedy', 'Romance Film', 'Romantic comedy']",1950,2
24640712,Judy Berlin,1999,['United States of America'],"['Indie', 'Drama']",1990,9
31563536,Hatey Bazarey,1967,['India'],"['Drama', 'World cinema']",1960,7
8707459,Hi Diddle Diddle,1943,['United States of America'],"['Black-and-white', 'Screwball comedy', 'Comedy', 'Romance Film', 'Romantic comedy']",1940,3
142417,Apollo 13,1995,['United States of America'],"['History', 'Adventure', 'Drama']",1990,5
2714689,Das Arche Noah Prinzip,1984,"['Germany', 'West Germany']",['Science Fiction'],1980,4
27617814,Jarrett,1973,['United States of America'],"['Detective fiction', 'Mystery', 'Detective', 'Adventure']",1970,3
20044790,Just Peck,2009,['United States of America'],"['Comedy', 'Family Film']",2000,9
12891285,Mauvaise Graine,1934,['France'],"['Comedy', 'Crime Comedy', 'World cinema', 'Comedy-drama', 'Drama']",1930,4
12515584,The Car Man,2001,['United Kingdom'],"['Romance Film', 'Romantic drama', 'Drama']",2000,1
4918808,Scaramouche,1952,['United States of America'],"['Action', 'Film adaptation', 'Action/Adventure', 'Remake', 'Swashbuckler films', 'Adventure', 'Drama']",1950,2
10807893,Gamperaliya,1964,['Sri Lanka'],['Drama'],1960,4
4886997,Chica de Río,2003,['United Kingdom'],"['Romance Film', 'Romantic comedy', 'Comedy']",2000,3
2518527,Hum Saath-Saath Hain: We Stand United,1999,['India'],['Bollywood'],1990,9
19697999,Moll Flanders,1996,"['Ireland', 'United States of America']","['Romance Film', 'Drama']",1990,6
22320215,Pasanga,2009,['India'],['Drama'],2000,9
4497658,Sidehackers,1969,['United States of America'],"['Action', 'Sports', 'Drama']",1960,9
16204877,Bedtime Stories,2008,['United States of America'],"['Fantasy Adventure', ""Children's Fantasy"", 'Comedy', 'Fantasy Comedy', 'Family Film', 'Fantasy']",2000,8
18456519,The Storm Warriors,2009,['Hong Kong'],"['Action', 'Fantasy Adventure', 'Action/Adventure', 'World cinema', 'Chinese Movies', 'Adventure', 'Wuxia', 'Fantasy']",2000,9
17181725,Utsab,2000,['India'],"['Art film', 'World cinema', 'Family Film', 'Drama']",2000,0
27070087,Boogie,2008,['Romania'],"['Drama', 'Comedy']",2000,8
29460674,Indiscreet,1998,['United States of America'],['Thriller'],1990,8
4429858,The Knack...and How to Get It,1965,['United Kingdom'],"['Black-and-white', 'Comedy', 'Romance Film', 'Romantic comedy', 'British New Wave', 'Sex comedy']",1960,5
10499315,Mama's Boy,2007,['United States of America'],"['Coming of age', 'Comedy', 'Domestic Comedy', 'Comedy-drama', 'Slice of life story']",2000,7
11891565,Black House,2007,['South Korea'],"['Horror', 'World cinema', 'Drama', 'Haunted House Film']",2000,7
293623,Secret Agent,1936,"['United Kingdom', 'England']","['Spy', 'Suspense', 'Black-and-white', 'Thriller', 'Drama']",1930,6
10946054,"Sally, Irene and Mary",1925,['United States of America'],"['Black-and-white', 'Comedy', 'Silent film', 'Comedy-drama', 'Drama']",1920,5
16301666,The Unborn,2009,['United States of America'],"['Mystery', 'Thriller', 'Horror', 'Supernatural']",2000,9
27862386,Surprise Surprise,2009,['United States of America'],"['Gay Themed', 'LGBT', 'Drama']",2000,9
31454049,Ten Minutes to Live,1932,['United States of America'],"['Musical', 'Mystery', 'Drama']",1930,2
5693400,Common Ground,2000,['United States of America'],"['LGBT', 'Drama']",2000,0
19580547,Seafood,2001,"['China', 'Hong Kong']","['Chinese Movies', 'Indie', 'Drama']",2000,1
9979,Eyes Wide Shut,1999,"['United Kingdom', 'United States of America']","['Surrealism', 'Psychological thriller', 'Erotic Drama', 'Mystery', 'Thriller', 'Romance Film', 'Drama', 'Marriage Drama', 'Erotic thriller', 'Erotica']",1990,9
26334230,Club Fed,1990,['United States of America'],"['Prison', 'Parody', 'Comedy']",1990,0
31489265,The Mystical Adventures of Billy Owens,2008,['Canada'],"['Adventure', 'Family Film', 'Fantasy']",2000,8
23811860,For My Daughter's Honor,1996,['United States of America'],"['Family Drama', 'Television movie', 'Drama', 'Courtroom Drama']",1990,6
4685891,History Is Made at Night,1937,['United States of America'],"['Black-and-white', 'Comedy', 'Drama']",1930,7
7415751,Poor Cinderella,1934,['United States of America'],"['Musical', 'Animation', 'Short Film', 'Comedy', 'Fantasy']",1930,4
10763417,My Suicide,2008,['United States of America'],"['Drama', 'Indie', 'Coming of age', 'Comedy', 'Romantic comedy', 'Black comedy', 'Comedy-drama']",2000,8
2045991,Now and Then,1995,['United States of America'],"['Crime Fiction', 'Indie', 'Comedy', 'Teen', 'Romance Film', 'Drama', 'Period piece', 'Coming of age', 'Comedy-drama', 'Ensemble Film']",1990,5
13387836,Luna de Avellaneda,2004,['Argentina'],"['Indie', 'Drama']",2000,4
8328948,A Wrinkle in Time,2003,['Canada'],"['Fantasy Adventure', 'Film adaptation', ""Children's/Family"", 'Adventure', 'Drama', ""Children's Fantasy"", 'Television movie', 'Science Fiction', 'Family Film', 'Fantasy']",2000,3
208814,The Blue Dahlia,1946,['United States of America'],"['Black-and-white', 'Crime Fiction', 'Mystery', 'Thriller', 'Film noir', 'Crime Thriller', 'Drama']",1940,6
24963370,Of Rice and Hen,1953,[],"['Animation', 'Short Film', 'Comedy film', 'Family Film']",1950,3
1858604,The Execution of Private Slovik,1974,['United States of America'],"['Anti-war', 'Anti-war film', 'Docudrama', 'War film', 'Drama']",1970,4
23101996,Guy,1997,"['United Kingdom', 'Germany', 'United States of America']",['Drama'],1990,7
5239682,10.5: Apocalypse,2006,['United States of America'],"['Action', 'Action/Adventure', 'Thriller', 'Television movie', 'Natural disaster', 'Disaster']",2000,6
5433016,Saaya,2003,['India'],"['Musical', 'Mystery', 'Romantic drama', 'Thriller', 'Bollywood', 'World cinema', 'Romance Film', 'Drama', 'Horror']",2000,3
350321,Cherry 2000,1987,['United States of America'],"['Action', 'Indie', 'Comedy', 'Apocalyptic and post-apocalyptic fiction', 'Adventure', 'Road movie', 'Doomsday film', 'Science Fiction', 'Cult']",1980,7
15217227,"To You, From Me",1994,['South Korea'],"['Adult', 'Romance Film', 'Erotica', 'Drama']",1990,4
24604442,The Play of God,1997,['India'],['Drama'],1990,7
3415524,Amarkalam,1999,['India'],"['Action', 'Tamil cinema']",1990,9
9535065,The Day of the Jackal,1973,"['United Kingdom', 'France']","['Action', 'Crime Fiction', 'Action/Adventure', 'Thriller', 'Political thriller']",1970,3
4780536,Thiruvilayadal,1965,['India'],"['Musical', 'Drama', 'Family Film']",1960,5
31923499,Ormakkayi,1982,[],"['Drama', 'Family Film']",1980,2
18959676,Nasaan Ka Man,2005,['Philippines'],"['Filipino Movies', 'Family Drama', 'World cinema', 'Romance Film', 'Drama']",2000,5
5230828,The New Land,1972,['Sweden'],"['Western', 'Drama']",1970,2
22989558,Anantaram,1987,['India'],['Drama'],1980,7
15478024,The Painted Hills,1951,['United States of America'],"['Action/Adventure', 'Family-Oriented Adventure', ""Children's/Family"", 'Adventure', 'Drama', 'Western', 'Animal Picture', 'Family Film']",1950,1
15480666,Les parents terribles,1948,['France'],['Romantic drama'],1940,8
1047835,Way of the Dragon,1972,['Hong Kong'],"['Chinese Movies', 'Martial Arts Film']",1970,2
22427855,Adam,2009,['United States of America'],"['Drama', 'Indie', 'Romantic drama', 'Comedy', 'Romance Film', 'Comedy-drama']",2000,9
18070632,A Ton of Luck,2006,['Colombia'],"['Action/Adventure', 'Comedy', 'Crime Comedy', 'World cinema', 'Comedy-drama']",2000,6
1516678,"Hips, Hips, Hooray!",1934,['United States of America'],"['Musical', 'Black-and-white', 'Comedy']",1930,4
6170621,Herod's Law,1999,['Mexico'],"['Political cinema', 'Political satire', 'Satire', 'Comedy', 'World cinema']",1990,9
1005379,Pompeii: The Last Day,2003,['United Kingdom'],"['Action/Adventure', 'World History', 'Disaster', 'Drama', 'Period piece', 'History', 'Television movie', 'Historical fiction']",2000,3
1585387,Street Fighter II: The Animated Movie,1994,['Japan'],"['Action', 'Animation', 'Japanese Movies', 'Action/Adventure', 'World cinema', 'Anime', 'Martial Arts Film']",1990,4
28286752,Flaming Hearts,1978,['West Germany'],['Drama'],1970,8
32372785,Runaway,1995,['South Korea'],"['Action', 'Thriller']",1990,5
736262,The Sure Thing,1985,['United States of America'],"['Comedy', 'Teen', 'Romance Film', 'Adventure', 'Drama', 'Coming of age', 'Romantic comedy', 'Road movie']",1980,5
13093390,The Boys & Girls Guide to Getting Down,2006,['United States of America'],"['Indie', 'Comedy']",2000,6
2459695,The Killing of a Chinese Bookie,1976,['United States of America'],"['Crime Fiction', 'Gangster Film', 'Indie', 'Crime Drama', 'Drama']",1970,6
11472483,Dance of the Dwarfs,1983,"['Philippines', 'United States of America']","['Filipino Movies', 'Horror', 'Adventure', 'Fantasy']",1980,3
16419638,Pilnyeo,1970,['South Korea'],['Drama'],1970,0
5843155,The Birds and the Bees,1956,['United States of America'],"['Musical', 'Crime Fiction', 'Screwball comedy', 'Romantic drama', 'Comedy', 'Romance Film', 'Drama', 'Romantic comedy']",1950,6
5620636,The Violent Men,1955,['United States of America'],"['Action', 'B-Western', 'Western', 'Action/Adventure']",1950,5
3380602,Another You,1991,['United States of America'],"['Screwball comedy', 'Buddy film', 'Comedy', 'Crime Comedy']",1990,1
3671146,A Room with a View,1985,['United Kingdom'],"['Period piece', 'Film adaptation', 'Romantic drama', 'Romance Film', 'Drama']",1980,5
27371888,I Love a Mystery,1945,['United States of America'],['Mystery'],1940,5
16731304,10:30 P.M. Summer,1966,"['Spain', 'United States of America']","['Film adaptation', 'Romantic drama', 'Romance Film', 'Melodrama', 'Drama']",1960,6
5164749,The Young Ones,1961,['United Kingdom'],"['Musical', 'Comedy']",1960,1
15371303,Defiance of a Teenager,1959,['South Korea'],"['Action', 'Romance Film', 'Drama']",1950,9
5468633,Day Zero,2007,['United States of America'],"['Indie', 'Political drama', 'Drama']",2000,7
9366283,Prudence and the Pill,1968,['United Kingdom'],"['Romance Film', 'Comedy', 'Sex comedy']",1960,8
27445372,Mr. Vampire IV,1988,['Hong Kong'],"['Chinese Movies', 'Horror']",1980,8
26601056,Decent Parties,2009,['India'],"['Romance Film', 'Drama']",2000,9
32967308,The Adorable Outcast,1928,[],['Silent film'],1920,8
3289723,Transamerica,2005,['United States of America'],"['LGBT', 'Indie', 'Family Drama', 'Comedy', 'Drama', 'Gay Themed', 'Gay', 'Gay Interest', 'Comedy-drama', 'Road movie']",2000,5
3078987,Carry On Girls,1973,['United Kingdom'],"['Parody', 'Comedy', 'Sex comedy']",1970,3
19609060,Union City,1980,['United States of America'],"['Thriller', 'Crime Thriller']",1980,0
1059662,Floating Weeds,1959,['Japan'],"['Art film', 'Japanese Movies', 'World cinema', 'Drama']",1950,9
1693880,The Night and the Moment,1994,[],"['Period piece', 'Film adaptation', 'Erotic Drama', 'Romantic drama', 'Romance Film', 'Erotica', 'Drama']",1990,4
11492833,Spies,1943,['United States of America'],"['Short Film', 'Animation']",1940,3
10370838,Il Generale della Rovere,1959,"['France', 'Italy']","['Black-and-white', 'Crime Fiction', 'Art film', 'World cinema', 'War film', 'Drama']",1950,9
5073042,Hatchet,2007,['United States of America'],"['Indie', 'Slasher', 'Horror', 'Black comedy', 'Cult']",2000,7
3078054,Carnal Madness,1975,['United States of America'],"['Drama', 'Comedy']",1970,5
1641666,The Young Poisoner's Handbook,1995,"['United Kingdom', 'France', 'Germany']","['Crime Fiction', 'Comedy', 'Black comedy', 'Comedy-drama', 'Drama']",1990,5
27441441,Trouble in the Glen,1954,['United Kingdom'],"['Comedy', 'Comedy of manners']",1950,4
9024508,The Parent Trap IV: Hawaiian Honeymoon,1989,['United States of America'],"['Comedy', 'Drama', 'Family Film']",1980,9
24187257,Full Confession,1939,['United States of America'],"['Black-and-white', 'Crime Fiction', 'Melodrama', 'Drama']",1930,9
27595922,The Dirk Diggler Story,1988,['United States of America'],"['Short Film', 'Biographical film', 'Mockumentary', 'Drama']",1980,8
34102388,The Newman Shame,1977,[],['Thriller'],1970,7
8796061,The Ant Bully,2006,['United States of America'],"['Animation', 'Comedy', 'Adventure', 'Family Film', 'Computer Animation']",2000,6
26469128,Veendum Chila Veettukaryangal,1999,['India'],"['Romance Film', 'Comedy', 'Drama']",1990,9
24725063,Terror in the Family,1996,['United States of America'],"['Family Drama', 'Melodrama', 'Television movie', 'Drama']",1990,6
2180837,Rebetiko,1983,['Greece'],"['Music', 'History', 'Biography', 'World cinema', 'War film', 'Drama']",1980,3
7189073,The Food of the Gods,1976,['United States of America'],"['Film adaptation', 'Monster', 'Drama', 'Creature Film', 'Natural horror films', 'Horror', 'B-movie', 'Science Fiction', 'Cult']",1970,6
2138030,Dev,2004,['India'],"['Drama', 'Bollywood', 'World cinema']",2000,4
31197106,C.I.D.,1990,['India'],"['Action', 'Thriller', 'Drama']",1990,0
12561843,Fantozzi,1975,['Italy'],"['Comedy-drama', 'Workplace Comedy', 'Comedy']",1970,5
33240879,Kadhal Kirukkan,2003,['India'],"['Romantic drama', 'Action/Adventure', 'World cinema', 'Romance Film', 'Drama']",2000,3
14503664,Sock-A-Bye Baby,1942,['United States of America'],"['Short Film', 'Black-and-white', 'Comedy']",1940,2
5795244,The Wicked City,1992,['Hong Kong'],"['Action', 'Science Fiction', 'Horror']",1990,2
4868957,The Story of Mankind,1957,['United States of America'],"['Historical fiction', 'Science Fiction', 'Fantasy']",1950,7
1188721,The Fighting Seabees,1944,['United States of America'],"['Action', 'Combat Films', 'Black-and-white', 'Action/Adventure', 'Adventure', 'War film']",1940,4
13056156,Everybody's woman,1934,['Italy'],"['Black-and-white', 'Drama']",1930,4
25491,The Rocky Horror Picture Show,1975,"['United Kingdom', 'United States of America']","['Musical', 'Comedy', 'Horror Comedy', 'Parody', 'Horror', 'Science Fiction', 'Cult', 'Sex comedy']",1970,5
4253777,Perdita Durango,1997,"['Spain', 'Mexico', 'United States of America']","['Action', 'Film adaptation', 'Crime Fiction', 'Indie', 'Action/Adventure', 'Comedy', 'World cinema', 'Black comedy', 'Drama', 'Horror']",1990,7
13058842,"Love, Pain & Vice Versa",2008,['Mexico'],"['Psychological thriller', 'Thriller', 'World cinema', 'Science Fiction', 'Drama']",2000,8
32024869,Dhuaan,1981,[],['Thriller'],1980,1
470185,Three Days of the Condor,1975,['United States of America'],"['Spy', 'Suspense', 'Mystery', 'Thriller', 'New Hollywood', 'Political thriller']",1970,5
4705514,One Good Cop,1991,['United States of America'],"['Action', 'Drama', 'Crime Fiction', 'Action/Adventure']",1990,1
24334645,Get Low,2009,"['Germany', 'Poland', 'United States of America']","['Crime Fiction', 'Mystery', 'Indie', 'Comedy', 'Black comedy', 'Romance Film', 'Drama', 'Period piece']",2000,9
11673194,Love Is a Ball,1963,['United States of America'],"['Film adaptation', 'Comedy', 'Romance Film', 'Romantic comedy', 'Drama']",1960,3
2168783,The Delta Force,1986,"['Israel', 'United States of America']","['Action', 'Action Thrillers', 'Action/Adventure', 'Thriller', 'Disaster', 'Martial Arts Film', 'Adventure', 'Drama', 'Airplanes and airports', 'War film']",1980,6
1350234,The Cardinal,1963,['United States of America'],"['Christian film', 'Drama']",1960,3
2450828,The Trouble with Men and Women,2003,['United Kingdom'],"['Romantic drama', 'Indie', 'Romance Film', 'Comedy-drama', 'Drama']",2000,3
11588549,Our Man in Havana,1959,['United Kingdom'],"['Spy', 'Film adaptation', 'Black-and-white', 'Political satire', 'Satire', 'Thriller', 'Comedy', 'Crime Thriller', 'Drama', 'Political thriller']",1950,9
5560593,The Puffy Chair,2005,['United States of America'],"['Mumblecore', 'Indie', 'Comedy', 'Romance Film', 'Drama', 'Romantic comedy', 'Comedy-drama', 'Road movie']",2000,5
2957019,The Phantom of the Opera,1990,"['France', 'Germany', 'Italy', 'United States of America']","['Music', 'Mystery', 'Horror', 'Drama']",1990,0
2296721,Cobra Verde,1987,"['Germany', 'West Germany']","['Adventure', 'Drama', 'World cinema']",1980,7
19902616,Surviving Sid,2008,['United States of America'],"['Short Film', 'Computer Animation']",2000,8
1186395,The Beguiled,1971,['United States of America'],"['Period piece', 'Melodrama', 'War film', 'Drama']",1970,1
12250991,Sakshatkara,1971,['India'],['Drama'],1970,1
5609683,The Snow Creature,1954,['United States of America'],"['Creature Film', 'Science Fiction', 'Horror']",1950,4
6506680,Crows and Sparrows,1949,['China'],"['Black-and-white', 'Drama', 'Chinese Movies']",1940,9
2795282,Runaway,1984,['United States of America'],"['Action', 'Film adaptation', 'Crime Fiction', 'Thriller', 'Science Fiction']",1980,4
11141640,Sathyaa,1988,['India'],"['Drama', 'Family Film']",1980,8
2971654,Lucky You,2006,"['United States of America', 'Australia']","['Romantic drama', 'Comedy', 'Romance Film', 'Sports', 'Drama']",2000,6
1922687,Momentum,2003,['United States of America'],"['Action', 'Action/Adventure', 'Thriller', 'Television movie', 'Crime Thriller', 'Science Fiction']",2000,3
14355632,Dreamboat,1952,['United States of America'],"['Black-and-white', 'Satire', 'Comedy']",1950,2
3375070,Port of Shadows,1938,['France'],"['Black-and-white', 'Crime Fiction', 'Art film', 'Romantic drama', 'Thriller', 'World cinema', 'Romance Film', 'Drama', 'Crime Drama', 'Melodrama']",1930,8
9318746,Saturday Night and Sunday Morning,1960,['United Kingdom'],"['Film adaptation', 'Romantic drama', 'Romance Film', 'British New Wave', 'Kitchen sink realism', 'Drama']",1960,0
33063765,The Wide Blue Road,1957,"['Yugoslavia', 'France', 'West Germany', 'Italy']","['World cinema', 'Romance Film', 'Melodrama', 'Drama']",1950,7
26976144,Fort Apache Napoli,2009,['Italy'],"['Crime Fiction', 'Biographical film', 'Drama']",2000,9
12685218,Lightning Jack,1994,"['United States of America', 'Australia']","['Action', 'Comedy Western', 'Action/Adventure', 'Western', 'Comedy', 'Adventure']",1990,4
5261356,Seven Minutes in Heaven,1985,['United States of America'],"['Romance Film', 'Comedy', 'Drama']",1980,5
11083203,La Viaccia,1961,['Italy'],"['Period piece', 'Black-and-white', 'Crime Drama', 'Drama']",1960,1
8317598,Lions for Lambs,2007,['United States of America'],"['Thriller', 'War film', 'Political drama', 'Drama', 'Ensemble Film']",2000,7
12746552,Avenging Angel,1985,['United States of America'],"['Action', 'Action/Adventure', 'Thriller', 'Crime Thriller']",1980,5
7895437,Soba,2004,['Mexico'],"['Drama', 'Crime Fiction', 'Indie', 'World cinema', 'Crime Drama']",2000,4
32025117,Taqdeer Ka Badshah,1982,['India'],['Action'],1980,2
461322,City of God,2002,"['Brazil', 'France']","['Action', 'Crime Fiction', 'Gangster Film', 'Thriller', 'World cinema', 'Drama', 'Period piece', 'Coming of age', 'Crime Drama']",2000,2
282964,The Killing,1956,['United States of America'],"['Suspense', 'Heist', 'Black-and-white', 'Crime Fiction', 'Thriller', 'Film noir', 'Drama']",1950,6
11695691,The Jolly Boys' Last Stand,2000,['United Kingdom'],"['Indie', 'Buddy film', 'Comedy', 'Comedy-drama', 'Drama']",2000,0
30981472,Kunwara,2000,['India'],['World cinema'],2000,0
9451117,Episode of Alabasta: The Desert Princess and the Pirates,2007,['Japan'],"['Action', 'Animation', 'Japanese Movies', 'Anime']",2000,7
7677006,The Raging Moon,1971,['United Kingdom'],"['Romance Film', 'Romantic drama', 'Drama']",1970,1
277710,Heartbreakers,2001,['United States of America'],"['Crime Fiction', 'Comedy', 'Romantic comedy', 'Romance Film']",2000,1
10193848,Hideaway,1995,['United States of America'],"['Suspense', 'Psychological thriller', 'Thriller', 'Horror', 'Crime Thriller', 'Supernatural']",1990,5
22160402,Time Bomb,1953,['United Kingdom'],"['Black-and-white', 'Thriller']",1950,3
20837994,Criminal Lovers,2000,['France'],"['Psychological thriller', 'Crime Fiction', 'Thriller', 'World cinema', 'Suspense', 'Horror', 'Crime Drama', 'Erotic thriller']",2000,0
15510926,Lady Killer,1933,['United States of America'],"['Black-and-white', 'Crime Fiction', 'Comedy', 'Drama']",1930,3
3616144,The Butterfly Effect 2,2006,['United States of America'],"['Psychological thriller', 'Thriller', 'Supernatural', 'Science Fiction', 'Drama']",2000,6
7276603,La Furia del Hombre Lobo,1972,['Spain'],"['World cinema', 'Horror']",1970,2
15782460,Hedwig and the Angry Inch,2001,['United States of America'],"['Musical', 'LGBT', 'Indie', 'Comedy', 'Drama', 'Romantic comedy', 'Comedy-drama', 'Cult']",2000,1
9195136,The Watcher,2000,['United States of America'],"['Psychological thriller', 'Suspense', 'Mystery', 'Thriller', 'Crime Thriller']",2000,0
2256164,Hellfighters,1968,['United States of America'],"['Disaster', 'Action/Adventure']",1960,8
31662759,Prema Kadha,1999,[],"['Romance Film', 'Tragedy']",1990,9
6647287,The Stooge,1952,['United States of America'],"['Musical', 'Comedy']",1950,2
8948359,Let's Do It Again,1975,['United States of America'],"['Boxing', 'Crime Fiction', 'Indie', 'Buddy film', 'Comedy', 'Sports']",1970,5
10640996,Padikkadavan,1986,['India'],[],1980,6
12913389,Lloyd,2001,['United States of America'],"['Comedy', ""Children's/Family"", 'Drama', 'Family Film']",2000,1
6189007,Mandala,1981,['South Korea'],['Drama'],1980,1
17456456,Five Children and It,2004,['United Kingdom'],"['Adventure', 'Family Film', 'Fantasy']",2000,4
11142076,Vrutham,1987,['India'],"['Action', 'Drama', 'Crime Fiction', 'Romance Film']",1980,7
4364536,A Million to Juan,1994,['United States of America'],"['Indie', 'Comedy', 'Comedy of manners']",1990,4
3016738,My First Mister,2001,"['Germany', 'United States of America']","['Drama', 'Indie', 'Coming of age', 'Comedy', 'Romantic comedy', 'Comedy-drama']",2000,1
1723357,Whirlpool,1949,['United States of America'],"['Psychological thriller', 'Black-and-white', 'Crime Fiction', 'Thriller', 'Film noir', 'Drama']",1940,9
3887641,The Andromeda Strain,1971,['United States of America'],"['Mystery', 'Science Fiction', 'Thriller']",1970,1
1368785,Freejack,1992,['United States of America'],"['Action', 'Film adaptation', 'Thriller', 'Drama', 'Time travel', 'Dystopia', 'Chase Movie', 'Science Fiction']",1990,2
4824326,Betsy's Wedding,1990,['United States of America'],"['Comedy', 'Romance Film', 'Romantic comedy', 'Domestic Comedy']",1990,0
2384090,Disciples of the 36th Chamber,1985,['Hong Kong'],"['Chinese Movies', 'Martial Arts Film', 'Comedy']",1980,5
2052646,Out of Time,2003,['United States of America'],"['Crime Fiction', 'Thriller', 'Crime Thriller', 'Drama']",2000,3
2861798,Vital,2004,['Japan'],"['Psychological thriller', 'Japanese Movies', 'Romantic drama', 'Thriller', 'World cinema', 'Romance Film', 'Drama']",2000,4
5698250,Libertarias,1996,['Spain'],"['Historical fiction', 'War film', 'Political drama', 'Drama']",1990,6
1573600,Family Plot,1976,['United States of America'],"['Psychological thriller', 'Detective fiction', 'Mystery', 'Comedy', 'Thriller', 'Black comedy', 'Crime Thriller', 'Suspense', 'Comedy Thriller', 'Detective']",1970,6
5731328,Tara Rum Pam Pam,2007,"['India', 'United States of America']","['Comedy film', 'Romance Film', 'Drama', 'Family Film']",2000,7
11074006,The Poppy Is Also a Flower,1966,"['France', 'Austria', 'United States of America']","['Spy', 'Crime Fiction', 'Drama']",1960,6
15420502,Hellmaster,1992,['United States of America'],"['Psychological thriller', 'Supernatural', 'Horror']",1990,2
7902926,Shahjahan,2001,['India'],"['Romantic drama', 'World cinema', 'Romance Film', 'Drama']",2000,1
20555109,Small Town Rivals,2007,['South Korea'],['Comedy'],2000,7
2332634,Death in Brunswick,1991,['Australia'],"['Crime Fiction', 'Comedy', 'Thriller']",1990,1
15554935,Black & White,2008,['India'],"['Musical', 'Bollywood', 'World cinema', 'Drama']",2000,8
18307974,Lange Flate Ballær 2,2008,['Norway'],"['War film', 'Comedy', 'Drama']",2000,8
18541519,Sun on a Hazy Day,1986,[],['Drama'],1980,6
3479886,Stardust,2007,"['United Kingdom', 'Iceland', 'United States of America']","['Film adaptation', 'Action/Adventure', 'Romantic drama', 'Romance Film', 'Costume drama', 'Adventure', 'Drama', 'Steampunk', 'Family Film', 'Fantasy']",2000,7
28874134,Bismarck,1940,['Germany'],"['Drama', 'Biographical film']",1940,0
22663672,The Dirt Bike Kid,1985,['United States of America'],"['Comedy', ""Children's/Family"", 'Adventure', 'Family Film', 'Fantasy']",1980,5
3644034,Blood for Dracula,1974,"['France', 'Italy']","['Drama', 'Indie', 'Comedy', 'Horror', 'B-movie', 'Costume Horror', 'Cult']",1970,4
12225994,Lake Dead,2007,['United States of America'],"['Slasher', 'Teen', 'Horror']",2000,7
21242801,The Far Horizons,1955,['United States of America'],"['Action/Adventure', 'Western', 'Biopic [feature]', 'Romance Film', 'Historical fiction', 'Adventure', 'Drama']",1950,5
1501461,The Temptations,1998,['United States of America'],"['Musical', 'Biography', 'Biographical film', 'Biopic [feature]', 'Musical Drama', 'Television movie', 'Drama']",1990,8
1054845,Pokémon: Destiny Deoxys,2005,"['Japan', 'United States of America']","['Action', 'Animated cartoon', 'Animation', 'Action/Adventure', ""Children's"", 'Adventure', 'Japanese Movies', 'Anime', 'Fantasy Comedy', 'Family Film']",2000,5
23276491,Ee Parakkum Thalika,2001,['India'],"['Romantic comedy', 'Comedy', 'Drama']",2000,1
12131002,Back to Bataan,1945,['United States of America'],"['Action', 'Combat Films', 'Black-and-white', 'Action/Adventure', 'War film', 'Drama']",1940,5
1612611,Encrypt,2003,"['Canada', 'United States of America']","['Action', 'Dystopia', 'Television movie', 'Science Fiction']",2000,3
26241103,La Choca,1974,['Mexico'],"['Action', 'Crime Fiction', 'Drama']",1970,4
5112304,Shadow Conspiracy,1997,['United States of America'],"['Action', 'Political thriller', 'Thriller']",1990,7
2056466,The Animal,2001,['United States of America'],"['Action', 'Action/Adventure', 'Comedy', 'Slapstick', 'Science Fiction']",2000,1
702632,Free Willy 2: The Adventure Home,1995,"['United States of America', 'France']","['Family Drama', 'Family-Oriented Adventure', ""Children's/Family"", 'Adventure', 'Drama', 'Coming of age', 'Animal Picture', 'Family Film']",1990,5
7815867,What's Cooking?,2000,"['United Kingdom', 'United States of America']","['Family Drama', 'Comedy', 'Domestic Comedy', 'Comedy-drama', 'Americana', 'Drama']",2000,0
3835239,The Power Within,1995,['United States of America'],"['Action', 'Action/Adventure', 'Martial Arts Film', 'Fantasy']",1990,5
28581081,Dropout,1970,['Italy'],"['Romance Film', 'Drama']",1970,0
6578012,Desire and Hell at Sunset Motel,1991,['United States of America'],"['Mystery', 'Indie', 'Comedy', 'Thriller', 'Black comedy']",1990,1
10320053,Kadhala Kadhala,1998,['India'],['Comedy'],1990,8
25681893,Di que sí,2004,['Spain'],['Comedy'],2000,4
7575627,Asterix Conquers America,1994,"['France', 'Germany']","['Animation', 'Adventure', 'Comedy film']",1990,4
652437,Armour of God,1986,['Hong Kong'],"['Comedy', 'Chinese Movies', 'Martial Arts Film', 'Adventure']",1980,6
2593362,Highwaymen,2004,"['Canada', 'United States of America']","['Action', 'Psychological thriller', 'Crime Fiction', 'Action/Adventure', 'Thriller', 'Crime Thriller']",2000,4
19347652,Lazy Days,1929,['United States of America'],"['Black-and-white', 'Short Film', 'Comedy', 'Family Film']",1920,9
28548430,The Last Days of Frankie the Fly,1997,['United States of America'],"['Action', 'Crime Fiction', 'Gangster Film', 'Thriller', 'Crime Drama', 'Crime Thriller', 'Drama']",1990,7
31304444,China,1943,['United States of America'],['War film'],1940,3
3667955,Angela's Ashes,1999,"['Ireland', 'United States of America']","['Period piece', 'Film adaptation', 'Coming of age', 'Family Drama', 'Biography', 'Drama']",1990,9
29759425,Lost Honeymoon,1947,['United States of America'],"['Romance Film', 'Romantic comedy', 'Comedy']",1940,7
2501693,Robin of Locksley,1996,['United States of America'],"['Comedy', 'Romantic comedy', 'Crime Thriller', 'Swashbuckler films', 'Adventure']",1990,6
6981094,War Hunt,1962,['United States of America'],"['Action', 'Drama', 'Action/Adventure', 'War film']",1960,2
35106919,Needhikku Thalaivanangu,1976,['India'],['Drama'],1970,6
5527653,Space Amoeba,1970,['Japan'],"['Japanese Movies', 'Thriller', 'World cinema', 'Science Fiction']",1970,0
11292060,Azur et Asmar,2006,"['Spain', 'Belgium', 'France', 'Italy']","['Animation', 'Fantasy', 'Adventure', 'Family Film', 'Computer Animation']",2000,6
18704092,The Black Six,1974,['United States of America'],"['Action', 'Blaxploitation', 'Biker Film', 'Outlaw biker film']",1970,4
15912142,The Old Man and the Sea,1958,['United States of America'],"['Film adaptation', 'Drama']",1950,8
10771128,Super Sweet 16: The Movie,2007,['United States of America'],"['Television movie', 'Comedy', 'Teen']",2000,7
29852202,The Flying Doctor,1936,['Australia'],['Drama'],1930,6
20981095,The Late George Apley,1947,['United States of America'],"['Romantic comedy', 'Black-and-white', 'Comedy']",1940,7
3533153,Hail the Conquering Hero,1944,['United States of America'],"['Black-and-white', 'Screwball comedy', 'Satire', 'Comedy', 'Comedy of Errors']",1940,4
18220708,Money Hai Toh Honey Hai,2008,['India'],"['Musical', 'Comedy', 'Bollywood', 'World cinema', 'Ensemble Film']",2000,8
34252872,Brahma Puthrudu,1988,['India'],"['Action', 'Adventure', 'Family Film']",1980,8
5257371,Is Paris Burning?,1966,"['France', 'United States of America']","['History', 'World cinema', 'War film', 'Drama', 'Ensemble Film']",1960,6
8502322,The History of Mr. Polly,1949,['United Kingdom'],"['Black-and-white', 'Drama']",1940,9
5476946,The Incredible Hulk,2008,['United States of America'],"['Action', 'Action/Adventure', 'Thriller', 'Superhero movie', 'Reboot', 'Science Fiction']",2000,8
9712166,Dead End Street,1982,['Israel'],"['Drama', 'World cinema']",1980,2
12343972,People Are Bunny,1959,['United States of America'],"['Animation', 'Short Film', 'Comedy film', 'Family Film']",1950,9
16727358,Zigs,2001,['United States of America'],['Drama'],2000,1
5671905,When Stand Up Stood Out,2003,[],"['Biography', 'Stand-up comedy', 'Comedy', 'Documentary']",2000,3
13938100,Windy Riley Goes Hollywood,1931,['United States of America'],"['Short Film', 'Black-and-white', 'Comedy']",1930,1
246658,Bwana Devil,1952,['United States of America'],"['Action', 'Period piece', 'Action/Adventure', 'Adventure']",1950,2
22575525,Fist of the Warrior,2009,['United States of America'],"['Action', 'Drama', 'Action Thrillers', 'Indie', 'Action/Adventure', 'Thriller', 'Martial Arts Film']",2000,9
25697457,Klimt,2006,"['Austria', 'United Kingdom', 'France', 'Germany']","['Period piece', 'Romantic drama', 'Biography', 'Romance Film', 'Drama']",2000,6
667945,Persona,1966,['Sweden'],"['Black-and-white', 'World cinema', 'Drama', 'Fantasy']",1960,6
6673788,Muta Mesthri,1993,['India'],"['Action', 'Drama']",1990,3
30171265,Life Begins at Eight-Thirty,1942,['United States of America'],['Drama'],1940,2
7839740,Pizza,2005,['United States of America'],"['Indie', 'Comedy', 'Romance Film', 'Romantic comedy']",2000,5
24759298,Nirmalayam,1973,['India'],['Drama'],1970,3
9530831,The Minx,2007,['United States of America'],"['Action', 'Detective fiction', 'Crime Fiction', 'Mystery', 'Indie', 'Action/Adventure', 'Comedy', 'Thriller', 'Drama', 'Detective']",2000,7
11952284,The Devil's Child,1997,['United States of America'],['Horror'],1990,7
4037159,My Name is Bruce,2007,['United States of America'],"['Parody', 'Comedy', 'Horror Comedy', 'Horror', 'Cult', 'Comedy of Errors']",2000,7
15202473,Julia Misbehaves,1948,['United States of America'],"['Romantic comedy', 'Black-and-white', 'Comedy']",1940,8
11258828,On the Edge of Innocence,1997,['United States of America'],['Drama'],1990,7
17511730,Conagher,1991,['United States of America'],"['Film adaptation', 'Revisionist Western', 'Action/Adventure', 'Western', 'Television movie', 'Drama']",1990,1
725984,Dick Tracy,1990,['United States of America'],"['Action', 'Crime Fiction', 'Action/Adventure', 'Thriller', 'Romance Film']",1990,0
14504334,Idle Roomers,1944,['United States of America'],"['Short Film', 'Black-and-white', 'Comedy']",1940,4
31132380,The Journalist,1967,['Soviet Union'],['Drama'],1960,7
26749011,Friesennot,1935,"['Nazi Germany', 'Germany']","['Propaganda film', 'Drama']",1930,5
5501627,"What Did You Do in the War, Daddy?",1966,['United States of America'],"['Parody', 'War film', 'Comedy']",1960,6
21194276,King of the Lost World,2005,['United States of America'],"['Action', 'Romantic fantasy', 'Adventure']",2000,5
9811711,Weird Woman,1944,['United States of America'],['Horror'],1940,4
1700874,Lotna,1959,['Poland'],"['War film', 'Drama', 'World cinema']",1950,9
25358590,Up From the Depths,1979,[],['Horror'],1970,9
5204767,Mutiny On The Bunny,1950,['United States of America'],"['Animation', 'Short Film', 'Comedy', 'Family Film']",1950,0
28856450,Flight from Folly,1945,['United Kingdom'],['Musical'],1940,5
1397377,"Planes, Trains and Automobiles",1987,['United States of America'],"['Airplanes and airports', 'Screwball comedy', 'Buddy film', 'Comedy', 'Road movie', 'Drama', 'Comedy of Errors']",1980,7
24963725,The Three Wishes of Billy Grier,1984,['United States of America'],"['Drama', 'Television movie']",1980,4
22882186,Death Song,1991,['South Korea'],['Drama'],1990,1
4556411,Love on the Run,1979,['France'],"['Drama', 'World cinema']",1970,9
2557883,Secret Beyond the Door...,1948,['United States of America'],"['Film noir', 'Psychological thriller', 'Black-and-white']",1940,8
2453601,Backwoods,2008,['United States of America'],"['Crime Thriller', 'Slasher', 'Thriller']",2000,8
4738587,Sailor Moon S the Movie,1994,['Japan'],"['Anime', 'Adventure', 'Fantasy']",1990,4
29892611,Cousin Bette,1998,"['United Kingdom', 'United States of America']","['Period piece', 'Comedy', 'World cinema', 'Romance Film', 'Drama']",1990,8
21875985,Singapore,1960,['India'],"['Action', 'Thriller']",1960,0
3382856,The American Astronaut,2001,['United States of America'],"['Musical', 'Indie', 'Action/Adventure', 'Musical comedy', 'Black comedy', 'Space western', 'Adventure', 'Western', 'Comedy film', 'Science Fiction']",2000,1
1179229,Sudden Impact,1983,['United States of America'],"['Action', 'Crime Fiction', 'Action Thrillers', 'Action/Adventure', 'Thriller']",1980,3
8753860,The Survivors,1983,['United States of America'],"['Screwball comedy', 'Comedy']",1980,3
10705512,On the Beach,1959,['United States of America'],"['Action/Adventure', 'Nuclear warfare', 'Doomsday film', 'Disaster', 'War film', 'Science Fiction', 'Drama']",1950,9
13915114,Mahayanam,1989,['India'],"['Action', 'Drama']",1980,9
1167226,The Powerpuff Girls Movie,2002,['United States of America'],"['Animation', 'Comedy', 'Family-Oriented Adventure', ""Children's/Family"", 'Adventure', 'Superhero movie', 'Family Film', 'Fantasy']",2000,2
729979,Amores perros,2000,['Mexico'],"['Drama', 'Thriller', 'Ensemble Film']",2000,0
8039722,"Wake Up, Ron Burgundy: The Lost Movie",2004,['United States of America'],"['Parody', 'Satire', 'Comedy']",2000,4
2390396,Hell Ride,2007,['United States of America'],"['Action', 'Drama', 'Indie', 'Action/Adventure', 'Thriller', 'Outlaw biker film']",2000,7
18432354,My Imprisoned Heart,2007,['United Kingdom'],['Drama'],2000,7
4015886,The King and I,1956,['United States of America'],"['Musical', 'Period piece', 'Romance Film', 'Costume drama', 'Drama', 'Family Film']",1950,6
11553544,Natutulog Pa Ang Diyos,1988,['Philippines'],['Filipino Movies'],1980,8
5311630,Monsieur Klein,1976,"['France', 'Italy']","['Crime Fiction', 'Mystery', 'Thriller', 'World cinema', 'War film', 'Drama']",1970,6
8291759,Lost,2004,['United States of America'],"['Action', 'Psychological thriller', 'Action/Adventure', 'Thriller', 'Crime Thriller']",2000,4
31937140,Prototype X29A,1992,['United States of America'],"['Action', 'Action/Adventure', 'Science Fiction', 'Thriller']",1990,2
28326154,For You Alone,1945,['United Kingdom'],['Musical'],1940,5
24064444,Sins of Silence,1996,['United States of America'],"['Drama', 'Horror']",1990,6
17346283,S. Darko,2009,['United States of America'],"['Psychological thriller', 'Crime Fiction', 'Mystery', 'Thriller', 'Teen', 'Coming of age', 'Supernatural', 'Science Fiction', 'Fantasy']",2000,9
80530,Hamlet,1948,['United Kingdom'],"['Film adaptation', 'Black-and-white', 'Roadshow theatrical release', 'Costume drama', 'Drama', 'Tragedy']",1940,8
22814902,Coco Chanel & Igor Stravinsky,2009,"['France', 'Switzerland', 'Japan']","['Romantic drama', 'Biographical film', 'World cinema', 'Romance Film', 'Drama', 'Period piece', 'Japanese Movies', 'Biopic [feature]', 'Melodrama']",2000,9
2182247,Let Him Have It,1991,['United Kingdom'],"['Crime Fiction', 'Crime Drama', 'Docudrama', 'Juvenile Delinquency Film', 'Drama', 'Courtroom Drama']",1990,1
18785526,The Magnet,1950,['United Kingdom'],"['Ealing Comedies', 'Comedy']",1950,0
15057370,Miss Gold Digger,2007,['South Korea'],['Romantic comedy'],2000,7
16830333,The Last Templar,2008,['Canada'],"['Television movie', 'Mystery', 'Thriller']",2000,8
33872851,The Lone Wolf Meets a Lady,1940,['United States of America'],"['Detective fiction', 'Crime Fiction', 'Mystery', 'Comedy', 'Detective', 'Drama']",1940,0
29475100,Berlin Calling,2008,['Germany'],"['Comedy', 'Drama', 'World cinema']",2000,8
4896031,Shaggy & Scooby-Doo Get a Clue!,2006,[],[],2000,6
2511267,Candy,2006,['Australia'],"['Romantic drama', 'Indie', 'World cinema', 'Romance Film', 'Drama']",2000,6
15656621,Fast & Furious,2009,['United States of America'],"['Action', 'Crime Fiction', 'Action Thrillers', 'Action/Adventure', 'Thriller', 'Auto racing', 'Drama', 'Chase Movie', 'Sports']",2000,9
5484444,Sweet November,1968,['United States of America'],['Drama'],1960,8
27320682,Home,2008,"['France', 'Switzerland', 'Belgium']","['Comedy', 'Drama', 'World cinema']",2000,8
7986246,Dark Ride,2006,['United States of America'],"['Slasher', 'Teen', 'Horror', 'Cult']",2000,6
7277111,Curse of the Devil,1973,"['Mexico', 'Spain']",['Horror'],1970,3
2559570,The World,2004,"['France', 'China', 'Japan']","['Japanese Movies', 'World cinema', 'Chinese Movies', 'Drama']",2000,4
26249449,Black Tight Killers,1966,['Japan'],"['Action', 'Action Thrillers', 'Japanese Movies', 'Action/Adventure', 'Thriller', 'World cinema', 'Drama']",1960,6
1686679,Tony Takitani,2005,['Japan'],"['Art film', 'Japanese Movies', 'Marriage Drama', 'World cinema', 'Drama']",2000,5
10387991,Bride for Sale,1949,['United States of America'],"['Workplace Comedy', 'Black-and-white', 'Comedy', 'Romance Film', 'Romantic comedy']",1940,9
2232503,Big Jake,1971,['United States of America'],"['Action/Adventure', 'Western']",1970,1
3703077,The Baby of Mâcon,1993,"['Belgium', 'United Kingdom', 'France', 'Germany', 'Netherlands']","['Period piece', 'History', 'Drama']",1990,3
3056404,Vampire in Brooklyn,1995,['United States of America'],"['Comedy', 'Horror Comedy', 'Horror', 'Black comedy']",1990,5
4594202,Body Melt,1993,"['New Zealand', 'Australia']","['Thriller', 'Horror', 'World cinema', 'Science Fiction']",1990,3
958387,Final Justice,1984,['United States of America'],"['Action', 'Crime Fiction', 'Indie', 'Action/Adventure', 'Thriller', 'Crime Thriller']",1980,4
24776067,Slovenian girl,2009,"['Croatia', 'Serbia', 'Slovenia', 'Germany', 'Bosnia and Herzegovina']","['Drama', 'World cinema']",2000,9
5991667,The Last Wagon,1956,['United States of America'],"['Action', 'Western', 'Action/Adventure']",1950,6
34596327,The Beast to Die,1980,['Japan'],"['Action', 'Crime Fiction', 'Drama']",1980,0
21742840,Three Daring Daughters,1948,['United States of America'],['Musical'],1940,8
22985953,Beachhead,1954,['United States of America'],"['Action', 'Film adaptation', 'Drama', 'Action/Adventure', 'War film']",1950,4
14169361,Seven Days,2007,['South Korea'],"['Drama', 'Thriller', 'World cinema']",2000,7
13107779,Dulhe Raja,1998,['India'],"['Romantic drama', 'Comedy', 'World cinema', 'Romance Film', 'Romantic comedy', 'Drama']",1990,8
3198839,French Rarebit,1951,['United States of America'],"['Animation', 'Short Film', 'Comedy', 'Family Film']",1950,1
19712210,Hollywood Hotel,1937,['United States of America'],"['Musical', 'Comedy', 'Musical comedy']",1930,7
26898572,City Limits,1934,['United States of America'],['Romantic comedy'],1930,4
4180427,Secret Cutting,2000,"['Canada', 'United States of America']","['Indie', 'Drama']",2000,0
29030072,Nightbreaker,1989,['United States of America'],['Drama'],1980,9
2031886,The Man Called Flintstone,1966,['United States of America'],"['Music', 'Action', 'Crime Fiction', 'Animation', 'Comedy', ""Children's"", 'Adventure', 'Drama', 'Comedy film', 'Family Film']",1960,6
5402494,Toothless,1997,['United States of America'],"[""Children's Fantasy"", 'Heaven-Can-Wait Fantasies', 'Comedy', 'Television movie', ""Children's/Family"", 'Family Film', 'Fantasy']",1990,7
3030953,Eklavya: The Royal Guard,2007,['India'],"['Musical', 'Romantic drama', 'Historical drama', 'Bollywood', 'World cinema', 'Romance Film', 'Epic']",2000,7
26073520,The Golden Pin,2009,['Canada'],"['Gay Themed', 'LGBT', 'Short Film', 'Drama']",2000,9
16430476,Mist: The Tale Of A Sheepdog Puppy,2006,['United Kingdom'],"['Family Drama', ""Children's/Family"", 'Drama', 'Family Film']",2000,6
2641743,The Villain,1979,['United States of America'],"['Action', 'Action/Adventure', 'Western', 'Comedy']",1970,9
25825341,Velaikaari,1949,['India'],[],1940,9
15318733,ChilePuede,2008,['Chile'],['Comedy'],2000,8
7154700,Retro Puppet Master,1999,['United States of America'],"['Creature Film', 'Horror']",1990,9
4773557,Slither,1973,['United States of America'],"['Crime Fiction', 'Comedy', 'Thriller', 'Road movie']",1970,3
736222,Billy Madison,1995,['United States of America'],"['Gross out', 'Gross-out film', 'Comedy', 'Romance Film', 'Slapstick', 'Adventure', 'Coming of age', 'Romantic comedy', 'Cult']",1990,5
7344453,Falafel,2006,['Lebanon'],"['Comedy', 'World cinema', 'Black comedy', 'Drama']",2000,6
9247802,Taarzan: The Wonder Car,2004,['India'],"['Action/Adventure', 'World cinema']",2000,4
2346853,Christmas Holiday,1944,['United States of America'],"['Black-and-white', 'Film noir', 'Crime Drama', 'Drama']",1940,4
1633705,Niagara,1953,['United States of America'],"['Psychological thriller', 'Mystery', 'Thriller', 'Film noir', 'Crime Thriller', 'Drama']",1950,3
10988446,Treasure Hunters,1981,['Hong Kong'],"['Action', 'Comedy film', 'Chinese Movies', 'Martial Arts Film']",1980,1
1763713,Airplane II: The Sequel,1982,['United States of America'],"['Airplanes and airports', 'Parody', 'Comedy', 'Disaster', 'Science Fiction', 'Cult', 'Absurdism']",1980,2
11895194,Fourplay,2001,"['United Kingdom', 'United States of America']","['Indie', 'Comedy', 'Romance Film', 'Romantic comedy', 'Sex comedy']",2000,1
924767,Sleeping with the Enemy,1991,['United States of America'],"['Psychological thriller', 'Suspense', 'Mystery', 'Thriller', 'Drama']",1990,1
25419009,Supari,2003,['India'],"['Crime Fiction', 'Drama', 'World cinema']",2000,3
2976581,Caddie,1976,['Australia'],"['Biopic [feature]', 'Romance Film', 'Melodrama', ""Children's/Family"", 'Docudrama', 'Drama']",1970,6
3913231,The Missing Link,1980,"['France', 'United States of America', 'Belgium']","['Comedy', 'Animation']",1980,0
2435668,Driven,2001,"['United States of America', 'Canada', 'Australia']","['Action', 'Auto racing', 'Action/Adventure', 'Thriller', 'Sports', 'Drama']",2000,1
16733548,The Hurt Locker,2008,['United States of America'],"['Combat Films', 'Action Thrillers', 'Action/Adventure', 'Thriller', 'War film', 'Drama']",2000,8
932864,Bande à part,1964,['France'],"['Crime Fiction', 'Romantic drama', 'World cinema', 'Crime Drama', 'Drama']",1960,4
11604278,No More Ladies,1935,['United States of America'],"['Black-and-white', 'Romantic drama', 'Comedy', 'Romance Film', 'Romantic comedy']",1930,5
10798819,El Amante Bilingüe,1993,"['Spain', 'Italy']",['Drama'],1990,3
22693523,Marine Boy,2009,['South Korea'],"['Crime Thriller', 'Action Thrillers', 'Thriller']",2000,9
3724764,"Mexicanos, al grito de guerra",1943,['Mexico'],"['Musical', 'Black-and-white', 'World cinema']",1940,3
8280960,D-Day the Sixth of June,1956,['United States of America'],"['Romantic drama', 'Romance Film', 'War film', 'Drama']",1950,6
23753991,Rivers Wash Over Me,2009,['United States of America'],"['LGBT', 'Drama']",2000,9
10821674,Terror in the Aisles,1984,['United States of America'],"['Documentary', 'Thriller', 'Horror']",1980,4
3653886,French Cancan,1955,"['France', 'Italy']","['Musical', 'Romantic drama', 'Comedy', 'World cinema', 'Musical comedy', 'Romance Film', 'Drama', 'Comedy-drama', 'Comedy of manners']",1950,5
22281602,The Slick Chick,1962,['United States of America'],"['Animation', 'Short Film', 'Comedy', 'Family Film']",1960,2
2731033,The People Against O'Hara,1951,['United States of America'],"['Crime Fiction', 'Mystery', 'Film noir', 'Drama', 'Courtroom Drama']",1950,1
7142686,Keep 'Em Flying,1941,['United States of America'],"['Black-and-white', 'Slapstick', 'Comedy', 'Family Film']",1940,1
10980875,My Tutor Friend,2003,['South Korea'],"['Comedy', 'Comedy film', 'Romance Film', 'Romantic comedy']",2000,3
18935792,Relentless,1989,['United States of America'],"['Crime Fiction', 'Thriller', 'Crime Thriller', 'Drama']",1980,9
12824672,Beast of the Yellow Night,1971,"['Philippines', 'United States of America']","['Filipino Movies', 'B-movie', 'Horror']",1970,1
8691570,The Widow of Saint-Pierre,2000,"['Canada', 'France']","['Period piece', 'Romantic drama', 'World cinema', 'Romance Film', 'Political drama', 'Drama']",2000,0
21817575,A Very Short Life,2009,['Hong Kong'],"['Drama', 'Thriller', 'Chinese Movies']",2000,9
13899262,Chow Hound,1951,['United States of America'],"['Animation', 'Short Film', 'Comedy', 'Family Film']",1950,1
25875124,It’s a Long Way to the Sea,1995,['India'],['Drama'],1990,5
9773691,Ultraman Tiga & Ultraman Dyna & Ultraman Gaia: Battle in Hyperspace,1998,['Japan'],"['Monster movie', 'Japanese Movies', 'Action/Adventure', 'World cinema', 'Superhero movie']",1990,8
1843900,One Fine Spring Day,2001,['South Korea'],"['Romance Film', 'Drama']",2000,1
3154773,Copycat,1995,['United States of America'],"['Psychological thriller', 'LGBT', 'Thriller', 'Crime Thriller']",1990,5
1409665,Bowfinger,1999,['United States of America'],"['Comedy', 'Comedy of Errors']",1990,9
4095104,Catharisis,2003,['Japan'],['Drama'],2000,3
5266283,Happy Accidents,2000,['United States of America'],"['Romantic fantasy', 'Indie', 'Comedy', 'Romance Film', 'Romantic comedy', 'Fantasy']",2000,0
648921,Face/Off,1997,['United States of America'],"['Action', 'Crime Fiction', 'Action Thrillers', 'Chase Movie', 'Thriller', 'Science Fiction', 'Tragedy']",1990,7
28474360,Rain,2008,['Bahamas'],"['Indie', 'Drama', 'World cinema']",2000,8
11124376,Method Man,1979,"['Hong Kong', 'Taiwan']","['Action', 'Comedy']",1970,9
24165971,KGB: The Secret War,1986,['United States of America'],"['Thriller', 'Drama']",1980,6
3113630,"Silent Night, Deadly Night 3: Better Watch Out!",1989,['United States of America'],"['Indie', 'Slasher', 'Horror', 'Holiday Film']",1980,9
9183822,The Black Balloon,2008,"['New Zealand', 'Australia']","['Coming of age', 'Family Drama', 'Indie', 'World cinema', 'Drama']",2000,8
14988569,Daybreak,1933,['China'],"['Black-and-white', 'Drama', 'Indie', 'Silent film', 'Chinese Movies']",1930,3
7905624,23rd March 1931: Shaheed,2002,['India'],"['Drama', 'Political drama']",2000,2
18416097,Hassan and Marcus,2008,['Egypt'],['Drama'],2000,8
2056353,The Word,1955,['Denmark'],"['Art film', 'Drama', 'World cinema']",1950,5
24523337,Wedding Daze,2004,['United States of America'],"['Comedy', 'Romance Film', 'Romantic comedy', 'Television movie']",2000,4
6976221,I'll Be Seeing You,1944,['United States of America'],"['Black-and-white', 'Romantic drama', 'Romance Film', 'Drama']",1940,4
11521166,Amar Deep,1958,['India'],"['Musical', 'Romance Film']",1950,8
8414489,It Waits,2005,['United States of America'],"['Creature Film', 'Horror']",2000,5
15766158,Santouri,2007,['Iran'],"['Drama', 'World cinema']",2000,7
4195529,Roommates,1995,['United States of America'],"['Drama', 'Comedy']",1990,5
21832989,Big Daddy,1969,['United States of America'],"['Drama', 'Adventure', 'Thriller']",1960,9
25329208,Paramedics,1988,['United States of America'],['Comedy'],1980,8
26363103,I Love My Wife,1970,['United States of America'],"['Marriage Drama', 'Comedy-drama']",1970,0
10860695,High Crime,1973,['Italy'],['Crime Fiction'],1970,3
21381088,Looking for Eric,2009,"['Spain', 'Belgium', 'United Kingdom', 'France', 'Italy']","['Drama', 'Indie', 'Comedy', 'Comedy-drama', 'Sports', 'Fantasy Comedy', 'Fantasy']",2000,9
25729280,Between Two Women,2004,['United Kingdom'],"['LGBT', 'Indie', 'Romantic drama', 'Romance Film', 'Drama']",2000,4
1955767,Hatari!,1962,['United States of America'],"['Action', 'Action/Adventure', 'Comedy', 'Adventure', 'Romance Film', 'Romantic comedy', 'Drama']",1960,2
5602768,Challenger,1990,['United States of America'],"['Drama', 'Television movie']",1990,0
29550286,Sitara,1980,['India'],"['Drama', 'Family Film']",1980,0
3792817,Flying Leathernecks,1951,['United States of America'],"['Action', 'Drama', 'Action/Adventure', 'War film']",1950,1
18890732,Flame & Citron,2008,"['Denmark', 'Sweden', 'Norway', 'France', 'Germany', 'Finland', 'Czech Republic']","['Crime Fiction', 'History', 'Thriller', 'World cinema', 'War film', 'Drama']",2000,8
21417215,What Price Porky,1938,['United States of America'],['Black-and-white'],1930,8
10933809,Warriors Two,1978,['Hong Kong'],"['Action', 'Action/Adventure', 'World cinema', 'Chinese Movies', 'Martial Arts Film']",1970,8
6015667,Sye,2004,['India'],['Romance Film'],2000,4
10791940,Andhamaina Anubhavam,1979,['India'],"['Musical', 'Romance Film']",1970,9
9604018,Plane Dead,2007,['United States of America'],"['Action', 'Horror', 'Black comedy', 'Zombie Film']",2000,7
7440211,Agaradhi,2008,['India'],['Action'],2000,8
1828138,The People Under the Stairs,1991,['United States of America'],"['Slasher', 'Comedy', 'Satire', 'Horror', 'Horror Comedy', 'Cult']",1990,1
27569703,Monkey on My Back,1957,['United States of America'],"['Sports', 'Boxing', 'Biography', 'Biopic [feature]', 'Addiction Drama', 'Drama']",1950,7
18010724,The Executioner's Song,1982,"['Sweden', 'United States of America']","['Film adaptation', 'Crime Fiction', 'Television movie', 'Drama', 'Courtroom Drama']",1980,2
10377382,Home of the Brave,1949,['United States of America'],"['Black-and-white', 'War film', 'Drama']",1940,9
9851612,His Mouse Friday,1951,['United States of America'],"['Animation', 'Short Film', 'Comedy', 'Family Film']",1950,1
26845517,Watan Ke Rakhwale,1987,['India'],"['Musical', 'Action/Adventure', 'Bollywood', 'World cinema']",1980,7
19148195,Import Export,2007,['Austria'],"['Adult', 'Indie', 'Drama']",2000,7
99454,Patton,1970,['United States of America'],"['Action', 'Biography', 'Action/Adventure', 'Biographical film', 'Drama', 'Biopic [feature]', 'New Hollywood', 'Epic', 'War film']",1970,0
7622475,Springtime,2004,['South Korea'],"['Romance Film', 'Melodrama', 'Drama']",2000,4
6535669,The Shadow Strikes,1937,['United States of America'],"['Detective fiction', 'Mystery', 'Superhero', 'Detective', 'Superhero movie']",1930,7
13830536,Samurai Banners,1969,['Japan'],"['Period piece', 'Samurai cinema', 'Japanese Movies', 'Action/Adventure', 'World cinema', 'Martial Arts Film', 'Drama']",1960,9
30045070,Catch Me If You Can,1989,['United States of America'],"['Action', 'Drama', 'Comedy']",1980,9
5878886,Black Like Me,1964,['United States of America'],"['Melodrama', 'Docudrama', 'Drama']",1960,4
23831370,Cheerleaders Beach Party,1978,['United States of America'],"['Musical', 'Comedy']",1970,8
11638265,Incognito,1997,['United States of America'],"['Suspense', 'Crime Fiction', 'Thriller', 'Crime Thriller']",1990,7
32777421,The Stowaway,1958,[],"['Adventure', 'Drama']",1950,8
5615617,Shake Hands With the Devil: The Journey of Roméo Dallaire,2005,['Canada'],"['Biography', 'Indie', 'Documentary', 'Culture & Society', 'Social issues', 'Political cinema', 'History', 'War film']",2000,5
6143584,Riot in Cell Block 11,1954,['United States of America'],"['Prison', 'Drama']",1950,4
2118495,The Prizefighter and the Lady,1933,['United States of America'],"['Boxing', 'Black-and-white', 'Crime Fiction', 'Romantic drama', 'Comedy', 'Romance Film', 'Drama']",1930,3
12349229,Texas Terror,1935,['United States of America'],"['Action', 'Black-and-white', 'Western', 'Action/Adventure', 'Romance Film']",1930,5
36225633,The Ghost Valley's Treasure Mysteries,1974,['Iran'],"['Drama', 'Comedy film']",1970,4
14592258,Lighthouse,2000,['United Kingdom'],"['Action', 'Psychological thriller', 'Slasher', 'Thriller', 'Horror']",2000,0
16054110,Mere Baap Pehle Aap,2008,['India'],"['Musical', 'Romantic drama', 'Bollywood', 'World cinema', 'Romance Film', 'Drama']",2000,8
6152265,Thunderball,1965,"['United Kingdom', 'Thailand']","['Action', 'Spy', 'Action Thrillers', 'Action/Adventure', 'Thriller', 'Glamorized Spy Film']",1960,5
27960424,Wild Elephinks,1933,['United States of America'],"['Animation', 'Short Film', 'Comedy', 'Family Film']",1930,3
10483547,The Ramen Girl,2008,"['Japan', 'United States of America']","['Japanese Movies', 'Indie', 'Comedy', 'Romance Film', 'Drama']",2000,8
17039851,Tonight or Never,1931,['United States of America'],"['Black-and-white', 'Comedy', 'Romance Film', 'Romantic comedy']",1930,1
970846,Grand Prix,1966,['United States of America'],"['Auto racing', 'Sports', 'Drama']",1960,6
24461289,The Silent Accuser,1924,[],['Silent film'],1920,4
12595448,Ana y los lobos,1973,['Spain'],"['Melodrama', 'Family Drama', 'Drama']",1970,3
5127878,Popcorn,2007,['United Kingdom'],"['Romance Film', 'Comedy']",2000,7
2682080,"So Long, Stooge",1983,['France'],['Drama'],1980,3
61514,The Story of Louis Pasteur,1936,['United States of America'],"['Period piece', 'Black-and-white', 'Biography', 'Biographical film', 'Biopic [feature]', 'Drama', 'Medical fiction']",1930,6
2678286,Rice Rhapsody,2004,"['Hong Kong', 'Singapore', 'Australia']","['LGBT', 'Chinese Movies', 'Comedy']",2000,4
5235481,The Phantom,1996,"['United States of America', 'Australia']","['Action', 'Action/Adventure', 'Adventure', 'Superhero movie', 'Fantasy']",1990,6
21356032,Charlie Strap and Froggy Ball Flying High,1991,['Sweden'],"['Animation', 'Adventure', 'Family Film']",1990,1
35075250,Buck Rogers in the 25th Century,1979,['United States of America'],"['Science Fiction', 'Adventure']",1970,9
3557879,Never Too Late,1997,['Canada'],"['Indie', 'Comedy', 'Drama']",1990,7
10364456,The Office Wife,1930,['United States of America'],['Pre-Code'],1930,0
16613205,The Tunnel,1935,['United Kingdom'],"['Film adaptation', 'Black-and-white', 'Science Fiction', 'Drama']",1930,5
26526241,2000 Weeks,1969,['Australia'],['Drama'],1960,9
18664076,Kraken: Tentacles of the Deep,2006,"['Canada', 'United States of America']","['Action/Adventure', 'Horror', 'Adventure', 'Natural horror films']",2000,6
1985720,Norwood,1970,['United States of America'],"['Film adaptation', 'Comedy', 'Comedy-drama', 'Road movie', 'Adventure', 'Drama']",1970,0
2017208,Meet the Robinsons,2007,['United States of America'],"['Animation', 'Comedy', ""Children's/Family"", 'Sci-Fi Adventure', 'Adventure', 'Computer Animation', ""Children's Fantasy"", 'Time travel', 'Science Fiction', 'Family Film', 'Fantasy']",2000,7
1913883,Project Viper,2002,['United States of America'],"['Action', 'Thriller', 'Horror', 'Sci-Fi Horror', 'Science Fiction']",2000,2
1945359,Final Destination 3,2006,"['Germany', 'United States of America', 'Canada']","['Slasher', 'Thriller', 'Horror', 'Teen', 'Supernatural', 'Cult']",2000,6
17570003,What Doesn't Kill You,2008,"['United Kingdom', 'United States of America']","['Action', 'Drama', 'Crime Fiction', 'Crime Drama']",2000,8
15513119,Who Loves the Sun,2006,['Canada'],"['Drama', 'Indie', 'Comedy', 'Romance Film']",2000,6
4278437,Baby: Secret of the Lost Legend,1985,['United States of America'],"['Adventure', ""Children's"", 'Family Film', 'Fantasy']",1980,5
15810661,Saroja,2008,['India'],"['Comedy', 'Thriller', 'Crime Drama', 'Drama']",2000,8
15672797,The Perils of Pauline,1933,['United States of America'],"['Action', 'Black-and-white', 'Action/Adventure', 'Adventure']",1930,3
414985,Bugs and Thugs,1954,['United States of America'],['Crime Fiction'],1950,4
739786,Scandal,1989,['United Kingdom'],"['Indie', 'Romance Film', 'Political drama', 'Drama']",1980,9
113460,Platoon,1986,"['United Kingdom', 'United States of America']","['Anti-war', 'Action', 'Combat Films', 'Drama', 'Anti-war film', 'Indie', 'War film']",1980,6
14581235,Scanners II: The New Order,1991,['Canada'],"['Indie', 'Horror', 'Sci-Fi Horror', 'Science Fiction']",1990,1
15930358,Nunca pasa nada,1963,"['France', 'Spain']","['Black-and-white', 'Drama']",1960,3
6411396,Mack the Knife,1990,"['Hungary', 'Netherlands', 'United States of America']","['Crime Fiction', 'Indie', 'Romantic comedy', 'Historical fiction', 'Drama']",1990,0
9835,Escape from New York,1981,"['United Kingdom', 'United States of America']","['Action', 'Crime Fiction', 'Indie', 'Action/Adventure', 'Thriller', 'Escape Film', 'Dystopia', 'Western', 'Doomsday film', 'Science Fiction']",1980,1
25977327,Ee Sabdam Innathe Sabdam,1985,['India'],"['Action', 'Crime Fiction', 'Drama']",1980,5
12675919,The Wild Bull,2008,['India'],"['Musical', 'Comedy', 'Bollywood', 'World cinema']",2000,8
123464,Fail-Safe,1964,['United States of America'],"['Cold War', 'Film adaptation', 'Thriller', 'Nuclear warfare', 'War film', 'Drama', 'Suspense', 'Doomsday film', 'Political drama', 'Political thriller']",1960,4
26630988,Not for Publication,1984,['United States of America'],"['Political cinema', 'Comedy', 'Romance Film', 'Romantic comedy']",1980,4
9092969,Night World,1932,['United States of America'],"['Black-and-white', 'Crime Fiction', 'Drama']",1930,2
20770694,Lady in the Dark,1944,['United States of America'],"['Musical', 'Romance Film', 'Drama']",1940,4
30440118,Love and Mary,2007,['United States of America'],"['Indie', 'Comedy', 'Romance Film', 'Romantic comedy']",2000,7
14035596,Boogie Woogie,2009,['United Kingdom'],"['Film adaptation', 'Indie', 'Comedy', 'Drama']",2000,9
11201793,Skal vi vædde en million?,1932,['Denmark'],"['Black-and-white', 'Drama']",1930,2
24603977,Kandam Bacha Kotte,1961,['India'],['Drama'],1960,1
931228,Gorgeous,1999,"['Hong Kong', 'Taiwan']","['Action', 'Action/Adventure', 'Comedy', 'World cinema', 'Romance Film', 'Chinese Movies', 'Martial Arts Film', 'Romantic comedy']",1990,9
24624834,Saturday Morning,2007,['United States of America'],"['Romance Film', 'Comedy', 'Fantasy']",2000,7
14781555,Don't Go Near the Park,1981,['United States of America'],"['Slasher', 'B-movie', 'Horror']",1980,1
5828557,Deepwater,2005,['United States of America'],"['Crime Fiction', 'Mystery', 'Indie', 'Thriller', 'Crime Thriller', 'Drama', 'Suspense', 'Erotic thriller']",2000,5
16686643,One Small Step: The Story of the Space Chimps,1995,['United States of America'],['Documentary'],1990,5
2313660,Friday the 13th Part VI: Jason Lives,1986,['United States of America'],"['Slasher', 'Teen', 'Horror', 'Supernatural', 'Cult']",1980,6
30665531,The Rifleman of the Voroshilov Regiment,1999,['Russia'],"['Drama', 'Crime Fiction']",1990,9
5922463,Hide and Creep,2004,['United States of America'],"['Comedy', 'Horror Comedy', 'Horror', 'B-movie', 'Zombie Film', 'Science Fiction']",2000,4
5563647,Diary of a Lost Girl,1929,"['Weimar Republic', 'Germany']","['Black-and-white', 'LGBT', 'Indie', 'Drama', 'World cinema', 'Silent film', 'Melodrama']",1920,9
4423122,Truth or Dare: 6th Floor Rear Flat,2003,['Hong Kong'],"['Comedy', 'World cinema', 'Comedy-drama', 'Chinese Movies', 'Ensemble Film']",2000,3
18089898,Takva: A Man's Fear of God,2006,"['Turkey', 'Germany']","['Drama', 'World cinema']",2000,6
453573,Soldier Blue,1970,['United States of America'],"['Film adaptation', 'Revisionist Western', 'Action/Adventure', 'Drama', 'Period piece', 'Western', 'Historical fiction', 'War film']",1970,0
4107909,Child of Glass,1978,['United States of America'],"[""Children's Fantasy"", ""Children's/Family"", 'Haunted House Film', 'Fantasy']",1970,8
6649969,What's Cookin' Doc?,1944,['United States of America'],"['Short Film', 'Comedy', 'Family Film']",1940,4
10603354,Kid with the Golden Arm,1979,['Hong Kong'],"['Action', 'Drama', 'Chinese Movies', 'Martial Arts Film']",1970,9
5082874,Where the Money Is,2000,"['Germany', 'United States of America']","['Action', 'Crime Fiction', 'Action/Adventure', 'Comedy', 'Romance Film', 'Drama', 'Heist', 'Caper story', 'Crime Comedy', 'Romantic comedy']",2000,0
9022217,Ab Dilli Dur Nahin,1957,['India'],"['Musical', 'Black-and-white', 'Bollywood', 'World cinema', 'Drama']",1950,7
20781972,If You Are the One,2008,['China'],"['Comedy', 'Romance Film', 'Romantic comedy', 'Comedy-drama', 'Chinese Movies', 'Slice of life story']",2000,8
7105919,Salome,1953,['United States of America'],"['Period piece', 'Epic', 'Costume drama', 'Drama']",1950,3
2000074,Glengarry Glen Ross,1992,['United States of America'],"['Film adaptation', 'Drama', 'Indie', 'Ensemble Film']",1990,2
10747141,When Women Had Tails,1970,['Italy'],['Comedy'],1970,0
19522686,The Sleepy Time Gal,2002,['United States of America'],['Indie'],2000,2
26363490,Les Godelureaux,1961,"['France', 'Italy']",['Drama'],1960,1
19978736,The Women,1939,['United States of America'],"['Black-and-white', 'Comedy', 'Comedy of manners', 'Comedy-drama']",1930,9
1660517,Alfalfa's Aunt,1939,['United States of America'],"['Black-and-white', 'Short Film', 'Comedy', 'Family Film']",1930,9
2488667,Dear Wendy,2005,"['France', 'Italy', 'Spain', 'Denmark', 'United Kingdom', 'Germany', 'Netherlands', 'United States of America']","['Drama', 'Crime Fiction', 'Indie', 'Comedy', 'World cinema', 'Melodrama']",2000,5
16167725,Diwan,2003,['India'],"['Romantic drama', 'World cinema', 'Romance Film', 'Drama']",2000,3
15843096,Pickled Pink,1965,[],"['Animation', 'Short Film', 'Comedy']",1960,5
5036880,Soccer Dog: European Cup,2004,['United States of America'],"['Comedy', 'Animal Picture', ""Children's/Family"", ""Children's"", 'Drama', 'Family Film']",2000,4
1529272,Gamera vs. Guiron,1969,['Japan'],"['Monster movie', 'Japanese Movies', 'World cinema', 'Science Fiction']",1960,9
22261980,Ah kai na 'moun antras,1966,['Greece'],"['Comedy', 'Black-and-white']",1960,6
442568,After the Fox,1966,"['United Kingdom', 'Italy']","['Crime Fiction', 'Comedy', 'Crime Comedy']",1960,6
26881153,The Borrowers,1973,"['Canada', 'United States of America']","['Family Film', 'Fantasy']",1970,3
27002245,A Brand New Life,2009,"['France', 'South Korea']","['Drama', 'World cinema']",2000,9
7445296,Her Night of Romance,1924,['United States of America'],"['Black-and-white', 'Indie', 'Comedy', 'Silent film', 'Romance Film', 'Comedy-drama']",1920,4
27158203,Bulldog Sees It Through,1940,['United Kingdom'],"['Mystery', 'Spy']",1940,0
15416966,Khuddar,1994,['India'],"['Action', 'Musical', 'Drama']",1990,4
28975286,The Minority,2006,['United States of America'],"['Action', 'Adventure', 'Comedy film']",2000,6
11410391,Kala Bazaar,1989,['India'],"['Action', 'Drama']",1980,9
35027740,Chinnamul,1950,['India'],[],1950,0
12401107,Kinky Business,1984,['United States of America'],"['Comedy', 'Adult']",1980,4
24235407,Munchie Strikes Back,1992,[],"[""Children's Fantasy"", 'Comedy', ""Children's/Family"", 'Family Film']",1990,2
27534646,To Trap a Spy,1964,['United States of America'],"['Action', 'Spy', 'Glamorized Spy Film', 'Adventure']",1960,4
303933,Twister,1996,['United States of America'],"['Disaster', 'Action/Adventure']",1990,6
20837828,Panchamirtham,2008,['India'],['Comedy'],2000,8
5824039,Taxi 4,2007,['France'],"['Action', 'Comedy', 'Slapstick', 'Ensemble Film']",2000,7
2011691,Cold Fever,1996,"['Iceland', 'Japan', 'United States of America']","['Drama', 'Japanese Movies', 'Indie', 'Mystery', 'Comedy', 'Comedy of manners', 'Road movie']",1990,6
2667323,L.A. Law: The Movie,2002,['United States of America'],"['Comedy-drama', 'Drama', 'Courtroom Drama']",2000,2
24453695,Aenigma,1987,['Italy'],['Horror'],1980,7
27065133,Dhoop,2003,['India'],['Drama'],2000,3
34196448,Due Marines e un Generale,1966,[],['Comedy'],1960,6
11992824,The White Buffalo,1977,['United States of America'],"['Western', 'Indian Western', 'Drama', 'Natural horror films']",1970,7
28887914,Alibaba Aur 40 Chor,1980,"['Soviet Union', 'India']","['Action', 'Romance Film', 'Adventure', 'Family Film']",1980,0
18531535,Buddy,2003,['Norway'],"['Romantic drama', 'Comedy', 'World cinema', 'Romance Film', 'Romantic comedy', 'Drama']",2000,3
537200,Honey,2003,['United States of America'],"['Musical', 'Romantic drama', 'Dance', 'Romance Film', 'Drama']",2000,3
706990,Saved!,2004,['United States of America'],"['LGBT', 'Indie', 'Comedy', 'Satire', 'Teen', 'Black comedy', 'Drama', 'Coming of age', 'Parody', 'Comedy-drama']",2000,4
1962520,Keeping the Faith,2000,['United States of America'],"['Romantic drama', 'Buddy film', 'Comedy', 'Romance Film', 'Drama', 'Romantic comedy', 'Religious Film', 'Comedy-drama']",2000,0
230839,Mickey's Christmas Carol,1983,['United States of America'],"['Short Film', ""Children's/Family""]",1980,3
26172077,Uncle Bun,1991,['India'],"['Romance Film', 'Comedy', 'Drama']",1990,1
8340202,Becoming dick,2000,"['Canada', 'United States of America']","['Romance Film', 'Romantic comedy', 'Comedy']",2000,0
3912186,Made in U.S.A.,1966,['France'],"['Crime Fiction', 'Thriller', 'World cinema']",1960,6
20898995,Though None Go with Me,2006,['United States of America'],"['Period piece', 'Film adaptation', 'Romantic drama', 'Drama']",2000,6
2749550,Oasis,2002,['South Korea'],"['Romantic drama', 'World cinema', 'Romance Film', 'Drama']",2000,2
7186157,The City of Violence,2006,['South Korea'],"['Action', 'Crime Fiction', 'Action Thrillers', 'Mystery', 'Action/Adventure', 'Thriller', 'World cinema', 'Crime Thriller', 'Martial Arts Film', 'Drama']",2000,6
8039739,It Ain't Hay,1943,['United States of America'],"['Black-and-white', 'Comedy', 'Family Film']",1940,3
17349517,The Dogway Melody,1930,['United States of America'],"['Musical', 'Short Film', 'Comedy film', 'Animal Picture']",1930,0
13136145,Life Support,2006,['United States of America'],"['Film à clef', 'Drama']",2000,6
6766096,Don't Give Up The Ship,1959,['United States of America'],"['Romance Film', 'Comedy']",1950,9
28353690,Faces in the Dark,1960,['United Kingdom'],"['Psychological thriller', 'Thriller']",1960,0
18849375,Thaaikkuppin Thaaram,1956,['India'],"['Romance Film', 'Drama']",1950,6
222500,Any Given Sunday,1999,['United States of America'],"['Sports', 'Drama', 'Ensemble Film']",1990,9
31585384,The Nesting,1981,['United States of America'],['Horror'],1980,1
7269566,Pros & Cons,1999,['United States of America'],['Comedy'],1990,9
5026667,Air Bud: Seventh Inning Fetch,2002,"['Canada', 'United States of America']","['Sports', 'Comedy', 'Animal Picture', ""Children's/Family"", ""Children's"", 'Family Film']",2000,2
5332316,Feed,2005,['Australia'],"['Psychological thriller', 'Crime Fiction', 'Mystery', 'Thriller', 'World cinema', 'Crime Thriller']",2000,5
31052739,Zoomates,1998,[],['Short Film'],1990,8
4757039,The Man From London,2007,"['France', 'Germany', 'Hungary']","['Black-and-white', 'Crime Fiction', 'Mystery', 'Thriller', 'World cinema', 'Film noir', 'Crime Thriller', 'Drama']",2000,7
171000,Pelle the Conqueror,1987,"['Sweden', 'Denmark']","['Period piece', 'Coming of age', 'Family Drama', 'World cinema', 'Drama']",1980,7
2211274,At Close Range,1986,['United States of America'],"['Crime Fiction', 'Indie', 'Drama']",1980,6
13130339,Sostiene Pereira,1996,"['Portugal', 'Italy']",['Drama'],1990,6
1141361,Red-Headed Woman,1932,['United States of America'],"['Romantic comedy', 'Black-and-white', 'Pre-Code']",1930,2
12332258,Golmaal Returns,2008,['India'],"['Musical', 'Comedy', 'Bollywood', 'World cinema']",2000,8
25915732,Hollywood,1923,['United States of America'],['Silent film'],1920,3
2645046,The Thing About My Folks,2005,['United States of America'],"['Drama', 'Indie', 'Family Drama', 'Comedy', 'Comedy-drama', 'Road movie']",2000,5
26724000,The Road to Hollywood,1947,['United States of America'],"['Musical', 'Biography', 'Comedy']",1940,7
24940480,End of the Line,2007,['Canada'],"['Slasher', 'Horror']",2000,7
6795138,Kalloori Vaasal,1996,[],[],1990,6
2709799,Moontrap,1989,['United States of America'],"['Indie', 'Science Fiction', 'Adventure']",1980,9
4549625,The Silence,1963,['Sweden'],"['Black-and-white', 'Art film', 'World cinema', 'Drama']",1960,3
13040946,Shanghai Kiss,2007,"['China', 'United States of America']","['Drama', 'Indie', 'Comedy', 'Romance Film', 'Romantic comedy', 'Comedy-drama', 'Chinese Movies']",2000,7
16671438,The Insatiable,2006,['United States of America'],['Horror'],2000,6
4768207,36 China Town,2006,['India'],"['Musical', 'Thriller', 'Bollywood', 'World cinema', 'Crime Thriller']",2000,6
1328234,Cradle of Fear,2001,['United Kingdom'],"['Slasher', 'B-movie', 'Horror']",2000,1
19248715,Bachelor Flat,1962,['United States of America'],"['Comedy', 'Comedy of manners']",1960,2
6304769,One Got Fat,1963,['United States of America'],['Short Film'],1960,3
29489803,Mickey's Tent Show,1933,['United States of America'],['Short Film'],1930,3
930143,The Good Girl,2002,"['Germany', 'United States of America', 'Netherlands']","['Romantic drama', 'Indie', 'Comedy', 'Black comedy', 'Romance Film', 'Drama', 'Tragedy', 'Romantic comedy']",2000,2
543276,Beaches,1988,['United States of America'],"['Musical', 'Buddy film', 'Comedy', 'Melodrama', 'Comedy-drama', 'Drama']",1980,8
26007256,Blood Dolls,2005,['United States of America'],"['Horror', 'B-movie']",2000,5
3822677,City of Women,1980,"['France', 'Italy']","['Surrealism', 'Art film', 'Romantic drama', 'Satire', 'Comedy', 'World cinema', 'Romance Film', 'Drama', 'Fantasy Comedy', 'Fantasy']",1980,0
31996104,The Heat's On,1943,['United States of America'],"['Musical', 'Comedy']",1940,3
9956825,Pal Joey,1957,['United States of America'],"['Musical', 'Comedy', 'Romance Film', 'Drama']",1950,7
5700963,Lemming,2005,['France'],"['Psychological thriller', 'Mystery', 'Marriage Drama', 'Thriller', 'World cinema', 'Comedy', 'Drama']",2000,5
19757771,Bubbling Troubles,1940,['United States of America'],"['Black-and-white', 'Short Film', 'Comedy', 'Family Film']",1940,0
7383485,Terror Among Us,1981,['United States of America'],"['Detective fiction', 'Crime Fiction', 'Detective', 'Horror']",1980,1
1637006,Caesar and Cleopatra,1945,['United Kingdom'],"['Period piece', 'Film adaptation', 'Romantic drama', 'Romance Film', 'Epic', 'Costume drama', 'Drama']",1940,5
11021372,Way Back Home,1931,['United States of America'],"['Black-and-white', 'Drama']",1930,1
3650208,Greased Lightning,1977,['United States of America'],"['Action', 'Auto racing', 'Action/Adventure', 'Comedy', 'Biographical film', 'Sports', 'Drama']",1970,7
1923049,Epidemic,1987,['Denmark'],"['Surrealism', 'Horror', 'World cinema', 'Science Fiction']",1980,7
5430789,Code of Silence,1985,['United States of America'],"['Action', 'Crime Fiction', 'Action/Adventure', 'Thriller', 'Martial Arts Film', 'Drama']",1980,5
1190017,Zaat,1971,['United States of America'],"['Science Fiction', 'Cult', 'Fantasy']",1970,1
9398262,Dead Homiez,1999,['United States of America'],"['Crime Fiction', 'Action/Adventure', 'Drama']",1990,9
934524,Taegukgi,2004,['South Korea'],"['Action', 'Drama', 'Action/Adventure', 'World cinema', 'War film']",2000,4
8099378,Dil Jo Bhi Kahey...,2005,['India'],"['Musical', 'Romantic drama', 'Bollywood', 'World cinema', 'Romance Film', 'Drama']",2000,5
11896654,Little Soldiers,1996,['India'],"['Drama', 'Thriller', 'World cinema']",1990,6
797951,Le Mouton noir,1992,['Canada'],"['Drama', 'Documentary']",1990,2
12510014,Just One Look,2002,['Hong Kong'],"['Romantic drama', 'World cinema', 'Romance Film', 'Chinese Movies', 'Drama']",2000,2
1107088,"The Karate Kid, Part II",1986,['United States of America'],"['Action', 'Family Drama', 'Action/Adventure', 'Romance Film', 'Adventure', 'Martial Arts Film', 'Drama', 'Sports', 'Family Film']",1980,6
24336583,Mango Soufflé,2002,['India'],"['LGBT', 'Comedy', 'World cinema', 'Drama']",2000,2
10640723,Raja Chinna Roja,1989,['India'],"[""Children's"", 'Drama']",1980,9
1881853,No Regrets for Our Youth,1946,['Japan'],"['Art film', 'Japanese Movies', 'World cinema', 'Political drama', 'Drama']",1940,6
1182345,Undercover Brother,2002,['United States of America'],"['Action', 'Parody', 'Action Comedy', 'Comedy']",2000,2
1836502,Vidocq,2001,['France'],"['Detective fiction', 'Mystery', 'Action/Adventure', 'Gothic Film', 'Thriller', 'World cinema', 'Whodunit', 'Crime Thriller', 'Drama', 'Period piece', 'Detective', 'Steampunk', 'Supernatural']",2000,1
34430924,10 Promises to My Dog,2008,['Japan'],"['Romance Film', 'Comedy', 'Drama']",2000,8
15465553,Aatish: Feel the Fire,1994,['India'],['Action'],1990,4
1580932,Staying Alive,1983,['United States of America'],"['Musical', 'Romantic drama', 'Dance', 'Romance Film', 'Drama']",1980,3
11361026,Gunslinger,1956,['United States of America'],"['Action', 'Western']",1950,6
1767914,Puteri Gunung Ledang,2004,['Malaysia'],"['Romance Film', 'Drama', 'Fantasy']",2000,4
30607983,Boat,2009,"['Japan', 'South Korea']",['Japanese Movies'],2000,9
21922672,Oscar and Lucinda,1997,"['United Kingdom', 'Australia', 'United States of America']","['Period piece', 'Film adaptation', 'Romantic drama', 'Romance Film', 'Drama']",1990,7
1744691,Intimate Relations,1997,"['Canada', 'United Kingdom']","['Black comedy', 'Comedy', 'Drama']",1990,7
15864743,A Letter from Death Row,1998,['United States of America'],"['Psychological thriller', 'Suspense', 'Crime Fiction', 'Mystery', 'Thriller', 'Crime Thriller', 'Drama']",1990,8
1649249,Champagne,1928,['United Kingdom'],"['Black-and-white', 'Indie', 'Comedy', 'Silent film']",1920,8
2003410,Shenandoah,1965,['United States of America'],"['Action/Adventure', 'Western', 'War film', 'Drama', 'Family Film']",1960,5
26375917,Bellamy,2009,['France'],"['Crime Fiction', 'Thriller', 'World cinema', 'Crime Thriller', 'Drama']",2000,9
29107563,Who Is the Man?,1924,['United Kingdom'],['Silent film'],1920,4
9649864,Minsara Kanna,1999,['India'],"['Drama', 'Comedy']",1990,9
1719500,Élisa,1995,['France'],"['Drama', 'Road movie']",1990,5
34155452,Aararo Aaariraro,1989,[],['Drama'],1980,9
3140828,The Air I Breathe,2007,"['Mexico', 'United States of America']","['Crime Fiction', 'Thriller', 'Drama', 'Ensemble Film']",2000,7
1767747,Dragon Ball Z: Bojack Unbound,1993,['Japan'],"['Action', 'Animation', 'Japanese Movies', 'Anime', 'Science Fiction']",1990,3
2255810,The Racket,1951,['United States of America'],"['Black-and-white', 'Crime Fiction', 'Thriller', 'Film noir', 'Drama']",1950,1
14526035,Three Little Twirps,1943,['United States of America'],"['Short Film', 'Black-and-white', 'Comedy']",1940,3
6831954,The King and I,1999,['United States of America'],"['Music', 'Musical', 'Animation', ""Children's"", 'Family Film']",1990,9
25239808,"Like Father, Like Santa",1998,['United States of America'],"['Family Film', 'Fantasy']",1990,8
4345625,Pocahontas II: Journey to a New World,1998,['United States of America'],"['Music', 'Animation', 'Romance Film', 'Family-Oriented Adventure', ""Children's/Family"", ""Children's"", 'Adventure', 'Family Film']",1990,8
5647190,Love and a .45,1994,['United States of America'],"['Crime Fiction', 'Indie', 'Crime Thriller', 'Drama', 'Suspense', 'Chase Movie', 'Crime Drama', 'Road movie']",1990,4
4340578,Ik Omhels Je Met 1000 Armen,2006,['Netherlands'],['Drama'],2000,6
1129041,Thirteen Days,2000,['United States of America'],"['Thriller', 'War film', 'Docudrama', 'Drama', 'Period piece', 'History', 'Historical fiction', 'Epic', 'Political drama', 'Political thriller']",2000,0
2648352,Freddie as F.R.O.7,1992,['United Kingdom'],"['Musical', 'Animation', 'Adventure', 'Fantasy']",1990,2
1312930,Wrong Is Right,1982,['United States of America'],"['Political cinema', 'Parody', 'Thriller', 'Satire', 'Comedy', 'Media Satire', 'Black comedy']",1980,2
8375858,Dance With Me Henry,1956,['United States of America'],"['Black-and-white', 'Slapstick', 'Comedy', 'Family Film']",1950,6
7192807,Betty Boop's Bizzy Bee,1932,['United States of America'],"['Animation', 'Short Film', 'Comedy', 'Family Film']",1930,2
5480913,The Island of Dr. Moreau,1977,['United States of America'],"['Film adaptation', 'Thriller', 'Horror', 'Science Fiction']",1970,7
1181830,Citizen Ruth,1996,['United States of America'],"['Political cinema', 'Drama', 'Political satire', 'Indie', 'Satire', 'Comedy']",1990,6
30275,Night of the Living Dead,1968,['United States of America'],"['Black-and-white', 'Mystery', 'Indie', 'Zombie Film', 'Splatter film', 'Horror', 'Doomsday film', 'Cult']",1960,8
24566634,Eating,1990,[],"['Indie', 'Ensemble Film', 'Comedy', 'Feminist Film']",1990,0
21290003,Relentless IV: Ashes to Ashes,1994,['United States of America'],['Thriller'],1990,4
24873771,Thiruthani,2008,['India'],['Action'],2000,8
31153575,Loyalties,1933,[],"['Drama', 'Crime Fiction']",1930,3
14052681,Madame X,1966,['United States of America'],"['LGBT', 'Drama', 'Courtroom Drama']",1960,6
903297,Foxfire,1996,['United States of America'],"['Film adaptation', 'LGBT', 'Crime Fiction', 'Coming of age', 'Indie', 'Drama', 'Teen']",1990,6
8231523,Tassels in the Air,1938,['United States of America'],"['Black-and-white', 'Short Film', 'Comedy', 'Slapstick']",1930,8
5236777,Time,2006,"['Japan', 'South Korea']","['Psychological thriller', 'Japanese Movies', 'Romantic drama', 'World cinema', 'Romance Film', 'Drama']",2000,6
11361834,Paranoid Park,2007,"['United States of America', 'France']","['Film adaptation', 'Crime Fiction', 'Mystery', 'Indie', 'Crime Thriller', 'Drama', 'Coming of age', 'Sports']",2000,7
9040490,The King of Masks,1999,"['China', 'Hong Kong']","['Period piece', 'Family Drama', 'Childhood Drama', 'World cinema', 'Chinese Movies', 'Drama']",1990,9
6326152,The Seedling,1974,['India'],"['Art film', 'Bollywood', 'World cinema', 'Romance Film', 'Drama']",1970,4
3791874,Flight from Ashiya,1964,"['Japan', 'United States of America']","['Action', 'Japanese Movies', 'Action/Adventure', 'Adventure', 'War film', 'Drama']",1960,4
20918140,The FJ Holden,1977,['Australia'],['Drama'],1970,7
19085827,Ka Kee,1980,['Thailand'],"['Drama', 'Fantasy']",1980,0
2815064,The Bow,2005,"['Japan', 'South Korea']","['Japanese Movies', 'Romantic drama', 'World cinema', 'Romance Film', 'Drama']",2000,5
2822925,My Geisha,1962,['United States of America'],"['Comedy', 'Romance Film', 'Romantic comedy', 'Comedy of Errors']",1960,2
16663530,Sand,2000,['United States of America'],"['Crime Fiction', 'Thriller', 'Crime Thriller', 'Drama']",2000,0
12939745,Parachute Jumper,1933,['United States of America'],"['Black-and-white', 'Crime Fiction', 'Crime Drama', 'Drama']",1930,3
6472505,The Wannabes,2003,"['New Zealand', 'Australia']","['Heist', 'Indie', 'Comedy', 'Crime Comedy', 'World cinema']",2000,3
9068710,Anthony Kaun Hai,2006,['India'],"['Comedy', 'World cinema']",2000,6
33365554,A Child for Sale,1920,[],['Silent film'],1920,0
2195094,Kevin of the North,2001,"['United Kingdom', 'United States of America', 'Canada']","['Action', 'Action/Adventure', 'Comedy', 'Family-Oriented Adventure', ""Children's"", 'Adventure', 'Animal Picture', 'Sports', 'Family Film']",2000,1
3461760,A Midnight Clear,1992,['United States of America'],"['Anti-war', 'Action', 'Film adaptation', 'Drama', 'Anti-war film', 'Indie', 'War film']",1990,2
24322190,Only the Valiant,1951,['United States of America'],"['Action', 'Film adaptation', 'Action/Adventure', 'Western', 'War film', 'Drama']",1950,1
2138941,The Incredible Mightiest vs. Mightiest,1991,['Japan'],"['Animated cartoon', 'Japanese Movies', 'Anime']",1990,1
34610062,Les Fanatiques,1957,"['France', 'Italy']","['Thriller', 'Drama']",1950,7
676038,Short Cuts,1993,['United States of America'],"['Film adaptation', 'Indie', 'Comedy', 'Drama', 'Ensemble Film']",1990,3
13198130,Albela,2001,['India'],['Romance Film'],2000,1
24473060,Chirag Kahan Roshni Kahan,1959,['India'],"['Musical', 'Bollywood', 'World cinema', 'Drama']",1950,9
8220647,Desh Premee,1982,['India'],"['Political drama', 'Drama', 'World cinema']",1980,2
27364959,The Case Against Brooklyn,1958,['United States of America'],"['Drama', 'Crime Fiction']",1950,8
7214505,A Word to the Wives,1955,['United States of America'],['Short Film'],1950,5
2439288,Farewell to the King,1989,['United States of America'],"['Action', 'Film adaptation', 'Indie', 'Action/Adventure', 'Thriller', 'Adventure', 'Drama', 'War film']",1980,9
67916,Strategic Air Command,1955,['United States of America'],"['Film à clef', 'Drama']",1950,5
1608670,Frailty,2001,"['Germany', 'United States of America', 'Italy']","['Psychological thriller', 'Crime Fiction', 'Mystery', 'Thriller', 'Crime Thriller', 'Drama', 'Period piece', 'Suspense', 'Horror']",2000,1
23214102,Iqraar By Chance,2006,['India'],"['Romantic drama', 'Comedy', 'Bollywood', 'World cinema', 'Romance Film', 'Romantic comedy', 'Drama']",2000,6
61191,The Divorcee,1930,['United States of America'],"['Film adaptation', 'Black-and-white', 'Romantic drama', 'Romance Film', 'Pre-Code', 'Drama']",1930,0
14713355,The Girl Most Likely,1957,['United States of America'],"['Musical', 'Romance Film', 'Comedy']",1950,7
10777778,Flash Legs,1982,['Hong Kong'],"['Action', 'Chinese Movies', 'Martial Arts Film', 'Drama']",1980,2
2397783,Maximum Surge,2003,"['Canada', 'United States of America']","['Science Fiction', 'Television movie']",2000,3
15697258,Year of Enlightenment,1986,['Spain'],['Comedy film'],1980,6
14958805,Montana Sky,2007,['United States of America'],"['Film adaptation', 'Family Drama', 'Romantic drama', 'Romance Film', 'Television movie', 'Drama']",2000,7
5984762,Mr. Lucky,1943,['United States of America'],"['Black-and-white', 'Crime Comedy', 'Romance Film', 'Romantic comedy', 'Comedy-drama']",1940,3
4277733,A Kid from Tibet,1991,"['Hong Kong', 'Taiwan']","['Action', 'Action/Adventure', 'World cinema', 'Chinese Movies', 'Martial Arts Film']",1990,1
3745503,Murder Most Foul,1964,['United Kingdom'],"['Film adaptation', 'Detective fiction', 'Mystery', 'Thriller', 'Detective', 'Crime Thriller', 'Whodunit']",1960,4
8746433,"Our Son, the Matchmaker",1996,['United States of America'],"['Romance Film', 'Romantic comedy', 'Melodrama', 'Family Film']",1990,6
4890336,Klatretøsen,2002,['Denmark'],"['Crime Fiction', 'Action/Adventure', 'Teen', 'World cinema', ""Children's/Family"", 'Adventure']",2000,2
31531490,Mausoleum,1983,['United States of America'],['Horror'],1980,3
6602116,Doraemon The Magic 2007,2007,['Japan'],"['Anime', 'Japanese Movies']",2000,7
4214783,Sengoku Jieitai 1549,2005,['Japan'],"['Action/Adventure', 'Japanese Movies']",2000,5
50486,French Kiss,1995,"['United Kingdom', 'United States of America']","['Romance Film', 'Romantic comedy', 'Comedy']",1990,5
4199150,Mercy,2000,['United States of America'],"['LGBT', 'Mystery', 'Thriller', 'Erotic thriller', 'Crime Thriller', 'Drama']",2000,0
226682,Casualties of War,1989,['United States of America'],"['Anti-war', 'Period piece', 'Anti-war film', 'War film', 'Drama', 'Tragedy']",1980,9
27691926,"I Will, I Will... for Now",1976,['United States of America'],"['Romance Film', 'Comedy film']",1970,6
636056,Twenty Bucks,1993,['United States of America'],"['Drama', 'Indie', 'Comedy', 'Ensemble Film']",1990,3
7657105,Hail Caesar,1994,['United States of America'],"['Romance Film', 'Romantic comedy', 'Comedy']",1990,4
14488588,Flying Saucer Daffy,1958,['United States of America'],"['Black-and-white', 'Short Film', 'Comedy', 'Adventure', 'Science Fiction']",1950,8
28074095,Larceny on the Air,1937,['United States of America'],"['Action', 'Drama', 'Crime Fiction', 'Thriller', 'Crime Thriller']",1930,7
67411,Above the Law,1988,"['Hong Kong', 'United States of America']","['Action', 'Action/Adventure', 'Thriller', 'Chinese Movies', 'Martial Arts Film']",1980,8
15652096,Cover Me Babe,1970,['United States of America'],['Drama'],1970,0
17199875,Wild Cherry,2009,"['Canada', 'United States of America']",['Comedy'],2000,9
27284085,Booky's Crush,2009,['Canada'],"['Period piece', 'Film adaptation', 'Coming of age', 'Family Drama', 'Television movie', 'Drama', 'Family Film']",2000,9
2447735,Fifteen and Pregnant,1998,['United States of America'],"['Family Drama', 'Teen', 'Television movie', 'Drama']",1990,8
27444757,Tammy and the T-Rex,1994,['United States of America'],"['Science Fiction', 'Comedy']",1990,4
5906792,Mini's First Time,2006,['United States of America'],"['Drama', 'Crime Fiction', 'Indie', 'Comedy', 'Film noir', 'Black comedy', 'Comedy-drama']",2000,6
7976591,Crusade in Jeans,2006,"['Luxembourg', 'Belgium', 'Germany', 'Netherlands']","['World cinema', 'Adventure', 'War film', 'Science Fiction', 'Family Film', 'Fantasy']",2000,6
14884678,Death in Love,2008,['United States of America'],"['Period piece', 'Drama', 'Indie', 'Family Drama', 'Romantic drama', 'Romance Film', 'War film']",2000,8
30777481,Gair Kanooni,1989,[],['Action'],1980,9
5917218,The Little Ones,1965,['United Kingdom'],"['Adventure', ""Children's/Family""]",1960,5
6512034,Lady Be Good,1941,['United States of America'],"['Musical', 'Black-and-white', 'Comedy', 'Romance Film', 'Romantic comedy']",1940,1
3653120,The Young Lions,1958,['United States of America'],"['Period piece', 'Film adaptation', 'Epic', 'War film', 'Drama']",1950,8
4673170,Barbie as the Princess and the Pauper,2004,['United States of America'],"['Musical', 'Animation', 'Animated Musical', ""Children's/Family"", ""Children's"", 'Computer Animation', 'Fairy tale', 'Family Film']",2000,4
29047235,The Fifth-Column Mouse,1943,['United States of America'],"['Animation', 'Short Film', 'Comedy']",1940,3
2507217,Chimes at Midnight,1965,"['Spain', 'Switzerland', 'France', 'England', 'United States of America']","['Comedy', 'War film', 'Tragicomedy', 'Costume drama', 'Drama']",1960,5
1212256,Homeward Bound: The Incredible Journey,1993,['United States of America'],"['Comedy', 'Family-Oriented Adventure', ""Children's/Family"", ""Children's"", 'Adventure', 'Drama', 'Animal Picture', 'Family Film']",1990,3
19270580,Sedin Dujone,2008,['India'],"['Romance Film', 'Drama']",2000,8
16258792,Broken Vessels,1998,['United States of America'],"['Crime Fiction', 'Drama', 'Medical fiction']",1990,8
254269,Bill & Ted's Bogus Journey,1991,['United States of America'],"['Buddy film', 'Comedy', 'Teen', 'Slapstick', 'Adventure', 'Science Fiction', 'Fantasy Comedy', 'Fantasy']",1990,1
30636098,Love at Times Square,2003,[],['Romance Film'],2000,3
1095555,Kung Pow! Enter the Fist,2002,['United States of America'],"['Action', 'Parody', 'Action/Adventure', 'Comedy', 'Martial Arts Film']",2000,2
93559,Cruel Intentions,1999,['United States of America'],"['Thriller', 'Teen', 'Romance Film', 'Melodrama', 'Drama']",1990,9
2730049,The Secret of NIMH 2: Timmy to the Rescue,1998,['United States of America'],"['Animation', 'Adventure', 'Family Film']",1990,8
6919595,Billy's Hollywood Screen Kiss,1998,['United States of America'],"['LGBT', 'Indie', 'Comedy', 'Romance Film', 'Gay Themed', 'Gay', 'Gay Interest', 'Romantic comedy', 'Ensemble Film']",1990,8
34243460,Budget Padmanabham,2001,['India'],"['Drama', 'Comedy film']",2000,1
221489,Tie Me Up! Tie Me Down!,1990,['Spain'],"['Comedy', 'World cinema', 'Black comedy', 'Romance Film', 'Drama', 'Romantic comedy', 'Erotica', 'Sex comedy']",1990,0
4524855,She's Out of Control,1989,['United States of America'],"['Coming of age', 'Indie', 'Comedy', 'Teen', 'Romantic comedy', 'Romance Film']",1980,9
6795057,Ennai Thalatta Varuvala,2003,['India'],[],2000,3
1771770,Hum Hain Rahi Pyar Ke,1992,['India'],['Bollywood'],1990,2
6102569,Ranam,2006,['India'],['Action'],2000,6
21549300,The Milk of Sorrow,2009,"['Spain', 'Peru']","['Music', 'Drama', 'World cinema']",2000,9
1428048,The Last of the Mohicans,1992,['United States of America'],"['Period piece', 'Film adaptation', 'Romantic drama', 'Romance Film', 'War film', 'Costume drama', 'Drama']",1990,2
19897850,Cheluvina Chittara,2007,['India'],['Drama'],2000,7
7258734,Nelly et Monsieur Arnaud,1995,"['France', 'Germany', 'Italy']","['Romantic drama', 'World cinema', 'Romance Film', 'Drama']",1990,5
1927548,Two-Lane Blacktop,1971,['United States of America'],"['Auto racing', 'Drama', 'Indie', 'Existentialism', 'Road movie', 'Cult']",1970,1
6715066,Last Embrace,1979,['United States of America'],"['Psychological thriller', 'Spy', 'Film adaptation', 'Mystery', 'Thriller', 'Crime Thriller', 'Drama', 'Suspense']",1970,9
11734992,Brown of Harvard,1926,['United States of America'],"['Silent film', 'Black-and-white', 'Indie']",1920,6
675935,Matilda,1996,['United States of America'],"['Comedy', 'Family Film', 'Fantasy']",1990,6
10747502,The Venetian Affair,1967,['United States of America'],"['Action', 'Spy', 'Thriller']",1960,7
21774390,Three Sailors and a Girl,1953,['United States of America'],['Musical'],1950,3
24007839,Endless Night,1972,['Kingdom of Great Britain'],"['Detective fiction', 'Crime Fiction', 'Mystery', 'Thriller', 'Crime Thriller', 'Suspense', 'Detective', 'Supernatural']",1970,2
14016369,Black Zoo,1963,['United States of America'],"['Horror', 'Melodrama', 'Drama', 'Natural horror films']",1960,3
667361,Harry Potter and the Philosopher's Stone,2001,"['United Kingdom', 'United States of America']","['Fantasy Adventure', ""Children's Fantasy"", 'School story', ""Children's/Family"", 'Adventure', 'Family Film', 'Fantasy']",2000,1
7424613,Master,1997,['India'],['Drama'],1990,7
547526,Barbershop 2: Back in Business,2004,['United States of America'],"['Workplace Comedy', 'Comedy', 'Ensemble Film']",2000,4
2317340,Friday the 13th Part 3: 3D,1982,['United States of America'],"['Slasher', 'Teen', 'Horror', 'Cult']",1980,2
7764053,The Librarian: Return to King Solomon's Mines,2006,['United States of America'],"['Action', 'Fantasy Adventure', 'Action/Adventure', 'Adventure', 'Television movie']",2000,6
14439238,"No Census, No Feeling",1940,['United States of America'],"['Short Film', 'Black-and-white', 'Comedy']",1940,0
30514819,Hitler,1998,[],['Crime Fiction'],1990,8
31406987,Kalikkalam,1990,[],"['Drama', 'Thriller', 'Comedy film']",1990,0
7191769,Chocolat,1988,"['France', 'Germany', 'Cameroon', 'West Germany']","['Comedy', 'Drama', 'World cinema']",1980,8
25757180,Crime in the Streets,1956,['United States of America'],"['Crime Fiction', 'Crime Drama', 'Juvenile Delinquency Film', 'Drama']",1950,6
706370,The Truth About Cats & Dogs,1996,['United States of America'],"['Comedy', 'Romance Film', 'Romantic comedy', 'Comedy of Errors']",1990,6
5469928,Four Flies on Grey Velvet,1972,"['France', 'Italy']","['Psychological thriller', 'Giallo', 'Crime Fiction', 'Mystery', 'Thriller', 'World cinema', 'Crime Thriller', 'Horror']",1970,2
10093456,Carnosaur 3: Primal Species,1996,['United States of America'],"['Creature Film', 'Science Fiction', 'Horror', 'B-movie', 'Sci-Fi Horror']",1990,6
18848181,Tweet and Sour,1956,[],"['Animation', 'Short Film', 'Family Film']",1950,6
5427784,How to Commit Marriage,1969,['United States of America'],"['Indie', 'Comedy', 'Romance Film', 'Drama']",1960,9
13697594,Party Camp,1987,['United States of America'],['Comedy'],1980,7
2091940,The Butcher's Wife,1991,['United States of America'],"['Comedy', 'Romance Film', 'Romantic comedy', 'Fantasy Comedy', 'Fantasy']",1990,1
6899733,Household Saints,1993,['United States of America'],"['Film adaptation', 'Indie', 'Comedy', 'Domestic Comedy', 'Religious Film', 'Drama']",1990,3
14736920,The Three Troubledoers,1946,['United States of America'],"['Short Film', 'Black-and-white', 'Comedy']",1940,6
2389941,Lady on a Train,1945,['United States of America'],"['Black-and-white', 'Mystery', 'Comedy', 'Film noir', 'Whodunit']",1940,5
3719166,Scooby Doo in Where's My Mummy?,2005,['United States of America'],"['Animation', 'Thriller', 'Family Film']",2000,5
2439209,My Science Project,1985,['United States of America'],"['Comedy', 'Teen', 'Adventure', 'Science Fiction']",1980,5
9368233,Danger Within,1958,['United Kingdom'],"['War film', 'Black-and-white']",1950,8
2220694,Can't Stop the Music,1980,['United States of America'],"['Musical', 'Comedy', 'Jukebox musical', 'Cult']",1980,0
9286198,Poramboku,2007,['India'],['Romance Film'],2000,7
18107156,Mad About Men,1954,['United Kingdom'],"['Romantic drama', 'Comedy', 'Romance Film', 'Romantic comedy', 'Drama', 'Fantasy']",1950,4
528256,Melinda and Melinda,2005,['United States of America'],"['Indie', 'Romantic drama', 'Comedy', 'Romance Film', 'Tragicomedy', 'Drama', 'Time travel', 'Romantic comedy', 'Comedy-drama', 'Comedy of manners']",2000,5
3644955,The Last Wave,1977,"['New Zealand', 'Australia']","['Suspense', 'Mystery', 'Thriller', 'World cinema', 'Supernatural', 'Drama']",1970,7
31844088,Sammohanam,1994,[],['Drama'],1990,4
1291727,Booty Call,1997,['United States of America'],"['Comedy', 'Sex comedy']",1990,7
33364558,A Real American Hero,1978,['United States of America'],"['Action', 'Drama', 'Crime Fiction', 'Action/Adventure', 'Biopic [feature]']",1970,8
31104252,The County Chairman,1935,['United States of America'],"['Romance Film', 'Comedy', 'Drama']",1930,5
6084677,Anand,2004,['India'],"['Musical', 'World cinema', 'Tollywood', 'Drama']",2000,4
2648891,Jane Eyre,1970,"['United Kingdom', 'United States of America']","['Costume drama', 'Drama']",1970,0
18965131,Stella Maris,1925,['United States of America'],"['Silent film', 'Black-and-white', 'Drama']",1920,5
76403,Verbena Tragica,1939,['United States of America'],"['Black-and-white', 'Drama']",1930,9
22611782,Purge,2008,['United States of America'],"['Short Film', 'Drama']",2000,8
1717731,Try Seventeen,2002,"['Canada', 'United States of America']","['Coming of age', 'Comedy', 'Romance Film', 'Romantic comedy']",2000,2
11893608,Pinocchio's Revenge,1996,['United States of America'],"['Monster movie', 'Slasher', 'Horror', 'B-movie']",1990,6
234382,Elephant,2003,['United States of America'],"['LGBT', 'Crime Fiction', 'Indie', 'Teen', 'Drama']",2000,3
8857538,Holy Matrimony,1943,['United States of America'],"['Black-and-white', 'Comedy', 'Drama', 'Family Film']",1940,3
2405382,Looking for Alibrandi,2000,['Australia'],"['Coming of age', 'Drama']",2000,0
3722586,The Other Me,2000,['United States of America'],"['Comedy', 'Family Film', 'Fantasy']",2000,0
893561,1492 Conquest of Paradise,1992,"['Spain', 'United Kingdom', 'France', 'United States of America']","['Period piece', 'Biography', 'Action/Adventure', 'Epic', 'Adventure', 'Drama']",1990,2
7967169,The Naked Island,1960,['Japan'],"['Japanese Movies', 'Drama']",1960,0
97740,Darling,1965,['United Kingdom'],"['Romance Film', 'Romantic drama', 'Drama']",1960,5
17471669,Detroit Metal City,2008,['Japan'],"['Japanese Movies', 'Comedy', 'World cinema']",2000,8
695227,Lethal Weapon 2,1989,['United States of America'],"['Action', 'Crime Fiction', 'Action Thrillers', 'Action/Adventure', 'Buddy film', 'Thriller', 'Comedy', 'Buddy cop']",1980,9
6045886,Up Periscope,1959,['United States of America'],"['Combat Films', 'Thriller', 'War film', 'Drama']",1950,9
12244820,Belli moda,1966,['India'],['Drama'],1960,6
32076460,Hanste Khelte,1984,[],['Crime Fiction'],1980,4
21312540,Up 'n' Under,1998,['United Kingdom'],"['Screwball comedy', 'Comedy']",1990,8
18701047,A Hen in the Wind,1948,['Japan'],"['Black-and-white', 'Japanese Movies', 'Drama']",1940,8
11020848,Hare Splitter,1948,['United States of America'],"['Animated cartoon', 'Short Film', 'Family Film']",1940,8
13364284,The Growing Pains Movie,2000,['United States of America'],"['Comedy', 'Family Film']",2000,0
13760378,Une étrange affaire,1981,['France'],"['Satire', 'Marriage Drama', 'Drama']",1980,1
32901953,Gloria,1999,['Portugal'],['Drama'],1990,9
24374818,The Errand of Angels,2008,['United States of America'],"['Indie', 'Drama']",2000,8
21494773,"Verde por fora, vermelho por dentro",1980,['Portugal'],[],1980,0
12105437,Flying Boys,2004,['South Korea'],"['Drama', 'Coming of age', 'Teen']",2000,4
20518252,Witch Crafty,1955,['United States of America'],"['Animation', 'Short Film', 'Comedy film', 'Family Film']",1950,5
14736812,If a Body Meets a Body,1945,['United States of America'],"['Black-and-white', 'Short Film', 'Comedy', 'Slapstick']",1940,5
22635683,"St. Trinian's, The Legend of Fritton's Gold",2009,['United Kingdom'],"['Comedy', 'Teen', 'Adventure']",2000,9
24348047,Colt 38 Special Squad,1978,['Italy'],"['Action', 'Drama', 'Action/Adventure', 'Thriller', 'World cinema']",1970,8
2296541,I Could Go On Singing,1963,['United Kingdom'],"['Musical', 'Melodrama', 'Drama']",1960,3
20937181,Timber Falls,2007,['United States of America'],"['Suspense', 'Slasher', 'Horror', 'Cult']",2000,7
11253503,Prince,1969,['India'],"['Musical', 'Romance Film']",1960,9
2010889,HouseSitter,1992,['United States of America'],"['Screwball comedy', 'Comedy', 'Romance Film', 'Romantic comedy']",1990,2
9314852,Little Athens,2006,['United States of America'],"['Indie', 'Comedy', 'Romantic comedy', 'Comedy-drama', 'Ensemble Film']",2000,6
3653877,The Golden Coach,1952,"['France', 'Italy']","['Costume Adventure', 'Romantic drama', 'Action/Adventure', 'Comedy', 'World cinema', 'Romance Film', 'Adventure', 'Drama', 'Romantic comedy']",1950,2
10838472,That Certain Summer,1972,['United States of America'],['Drama'],1970,2
3358393,"Up, Up, and Away",2000,"['Canada', 'United States of America']","['Superhero movie', ""Children's""]",2000,0
7490614,Wine Road of the Samurai,2006,['Japan'],"['Japanese Movies', 'Documentary']",2000,6
2723452,Overnight Delivery,1998,['United States of America'],"['Comedy', 'Teen', 'Romance Film', 'Romantic comedy', 'Road movie']",1990,8
15007612,W.C. Fields and Me,1978,['United States of America'],"['Comedy', 'Biographical film', 'Biopic [feature]', 'Drama']",1970,8
25751187,Uncovered,1994,"['United Kingdom', 'Spain']","['Action', 'Suspense', 'Mystery', 'Action/Adventure', 'Thriller', 'Crime Thriller']",1990,4
9308623,Mozhi,2007,['India'],"['Musical', 'Romance Film', 'Comedy']",2000,7
22322199,No Tomorrow,1999,['United States of America'],"['Crime Fiction', 'Action/Adventure', 'Thriller', 'Crime Thriller']",1990,9
22295674,I Saw the Sun,2009,['Turkey'],"['Family Drama', 'World cinema', 'Epic', 'Drama']",2000,9
333492,First Kid,1996,['United States of America'],"['Comedy', ""Children's/Family"", ""Children's"", 'Family Film']",1990,6
3471159,In My Country,2005,"['United Kingdom', 'South Africa', 'Ireland']","['Romantic drama', 'Romance Film', 'Political drama', 'Drama']",2000,5
12133251,Death to the Supermodels,2005,['United States of America'],"['Parody', 'Horror Comedy', 'Teen', 'Horror', 'Comedy']",2000,5
1684625,Lords of Dogtown,2005,"['Germany', 'United States of America']","['Period piece', 'Coming of age', 'Biographical film', 'Teen', 'Sports', 'Drama']",2000,5
3538462,The Mermaid,1965,['Hong Kong'],"['Musical', 'Fairy tale', ""Children's Fantasy"", ""Children's/Family"", 'Chinese Movies', 'Fantasy']",1960,5
6739637,Chak De India,2007,['India'],"['Bollywood', 'Sports', 'Drama', 'Family Film']",2000,7
2838499,The Grey Zone,2001,['United States of America'],"['Period piece', 'Indie', 'Historical fiction', 'Drama']",2000,1
17661373,Racing for Time,2008,['United States of America'],"['Television movie', 'Biographical film', 'Drama']",2000,8
5467648,Flying Elephants,1928,['United States of America'],"['Black-and-white', 'Indie', 'Short Film', 'Comedy', 'Silent film', 'Slapstick', 'Fantasy']",1920,8
9437888,Don't Give Up on Us,2006,['Philippines'],"['Filipino Movies', 'Romantic drama', 'Comedy', 'Thriller', 'World cinema', 'Romance Film', 'Drama', 'Romantic comedy']",2000,6
7014541,If You Go Down in the Woods Today,1981,['United Kingdom'],['Comedy'],1980,1
23819012,Uchū Senkan Yamato: Fukkatsu hen,2009,['Japan'],"['Action', 'Animation', 'Japanese Movies', 'Adventure', 'Anime', 'Science Fiction', 'Fantasy']",2000,9
3598416,While the City Sleeps,1956,['United States of America'],"['Psychological thriller', 'Black-and-white', 'Crime Fiction', 'Thriller', 'Film noir', 'Drama']",1950,6
5221392,Arirang 3,1936,['Korea'],[],1930,6
23013668,A Bone for a Bone,1951,[],"['Animation', 'Short Film', 'Comedy film', 'Family Film']",1950,1
5688616,The Kid from Brooklyn,1946,['United States of America'],['Comedy'],1940,6
8844071,Vijay,1988,['India'],"['Bollywood', 'World cinema']",1980,8
14469100,"Forever, Darling",1956,['United States of America'],"['Comedy', 'Romance Film', 'Romantic comedy', 'Fantasy']",1950,6
4360451,Code Breakers,2005,['United States of America'],"['Sports', 'Drama', 'Family Film']",2000,5
14143579,Captain Midnight,1942,['United States of America'],"['Adventure', 'Black-and-white']",1940,2
2053385,Heart of Dixie,1989,['United States of America'],"['Period piece', 'Political drama', 'Drama']",1980,9
23299382,The Legend of Gator Face,1996,['Canada'],"['Comedy', 'Horror', 'Adventure', ""Children's"", 'Family Film']",1990,6
31357325,The Big Shot-Caller,2008,['United States of America'],"['Dance', 'Indie', 'Drama']",2000,8
6696498,Penny Points to Paradise,1951,['United Kingdom'],['Comedy'],1950,1
6708534,Bride of the Gorilla,1951,['United States of America'],"['Black-and-white', 'Thriller', 'Horror', 'B-movie', 'Science Fiction']",1950,1
22591470,The Incredible Journey,1963,"['Canada', 'United States of America']","['Adventure', 'Family Film']",1960,3
19149088,Keladi Kanmani,1990,['India'],['Drama'],1990,0
26183012,Green Light,2002,['Turkey'],"['Comedy', 'Romance Film', 'Drama', 'Fantasy']",2000,2
7194759,The Record of a Tenement Gentleman,1947,['Japan'],"['Art film', 'Japanese Movies', 'Melodrama', 'Historical fiction', 'Drama']",1940,7
1801280,Mr. Mom,1983,['United States of America'],"['Comedy', 'Satire', 'Domestic Comedy', 'Family Film']",1980,3
103018,Heaven Can Wait,1978,['United States of America'],"['Comedy', 'Remake', 'New Hollywood', 'Romantic comedy', 'Romance Film', 'Sports', 'Fantasy']",1970,8
16703049,Who's Been Sleeping in My Bed?,1963,['United States of America'],"['Romance Film', 'Romantic comedy', 'Comedy']",1960,3
2540490,Bye Bye Blues,1989,['Canada'],"['Drama', 'Indie', 'Romantic drama', 'Marriage Drama', 'Romance Film', 'War film']",1980,9
22716058,The Man on the Eiffel Tower,1949,"['United States of America', 'France']","['Suspense', 'Mystery', 'Thriller', 'Crime Thriller']",1940,9
6060780,Jo Bole So Nihaal,2005,"['India', 'United States of America']","['Action', 'Action/Adventure', 'Thriller', 'World cinema']",2000,5
32171599,Yaadon Ki Kasam,1985,['India'],"['Action', 'Musical', 'Bollywood', 'World cinema', 'Romance Film', 'Drama']",1980,5
6436552,Savage Planet,2006,"['Canada', 'United States of America']","['Creature Film', 'Horror', 'Adventure', 'Television movie', 'Sci-Fi Horror', 'Science Fiction']",2000,6
23738488,Nasaan si Francis?,2006,['Philippines'],"['Filipino Movies', 'Comedy', 'World cinema', 'Drama']",2000,6
3986674,The Wabbit Who Came to Supper,1942,['United States of America'],"['Animation', 'Short Film', 'Family Film']",1940,2
15442575,Lodge Night,1923,['United States of America'],"['Black-and-white', 'Indie', 'Short Film', 'Comedy', 'Silent film', 'Family Film']",1920,3
28625636,Ruby,1977,['United States of America'],"['Drama', 'Horror']",1970,7
2017575,They call me MISTER Tibbs,1970,['United States of America'],"['Action', 'Crime Fiction', 'Action/Adventure', 'Thriller', 'Crime Thriller', 'Drama']",1970,0
73930,Greed,1924,['United States of America'],"['Silent film', 'Black-and-white', 'Drama']",1920,4
5848001,Gypsy 83,2001,['United States of America'],"['LGBT', 'Indie', 'Comedy', 'Black comedy', 'Drama', 'Coming of age', 'Comedy-drama', 'Road movie']",2000,1
16780424,The Unholy Three,1925,['United States of America'],"['Black-and-white', 'Crime Fiction', 'Indie', 'Thriller', 'Silent film']",1920,5
23795974,Anandabhairavi,2007,['India'],['Drama'],2000,7
2585223,The Claim,2000,"['Canada', 'United Kingdom', 'France', 'United States of America']","['Period piece', 'Film adaptation', 'Romantic drama', 'Western', 'Romance Film', 'Costume drama', 'Drama']",2000,0
28761811,Circumstantial Evidence,1952,['United Kingdom'],['Crime Fiction'],1950,2
11549218,Satan's Waitin',1954,['United States of America'],"['Short Film', 'Comedy', 'Family Film']",1950,4
9186440,Masam Masam Manis,1965,['Malaysia'],"['Musical', 'Comedy']",1960,5
18488743,Hare Ram,2008,['India'],"['Action', 'Crime Fiction', 'Gangster Film', 'Romance Film']",2000,8
6550500,Shyamal Chhaya,2004,['Bangladesh'],['Drama'],2000,4
24490979,The Tower of Lies,1925,['United States of America'],"['Family Drama', 'Silent film', 'Melodrama', 'Drama']",1920,5
555629,The Cannonball Run,1981,"['Hong Kong', 'United States of America']","['Action', 'Adventure Comedy', 'Screwball comedy', 'Action/Adventure', 'Comedy', 'Buddy film', 'Chinese Movies', 'Auto racing', 'Action Comedy', 'Chase Movie', 'Road movie']",1980,1
8782644,Bhalo Theko,2003,['India'],"['Romance Film', 'Drama']",2000,3
24608710,Manu Uncle,1988,['India'],"[""Children's""]",1980,8
10062012,A Woman Called Sada Abe,1975,['Japan'],"['Erotic Drama', 'Romantic drama', 'World cinema', 'Romance Film', 'Drama', 'Softcore Porn', 'Japanese Movies', 'Pinku eiga', 'Erotica']",1970,5
27858885,Rakshasa Rajavu,2000,['India'],"['Action', 'Drama', 'Bollywood']",2000,0
8470456,"Adiós, Roberto",1985,['Argentina'],['Drama'],1980,5
7468020,Anuranan,2006,['India'],"['Musical', 'Art film', 'World cinema', 'Drama']",2000,6
5148493,Reflections in a Golden Eye,1967,['United States of America'],"['Film adaptation', 'LGBT', 'Thriller', 'Drama', 'Gay Themed', 'Gay', 'Gay Interest', 'Marriage Drama']",1960,7
5489126,Hitman Hart: Wrestling with Shadows,1998,['Canada'],"['Biography', 'Documentary', 'Extreme Sports', 'Sports']",1990,8
24731562,Children of the Corn,2009,[],"['Film adaptation', 'Television movie', 'Horror']",2000,9
1686031,Unleashed,2005,"['United Kingdom', 'France', 'United States of America']","['Action', 'Crime Fiction', 'Coming of age', 'Action/Adventure', 'Thriller', 'Martial Arts Film', 'Drama']",2000,5
2968661,Heaven's a Drag,1994,['United Kingdom'],"['LGBT', 'Drama', 'Indie', 'Comedy', 'Romance Film', 'Fantasy']",1990,4
29201788,Mr. Proudfoot Shows a Light,1941,['United Kingdom'],['Short Film'],1940,1
1592832,Umrao Jaan,1981,['India'],"['Musical', 'Bollywood', 'World cinema', 'Drama']",1980,1
1605358,Champagne Charlie,1944,['United Kingdom'],"['Musical', 'Black-and-white', 'Comedy', 'Drama']",1940,4
26054640,Margie,1946,['United States of America'],['Comedy'],1940,6
13860081,The Dawn Patrol,1938,['United States of America'],"['Action', 'Drama', 'Action/Adventure', 'War film']",1930,8
6821816,Les Amants,1958,['France'],"['Romantic drama', 'Marriage Drama', 'Romance Film', 'Drama']",1950,8
24987329,La bête,1975,['France'],"['Romantic fantasy', 'Romantic drama', 'Comedy', 'Horror']",1970,5
923518,Dames,1934,['United States of America'],"['Musical', 'Black-and-white', 'Comedy', 'Musical comedy', 'Romance Film', 'Pre-Code']",1930,4
3659082,Perhaps Love,2005,"['Hong Kong', 'Malaysia', 'China']","['Musical', 'Romantic drama', 'World cinema', 'Romance Film', 'Chinese Movies', 'Drama']",2000,5
7882235,Smart People,2008,['United States of America'],"['Indie', 'Family Drama', 'Comedy', 'Black comedy', 'Romance Film', 'Drama', 'Romantic comedy', 'Comedy-drama']",2000,8
15791592,Roughly Speaking,1945,['United States of America'],"['Black-and-white', 'Comedy', 'Domestic Comedy', 'Romantic comedy']",1940,5
5662631,Bancho Sarayashiki,1957,['Japan'],['Horror'],1950,7
19942408,Lifespan,1976,['Netherlands'],"['Mystery', 'Thriller', 'Science Fiction', 'Drama']",1970,6
27947113,Božská Ema,1979,['Czech Republic'],['Drama'],1970,9
8078282,Australia,2008,"['Australia', 'United Kingdom', 'New Zealand', 'United States of America']","['Romantic drama', 'Romance Film', 'Adventure', 'Drama', 'Period piece', 'History', 'Western', 'Epic', 'War film']",2000,8
3672796,Dr. Jekyll and Mr. Hyde,1920,['United States of America'],"['Black-and-white', 'Crime Fiction', 'Horror', 'Silent film', 'Science Fiction', 'Drama']",1920,0
13870077,The Sun in a Net,1962,['Czechoslovakia'],"['Czechoslovak New Wave', 'Drama']",1960,2
3899170,36 Hours,1965,['United States of America'],"['Drama', 'War film', 'Thriller']",1960,5
6470956,Man of the Year,2006,['United States of America'],"['Political cinema', 'Parody', 'Satire', 'Thriller', 'Comedy', 'Drama']",2000,6
28177009,Rest Stop: Don't Look Back,2008,['United States of America'],"['Slasher', 'Teen', 'Horror']",2000,8
8802748,This Divided State,2005,['United States of America'],"['Social issues', 'Political cinema', 'Biography', 'Indie', 'Documentary', 'Political drama', 'Culture & Society']",2000,5
5974420,Koodal Nagar,2007,['India'],['Romance Film'],2000,7
3864619,Malli,1998,['India'],['Drama'],1990,8
28126186,Manèges,1950,['France'],"['Film noir', 'Melodrama', 'Drama']",1950,0
20181491,Planet of the Apes,2001,['United States of America'],"['Action', 'Time travel', 'Thriller', 'Adventure', 'Science Fiction']",2000,1
4021176,Sudden Death,1995,['United States of America'],"['Action', 'Drama', 'Action/Adventure', 'Thriller']",1990,5
22885135,Blood Reign: Curse of the Yoma,1989,['Japan'],"['Action', 'Animation', 'Japanese Movies', 'World cinema', 'Horror', 'Anime', 'Fantasy']",1980,9
19399172,Suzhou River,2000,"['China', 'Germany']","['Crime Fiction', 'Romantic drama', 'World cinema', 'Romance Film', 'Chinese Movies', 'Drama']",2000,0
2528686,Flying Down to Rio,1933,['United States of America'],"['Musical', 'Black-and-white', 'Musical Drama', 'Comedy', 'Musical comedy', 'Romance Film', 'Pre-Code', 'Airplanes and airports', 'Romantic comedy']",1930,3
23566188,Golgo 13: The Professional,1983,['Japan'],"['Action', 'Animation', 'Action/Adventure', 'Thriller', 'World cinema', 'Drama', 'Japanese Movies', 'Anime']",1980,3
5379725,Huevos de oro,1993,"['France', 'Spain', 'Italy']","['Comedy', 'World cinema', 'Drama', 'Sex comedy']",1990,3
31685432,Abhayam,1991,[],"[""Children's""]",1990,1
3371225,A Very Brady Christmas,1988,['United States of America'],"['Comedy-drama', 'Family Film']",1980,8
18629672,"Angélique, Marquise des Anges",1964,"['France', 'West Germany', 'Italy']","['Romantic drama', 'World cinema', 'Romance Film', 'Drama']",1960,4
19937593,The Amorous Mis-Adventures of Casanova,1976,"['France', 'Austria', 'Italy']","['Parody', 'Comedy', 'Romance Film', 'Romantic comedy']",1970,6
11594636,Letty Lynton,1932,['United States of America'],"['Black-and-white', 'Mystery', 'Romantic drama', 'Pre-Code', 'Drama']",1930,2
21868051,Desperate Justice,2001,['United States of America'],"['Drama', 'Crime Fiction']",2000,1
24427315,The Girl Who Had Everything,1953,['United States of America'],"['Romantic drama', 'Romance Film', 'Melodrama', 'Drama']",1950,3
4951212,Rojo amanecer,1989,['Mexico'],"['Drama', 'Political drama', 'Thriller']",1980,9
689948,The Horse Soldiers,1959,['United States of America'],"['Action/Adventure', 'Western', 'Cavalry Film', 'War film']",1950,9
6124520,Jill Rips,2000,['Canada'],"['Erotic thriller', 'Crime Thriller', 'Thriller']",2000,0
15871827,Blue City,1986,['United States of America'],"['Action', 'Film adaptation', 'Crime Fiction', 'Mystery', 'Thriller', 'Crime Thriller', 'Drama', 'Political thriller']",1980,6
3183403,The Grizzly and the Treasure,1975,['United States of America'],"['Period piece', 'Adventure', 'Family Film']",1970,5
12075531,The Man from Blankley's,1930,['United States of America'],"['Black-and-white', 'Comedy', 'Satire', 'Slapstick']",1930,0
33521974,Wicked Spring,2002,[],"['Action', 'Period piece', 'Drama', 'Historical fiction']",2000,2
9979687,Beauty in Trouble,2006,['Czech Republic'],"['Romantic drama', 'Comedy', 'World cinema', 'Drama']",2000,6
2220448,Graffiti Bridge,1990,['United States of America'],"['Musical', 'Drama']",1990,0
5754330,Simon Says,2006,['United States of America'],"['Crime Fiction', 'Mystery', 'Slasher', 'Thriller', 'Horror', 'Teen']",2000,6
10890538,Beauty and the Breast,2002,['Hong Kong'],"['Chinese Movies', 'Comedy', 'World cinema']",2000,2
710906,My Girl 2,1994,['United States of America'],"['Family Drama', 'Comedy', 'Teen', 'Romance Film', 'Drama', 'Coming of age', 'Comedy-drama', 'Family Film']",1990,4
8370509,Parallel Sons,1995,['United States of America'],"['Romance Film', 'Drama']",1990,5
13126825,Deadman's Curve,1978,['United States of America'],"['Musical', 'Drama', 'Biopic [feature]']",1970,8
11933253,Stalking Santa,2006,['United States of America'],"['Christmas movie', 'Comedy', 'Family Film']",2000,6
515217,Earthquake,1974,['United States of America'],"['Action', 'Action/Adventure', 'Natural disaster', 'Doomsday film', 'Disaster']",1970,4
21936886,Panchavadi Palam,1984,['India'],['Comedy'],1980,4
8988995,Pranam Khareedu,1978,['India'],['Drama'],1970,8
11445288,Signs of Life,1968,['Germany'],"['Drama', 'World cinema']",1960,8
2278187,Miracle Landing,1990,['United States of America'],"['Action', 'Drama', 'Docudrama', 'Television movie', 'Disaster']",1990,0
5145148,House IV,1992,['United States of America'],"['Comedy', 'Horror']",1990,2
633855,Hart's War,2002,['United States of America'],"['Period piece', 'Crime Fiction', 'Political drama', 'War film', 'Drama', 'Courtroom Drama']",2000,2
55601,Sleepy Hollow,1999,"['Germany', 'United States of America']","['Detective fiction', 'Crime Fiction', 'Mystery', 'Gothic Film', 'Thriller', 'Period Horror', 'Costume Horror', 'Costume drama', 'Detective', 'Horror', 'Steampunk', 'Supernatural', 'Fantasy']",1990,9
3183207,Lilith,1964,['United States of America'],"['Black-and-white', 'Romantic drama', 'Romance Film', 'Drama']",1960,4
20674415,Personal Effects,2009,"['Germany', 'United States of America']","['Drama', 'Crime Fiction']",2000,9
5384210,Gagamboy,2004,['Philippines'],"['Action', 'Filipino Movies', 'Action/Adventure', 'Comedy', 'World cinema', 'Superhero movie', 'Filipino', 'Science Fiction', 'Fantasy']",2000,4
7094942,Betty Boop's Bamboo Isle,1932,['United States of America'],"['Animation', 'Short Film', 'Comedy']",1930,2
18206094,Via Darjeeling,2008,['India'],"['Drama', 'Mystery', 'Thriller']",2000,8
6471697,Ajooba,1991,"['Soviet Union', 'India']","['Adventure', 'Bollywood', 'Fantasy']",1990,1
1029087,Flash Gordon's Trip to Mars,1938,['United States of America'],"['Action', 'Black-and-white', 'Adventure', 'Movie serial', 'Superhero movie', 'Science Fiction']",1930,8
30865082,Seed of Chucky,2004,"['United Kingdom', 'Romania', 'United States of America']","['Comedy', 'Satire', 'Thriller', 'Horror Comedy', 'Romance Film', 'Black comedy', 'Parody', 'Slasher', 'Horror', 'Supernatural', 'Cult']",2000,4
4711699,Good Advice,2001,['United States of America'],"['Indie', 'Comedy', 'Romance Film', 'Romantic comedy']",2000,1
22833569,Vendetta,1986,['United States of America'],"['Action', 'Indie', 'Drama']",1980,6
6173832,Attack from Space,1964,['Japan'],"['Japanese Movies', 'World cinema', 'Superhero movie', 'Science Fiction']",1960,4
13775574,Tattooed Flower Vase,1976,['Japan'],"['Romantic drama', 'World cinema', 'Romance Film', 'Drama', 'Softcore Porn', 'Japanese Movies', 'Pornographic movie', 'Pinku eiga', 'Erotica', 'Adult']",1970,6
19486539,Aval Peyar Thamizharasi,2009,['India'],['Comedy'],2000,9
5735467,Body Snatchers,1993,['United States of America'],"['Film adaptation', 'Thriller', 'Horror', 'Alien Film', 'Science Fiction', 'Drama']",1990,3
14640430,Holiday in Handcuffs,2007,['United States of America'],"['Comedy', 'Romantic comedy', 'Television movie', 'Romance Film', 'Holiday Film', 'Family Film']",2000,7
3793519,Saving Grace,2000,['United Kingdom'],"['Crime Fiction', 'Stoner film', 'Indie', 'Comedy']",2000,0
20756695,Shorts,2009,"['United Arab Emirates', 'United States of America']","['Comedy', 'Family Film', 'Adventure']",2000,9
29472242,Naaraaz,1994,['India'],"['Action', 'Crime Fiction', 'Drama']",1990,4
158982,You've Got Mail,1998,['United States of America'],"['Workplace Comedy', 'Comedy', 'Romance Film', 'Romantic comedy']",1990,8
8114232,Buck Privates Come Home,1947,['United States of America'],"['Black-and-white', 'Slapstick', 'Buddy film', 'Comedy', 'Family Film']",1940,7
16175260,The Awaken Punch,1973,['Hong Kong'],"['Action', 'Chinese Movies', 'Martial Arts Film']",1970,3
13882867,South of Pico,2007,['United States of America'],"['Indie', 'Drama']",2000,7
983692,Sybil,1976,['United States of America'],"['Drama', 'Television movie']",1970,6
7914630,Sixty Six,2006,['United Kingdom'],"['Period piece', 'Drama', 'Indie', 'Coming of age', 'Comedy', 'Comedy-drama']",2000,6
666948,The Cell,2000,"['Germany', 'United States of America']","['Psychological thriller', 'Thriller', 'Horror', 'Crime Thriller', 'Science Fiction', 'Fantasy']",2000,0
8050436,Al-Yateematain,1949,['Egypt'],['Drama'],1940,9
42225,Everyone Says I Love You,1996,['United States of America'],"['Musical', 'Indie', 'Comedy', 'Musical comedy', 'Romance Film', 'Romantic comedy', 'Ensemble Film']",1990,6
7854762,The House with Laughing Windows,1976,['Italy'],"['Giallo', 'Thriller', 'Horror', 'World cinema', 'Supernatural']",1970,6
27559995,Los Cuervos están de luto,1965,[],"['Fantasy', 'Comedy film', 'Horror']",1960,5
536009,The Talented Mr. Ripley,1999,['United States of America'],"['Psychological thriller', 'Film adaptation', 'Crime Fiction', 'Mystery', 'Thriller', 'Romance Film', 'Crime Thriller', 'Drama', 'Period piece']",1990,9
18794003,A Girl in Australia,1971,['Italy'],['Comedy'],1970,1
3625574,Khamoshi,1969,['India'],"['Bollywood', 'War film']",1960,9
11122768,Qila,1998,['India'],"['Music', 'Drama', 'Family Film']",1990,8
7174266,Parade of the Wooden Soldiers,1933,['United States of America'],"['Animation', 'Short Film', 'Comedy film', 'Family Film']",1930,3
4360185,The Fox and the Hound 2,2006,['United States of America'],"['Animated cartoon', 'Animation', 'Animated Musical', 'Animal Picture', ""Children's/Family"", 'Family Film']",2000,6
8208607,The Castaways on Gilligan's Island,1979,['United States of America'],['Comedy'],1970,9
9249856,Rendition,2007,['United Kingdom'],"['Suspense', 'Thriller', 'Political drama', 'Drama', 'Political thriller']",2000,7
948608,The Man in the Moon,1991,['United States of America'],"['Period piece', 'Coming of age', 'Romantic drama', 'Teen', 'Romance Film', 'Drama']",1990,1
15688731,Bingo Bongo,1982,"['West Germany', 'Italy']","['Comedy', 'World cinema']",1980,2
31632714,Vazhve Mayam,1970,['India'],['Romance Film'],1970,0
1665678,Deliver Us from Eva,2003,['United States of America'],"['Family Drama', 'Comedy', 'Romance Film', 'Romantic comedy', 'Comedy-drama', 'Drama']",2000,3
12985644,Feel the Noise,2007,['United States of America'],"['Romantic drama', 'Musical Drama', 'Romance Film', 'Drama']",2000,7
27361692,Rage,1966,"['Mexico', 'United States of America']",['Drama'],1960,6
1388289,White Dog,1981,['United States of America'],"['Suspense', 'Film adaptation', 'Crime Fiction', 'Horror', 'Animal Picture', 'Drama']",1980,1
26113897,Kung Fu Chefs,2009,['China'],"['Action/Adventure', 'World cinema', 'Chinese Movies', 'Martial Arts Film']",2000,9
5877549,Johnny Tremain,1957,['United States of America'],"['Historical fiction', 'Historical Epic', 'War film', 'Adventure', 'Drama', 'Family Film']",1950,7
2324980,Rolling Thunder,1977,['United States of America'],['War film'],1970,7
1040736,Stalingrad,1993,"['Sweden', 'Germany']","['War film', 'Drama', 'World cinema']",1990,3
19898489,Tawaif,1985,['India'],"['Musical', 'Romantic drama', 'Bollywood', 'World cinema', 'Romance Film', 'Drama']",1980,5
11779733,Beverly Hills Chihuahua,2008,['United States of America'],"['Adventure Comedy', ""Children's"", 'Comedy', 'Animal Picture', 'Family Film', 'Adventure']",2000,8
9932614,Heartbreak Hotel,1988,['United States of America'],"['Screwball comedy', 'Comedy']",1980,8
2097096,The Treatment,2001,['China'],"['Chinese Movies', 'Drama']",2000,1
1602002,The Believer,2001,['United States of America'],"['Coming of age', 'Indie', 'Social problem film', 'Drama']",2000,1
5929445,Swamp Thing,1982,['United States of America'],"['Monster movie', 'Superhero', 'Action/Adventure', 'Science Fiction', 'Horror', 'Superhero movie', 'Cult']",1980,2
31155456,Kavyamela,1965,['India'],['Drama'],1960,5
4687991,The Classic,2003,['South Korea'],['Romance Film'],2000,3
24367532,Love Child,1982,['United States of America'],"['Drama', 'Biographical film']",1980,2
11167,Flåklypa Grand Prix,1975,['Norway'],"['Auto racing', 'Stop motion']",1970,5
4907569,Out for a Kill,2003,"['Aruba', 'United States of America']","['Action', 'Crime Fiction', 'Action Thrillers', 'Gangster Film', 'Action/Adventure', 'Thriller', 'Martial Arts Film']",2000,3
16586081,Little Lord Fauntleroy,1936,['United States of America'],"['Black-and-white', 'Drama']",1930,6
1296943,Life With Feathers,1945,['United States of America'],"['Short Film', 'Comedy', 'Family Film']",1940,5
3225410,Jungdok,2002,['South Korea'],"['Mystery', 'Thriller', 'Romance Film', 'Drama']",2000,2
5777280,Mahapurush,1965,['India'],"['Art film', 'Satire', 'Comedy', 'World cinema', 'Drama']",1960,5
26963421,Vazhkai,1949,['India'],[],1940,9
2903396,Pulse,2006,['United States of America'],"['Psychological thriller', 'Teen', 'Horror']",2000,6
23491875,Samurai Princess,2009,['Japan'],"['Action', 'Japanese Movies', 'Action/Adventure', 'World cinema', 'Horror', 'Science Fiction']",2000,9
10206152,Americanese,2006,['United States of America'],"['Film adaptation', 'Indie', 'Comedy', 'Romance Film', 'Drama', 'Romantic comedy', 'Comedy-drama', 'Slice of life story', 'Ensemble Film']",2000,6
2501824,The Scout,1994,['United States of America'],"['Comedy-drama', 'Sports', 'Comedy']",1990,4
9005576,Close to Eden,1991,"['Russia', 'Soviet Union', 'France']",['Drama'],1990,1
3383952,"Girl, Interrupted",1999,"['Germany', 'United States of America']","['Psychological thriller', 'Period piece', 'Coming of age', 'Biographical film', 'Melodrama', 'Drama']",1990,9
4910570,The Bellboy,1960,['United States of America'],"['Slapstick', 'Comedy', 'Satire', 'Comedy of Errors']",1960,0
986974,Pasión de gavilanes,2003,[],"['Romance Film', 'Drama']",2000,3
11337966,The Sweet Hereafter,1997,['Canada'],"['Courtroom Drama', 'Film adaptation', 'Drama', 'Indie', 'Ensemble Film', 'Disaster']",1990,7
2821645,Stanley and Iris,1990,['United States of America'],"['Romance Film', 'Romantic drama', 'Drama']",1990,0
13811386,La Balance,1982,['France'],"['Crime Fiction', 'Thriller', 'World cinema', 'Crime Thriller', 'Drama']",1980,2
17175592,Battle for Terra,2007,['United States of America'],"['Animation', 'Science Fiction', 'Family Film', 'Computer Animation']",2000,7
22275671,Drums Across the River,1954,['United States of America'],"['Action', 'Western']",1950,4
4343386,The Favor,1994,['United States of America'],"['Drama', 'Indie', 'Romantic drama', 'Comedy', 'Romance Film', 'Romantic comedy']",1990,4
11535972,Raaz,1967,['India'],"['Mystery', 'Thriller']",1960,7
1722134,Return from Witch Mountain,1978,['United States of America'],"['Mystery', 'Thriller', ""Children's/Family"", 'Adventure', ""Children's Fantasy"", 'Science Fiction', 'Family Film', 'Fantasy']",1970,8
21215095,An Old Fashioned Thanksgiving,2008,"['Canada', 'United States of America']","['Film adaptation', 'Family Drama', 'Television movie', 'Family Film', 'Drama']",2000,8
25860737,Click,2008,['India'],"['Thriller', 'Remake', 'Horror', 'World cinema']",2000,8
32288355,Naughty but Nice,1927,[],['Silent film'],1920,7
11021037,Seed,1931,['United States of America'],"['Black-and-white', 'Drama']",1930,1
6851757,Bardelys the Magnificent,1926,['United States of America'],"['Black-and-white', 'Indie', 'Romance Film', 'Swashbuckler films', 'Adventure', 'Drama', 'Silent film', 'Melodrama']",1920,6
1721255,Village of the Damned,1995,['United States of America'],"['Science Fiction', 'Thriller', 'Horror']",1990,5
14244939,A Missed Fortune,1952,['United States of America'],"['Short Film', 'Black-and-white', 'Comedy']",1950,2
34974233,Everyone Dies Alone,1976,"['Germany', 'West Germany']",['Drama'],1970,6
9652391,Right Cross,1950,['United States of America'],['Drama'],1950,0
5975925,Pokémon: Diamond and Pearl The Movie,2007,"['Japan', 'United States of America']","['Fantasy Adventure', 'Animated cartoon', 'Animation', 'Action/Adventure', ""Children's"", 'Adventure', 'Japanese Movies', 'Anime', 'Family Film']",2000,7
3862631,Seven Thieves,1960,['United States of America'],"['Heist', 'Crime Fiction', 'Caper story', 'Thriller', 'Film noir', 'Crime Thriller', 'Drama']",1960,0
3168490,Brubaker,1980,['United States of America'],"['Prison', 'Drama', 'Crime Fiction', 'Prison film', 'Docudrama', 'Political drama']",1980,0
16681204,First World,2007,['United States of America'],"['Action', 'Short Film', 'Historical drama', 'War film', 'Science Fiction', 'Drama']",2000,7
28223375,The Brown Wallet,1936,['United Kingdom'],"['Crime Fiction', 'Thriller']",1930,6
34623319,The Shark Hunter,1979,"['Spain', 'Mexico', 'Italy']",['Adventure'],1970,9
3020167,How to Stuff a Wild Bikini,1965,['United States of America'],"['Musical', 'Comedy', 'Teen', 'Romance Film', 'Romantic comedy', 'Beach Film']",1960,5
13633284,Cold Water,1994,['France'],"['Coming of age', 'Romantic drama', 'Teen', 'Drama']",1990,4
17372262,Bilitis,1977,['France'],"['Erotic Drama', 'Romantic drama', 'Romance Film', 'Drama', 'Gay Themed', 'Softcore Porn', 'Gay', 'Gay Interest', 'Adult']",1970,7
16091743,Jonathan Livingston Seagull,1973,['United States of America'],"['Film adaptation', 'Family Drama', 'Drama', 'Family Film']",1970,3
1134216,Some Kind of Monster,2004,['United States of America'],"['Musical', 'Rockumentary', 'Documentary']",2000,4
1931788,Hannie Caulder,1971,['United Kingdom'],"['Crime Fiction', 'Revisionist Western', 'Action/Adventure', 'Western', 'Thriller', 'Comedy film', 'Drama']",1970,1
25284964,Rusty: A Dog's Tale,1998,['United States of America'],['Family Film'],1990,8
1637639,The Decline of Western Civilization III,1998,['United States of America'],"['Rockumentary', 'Punk rock', 'Documentary']",1990,8
19474401,The Chaser,2008,['South Korea'],"['Action', 'Action/Adventure', 'Thriller', 'World cinema', 'Crime Thriller']",2000,8
10200200,Amantes,1991,['Spain'],"['Crime Fiction', 'Drama', 'World cinema']",1990,1
7057083,Hall of Mirrors,2001,['United States of America'],"['Crime Fiction', 'Mystery', 'Indie', 'Drama']",2000,1
20865573,D' Anothers,2005,['Philippines'],"['Filipino Movies', 'Comedy', 'Horror']",2000,5
4219204,Hercules,2005,['United States of America'],"['Adventure', 'Drama']",2000,5
33435792,Hum Intezaar Karenge,1989,['India'],"['Romantic drama', 'World cinema', 'Romance Film', 'Drama']",1980,9
2480828,Valentine,2001,['United States of America'],"['Slasher', 'Teen', 'Horror']",2000,1
695780,Casino,1995,"['United States of America', 'France']","['Period piece', 'Film adaptation', 'Crime Fiction', 'Gangster Film', 'Biography', 'Drama']",1990,5
18882688,They Nest,2000,['United States of America'],"['Psychological thriller', 'Thriller', 'Horror', 'Science Fiction', 'Natural horror films']",2000,0
5028914,3 Needles,2006,"['South Africa', 'China', 'Canada']","['Drama', 'Indie', 'Social problem film', 'Chinese Movies']",2000,6
2603956,Four Eyes and Six Guns,1991,['United States of America'],"['Comedy Western', 'Western', 'Comedy']",1990,1
36038941,Hollywood Chaos,1989,['United States of America'],"['Action', 'Drama', 'Comedy film', 'Adventure']",1980,9
12066052,Hello,2007,['India'],"['Mystery', 'Comedy']",2000,7
9109336,Hurricane on the Bayou,2006,['United States of America'],"['Nature', 'Culture & Society', 'Documentary']",2000,6
9179202,Evelyn: The Cutest Evil Dead Girl,2002,['Canada'],"['Short Film', 'Comedy']",2000,2
2213107,Kandukondain Kandukondain,2000,['India'],"['Musical', 'Romantic drama', 'Bollywood', 'World cinema', 'Romance Film', 'Drama']",2000,0
3025328,School's Out,1992,['Canada'],"['Coming of age', 'Teen']",1990,2
1704161,Blood Debts,1983,['Philippines'],"['Action', 'Filipino Movies', 'Drama']",1980,3
638809,Godzilla vs. Destoroyah,1995,['Japan'],"['Creature Film', 'Monster', 'Japanese Movies', 'Science Fiction']",1990,5
23470411,Nevada,1927,['United States of America'],['Western'],1920,7
14647588,The World's Greatest Lover,1977,['United States of America'],"['Parody', 'Comedy', 'Romance Film', 'Romantic comedy', 'Slapstick']",1970,7
23799090,Jajabara,1975,['India'],['Drama'],1970,5
5801192,Patlabor the Movie,1989,['Japan'],"['Action', 'Animation', 'Japanese Movies', 'Future noir', 'Anime', 'Science Fiction']",1980,9
8862350,Kings of the Road,1976,['West Germany'],"['Black-and-white', 'Road movie', 'Drama']",1970,6
3112996,The Witches,1990,"['Norway', 'United Kingdom', 'United States of America']","['Fantasy', 'Family Film', 'Horror']",1990,0
33593483,Doughboys,1930,['United States of America'],"['War film', 'Comedy']",1930,0
26146732,The Hour Before the Dawn,1944,['United States of America'],['Drama'],1940,4
3607757,Don: The Chase Begins Again,2006,['India'],"['Action', 'Crime Fiction', 'Gangster Film', 'Mystery', 'Action/Adventure', 'Comedy', 'Thriller', 'Bollywood', 'World cinema', 'Romance Film', 'Drama']",2000,6
14734214,Scheming Schemers,1956,['United States of America'],"['Short Film', 'Black-and-white', 'Comedy']",1950,6
14615235,Live feed,2006,['Canada'],"['Slasher', 'Teen', 'Horror', 'B-movie']",2000,6
8355891,A hierro muere,1962,"['Argentina', 'Spain']",['Crime Fiction'],1960,2
4618142,Zombi 3,1987,['Italy'],"['Creature Film', 'Horror', 'World cinema', 'Zombie Film']",1980,7
7725236,The Anniversary,1968,['United Kingdom'],"['Black comedy', 'Comedy', 'Drama']",1960,8
9627851,Conversaciones con mamá,2004,['Argentina'],"['Family Drama', 'Comedy', 'World cinema', 'Drama']",2000,4
5823793,Ripley's Game,2004,"['United Kingdom', 'Italy', 'United States of America']","['Psychological thriller', 'Thriller', 'Crime Thriller', 'Drama']",2000,4
14348806,Winter Meeting,1948,['United States of America'],"['Black-and-white', 'Romantic drama', 'Romance Film', 'Melodrama', 'Drama']",1940,8
1597823,Dancing Romeo,1944,['United States of America'],"['Black-and-white', 'Short Film', 'Comedy', 'Family Film']",1940,4
25135132,The Reverse,2009,['Poland'],"['Comedy', 'Thriller', 'World cinema', 'Romance Film', 'Drama']",2000,9
24104583,Ramudu Bheemudu,1964,['India'],"['Drama', 'Comedy']",1960,4
12232137,Aaj Aur Kal,1963,['India'],"['Drama', 'World cinema']",1960,3
27522599,Americana,1983,['United States of America'],['Drama'],1980,3
5144523,Demoni 2,1986,['Italy'],"['Supernatural', 'Cult', 'Horror']",1980,6
19702661,Fairy Tales,1978,['United States of America'],"['Musical', 'Sex comedy', 'Comedy', 'Romance Film', 'Fantasy']",1970,8
20714148,My Love,2007,['South Korea'],"['Romance Film', 'Comedy', 'Comedy film']",2000,7
20978744,Ullasa Utsaha,2009,['India'],['Romance Film'],2000,9
2159529,Airport 1975,1974,['United States of America'],"['Action', 'Airplanes and airports', 'Action/Adventure', 'Thriller', 'Disaster', 'Drama', 'Ensemble Film']",1970,4
897540,S1m0ne,2002,['United States of America'],"['Comedy', 'Science Fiction', 'Drama', 'Fantasy']",2000,2
17653877,Belle Boys,1953,['United States of America'],['Animation'],1950,3
1897047,Kyun...! Ho Gaya Na,2004,['India'],"['Romantic drama', 'World cinema', 'Romance Film', 'Drama']",2000,4
11033226,The Dark Side of the Moon,1990,['United States of America'],"['Action', 'Mockumentary', 'Thriller', 'Horror', 'Supernatural', 'Science Fiction']",1990,0
16850022,BABO,2008,['South Korea'],['Drama'],2000,8
22194205,The White Dawn,1974,"['Canada', 'United States of America']","['Action', 'Film adaptation', 'Drama', 'Action/Adventure', 'Adventure']",1970,4
11613486,The Case of Lena Smith,1929,['United States of America'],"['Black-and-white', 'Short Film', 'Drama']",1920,9
9719678,Los Caranchos de la Florida,1938,['Argentina'],"['Black-and-white', 'Drama']",1930,8
28372726,How to Save a Marriage and Ruin Your Life,1968,['United States of America'],"['Romance Film', 'Romantic comedy', 'Comedy']",1960,8
7019130,Hangman's House,1928,['United States of America'],"['Black-and-white', 'Drama', 'Indie', 'Silent film', 'Romance Film', 'Melodrama']",1920,8
23974139,"Oh, Susanna!",1936,['United States of America'],"['Black-and-white', 'Western', 'Action/Adventure', 'Romance Film']",1930,6
2541511,Little Tough Guy,1938,['United States of America'],"['Black-and-white', 'Juvenile Delinquency Film', 'Drama', 'Family Film']",1930,8
12003939,The 8th Plague,2006,['United States of America'],"['Horror', 'B-movie']",2000,6
18456573,Box Car Blues,1930,[],"['Animation', 'Short Film', 'Comedy film', 'Family Film']",1930,0
350847,Reality Bites,1994,['United States of America'],"['Drama', 'Coming of age', 'Indie', 'Comedy', 'Romantic comedy', 'Ensemble Film']",1990,4
6881545,Thugs with Dirty Mugs,1939,['United States of America'],"['Comedy film', 'Crime Fiction']",1930,9
12764922,Phffft!,1954,['United States of America'],"['Black-and-white', 'Screwball comedy', 'Comedy', 'Romance Film', 'Romantic comedy']",1950,4
20461830,A Frozen Flower,2008,['South Korea'],"['Period piece', 'World cinema', 'Romance Film', 'Historical fiction', 'Drama']",2000,8
441249,Fitzcarraldo,1982,"['Germany', 'West Germany', 'Peru']","['Action/Adventure', 'Jungle Film', 'World cinema', 'Adventure']",1980,2
2712712,A Christmas Carol,1984,"['United Kingdom', 'United States of America']","['Film adaptation', 'Family Drama', 'Costume drama', 'Christmas movie', 'Drama', 'Period piece', 'Television movie', 'Family Film', 'Fantasy']",1980,4
8543798,Quelques jours en septembre,2006,['France'],"['Suspense', 'Thriller', 'World cinema', 'Drama', 'Political thriller']",2000,6
1995966,The Singing Fool,1928,['United States of America'],"['Musical', 'Black-and-white', 'Musical Drama', 'Melodrama', 'Drama']",1920,8
10380023,Population 436,2006,"['Canada', 'United States of America']","['Psychological thriller', 'Indie', 'Thriller', 'Horror', 'Supernatural']",2000,6
9834670,My Girlfriend's Boyfriend,1999,['United States of America'],['Comedy film'],1990,9
15242784,Manhattan Baby,1982,['Italy'],"['Supernatural', 'Horror']",1980,2
26742855,Bed Dance,1967,['Japan'],['Japanese Movies'],1960,7
11155843,Campfire,2005,['Israel'],"['Romantic drama', 'World cinema', 'Romance Film', 'Political drama', 'Drama']",2000,5
5603632,Early to Bed,1928,['United States of America'],"['Black-and-white', 'Indie', 'Short Film', 'Comedy', 'Silent film']",1920,8
5603479,Their Purple Moment,1928,['United States of America'],"['Black-and-white', 'Indie', 'Short Film', 'Comedy', 'Silent film', 'Slapstick']",1920,8
25211469,Road to Sangam,2009,['India'],['Drama'],2000,9
23791169,Choices of the Heart: The Margaret Sanger Story,1995,['United States of America'],"['Biography', 'Biopic [feature]', 'Docudrama', 'Television movie', 'Drama', 'Feminist Film']",1990,5
7915074,Meghasandesam,1983,['India'],"['Musical', 'Drama']",1980,3
7309894,Restless Wives,1924,['United States of America'],"['Black-and-white', 'Drama', 'Indie', 'Silent film']",1920,4
24676396,Late Marriage,2001,"['Israel', 'France']","['Family Drama', 'Romantic drama', 'Comedy', 'World cinema', 'Romance Film', 'Drama', 'Romantic comedy', 'Comedy-drama', 'Comedy of manners']",2000,1
27049700,Kudumbam Oru Kadambam,1981,['India'],[],1980,1
25852932,Wet Weekend,1979,[],['Pornographic movie'],1970,9
4573857,Nongjungjo,1926,['Korea'],"['Silent film', 'Drama']",1920,6
958028,To Hell and Back,1955,['United States of America'],"['Biography', 'Biographical film', 'Biopic [feature]', 'War film', 'Drama']",1950,5
15250411,A Cage of Nightingales,1945,['France'],"['Music', 'Drama']",1940,5
3507894,Crimson Rivers II: Angels of the Apocalypse,2004,"['United Kingdom', 'France', 'Italy']","['Action', 'Detective', 'Thriller', 'World cinema', 'Crime Thriller', 'Supernatural']",2000,4
22766241,South Sea Woman,1953,['United States of America'],"['Adventure Comedy', 'Action', 'Black-and-white', 'Action/Adventure', 'Comedy', 'Adventure', 'Comedy-drama', 'War film']",1950,3
15397651,The Wildcats of St Trinian's,1980,['United Kingdom'],['Comedy'],1980,0
6980481,Carnosaur 2,1993,['United States of America'],"['Creature Film', 'Science Fiction', 'Horror', 'B-movie', 'Sci-Fi Horror']",1990,3
1655618,The Apple Dumpling Gang,1975,['United States of America'],"['Comedy Western', 'Comedy', ""Children's/Family"", 'Slapstick', ""Children's"", 'Drama', 'Family Film']",1970,5
24026813,Chess Fever,1925,['Soviet Union'],"['Short Film', 'Comedy']",1920,5
17782369,Turnabout,1940,['United States of America'],"['Black-and-white', 'Comedy', 'Sex comedy']",1940,0
17360238,Paying Guest,2008,['India'],"['Comedy', 'World cinema']",2000,8
9200771,Purple People Eater,1988,['United States of America'],"['Science Fiction', 'Comedy', 'Family Film']",1980,8
18279525,Ajab Prem Ki Ghazab Kahani,2009,['India'],"['Musical', 'Romantic drama', 'Comedy', 'Bollywood', 'World cinema', 'Romance Film', 'Drama', 'Romantic comedy']",2000,9
187103,Sudden Fear,1952,['United States of America'],"['Psychological thriller', 'Black-and-white', 'Crime Fiction', 'Thriller', 'Film noir', 'Crime Thriller', 'Drama', 'Suspense']",1950,2
20700027,North Face,2008,"['Switzerland', 'Germany', 'Austria']","['Action/Adventure', 'World cinema', 'Adventure', 'Drama']",2000,8
20533205,Operation Sawdust,1953,[],"['Animation', 'Short Film', 'Family Film']",1950,3
15101415,Aa Naluguru,2004,['India'],['Drama'],2000,4
4094415,The Lonely Guy,1984,['United States of America'],"['Comedy', 'Comedy of manners', 'Romance Film', 'Romantic comedy']",1980,4
19481265,Mesmer,1994,"['Canada', 'Austria', 'United Kingdom', 'Germany']","['Biographical film', 'Drama', 'World cinema']",1990,4
5479998,Murders in the Rue Morgue,1932,['United States of America'],"['Black-and-white', 'Detective', 'Horror', 'Pre-Code']",1930,2
19360121,Season's Beatings,1999,['France'],"['Comedy', 'Drama', 'World cinema']",1990,9
1291589,Porky's Badtime Story,1937,[],"['Animation', 'Short Film', 'Comedy film', 'Family Film']",1930,7
2124881,Heaven and Earth,1990,['Japan'],['Japanese Movies'],1990,0
13035663,Half Moon,2007,"['Austria', 'Iran', 'Iraq', 'France']","['Music', 'Musical Drama', 'Comedy', 'World cinema', 'Drama']",2000,7
33023017,L'imbroglio nel lenzuolo,2009,"['Spain', 'Mexico', 'Italy']","['Romance Film', 'Romantic comedy', 'Comedy film']",2000,9
4576677,Paid in Full,2002,['United States of America'],"['Action', 'Period piece', 'Crime Fiction', 'Action/Adventure', 'Crime Thriller', 'Drama']",2000,2
1005828,Duct Tape Forever,2002,['Canada'],"['Dogme 95', 'Comedy']",2000,2
12768840,Muriel ou Le temps d'un retour,1963,"['France', 'Italy']","['Drama', 'World cinema']",1960,3
877225,The Crow: Salvation,2000,['United States of America'],"['Action', 'Superhero', 'Indie', 'Action/Adventure', 'Thriller', 'Horror', 'Superhero movie']",2000,0
16314437,Demons of the Mind,1972,['United Kingdom'],"['Psychological thriller', 'Suspense', 'Horror', 'Period Horror', 'Costume Horror']",1970,2
1591891,The Mating Season,1951,['United States of America'],"['Black-and-white', 'Screwball comedy', 'Comedy', 'Romance Film', 'Romantic comedy']",1950,1
287408,The Lodger: A Story of the London Fog,1927,['United Kingdom'],"['Suspense', 'Black-and-white', 'Mystery', 'Indie', 'Thriller', 'Silent film', 'Crime Thriller']",1920,7
10183854,Head of the Family,1996,['United States of America'],"['B-movie', 'Comedy film', 'Horror']",1990,6
26063590,Troublesome Night 16,2002,['Hong Kong'],"['Chinese Movies', 'Fantasy', 'Horror']",2000,2
6161511,Subash Chandra Bose,2005,['India'],[],2000,5
5212120,It Happens Every Spring,1949,['United States of America'],"['Comedy', 'Fantasy Comedy']",1940,9
914406,Giant Robo,1991,['Japan'],"['Action', 'Animation', 'Anime', 'Martial Arts Film', 'Science Fiction', 'Drama', 'Fantasy']",1990,1
23181793,Baby on Board,2008,['United States of America'],['Comedy'],2000,8
3644898,Häxan,1923,"['Sweden', 'Denmark']","['Black-and-white', 'Indie', 'World cinema', 'Documentary', 'Drama', 'Horror', 'Silent film', 'Supernatural', 'Fantasy']",1920,3
5670572,Shoot 'em Up,2007,['United States of America'],"['Action', 'Crime Fiction', 'Action/Adventure', 'Comedy', 'Thriller']",2000,7
25781446,"Follow Kadri, Not Your Heart",2009,['Turkey'],['Comedy film'],2000,9
1760207,The Passion of Anna,1969,['Sweden'],"['Black-and-white', 'Art film', 'World cinema', 'Drama']",1960,9
14706271,The Affairs of Anatol,1921,['United States of America'],"['Black-and-white', 'Indie', 'Romantic drama', 'Comedy', 'Romance Film', 'Black comedy', 'Drama', 'Marriage Drama', 'Silent film', 'Romantic comedy']",1920,1
5444284,The Strawberry Statement,1970,['United States of America'],"['Coming of age', 'Satire', 'Romance Film', 'Comedy-drama', 'Drama']",1970,0
21884835,Interview,1971,['India'],['Drama'],1970,1
23714330,Passing Fancy,1933,['Japan'],"['Black-and-white', 'Japanese Movies', 'Comedy', 'World cinema', 'Silent film', 'Drama']",1930,3
19417127,The Lazarus Child,2004,['United States of America'],"['Science Fiction', 'Drama']",2000,4
32777848,The Hedgehog,2009,"['France', 'Italy']","['Drama', 'Comedy']",2000,9
11965354,Clara es el Precio,1975,['Spain'],['Drama'],1970,5
10662963,Haasil,2003,['India'],"['Romantic drama', 'Bollywood', 'World cinema', 'Romance Film', 'Drama']",2000,3
12626400,Sky West and Crooked,1966,['United Kingdom'],"['Romance Film', 'Romantic drama', 'Drama']",1960,6
26640409,Sl8n8,2006,['Belgium'],"['Action', 'Thriller', 'Horror', 'World cinema']",2000,6
11357777,Alice's Restaurant,1969,['United States of America'],"['Coming of age', 'Comedy', 'Comedy-drama', 'Americana']",1960,9
19992131,After.Life,2009,['United States of America'],"['Psychological thriller', 'Mystery', 'Thriller', 'Horror', 'Drama']",2000,9
8427473,"Housewife, 49",2006,['United Kingdom'],"['Period piece', 'Drama']",2000,6
22295160,Eat the Peach,1986,['Ireland'],"['Comedy of manners', 'Comedy-drama']",1980,6
4541280,Tere Pyar Mein,2000,['Pakistan'],"['Romance Film', 'Drama']",2000,0
7350134,Maine Gandhi Ko Nahin Mara,2005,['India'],"['Slice of life story', 'Drama', 'World cinema']",2000,5
6181084,Intact,2001,['Spain'],"['Psychological thriller', 'Action/Adventure', 'Thriller', 'World cinema', 'Crime Thriller', 'Supernatural', 'Drama']",2000,1
1105412,Kinsey,2004,"['Germany', 'United States of America']","['Period piece', 'LGBT', 'Biography', 'Biographical film', 'Biopic [feature]', 'Drama']",2000,4
2332592,La Chinoise,1967,['France'],"['Art film', 'Satire', 'World cinema', 'Comedy-drama', 'Political drama', 'Propaganda film', 'Drama']",1960,7
18490185,Male Companion,1964,"['France', 'Italy']",['Comedy'],1960,4
18323091,Sakigake!! Otokojuku,2008,['Japan'],[],2000,8
1338461,Birdy,1984,['United States of America'],"['Period piece', 'Film adaptation', 'Coming of age', 'War film', 'Drama']",1980,4
26607341,Someone Behind the Door,1971,['France'],"['Psychological thriller', 'Suspense', 'Thriller', 'World cinema']",1970,1
2243769,The FBI Story,1959,['United States of America'],"['Crime Fiction', 'Crime Thriller', 'Drama']",1950,9
5698193,Claustrophobia,2003,['United States of America'],"['Slasher', 'Horror']",2000,3
593184,Lake Placid,1999,"['Canada', 'United States of America']","['Action', 'Comedy', 'Thriller', 'Buddy film', 'Horror Comedy', 'Natural horror films', 'Horror', 'Cult']",1990,9
30860806,Masti: Sanam Teri Kasam,2004,['India'],"['Musical', 'Romantic drama', 'Comedy', 'Bollywood', 'World cinema', 'Romance Film', 'Drama', 'Romantic comedy']",2000,4
3769379,Herr Meets Hare,1945,['United States of America'],['Propaganda film'],1940,5
18811245,A Complete History of My Sexual Failures,2008,['United Kingdom'],"['Interpersonal Relationships', 'Indie', 'Documentary', 'Culture & Society']",2000,8
6219956,Susie Q,1996,['United States of America'],"['Comedy', 'Fantasy']",1990,6
21281676,Absolute Evil,2009,"['Germany', 'United States of America']","['Mystery', 'Indie', 'Thriller', 'Crime Thriller', 'Drama']",2000,9
5760732,Nerrukku Ner,1997,['India'],"['Musical', 'Bollywood', 'World cinema', 'Drama']",1990,7
3306709,The Color of Friendship,2000,"['Canada', 'United States of America']",['Drama'],2000,0
7677145,Ironweed,1987,['United States of America'],"['Period piece', 'Film adaptation', 'Drama']",1980,7
4614381,Cheese and Jam,2003,['Slovenia'],['Comedy'],2000,3
32621433,Meet Danny Wilson,1951,['United States of America'],"['Crime Fiction', 'Musical Drama', 'Drama']",1950,1
25413046,Colossus and the Amazon Queen,1960,['Italy'],"['Action', 'Adventure', 'Comedy film']",1960,0
669546,Ship of Fools,1965,['United States of America'],"['Film adaptation', 'Black-and-white', 'Drama', 'Ensemble Film']",1960,5
32787932,Udhavikku Varalaamaa,1998,[],['Comedy film'],1990,8
10271274,Ghost Soup,1992,['Japan'],"['Japanese Movies', 'Drama']",1990,2
3903364,Howl's Moving Castle,2004,['Japan'],"['Action', 'Fantasy Adventure', 'Animation', 'World cinema', 'Romance Film', ""Children's"", 'Adventure', 'Japanese Movies', 'Anime', 'Steampunk', 'Family Film', 'Fantasy']",2000,4
1172795,The Way of All Flesh,1927,['United States of America'],"['Black-and-white', 'Drama', 'Indie', 'Silent film']",1920,7
17592404,The Dollar Bottom,1980,['United Kingdom'],"['Indie', 'Short Film']",1980,0
5123642,Never Cry Wolf,1983,['United States of America'],"['Action/Adventure', 'Adventure', 'Animal Picture', 'Drama']",1980,3
33498623,Death at Love House,1976,['United States of America'],"['Action', 'Psychological thriller', 'Gothic Film', 'Thriller', 'Crime Thriller', 'Haunted House Film', 'Drama', 'Horror', 'Television movie', 'Supernatural', 'Fantasy']",1970,6
3526227,Voyage to the Planet of Prehistoric Women,1968,['United States of America'],"['Indie', 'Adventure', 'Science Fiction', 'Fantasy']",1960,8
37373877,Crazy Eights,2006,['United States of America'],"['Cult', 'Horror']",2000,6
3701905,The Polar Express,2004,['United States of America'],"['Animation', 'Fantasy', 'Christmas movie', 'Family Film', 'Computer Animation']",2000,4
574768,Roxanne,1987,['United States of America'],"['Comedy', 'Romance Film', 'Romantic comedy', 'Drama']",1980,7
25012178,The Lively Set,1964,['United States of America'],"['Action', 'Drama']",1960,4
7074438,Miss Sadie Thompson,1953,['United States of America'],"['Musical', 'Drama']",1950,3
11351541,Pursuit to Algiers,1945,['United States of America'],"['Film adaptation', 'Detective fiction', 'Black-and-white', 'Crime Fiction', 'Mystery', 'Thriller', 'Crime Thriller', 'Drama', 'Detective']",1940,5
18137051,Strange Fruit,2004,['United States of America'],"['Gay Themed', 'LGBT', 'Crime Fiction', 'Drama']",2000,4
9892634,Yaarana,1981,['India'],"['Drama', 'Bollywood', 'World cinema']",1980,1
21227360,Nana,1926,['France'],"['Silent film', 'Black-and-white']",1920,6
1682270,What a Way to Go!,1964,['United States of America'],"['Musical', 'Parody', 'Comedy', 'Black comedy', 'Romantic comedy', 'Romance Film']",1960,4
9822793,Death Wish,1974,['United States of America'],"['Action', 'Film adaptation', 'Crime Fiction', 'Action/Adventure', 'Thriller', 'Crime Thriller', 'Drama']",1970,4
167303,A Canterbury Tale,1944,['United Kingdom'],"['Black-and-white', 'Mystery', 'Buddy film', 'Comedy', 'Drama', 'Period piece', 'Comedy-drama', 'Road movie', 'War film']",1940,4
33383581,Sheesha,1986,['India'],"['Thriller', 'World cinema', 'Drama', 'Family Film']",1980,6
25306569,The Bed-Sitting Room,1970,['United Kingdom'],"['Film adaptation', 'Drama', 'Indie', 'Comedy', 'Experimental film', 'Black comedy', 'Doomsday film']",1970,0
26274423,R. P. M.,1970,['United States of America'],['Drama'],1970,0
2821964,Eyes of Laura Mars,1978,['United States of America'],"['Psychological thriller', 'Mystery', 'Thriller', 'Horror', 'Crime Thriller', 'Supernatural']",1970,8
9417340,Broken English,1996,['New Zealand'],['Romance Film'],1990,6
5515243,The Wicker Man,2006,"['Germany', 'United States of America', 'Canada']","['Mystery', 'Thriller', 'Horror']",2000,6
11450148,Crash Course,1988,['United States of America'],"['Television movie', 'Comedy', 'Teen']",1980,8
27430676,Aksharathettu,1989,['India'],[],1980,9
25967434,Putevoy obkhodchik,2007,['Russia'],"['Slasher', 'Horror']",2000,7
2038178,Mujhse Shaadi Karogi,2004,['India'],"['Musical', 'Romantic drama', 'Bollywood', 'World cinema', 'Romance Film', 'Romantic comedy', 'Drama']",2000,4
31322538,Anna Susanna,1953,['German Democratic Republic'],"['Drama', 'Crime Fiction']",1950,3
16035558,Ananda Tandavam,2009,['India'],['Romance Film'],2000,9
19093596,It,1966,['West Germany'],"['Black-and-white', 'Drama']",1960,6
10410665,Mutants,2009,['France'],"['Science Fiction', 'World cinema', 'Horror']",2000,9
1223386,Nowhere,1997,"['France', 'United States of America']","['LGBT', 'Indie', 'Comedy', 'Teen', 'Black comedy', 'Drama', 'Gay Themed', 'Gay', 'Gay Interest', 'Comedy-drama', 'Science Fiction']",1990,7
8530075,Woman Sesame Oil Maker,1993,['China'],"['Drama', 'Chinese Movies', 'World cinema']",1990,3
5169996,The Man in the Iron Mask,1998,"['United Kingdom', 'United States of America']","['Action', 'Action/Adventure', 'Adventure', 'Historical fiction', 'Drama']",1990,8
22681199,More Than Blue,2009,['South Korea'],"['Romance Film', 'Melodrama', 'Romantic drama']",2000,9
11633508,Calendar Leaves,2005,['Canada'],"['Short Film', 'Drama']",2000,5
5246214,Piravi,1988,['India'],"['Drama', 'Art film']",1980,8
30467227,Manonmani,1942,[],['Romance Film'],1940,2
732851,Behind Enemy Lines,2001,['United States of America'],"['Action', 'Drama', 'Action/Adventure', 'Thriller', 'War film']",2000,1
1157009,House Hunting Mice,1948,['United States of America'],"['Animation', 'Short Film', 'Comedy', 'Family Film']",1940,8
36724042,Shark Attack 3: Megalodon,2002,"['Israel', 'South Africa', 'United States of America']","['Creature Film', 'Horror', 'B-movie', 'Natural horror films', 'Fantasy']",2000,2
4978691,The Forest,2002,"['Spain', 'Portugal']","['Adventure', 'Drama']",2000,2
5374465,Gumby: The Movie,1995,['United States of America'],"['Animation', 'Comedy', 'Stop motion', ""Children's/Family"", 'Adventure', ""Children's Fantasy"", 'Family Film', 'Fantasy']",1990,5
1312804,It's a Gift,1934,['United States of America'],"['Comedy', 'Black-and-white']",1930,4
12491754,Evil Angel,2009,['United States of America'],"['Thriller', 'Horror']",2000,9
12783565,Friendly Persuasion,1975,['United States of America'],['Drama'],1970,5
11038839,Open Doors,1989,['Italy'],['Drama'],1980,9
6851920,Kareeb,1998,['India'],['World cinema'],1990,8
24573555,The Gay Deceiver,1926,[],['Silent film'],1920,6
24063523,A Bride for Henry,1937,['United States of America'],"['Comedy film', 'Romance Film', 'Romantic comedy', 'Drama']",1930,7
24238313,Yugandhar,1993,['India'],['Action'],1990,3
8621074,The Horse's Mouth,1958,['United Kingdom'],"['Screwball comedy', 'Comedy', 'Comedy of manners']",1950,8
18212638,Suburban Secrets,2004,['United States of America'],"['Softcore Porn', 'Adult', 'Pornographic movie']",2000,4
15945947,Perfume,2001,['United States of America'],"['Indie', 'Comedy', 'Drama']",2000,1
6776184,Mermaids,2003,['United States of America'],"['Family Film', 'Fantasy']",2000,3
704063,A Simple Wish,1997,['United States of America'],"[""Children's Fantasy"", 'Comedy', ""Children's/Family"", 'Fantasy Comedy', 'Family Film', 'Fantasy']",1990,7
13709308,Striker's Mountain,1987,['Canada'],['Drama'],1980,7
11372598,Foot Path,1953,['India'],"['Drama', 'Crime Fiction']",1950,3
9612342,A Degree of Murder,1967,['West Germany'],"['Drama', 'Crime Fiction']",1960,7
15114980,After Jimmy,1996,['United States of America'],['Drama'],1990,6
33902347,Fear Me Not,2008,['Denmark'],"['Drama', 'Thriller', 'World cinema']",2000,8
1031573,Chasing Liberty,2004,"['United Kingdom', 'United States of America']","['Comedy', 'Teen', 'Romance Film', 'Romantic comedy', 'Road movie']",2000,4
21965987,Akash Kusum,1965,['India'],['Drama'],1960,5
1607765,Prefontaine,1997,['United States of America'],"['Period piece', 'Sports', 'Biography', 'Biographical film', 'Biopic [feature]', 'Drama']",1990,7
770300,Passion Fish,1992,['United States of America'],"['Indie', 'Comedy of manners', 'Comedy-drama', 'Drama', 'Ensemble Film']",1990,2
27434686,Safari,1955,['United Kingdom'],['Adventure'],1950,5
18757474,Pasukob,2007,['Philippines'],"['Filipino Movies', 'Comedy', 'World cinema']",2000,7
24310768,Annie: A Royal Adventure!,1995,"['United Kingdom', 'United States of America']","['Comedy', 'Television movie', 'Adventure', 'Family Film']",1990,5
2889537,Naran,2005,['India'],"['Action', 'Thriller', 'Bollywood']",2000,5
165362,Punch Drunks,1934,['United States of America'],"['Short Film', 'Black-and-white', 'Comedy']",1930,4
2167727,Love Potion No. 9,1992,['United States of America'],"['Romantic fantasy', 'Comedy', 'Romance Film', 'Romantic comedy']",1990,2
28722788,Dekh Kabira Roya,1957,['India'],"['Musical', 'Romantic drama', 'Comedy', 'Bollywood', 'World cinema', 'Romance Film', 'Drama']",1950,7
10618415,Aadalat,1976,['India'],"['Action', 'Bollywood']",1970,6
11950831,Ambush at Cimarron Pass,1958,['United States of America'],"['Western', 'Black-and-white', 'Action/Adventure']",1950,8
2983249,The Ultimate Christmas Present,2000,"['Canada', 'United States of America']","['Comedy', 'Family Film']",2000,0
11686007,Sioux City,1994,['United States of America'],"['Detective fiction', 'Crime Fiction', 'Mystery', 'Indie', 'Thriller', 'Crime Thriller', 'Drama', 'Detective']",1990,4
2807023,Bad Guy,2001,['South Korea'],"['Romantic drama', 'Thriller', 'World cinema', 'Romance Film', 'Drama']",2000,1
29255903,Hammer the Toff,1952,[],['Crime Fiction'],1950,2
15107248,Fatal Contact,2006,['Hong Kong'],"['Action', 'Action/Adventure', 'World cinema', 'Chinese Movies', 'Martial Arts Film']",2000,6
15112634,Turned Out Nice Again,1941,['United Kingdom'],"['Musical', 'Comedy']",1940,1
24094015,My Man,1928,[],['Musical'],1920,8
16512703,Testosterone,2004,"['Argentina', 'United States of America']","['LGBT', 'Indie', 'Comedy']",2000,4
1448945,The Brave Little Toaster,1987,"['Taiwan', 'Japan', 'United States of America']","['Music', 'Musical', 'Animation', 'Comedy', ""Children's/Family"", ""Children's"", 'Adventure', 'Japanese Movies', 'Road movie', 'Family Film', 'Fantasy']",1980,7
6469852,Cheerleader Camp,1987,"['Japan', 'United States of America']","['Japanese Movies', 'Horror Comedy', 'Thriller', 'Horror', 'Slasher', 'Teen', 'B-movie']",1980,7
2060350,Experiment Perilous,1944,['United States of America'],"['Black-and-white', 'Crime Fiction', 'Thriller', 'Film noir', 'Melodrama', 'Drama']",1940,4
438356,Big Deal on Madonna Street,1958,['Italy'],"['Black-and-white', 'Heist', 'Crime Fiction', 'Caper story', 'Comedy', 'Crime Comedy', 'World cinema']",1950,8
277666,Tomcats,2001,['United States of America'],"['Screwball comedy', 'Comedy', 'Romance Film', 'Romantic comedy']",2000,1
16167288,Hey! Nee Romba Azhaga Irukke,2002,['India'],['World cinema'],2000,2
871066,Quatermass and the Pit,1967,['United Kingdom'],"['Alien invasion', 'Science Fiction', 'Horror']",1960,7
8459375,One Armed Boxer,1971,['Hong Kong'],"['Action', 'Chinese Movies', 'Martial Arts Film']",1970,1
2098698,Beyond the Forest,1949,['United States of America'],"['Film noir', 'Black-and-white']",1940,9
27726042,Female Prisoner Ayaka: Tormenting and Breaking in a Bitch,2008,['Japan'],['Japanese Movies'],2000,8
3793842,Varan the Unbelievable,1958,['Japan'],"['Creature Film', 'Japanese Movies', 'Horror', 'World cinema', 'Science Fiction']",1950,8
21312938,"Sumo Do, Sumo Don't",1992,['Japan'],"['Japanese Movies', 'Sports', 'Comedy']",1990,2
2783427,Greenfingers,2001,"['United Kingdom', 'United States of America']","['Prison', 'Comedy', 'Comedy of manners', 'Comedy-drama', 'Drama']",2000,1
11696799,Breaking the Surface: The Greg Louganis Story,1997,['United States of America'],"['Sports', 'Biographical film', 'Drama']",1990,7
6440344,The Fool of the World and the Flying Ship,1990,['United Kingdom'],"['Fairy tale', 'Animation', 'Stop motion', ""Children's/Family"", 'Adventure', 'Fantasy']",1990,0
23973599,Misbehaving Husbands,1940,['United States of America'],"['Romance Film', 'Black-and-white', 'Comedy']",1940,0
22049867,Hello Down There,1969,['United States of America'],"['Musical', 'Comedy']",1960,9
17618897,Alan & Naomi,1992,['United States of America'],['Drama'],1990,2
13425532,Pizza Man,1991,['United States of America'],"['Comedy', 'Satire']",1990,1
25724565,Nuummioq,2009,['Denmark'],"['Romance Film', 'Drama', 'World cinema']",2000,9
16114008,Grand Central Murder,1942,['United States of America'],"['Detective fiction', 'Black-and-white', 'Crime Fiction', 'Mystery', 'Detective', 'Film noir']",1940,2
198061,Chicago,1927,['United States of America'],"['Black-and-white', 'Crime Fiction', 'Indie', 'Comedy', 'Roadshow theatrical release', 'Drama', 'Silent film', 'Comedy-drama']",1920,7
73585,Man Bites Dog,1992,['Belgium'],"['Black-and-white', 'Crime Fiction', 'Action/Adventure', 'Satire', 'Comedy', 'World cinema', 'Media Satire', 'Black comedy', 'Mockumentary', 'Crime Comedy', 'Comedy-drama']",1990,2
20889324,Revelation,1998,"['Canada', 'United States of America']","['Action', 'Mystery', 'Action/Adventure', 'Science Fiction', 'Thriller', 'Drama']",1990,8
8779772,Goofs and Saddles,1937,['United States of America'],"['Black-and-white', 'Short Film', 'Comedy', 'Slapstick']",1930,7
18969101,No My Darling Daughter,1961,['United Kingdom'],"['Romantic comedy', 'Black-and-white']",1960,1
18581691,Ride,1998,['United States of America'],"['Indie', 'Comedy']",1990,8
6786095,Rickshawkaran,1971,['India'],['Drama'],1970,1
7313414,Desert Hearts,1985,['United States of America'],"['Film adaptation', 'LGBT', 'Indie', 'Romantic drama', 'Romance Film', 'Drama', 'Feminist Film', 'Period piece', 'Gay Themed', 'Gay', 'Gay Interest']",1980,5
25456878,Eleftherios Venizelos,1980,['Greece'],"['Historical drama', 'Biographical film']",1980,0
2254144,The Palm Beach Story,1942,['United States of America'],"['Black-and-white', 'Screwball comedy', 'Comedy', 'Comedy of manners', 'Romance Film', 'Romantic comedy']",1940,2
11923262,Brain Dead,1990,['United States of America'],"['Action', 'Psychological thriller', 'Indie', 'Action/Adventure', 'Thriller', 'Drama', 'Horror', 'Science Fiction']",1990,0
3387839,Madame Rosa,1977,['France'],"['Drama', 'World cinema']",1970,7
3587257,Ucho,1970,"['Czech Republic', 'Czechoslovakia']","['Black-and-white', 'Political satire', 'Thriller', 'Drama']",1970,0
2642703,Kedma,2002,"['Israel', 'France', 'Italy']","['World cinema', 'Historical fiction', 'War film', 'Drama', 'Tragedy']",2000,2
45242,Reds,1981,['United States of America'],"['Biography', 'Romantic drama', 'Biographical film', 'Romance Film', 'War film', 'Drama', 'Period piece', 'New Hollywood', 'Political drama']",1980,1
17415776,The Romance of Rosy Ridge,1947,['United States of America'],"['Black-and-white', 'Comedy-drama', 'Drama']",1940,7
1071462,Radio Flyer,1992,['United States of America'],"['Drama', 'Fantasy']",1990,2
3657826,L'uccello dalle piume di cristallo,1970,"['Germany', 'West Germany', 'Italy']","['Psychological thriller', 'Giallo', 'Mystery', 'Thriller', 'Horror']",1970,0
4343478,House of the Long Shadows,1983,['United Kingdom'],"['Mystery', 'Parody', 'Indie', 'Comedy Thriller', 'Comedy', 'Horror Comedy', 'Horror']",1980,3
9078941,The Disappearance of Flight 412,1974,['United States of America'],"['Mystery', 'Political drama', 'Drama']",1970,4
4343404,Cutting Class,1989,['United States of America'],"['Mystery', 'Satire', 'Thriller', 'Comedy', 'Teen', 'Crime Thriller', 'Slasher', 'Horror']",1980,9
9167041,Agnipankh,2004,['India'],"['Action', 'Romantic drama', 'Action/Adventure', 'World cinema', 'Romance Film', 'Drama']",2000,4
1790734,Summer of '42,1971,['United States of America'],"['Period piece', 'Coming of age', 'Romantic drama', 'Biographical film', 'Romance Film', 'Americana', 'Drama']",1970,1
12172635,Madagascar Skin,1996,['United Kingdom'],"['Gay Themed', 'LGBT', 'Indie', 'Romantic comedy', 'Drama']",1990,6
15634489,Prom Wars,2008,['Canada'],"['Indie', 'Comedy', 'Romance Film', 'Romantic comedy']",2000,8
7618765,The Mask,1961,['Canada'],['Horror'],1960,1
2180825,The Glass Slipper,1955,['United States of America'],"['Musical', 'Romance Film', 'Costume drama']",1950,5
10439707,Severed: Forest of the Dead,2005,['United States of America'],"['Horror', 'Zombie Film']",2000,5
2639650,The Assassination of Jesse James by the Coward Robert Ford,2007,"['Canada', 'United States of America']","['Crime Fiction', 'History', 'Biography', 'Western', 'Drama']",2000,7
1170181,Vivre Sa Vie,1962,['France'],"['Art film', 'Drama', 'World cinema']",1960,2
7320692,Butch Camp,1996,['United States of America'],"['LGBT', 'Screwball comedy', 'Indie', 'Comedy', 'Romance Film', 'Romantic comedy']",1990,6
3816289,Digital Monster X-Evolution,2005,['Japan'],"['Computer Animation', 'Animation', 'Japanese Movies']",2000,5
435566,I Shot Andy Warhol,1996,"['United Kingdom', 'United States of America']","['LGBT', 'Crime Fiction', 'Biography', 'Indie', 'Drama', 'Feminist Film', 'Period piece', 'Biopic [feature]']",1990,6
7358580,Ellie Parker,2005,['United States of America'],"['Indie', 'Satire', 'Comedy', 'Comedy-drama', 'Drama']",2000,5
5075286,You Were Made for Love,2005,['India'],"['Romantic drama', 'Thriller', 'World cinema', 'Romance Film', 'Drama']",2000,5
11998146,Big Brother,2007,['India'],"['Action/Adventure', 'Thriller', 'World cinema']",2000,7
16768172,Lucy,2003,['United States of America'],"['Television movie', 'Comedy-drama', 'Biographical film']",2000,3
22835906,Army of Crime,2009,['France'],"['History', 'World cinema', 'War film', 'Drama']",2000,9
23703779,Mukunthetta Sumitra Vilikkunnu,1988,['India'],['Comedy'],1980,8
11143202,Ullasa Paravaigal,1980,['India'],['World cinema'],1980,0
142274,The Adventures of Buckaroo Banzai Across the 8th Dimension,1984,['United States of America'],"['Parody', 'Science Fiction', 'Comedy', 'Adventure', 'Cult']",1980,4
21800330,The Assassin of the Tsar,1991,"['Soviet Union', 'United Kingdom']","['Political drama', 'Drama', 'World cinema']",1990,1
14825582,Strangers When We Meet,1960,['United States of America'],"['Film adaptation', 'Romantic drama', 'Romance Film', 'Melodrama', 'Drama']",1960,0
515151,The Ghost and the Darkness,1996,['United States of America'],"['British Empire Film', 'Action', 'Costume Adventure', 'Action/Adventure', 'Thriller', 'Adventure', 'Drama', 'Period piece', 'Suspense', 'Jungle Film', 'Horror']",1990,6
2769128,Goal!,2005,"['United Kingdom', 'United States of America']","['Sports', 'Drama']",2000,5
5579814,Bad Company,1995,['United States of America'],"['Action', 'Psychological thriller', 'Crime Fiction', 'Thriller', 'Erotic thriller', 'Crime Thriller', 'Drama']",1990,5
4946798,Alligator,1980,['United States of America'],"['Monster', 'Satire', 'Comedy', 'Creature Film', 'Natural horror films', 'Horror', 'Science Fiction', 'Cult']",1980,0
2590063,"Pepi, Luci, Bom and Other Girls on the Heap",1980,['Spain'],"['Satire', 'Comedy', 'Black comedy', 'Comedy-drama', 'Sex comedy']",1980,0
3309323,"7 mujeres, 1 homosexual y Carlos",2004,['Mexico'],"['LGBT', 'Romantic drama', 'Comedy', 'World cinema', 'Romance Film', 'Drama', 'Romantic comedy', 'Sex comedy']",2000,4
1499129,Pooh's Heffalump Movie,2005,['United States of America'],"['LGBT', 'Animation', 'Comedy', ""Children's/Family"", ""Children's"", 'Adventure', ""Children's Fantasy"", 'Family Film', 'Fantasy']",2000,5
11230221,Gharana,1961,['India'],"['Drama', 'World cinema']",1960,1
4922371,Double Whammy,2001,['United States of America'],"['Action', 'Crime Fiction', 'Indie', 'Action/Adventure', 'Satire', 'Comedy', 'Drama', 'Romantic comedy', 'Comedy-drama']",2000,1
5409364,Stolen Desire,1958,['Japan'],['Japanese Movies'],1950,8
748937,Kikujirō no Natsu,1999,['Japan'],"['Japanese Movies', 'Comedy', 'World cinema', 'Drama']",1990,9
28929724,Double Vision,1992,"['Canada', 'United Kingdom', 'France', 'Germany']","['Drama', 'Mystery', 'Thriller']",1990,2
2218334,The Toll of the Sea,1922,['United States of America'],"['Silent film', 'Drama']",1920,2
6551171,Howard the Duck,1986,['United States of America'],"['Action', 'Animation', 'Action/Adventure', 'Comedy', 'Thriller', 'Romance Film', 'Adventure', 'Superhero movie', 'Stop motion', 'Science Fiction', 'Cult']",1980,6
5452459,Pari,1995,['Iran'],"['Romance Film', 'Drama']",1990,5
11406036,Bad Biology,2008,['United States of America'],"['Fantasy', 'Cult', 'Horror']",2000,8
24212705,Border Vengeance,1935,['United States of America'],['Black-and-white'],1930,5
19646172,Finding Rin Tin Tin,2007,"['Bulgaria', 'United States of America']","['Period piece', 'Comedy', 'Animal Picture', 'Adventure', 'Drama', 'Family Film']",2000,7
15221214,"X,Y, and Zee",1972,['United Kingdom'],"['Romance Film', 'Romantic drama', 'Drama']",1970,2
3409175,The Matador,2005,"['Germany', 'United States of America', 'Ireland']","['Action', 'Indie', 'Action/Adventure', 'Buddy film', 'Comedy', 'Black comedy', 'Crime Thriller', 'Drama']",2000,5
16226377,The Emperor's Candlesticks,1937,['United States of America'],"['Romance Film', 'Black-and-white', 'Drama']",1930,7
11244591,Push-Button Kitty,1952,['United States of America'],"['Animated cartoon', 'Short Film', 'Family Film']",1950,2
19139397,Farewell to Space Battleship Yamato,1978,['Japan'],"['Anime', 'Japanese Movies', 'Science Fiction']",1970,8
2259232,Solarbabies,1986,['United States of America'],"['Action', 'Adventure', 'Sci-Fi Adventure', 'Science Fiction', 'Fantasy']",1980,6
7062572,"Grips, Grunts and Groans",1937,['United States of America'],"['Black-and-white', 'Short Film', 'Comedy', 'Slapstick']",1930,7
12835144,The Pickpocket,1997,"['China', 'Hong Kong']","['Comedy', 'Crime Comedy', 'Chinese Movies', 'Drama']",1990,7
8519164,Sucker Free City,2004,['United States of America'],"['Drama', 'Crime Fiction']",2000,4
14440087,"Yes, We Have No Bonanza",1939,['United States of America'],"['Black-and-white', 'Short Film', 'Comedy', 'Slapstick']",1930,9
4403446,The Spanish Main,1945,['United States of America'],"['Swashbuckler films', 'Adventure', 'Drama']",1940,5
9721229,Noah's Ark,1928,['United States of America'],"['Musical', 'Black-and-white']",1920,8
4229906,I Was a Teenage Frankenstein,1957,['United States of America'],"['Creature Film', 'Comedy', 'Horror Comedy', 'Horror', 'Teen']",1950,7
9534652,Biće skoro propast sveta,1968,"['Yugoslavia', 'France']","['Drama', 'World cinema']",1960,8
32844727,The Breach,1970,"['France', 'Italy', 'Belgium']","['Psychological thriller', 'Thriller', 'World cinema']",1970,0
27297304,Danny Boy,1934,['United Kingdom'],['Musical'],1930,4
4543239,Baby Boom,1987,['United States of America'],"['Comedy', 'Comedy of manners', 'Romance Film', 'Romantic comedy', 'Domestic Comedy', 'Family Film']",1980,7
1511944,Love Me If You Dare,2003,"['France', 'Belgium']","['Romantic drama', 'Comedy', 'World cinema', 'Romance Film', 'Romantic comedy', 'Comedy-drama', 'Drama']",2000,3
237303,Bruce Almighty,2003,['United States of America'],"['Heavenly Comedy', 'Comedy', 'Religious Film', 'Fantasy Comedy', 'Drama', 'Fantasy']",2000,3
190053,Who Am I?,1998,"['Hong Kong', 'United States of America']","['Action', 'Action/Adventure', 'Comedy', 'Thriller', 'World cinema', 'Chinese Movies', 'Martial Arts Film']",1990,8
25971258,Rio das Mortes,1970,['Germany'],"['Ensemble Film', 'Drama', 'World cinema']",1970,0
8075358,On Ice,1935,['United States of America'],"['Animated cartoon', 'Short Film', 'Comedy', ""Children's/Family""]",1930,5
1346716,Secret Ceremony,1968,['United Kingdom'],"['Family Drama', 'Drama']",1960,8
33522398,Tomorrow's Children,1934,['United States of America'],['Drama'],1930,4
14355683,Chocolate,2007,['India'],"['Romance Film', 'Comedy']",2000,7
3683731,Ship Ahoy,1942,['United States of America'],"['Musical', 'Black-and-white', 'Comedy', 'Musical comedy', 'Comedy of Errors']",1940,2
32998580,Circumstance,1922,[],['Silent film'],1920,2
15749099,Dark Harbor,1998,['United States of America'],"['Psychological thriller', 'Suspense', 'Mystery', 'Thriller', 'Erotic thriller', 'Crime Thriller']",1990,8
33022624,Woochi,2009,['South Korea'],"['Action', 'Action/Adventure', 'Comedy', 'World cinema', 'Adventure', 'Science Fiction', 'Fantasy']",2000,9
4384761,The Black Godfather,1974,['United States of America'],"['Action', 'Blaxploitation', 'Crime Fiction', 'Gangster Film', 'Action/Adventure', 'Thriller', 'Drama']",1970,4
3956101,Tension,1950,['United States of America'],"['Psychological thriller', 'Black-and-white', 'Crime Fiction', 'Thriller', 'Film noir', 'Drama']",1950,0
2268745,Blood and Wine,1997,"['United Kingdom', 'United States of America']","['Neo-noir', 'Heist', 'Crime Fiction', 'Thriller', 'Crime Drama', 'Crime Thriller', 'Drama']",1990,7
18619459,Confessions d'un Barjo,1992,['France'],"['Domestic Comedy', 'Comedy-drama', 'Comedy of manners', 'Drama']",1990,2
1937840,Thérèse,1986,['France'],"['Period piece', 'Biography', 'World cinema', 'Drama']",1980,6
7770667,The Ice Storm,1997,['United States of America'],"['Period piece', 'Film adaptation', 'Drama', 'Indie', 'Family Drama', 'Marriage Drama', 'Ensemble Film']",1990,7
14076686,The Mutant Chronicles,2008,['United States of America'],"['Action', 'Steampunk', 'Science Fiction']",2000,8
3907719,The Beast in the Heart,2005,"['Spain', 'United Kingdom', 'France', 'Italy']","['Drama', 'World cinema']",2000,5
3111180,FM,1978,['United States of America'],"['Drama', 'Comedy']",1970,8
9040345,Sailing for Madagascar,2005,['United States of America'],['Short Film'],2000,5
5673173,American Pie Presents: The Naked Mile,2006,"['Canada', 'United States of America']","['Gross out', 'Gross-out film', 'Comedy', 'Sex comedy']",2000,6
8666205,Cardcaptor: The Movie 2,2000,['Japan'],"['Animation', 'Japanese Movies', 'World cinema', 'Anime', 'Fantasy']",2000,0
25575984,My Neighbor's Secret,2009,[],"['Crime Fiction', 'Mystery', 'Thriller']",2000,9
31063644,Night in Manhattan,1937,['United States of America'],['Short Film'],1930,7
30826764,Bala Mitrula Katha,1972,['India'],['Drama'],1970,2
156558,Baby Boy,2001,['United States of America'],"['Crime Fiction', 'Coming of age', 'Drama']",2000,1
2676497,Flesh and the Devil,1926,['United States of America'],"['Film adaptation', 'Black-and-white', 'Indie', 'Romantic drama', 'Romance Film', 'Drama', 'Silent film', 'Melodrama']",1920,6
1166501,Mifune's Last Song,1999,"['Sweden', 'Denmark']","['Family Drama', 'Romantic drama', 'Comedy', 'World cinema', 'Romance Film', 'Drama', 'Dogme 95', 'Romantic comedy']",1990,9
7467793,Nothing But Life,2004,"['India', 'United States of America']","['Drama', 'Comedy']",2000,4
18588953,True Confessions of a Hollywood Starlet,2008,['United States of America'],"['Film adaptation', 'Comedy', 'Television movie', 'Comedy-drama', 'Addiction Drama', 'Drama']",2000,8
16621128,The World Moves On,1934,['United States of America'],"['Black-and-white', 'Romance Film', 'War film', 'Drama']",1930,4
3724436,The 39 Steps,1935,['United Kingdom'],"['Spy', 'Suspense', 'Black-and-white', 'Mystery', 'Thriller', 'Crime Thriller']",1930,5
6911871,Kicking It Old Skool,2007,['United States of America'],"['Parody', 'Satire', 'Comedy']",2000,7
1673949,Gilda,1946,['United States of America'],"['Black-and-white', 'Romantic drama', 'Thriller', 'Film noir', 'Romance Film', 'Drama']",1940,6
1060187,Maria Full of Grace,2004,"['Colombia', 'United States of America']","['Crime Fiction', 'Thriller', 'World cinema', 'Social problem film', 'Drama']",2000,4
5172934,Bichhoo,2000,['India'],"['Thriller', 'Bollywood', 'World cinema']",2000,0
23998259,Leaving Normal,1992,['United States of America'],"['Buddy film', 'Comedy', 'Road movie', 'Drama', 'Feminist Film']",1990,2
3915041,Leaving Metropolis,2002,['Canada'],"['LGBT', 'Indie', 'Romantic drama', 'Drama', 'Gay Themed', 'Gay', 'Gay Interest', 'Ensemble Film']",2000,2
2310279,Mad Love,1935,['United States of America'],"['Psychological thriller', 'Black-and-white', 'Horror']",1930,5
1899307,The Innocents,1961,['United Kingdom'],"['Film adaptation', 'Black-and-white', 'Thriller', 'Horror', 'Drama', 'Cult']",1960,1
19815563,"80,000 Suspects",1963,['United Kingdom'],"['Romance Film', 'Drama', 'Medical fiction']",1960,3
7767613,Star!,1968,['United States of America'],"['Musical', 'Biography', 'Biographical film', 'Biopic [feature]', 'Musical Drama', 'Drama']",1960,8
20533089,Goa,2009,['India'],"['Romantic comedy', 'Comedy']",2000,9
9919206,Buena Vida Delivery,2004,"['Argentina', 'France', 'Netherlands']","['Indie', 'Comedy', 'Drama']",2000,4
5997215,Across the Hall,2006,['United States of America'],"['Drama', 'Short Film', 'Thriller']",2000,6
19286149,Raja Desingu,1960,['India'],['Historical fiction'],1960,0
7249177,Face of the Screaming Werewolf,1964,"['Mexico', 'United States of America']",['Horror'],1960,4
28725665,Crime by Night,1944,['United States of America'],"['Detective fiction', 'Crime Fiction', 'Mystery', 'Detective', 'Crime Thriller']",1940,4
6476028,"Clean, Shaven",1993,['United States of America'],"['Mystery', 'Crime Fiction', 'Thriller', 'Crime Thriller', 'Drama']",1990,3
980601,Tape,2001,['United States of America'],"['Psychological thriller', 'Crime Fiction', 'Indie', 'Drama']",2000,1
20926831,Vengeance,2009,"['France', 'Hong Kong']","['Action', 'Crime Fiction', 'Action/Adventure', 'Thriller', 'World cinema', 'Film noir', 'Chinese Movies', 'Drama']",2000,9
7588472,Betty Boop's Prize Show,1934,['United States of America'],"['Animation', 'Short Film', 'Comedy', 'Family Film']",1930,4
9051332,Waitress,2007,['United States of America'],"['Comedy', 'Romance Film', 'Romantic comedy', 'Comedy-drama', 'Drama', 'Slice of life story']",2000,7
1609520,Pride,1973,['India'],"['Musical', 'Romantic drama', 'Musical Drama', 'Bollywood', 'World cinema', 'Romance Film', 'Drama', 'Melodrama']",1970,3
4589710,Monstrosity,1964,['United States of America'],"['Black-and-white', 'Indie', 'Horror', 'Science Fiction']",1960,4
34152185,Dangerously They Live,1941,[],"['Thriller', 'Romance Film', 'War film', 'Drama']",1940,1
5747371,Jaani Dushman,1979,['India'],"['World cinema', 'Drama', 'Horror']",1970,9
679636,Abre los ojos,1997,"['France', 'Spain', 'Italy']","['Psychological thriller', 'Mystery', 'Future noir', 'Thriller', 'World cinema', 'Romance Film', 'Drama']",1990,7
34043061,Beautiful Thing,1995,"['United Kingdom', 'England']","['LGBT', 'Coming of age', 'Comedy film', 'Romantic comedy', 'Romance Film', 'Drama']",1990,5
5191706,Be Kind Rewind,2008,"['United Kingdom', 'United States of America']","['Comedy', 'Drama', 'Comedy of Errors']",2000,8
3730244,The Ballad of Cable Hogue,1970,['United States of America'],"['Action', 'Comedy Western', 'Revisionist Western', 'Indie', 'Action/Adventure', 'Western', 'Comedy']",1970,0
20435857,De Dana Dan,2009,['India'],"['Musical', 'Comedy', 'Bollywood', 'World cinema']",2000,9
2603838,From Beijing With Love,1994,['Hong Kong'],"['Action', 'Action/Adventure', 'Comedy', 'World cinema', 'Chinese Movies']",1990,4
5574669,Air,2005,['Japan'],"['Animation', 'Japanese Movies', 'Anime', 'Drama', 'Fantasy']",2000,5
3523345,The Honey Pot,1967,['United States of America'],"['Film adaptation', 'Mystery', 'Comedy', 'Thriller', 'Black comedy', 'Crime Thriller', 'Tragicomedy', 'Drama']",1960,7
20358218,Beast Stalker,2008,['Hong Kong'],"['Action', 'Action Thrillers', 'Action/Adventure', 'Thriller', 'World cinema', 'Chinese Movies']",2000,8
7535776,Vathiyar,2006,['India'],['Action'],2000,6
19816863,Don't Lie,1942,['United States of America'],"['Black-and-white', 'Short Film', 'Comedy', ""Children's/Family"", 'Family Film']",1940,2
7369863,War Inc.,2008,['United States of America'],"['Action', 'Political satire', 'Satire', 'Thriller', 'Comedy']",2000,8
4213183,Lovers and Liars,1979,['Italy'],"['Comedy', 'World cinema', 'Romance Film', 'Romantic comedy']",1970,9
5627716,Jagriti,1954,['India'],"['Drama', 'Bollywood', 'World cinema']",1950,4
1494502,Red Planet,2000,"['United States of America', 'Australia']","['Action/Adventure', 'Thriller', 'Adventure', 'Disaster', 'Science Fiction']",2000,0
18188453,Lovedolls Superstar,1986,['United States of America'],"['Music', 'Musical', 'Indie', 'Satire', 'Comedy', 'Punk rock', 'Parody', 'Cult']",1980,6
1613385,The 27th Day,1957,['United States of America'],['Science Fiction'],1950,7
5799733,The Sinners of Hell,1960,['Japan'],"['Japanese Movies', 'World cinema', 'Horror']",1960,0
99459,Airport,1970,['United States of America'],"['Action', 'Airplanes and airports', 'Action/Adventure', 'Thriller', 'Disaster']",1970,0
10737634,La Pasión Turca,1994,['Spain'],"['Erotic Drama', 'Drama']",1990,4
10620078,Sawan Bhadon,1970,['India'],"['Romantic drama', 'World cinema', 'Romance Film', 'Drama']",1970,0
25452154,Beer,1985,['United States of America'],"['Parody', 'Comedy', 'Media Satire', 'Workplace Comedy']",1980,5
11843126,Urban Justice,2007,['United States of America'],"['Action', 'Crime Fiction', 'Action Thrillers', 'Action/Adventure', 'Thriller']",2000,7
61189,Disraeli,1929,['United States of America'],"['Black-and-white', 'Drama', 'Biography', 'Indie', 'Biographical film', 'Silent film', 'Political drama']",1920,9
10637370,Dulhan Wahi Jo Piya Man Bhaye,1977,['India'],"['Romantic drama', 'World cinema', 'Romance Film', 'Drama']",1970,7
14270386,Butch Jamie,2007,['United States of America'],"['Gay Themed', 'LGBT', 'Gay', 'Indie', 'Gay Interest', 'Comedy', 'Romantic comedy']",2000,7
6577088,Thiruvilayadal Aarambam,2006,['India'],"['Musical', 'Romantic drama', 'Comedy', 'Bollywood', 'World cinema', 'Romance Film', 'Drama', 'Romantic comedy']",2000,6
24423022,The Crazy World of Julius Vrooder,1974,['United States of America'],"['Comedy-drama', 'Comedy', 'Drama']",1970,4
1109777,Contempt,1963,"['France', 'Italy']","['Art film', 'Romantic drama', 'Satire', 'Marriage Drama', 'World cinema', 'Romance Film', 'Drama']",1960,3
1402997,Son of the Mask,2005,"['Germany', 'United States of America']","['Action/Adventure', 'Slapstick', 'Comedy', 'Superhero movie', 'Fantasy Comedy', 'Family Film', 'Fantasy']",2000,5
9077932,The Violent Years,1956,['United States of America'],"['Black-and-white', 'Crime Fiction', 'Thriller', 'Teen', 'Crime Thriller', 'Drama']",1950,6
23005993,Artisten,1935,['Germany'],['Black-and-white'],1930,5
8506932,Lightning Bug,2004,['United States of America'],"['Psychological thriller', 'Indie', 'Thriller', 'Horror', 'Drama']",2000,4
20723352,The Frog Prince,1984,['United Kingdom'],['Romantic comedy'],1980,4
9140037,Bad Bascomb,1946,['United States of America'],"['Action', 'Western']",1940,6
5560792,Pinocchio 3000,2004,"['France', 'Spain', 'Canada']","['Animation', 'Adventure', 'Science Fiction', 'Family Film', 'Computer Animation']",2000,4
547687,They Were Expendable,1945,['United States of America'],"['Action', 'Combat Films', 'Black-and-white', 'Action/Adventure', 'War film', 'Drama']",1940,5
13851011,Tom and Jerry: A Nutcracker Tale,2007,['United States of America'],"['Historical Epic', ""Children's/Family"", 'Animation']",2000,7
673158,The Shaggy Dog,1959,['United States of America'],"['Comedy', 'Drama', 'Family Film', 'Fantasy']",1950,9
7154803,Puppet Master: The Legacy,2004,['United States of America'],['Horror'],2000,4
35570671,Lucignolo,1999,['Italy'],['Comedy film'],1990,9
24399610,Long Weekend,1978,"['New Zealand', 'Australia']","['Mystery', 'Thriller', 'Horror']",1970,8
3803778,Initial D,2005,"['Hong Kong', 'China', 'Japan']","['Action', 'Action Thrillers', 'Action/Adventure', 'Thriller', 'World cinema', 'Teen', 'Auto racing', 'Chinese Movies', 'Japanese Movies', 'Sports']",2000,5
62110,Test Pilot,1938,['United States of America'],"['Romance Film', 'Drama']",1930,8
21808115,Heartstopper,2006,['Canada'],"['Slasher', 'Thriller', 'Horror']",2000,6
8944549,Slam Dunk,2008,"['Hong Kong', 'Taiwan', 'China']","['Chinese Movies', 'Action/Adventure', 'Comedy', 'World cinema', 'Sports']",2000,8
25707959,What Alice Found,2003,['United States of America'],"['Crime Fiction', 'Indie', 'Road movie', 'Drama']",2000,3
22674979,Fermat's Room,2007,['Spain'],"['Psychological thriller', 'Mystery', 'Thriller', 'World cinema']",2000,7
26284611,The Stranglers of Bombay,1960,['United Kingdom'],"['Action', 'Horror', 'Historical fiction', 'Adventure']",1960,0
7478725,Jack Be Nimble,1993,"['United Kingdom', 'New Zealand', 'Australia']","['Suspense', 'Thriller', 'Horror', 'World cinema', 'Supernatural']",1990,3
5693644,Bonnie Scotland,1935,['United States of America'],"['Black-and-white', 'Comedy', 'Satire', 'Slapstick']",1930,5
9143305,Untamed,1955,['United States of America'],"['Adventure', 'War film']",1950,5
1365472,Written on the Wind,1956,['United States of America'],"['Romantic drama', 'Family Drama', 'Romance Film', 'Melodrama', 'Drama']",1950,6
23121389,I Love You,1981,['Brazil'],['Drama'],1980,1
2912851,The Beautiful Country,2004,"['Norway', 'United States of America']","['Drama', 'Indie', 'Social problem film', 'Adventure']",2000,4
31104988,Never Forget,1991,['United States of America'],"['War film', 'Drama']",1990,1
28098139,Remedy,2005,['United States of America'],"['Mystery', 'Indie', 'Thriller']",2000,5
34149703,Il vostro super agente Flit,1966,[],['Comedy film'],1960,6
6528803,Black Dragons,1942,['United States of America'],"['Spy', 'Black-and-white', 'Science Fiction']",1940,2
350629,Altered States,1980,['United States of America'],"['Surrealism', 'Psychological thriller', 'Film adaptation', 'Drama', 'Creature Film', 'Horror', 'Science Fiction', 'Cult']",1980,0
23865847,An Inn in Tokyo,1935,['Japan'],"['Silent film', 'Black-and-white', 'Japanese Movies']",1930,5
26183167,Cholera Street,1997,"['France', 'Turkey', 'Hungary']","['Romance Film', 'Crime Fiction', 'Drama']",1990,7
3792950,Permanent Vacation,1980,['United States of America'],"['Indie', 'Drama']",1980,0
3570614,Different for Girls,1996,"['United Kingdom', 'France']","['LGBT', 'Romantic drama', 'Comedy', 'Romance Film', 'Gay Themed', 'Gay', 'Gay Interest', 'Romantic comedy', 'Comedy-drama', 'Cult']",1990,6
4512744,Straight Out of Brooklyn,1991,['United States of America'],"['Crime Fiction', 'Coming of age', 'Indie', 'Crime Drama', 'Drama']",1990,1
4712007,Pusher III,2004,['Denmark'],"['Action', 'Crime Fiction', 'Gangster Film', 'Action/Adventure', 'Thriller', 'World cinema', 'Black comedy', 'Crime Thriller', 'Drama', 'Crime Drama']",2000,4
24715951,The King's Daughters,2000,"['France', 'Germany', 'Belgium']","['Period piece', 'History', 'Romance Film', 'Historical fiction', 'Drama']",2000,0
34259689,Manasukkul Mathappu,1988,['India'],['Drama'],1980,8
13166007,Neon Maniacs,1986,['United States of America'],"['Creature Film', 'Monster movie', 'Slasher', 'Teen', 'Horror']",1980,6
9507405,Dance Party USA,2006,['United States of America'],"['Indie', 'Drama']",2000,6
18769534,Neninthe,2008,['India'],['Drama'],2000,8
27843210,Adharvam,1989,['India'],"['Thriller', 'Adventure', 'Drama', 'Fantasy']",1980,9
4506211,Barb Wire,1996,['United States of America'],"['Action', 'Indie', 'Action/Adventure', 'Superhero movie', 'Science Fiction', 'Fantasy']",1990,6
11344266,Hero,1983,['India'],"['Musical', 'Bollywood', 'World cinema', 'Drama']",1980,3
1560455,My Sassy Girl,2001,['South Korea'],['Romantic comedy'],2000,1
4728,Batman Returns,1992,"['United Kingdom', 'United States of America']","['Action', 'Crime Fiction', 'Superhero', 'Action/Adventure', 'Thriller', 'Master Criminal Films', 'Superhero movie', 'Fantasy']",1990,2
74930,Manhattan,1979,['United States of America'],"['Black-and-white', 'Indie', 'Comedy', 'New Hollywood', 'Romance Film', 'Romantic comedy']",1970,9
2361396,Coyote Ugly,2000,['United States of America'],"['Musical', 'Romantic drama', 'Comedy', 'Romance Film', 'Drama', 'Coming of age', 'Romantic comedy', 'Comedy-drama']",2000,0
4278061,King Uncle,1993,['India'],"['Action', 'Drama', 'Comedy', 'Family Film']",1990,3
1792094,Zubeidaa,2001,['India'],"['Musical', 'Period piece', 'Romantic drama', 'Bollywood', 'World cinema', 'Romance Film', 'Drama']",2000,1
9054377,Les Nanas,1985,['France'],['Comedy'],1980,5
22667247,Bodyguards and Assassins,2009,"['China', 'Hong Kong']","['Action', 'Action Thrillers', 'Action/Adventure', 'Thriller', 'World cinema', 'Chinese Movies', 'Martial Arts Film', 'Adventure', 'Drama', 'Period piece', 'History', 'Historical fiction']",2000,9
765310,Head of State,2003,['United States of America'],"['Political cinema', 'Political satire', 'Satire', 'Comedy']",2000,3
8904818,Casi Casi,2006,['Puerto Rico'],"['Comedy', 'Teen', 'World cinema', 'Romantic comedy', 'Adventure']",2000,6
9897904,Article 99,1992,['United States of America'],"['Satire', 'Black comedy', 'Comedy-drama', 'Drama', 'Medical fiction']",1990,2
9633845,Live-in Maid,2005,"['Argentina', 'Spain']","['Indie', 'Satire', 'World cinema', 'Comedy-drama', 'Drama']",2000,5
3350098,Sam Whiskey,1967,['United States of America'],"['Comedy Western', 'Action/Adventure', 'Western', 'Comedy']",1960,7
21785792,Verboten!,1959,['United States of America'],"['Romance Film', 'War film', 'Drama']",1950,9
12293235,Some of My Best Friends Are...,1971,['United States of America'],['Drama'],1970,1
21607420,Street Racer,2008,['United States of America'],"['Action', 'Crime Fiction', 'Action Thrillers', 'Indie', 'Action/Adventure', 'Thriller', 'Auto racing', 'Sports']",2000,8
6179031,One Girl's Confession,1953,['United States of America'],"['Black-and-white', 'Crime Fiction', 'Film noir', 'Drama']",1950,3
1512171,Diary of a Mad Black Woman,2005,['United States of America'],"['Romantic drama', 'Comedy', 'Romance Film', 'Romantic comedy', 'Comedy-drama', 'Drama']",2000,5
15439044,Sandai,2008,['India'],['Drama'],2000,8
3838436,Follow Me Quietly,1949,['United States of America'],"['Psychological thriller', 'Black-and-white', 'Mystery', 'Thriller', 'Film noir', 'Drama']",1940,9
19273689,Hot Enough for June,1964,['United Kingdom'],"['Spy', 'Comedy']",1960,4
31325527,His Bitter Half,1950,[],"['Animation', 'Short Film', 'Comedy film', 'Family Film']",1950,0
6089198,Thou Shalt Not Kill... Except,1985,['United States of America'],"['Action', 'Action Thrillers', 'Action/Adventure', 'Slasher', 'Thriller', 'Horror', 'War film']",1980,5
892265,Bratz: Starrin & Stylin',2004,['United States of America'],"['Comedy', 'Animation']",2000,4
161460,Lust for Life,1956,['United States of America'],"['Period piece', 'Biography', 'Biopic [feature]', 'Drama']",1950,6
12014760,One Missed Call: Final,2006,"['Japan', 'South Korea']","['Japanese Movies', 'World cinema', 'Horror']",2000,6
6653265,Delta Force 2: The Colombian Connection,1990,['United States of America'],"['Action', 'Action Thrillers', 'Action/Adventure', 'Thriller', 'Martial Arts Film']",1990,0
32807647,The Jericho Mile,1979,[],"['Television movie', 'Sports', 'Drama']",1970,9
630721,Punch-Drunk Love,2002,['United States of America'],"['Comedy', 'Romance Film', 'Romantic comedy', 'Comedy-drama', 'Drama', 'Absurdism']",2000,2
26136751,It's My Turn,1980,['United States of America'],"['Romantic drama', 'Comedy', 'Romance Film', 'Romantic comedy']",1980,0
1729455,Ninne Pelladutha,1996,['India'],"['Romance Film', 'Comedy', 'Drama']",1990,6
1087443,The Mark of Zorro,1920,['United States of America'],"['Black-and-white', 'Indie', 'Action/Adventure', 'Romantic drama', 'Romance Film', 'Swashbuckler films', 'Drama', 'Silent film', 'Superhero movie']",1920,0
12296573,High Treason,1929,['United Kingdom'],['Science Fiction'],1920,9
1724742,Hour of the Wolf,1968,['Sweden'],"['Black-and-white', 'Art film', 'Gothic Film', 'Thriller', 'World cinema', 'Drama', 'Marriage Drama', 'Horror', 'Supernatural']",1960,8
12308598,Shinjuku Incident,2009,"['Hong Kong', 'Japan']","['Crime Fiction', 'Action/Adventure', 'Thriller', 'World cinema', 'Crime Thriller', 'Chinese Movies', 'Drama', 'Japanese Movies']",2000,9
14779345,San Quentin,1937,['United States of America'],"['Action', 'Black-and-white', 'Drama', 'Crime Fiction']",1930,7
1755731,Maid in Manhattan,2002,['United States of America'],"['Comedy', 'Romance Film', 'Romantic comedy', 'Drama']",2000,2
10304498,Incendiary,2008,"['United Kingdom', 'United States of America']","['Indie', 'Drama']",2000,8
901907,The Magician,1926,['United States of America'],"['Silent film', 'Black-and-white', 'Horror']",1920,6
8282525,David,1988,['United States of America'],['Drama'],1980,8
295757,Mystery Men,1999,['United States of America'],"['Action', 'Indie', 'Parody', 'Action/Adventure', 'Comedy', 'Superhero movie', 'Fantasy']",1990,9
17467039,The Organization,1971,['United States of America'],"['Action', 'Crime Fiction', 'Action/Adventure', 'Thriller']",1970,1
33171729,True Friends,1954,[],"['Romance Film', 'Drama', 'Comedy film']",1950,4
6845157,Starship Troopers 3: Marauder,2008,"['Germany', 'South Africa', 'United States of America']","['Action', 'Action/Adventure', 'Thriller', 'Horror', 'Adventure', 'Science Fiction']",2000,8
1481638,Saturn 3,1980,"['United Kingdom', 'United States of America']","['Thriller', 'Horror', 'Adventure', 'Science Fiction']",1980,0
2287595,Back by Midnight,2005,['United States of America'],"['Prison', 'Comedy', 'Crime Comedy', 'Slapstick']",2000,5
6174864,Doctor X,1932,['United States of America'],"['Mystery', 'Thriller', 'Horror', 'Pre-Code']",1930,2
104984,Rocky IV,1985,['United States of America'],"['Action', 'Boxing', 'Drama', 'Sports', 'Political drama']",1980,5
16389361,Main Aur Mrs Khanna,2009,['India'],"['Musical', 'Romantic drama', 'Comedy', 'Bollywood', 'World cinema', 'Romance Film', 'Drama']",2000,9
6165779,When Zachary Beaver Came to Town,2003,['United States of America'],"['Family Drama', 'Coming of age', ""Children's/Family"", 'Comedy-drama', ""Children's"", 'Drama', 'Family Film']",2000,3
32736970,Porky in Egypt,1938,['United States of America'],"['Animation', 'Short Film', 'Comedy film', 'Family Film']",1930,8
2725075,Pardes,1997,['India'],['Bollywood'],1990,7
12138300,All The Boys Love Mandy Lane,2008,['United States of America'],"['Slasher', 'Thriller', 'Horror', 'Teen']",2000,8
18302086,Public Enemy Returns,2008,['South Korea'],"['Action', 'Crime Fiction', 'Thriller', 'Comedy film']",2000,8
4399566,Beatrice Wood: Mama of Dada,1993,['United States of America'],['Documentary'],1990,3
382510,Behind the Green Door,1972,['United States of America'],"['Adult', 'Hardcore pornography', 'Pornographic movie']",1970,2
14411179,No Time for Comedy,1940,['United States of America'],"['Romance Film', 'Comedy', 'Drama']",1940,0
12111728,Charlie Bartlett,2007,['United States of America'],"['Drama', 'Indie', 'Coming of age', 'Comedy', 'Teen', 'Comedy-drama']",2000,7
30873695,The Exorcist III,1990,['United States of America'],"['Psychological thriller', 'Horror', 'Supernatural', 'Cult']",1990,0
10106919,Bug,2002,['United States of America'],"['Indie', 'Comedy']",2000,2
10727249,Wild Thing,1987,['United States of America'],"['Action', 'Thriller', 'Drama']",1980,7
9107557,Nizhalkuthu,2002,['India'],"['Crime Fiction', 'Art film', 'Bollywood', 'World cinema', 'Drama']",2000,2
4677732,Give a Girl a Break,1953,['United States of America'],"['Musical', 'Drama', 'Musical comedy']",1950,3
144831,The Thin Man Goes Home,1945,['United States of America'],"['Black-and-white', 'Crime Fiction', 'Screwball comedy', 'Mystery', 'Comedy', 'Thriller', 'Crime Thriller', 'Comedy Thriller', 'Crime Comedy']",1940,5
5305695,The Three Muscatels,1991,['United States of America'],"['Parody', 'Comedy']",1990,1
770144,The Fabulous Baker Boys,1989,['United States of America'],"['Musical', 'Romantic drama', 'Musical Drama', 'Romance Film', 'Drama']",1980,9
5319581,Dorf Goes Auto Racing,1990,['United States of America'],"['Parody', 'Short Film', 'Comedy', 'Auto racing']",1990,0
6294854,Mr. Socrates,2005,['South Korea'],"['Action', 'Crime Fiction']",2000,5
14923841,Nadiya Ke Paar,1982,['India'],"['Romantic drama', 'World cinema', 'Romance Film', 'Drama']",1980,2
8401840,Captain Corelli's Mandolin,2001,"['United Kingdom', 'France', 'United States of America']","['Period piece', 'Music', 'Film adaptation', 'Romantic drama', 'Romance Film', 'War film', 'Drama']",2000,1
612007,Lessons of Darkness,1992,"['United Kingdom', 'France', 'Germany', 'England']","['Political cinema', 'World cinema', 'Documentary', 'Gulf War', 'War film', 'Science Fiction']",1990,2
10725778,A Place of One's Own,1943,['United Kingdom'],"['Psychological thriller', 'Black-and-white', 'Thriller', 'Crime Thriller', 'Supernatural', 'Drama']",1940,3
7504586,House Cleaning Blues,1937,['United States of America'],"['Animation', 'Short Film', 'Comedy']",1930,7
17927279,My Scene Goes Hollywood,2005,['United States of America'],"[""Children's/Family"", 'Animation', 'Family Film']",2000,5
939203,North,1994,['United States of America'],"['Film adaptation', 'Comedy', 'Drama', 'Family Film', 'Fantasy']",1990,4
26519331,Inflatable Sex Doll of the Wastelands,1967,['Japan'],['Japanese Movies'],1960,7
1624537,The Elusive Avengers,1966,"['Russia', 'Soviet Union']","['Action', 'Action/Adventure', 'Western', 'Comedy', 'World cinema', 'Adventure']",1960,6
947616,House on Haunted Hill,1999,['United States of America'],"['Mystery', 'Thriller', 'Horror']",1990,9
8414283,I Saw Mommy Kissing Santa Claus,2001,"['Germany', 'United States of America']","[""Children's/Family"", 'Comedy', 'Family Film']",2000,1
19451074,Dadar Kirti,1980,['India'],"['Romantic comedy', 'Drama']",1980,0
19606092,The Extraordinary Seaman,1969,['United States of America'],"['War film', 'Comedy']",1960,9
19526757,The Siege of Firebase Gloria,1989,['United States of America'],"['Action', 'Drama', 'Action/Adventure', 'World cinema', 'War film']",1980,9
967174,The Guardian,1990,['United States of America'],"['Supernatural', 'Thriller', 'Horror']",1990,0
17620280,Haal-e-dil,2008,['India'],"['Musical', 'Romantic drama', 'Bollywood', 'World cinema', 'Romance Film', 'Drama', 'Romantic comedy', 'Ensemble Film']",2000,8
18423431,Micmacs,2009,['France'],"['Crime Fiction', 'Comedy', 'World cinema', 'Fantasy Comedy']",2000,9
14587462,Scanners: The Showdown,1995,['United States of America'],['Horror'],1990,5
23894804,Belle Starr,1941,['United States of America'],['Western'],1940,1
45126,Anne of the Thousand Days,1969,['United Kingdom'],"['Period piece', 'Romantic drama', 'Marriage Drama', 'Romance Film', 'Historical fiction', 'Costume drama', 'Drama']",1960,9
9416151,Más negro que la noche,1975,['Mexico'],"['Haunted House Film', 'Horror']",1970,5
10048887,My Chauffeur,1986,['United States of America'],"['Indie', 'Comedy', 'Teen', 'Romance Film', 'Romantic comedy', 'Sex comedy']",1980,6
23409260,Dancing In the Dark,1949,['United States of America'],['Musical'],1940,9
261364,Agent Cody Banks,2003,"['Canada', 'United States of America']","['Action', 'Spy', 'Crime Fiction', 'Action/Adventure', 'Comedy', 'Thriller', 'Romance Film', 'Family-Oriented Adventure', ""Children's/Family"", ""Children's"", 'Adventure', 'Family Film']",2000,3
2134635,FeardotCom,2002,"['Luxembourg', 'United Kingdom', 'Germany', 'United States of America']","['Slasher', 'Horror']",2000,2
16343214,In search of a midnight kiss,2007,['United States of America'],"['Mumblecore', 'Indie', 'Romantic drama', 'Comedy', 'Romance Film', 'Drama', 'Slice of life story', 'Romantic comedy']",2000,7
16663101,Dawg,2002,['United States of America'],"['Comedy film', 'Romance Film', 'Melodrama', 'Drama']",2000,2
9006288,Barbarosa,1982,['United States of America'],"['Action/Adventure', 'Western', 'Buddy film']",1980,2
33922458,Dastak,1996,['India'],"['Thriller', 'World cinema']",1990,6
20370386,Bronson,2008,['United Kingdom'],"['Action', 'Prison', 'Crime Fiction', 'Biography', 'Biographical film', 'Thriller', 'Drama', 'Biopic [feature]', 'Crime Drama']",2000,8
22361477,The Third Secret,1964,['United Kingdom'],"['Detective fiction', 'Crime Fiction', 'Mystery', 'Thriller', 'Detective', 'Crime Thriller', 'Drama']",1960,4
8816501,The Nines,2007,['United States of America'],"['Mystery', 'Fantasy Drama', 'Comedy-drama', 'Science Fiction', 'Drama', 'Fantasy']",2000,7
24962629,Project Shadowchaser IV,1996,['United States of America'],"['Action', 'Action Thrillers', 'Action/Adventure', 'Science Fiction', 'Thriller']",1990,6
5106141,Malaamal Weekly,2006,['India'],"['Musical', 'Comedy', 'Bollywood', 'World cinema', 'Romance Film', 'Drama']",2000,6
3117881,La Mariée était en noir,1968,['France'],"['Psychological thriller', 'Romantic drama', 'Thriller', 'World cinema', 'Romance Film', 'Drama']",1960,8
1882999,All the Fine Promises,2003,['France'],['Drama'],2000,3
10818667,Perfect Body,1997,['United States of America'],"['Teen', 'Television movie', 'Sports', 'Drama']",1990,7
14628378,The Trail of the Lonesome Pine,1936,['United States of America'],"['Film adaptation', 'Action/Adventure', 'Western', 'Drama']",1930,6
9023277,Beautiful Girl,2003,['United States of America'],"['Comedy', 'Family Film']",2000,3
13212232,Arabikkatha,2007,['India'],['Drama'],2000,7
13976296,Dick Tracy vs. Cueball,1946,['United States of America'],"['Action', 'Black-and-white', 'Superhero', 'Mystery', 'Detective', 'Film noir', 'Superhero movie']",1940,6
2981371,Aha!,2007,[],['Drama'],2000,7
18290736,Mustafa Hakkında Herşey,2004,['Turkey'],['Thriller'],2000,4
15998246,Gold Diggers in Paris,1938,['United States of America'],"['Musical', 'Romance Film', 'Comedy film']",1930,8
10030670,The Hound of the Baskervilles,1978,['United Kingdom'],"['Film adaptation', 'Mystery', 'Parody', 'Comedy', 'Thriller', 'Crime Thriller', 'Drama']",1970,8
32136949,Khauff,2000,['India'],['World cinema'],2000,0
8124062,The Noose Hangs High,1948,['United States of America'],"['Black-and-white', 'Crime Fiction', 'Slapstick', 'Comedy', 'Crime Comedy', 'Comedy of Errors', 'Family Film']",1940,8
23590179,Beautiful Kate,2009,"['New Zealand', 'Australia']","['Family Drama', 'Drama', 'World cinema']",2000,9
3487956,The Hills Have Eyes,2006,['United States of America'],"['Monster movie', 'Slasher', 'Thriller', 'Horror', 'Road-Horror', 'Cult']",2000,6
30418882,Seetharamaiah Gari Manavaralu,1991,['India'],['Drama'],1990,1
2402218,The Great Flamarion,1945,['United States of America'],"['Black-and-white', 'Film noir', 'Crime Drama', 'Melodrama', 'Drama']",1940,5
7424807,Mondi Ghatam,1982,['India'],"['Action', 'Drama', 'Family Film']",1980,2
7261333,Norbit,2007,['United States of America'],"['Gross out', 'Gross-out film', 'Comedy', 'Romance Film', 'Romantic comedy', 'Slapstick']",2000,7
3606413,Impostor,2001,['United States of America'],"['Action', 'Drama', 'Thriller', 'Alien Film', 'Science Fiction']",2000,1
22829387,The Twins,2005,['South Korea'],"['Crime Fiction', 'Comedy', 'Comedy film', 'Drama']",2000,5
4368446,Ezhavathu Manithan,1982,['India'],"['Drama', 'Tamil cinema']",1980,2
15297491,A Dangerous Profession,1949,['United States of America'],"['Black-and-white', 'Crime Fiction', 'Mystery', 'Thriller', 'Film noir', 'Drama']",1940,9
7499930,The Secret of Santa Vittoria,1969,"['Italy', 'United States of America']","['Film adaptation', 'Comedy', 'Comedy-drama', 'War film', 'Drama']",1960,9
20768131,My Name is Jerry,2009,['United States of America'],"['Indie', 'Comedy', 'Comedy-drama', 'Slice of life story']",2000,9
21347979,Paco and the Magical Book,2008,['Japan'],['Japanese Movies'],2000,8
11553550,American Son,2008,['United States of America'],"['Drama', 'Indie', 'Romance Film', 'War film', 'Slice of life story']",2000,8
15769706,Ontari,2008,['India'],"['Action', 'Romance Film']",2000,8
13504616,Johnny Gaddaar,2007,['India'],"['Musical', 'Comedy', 'Thriller', 'Bollywood', 'World cinema', 'Crime Thriller']",2000,7
14144391,Blazing the Overland Trail,1956,['United States of America'],"['Adventure', 'Black-and-white']",1950,6
10892479,Noorie,1979,['India'],"['Musical', 'Romantic drama', 'Bollywood', 'World cinema', 'Romance Film', 'Drama']",1970,9
29728646,Disaster Zone: Volcano in New York,2006,[],"['Action', 'Action/Adventure', 'Science Fiction', 'Thriller', 'Disaster']",2000,6
14718618,She's Oil Mine,1941,['United States of America'],"['Black-and-white', 'Short Film', 'Comedy film']",1940,1
8435438,Future War,1997,['United States of America'],"['Indie', 'Action/Adventure', 'Martial Arts Film', 'Science Fiction']",1990,7
32172821,To Bina Mo Kahani Addha,2007,['India'],['Drama'],2000,7
17867578,Sarvam,2009,['India'],"['Romantic comedy', 'Thriller']",2000,9
9323265,You Ruined My Life,1987,['United States of America'],"[""Children's/Family"", 'Comedy', 'Family Film']",1980,7
12594839,Primal,2009,['United States of America'],"['Creature Film', 'Monster movie', 'Action', 'Action/Adventure', 'Thriller', 'Horror', 'Adventure']",2000,9
2066226,Paradise,1982,['Canada'],"['Coming of age', 'Indie', 'Teen', 'Romance Film', 'Erotica', 'Adventure', 'Drama']",1980,2
22558992,"Christmas Miracle in Caufield, U.S.A.",1977,['United States of America'],['Drama'],1970,7
2187291,The Man With the Screaming Brain,2005,"['Germany', 'United States of America']","['Drama', 'Indie', 'Comedy', 'Horror', 'Science Fiction', 'Cult']",2000,5
21734367,A Little Piece of Heaven,1991,['United States of America'],"['Drama', 'Television movie']",1990,1
9559652,Savi Savi Nenapu,2007,['India'],"['Romance Film', 'Drama']",2000,7
2294801,Hells Angels on Wheels,1967,['United States of America'],"['Drama', 'Outlaw biker film', 'Thriller']",1960,7
4125255,ChaalBaaz,1989,['India'],"['Bollywood', 'World cinema']",1980,9
9234454,The Best Day of My Life,2002,"['United Kingdom', 'Italy']","['LGBT', 'Drama']",2000,2
436955,Benny & Joon,1993,['United States of America'],"['Comedy', 'Romance Film', 'Romantic comedy', 'Drama']",1990,3
16225933,Jassy,1947,['United Kingdom'],"['Crime Drama', 'Melodrama', 'Drama']",1940,7
1128561,Crossroads,2002,['United States of America'],"['Musical', 'Romantic drama', 'Comedy', 'Teen', 'Romance Film', 'Adventure', 'Drama', 'Coming of age', 'Romantic comedy', 'Comedy-drama']",2000,2
17776794,Brooklyn's Finest,2009,['United States of America'],"['Action', 'Crime Fiction', 'Thriller', 'Crime Drama', 'Crime Thriller', 'Drama']",2000,9
1934924,Where the Sidewalk Ends,1950,['United States of America'],"['Black-and-white', 'Crime Fiction', 'Thriller', 'Crime Drama', 'Film noir', 'Crime Thriller', 'Drama']",1950,0
13731934,Buffalo Bill,1944,['United States of America'],"['Biography', 'Action/Adventure', 'Western', 'Biographical film', 'Biopic [feature]']",1940,4
15272676,Sex Is Zero 2,2007,['South Korea'],"['Comedy', 'Sex comedy']",2000,7
5036653,Soccer Dog: The Movie,1999,['United States of America'],"['Sports', 'Comedy', 'Animal Picture', ""Children's/Family"", ""Children's"", 'Drama', 'Family Film']",1990,9
21984862,In Praise of Older Women,1978,['Canada'],"['Period piece', 'Coming of age', 'Romantic drama', 'Romance Film', 'Drama']",1970,8
23397826,Jail,2009,['India'],"['Musical', 'Prison', 'Bollywood', 'World cinema', 'Drama']",2000,9
468356,Pieces of April,2003,['United States of America'],"['Drama', 'Indie', 'Comedy', 'Domestic Comedy', 'Comedy-drama', 'Holiday Film']",2000,3
923265,The Motorcycle Diaries,2004,"['France', 'Peru', 'Brazil', 'Chile', 'Argentina', 'United Kingdom', 'Germany', 'United States of America']","['Indie', 'Biographical film', 'World cinema', 'Adventure', 'Drama', 'Coming of age', 'Biopic [feature]', 'Road movie']",2000,4
20855443,The Great Commandment,1939,['United States of America'],['Drama'],1930,9
19284991,Snow,2008,"['Iran', 'France', 'Germany', 'Bosnia and Herzegovina']",['Drama'],2000,8
4390986,Charlotte Sometimes,2002,['United States of America'],"['Romantic drama', 'Indie', 'Romance Film', 'Drama']",2000,2
8476961,Antonieta,1982,"['France', 'Spain', 'Mexico']","['Period piece', 'Art film', 'World cinema', 'Drama']",1980,2
5081636,The Last War,1961,['Japan'],['Japanese Movies'],1960,1
3294536,Ying wang,1971,['Hong Kong'],"['Action/Adventure', 'World cinema', 'Wuxia', 'Chinese Movies', 'Martial Arts Film']",1970,1
28759147,Cold Lunch,2008,['Norway'],['Drama'],2000,8
14454173,Cookoo Cavaliers,1940,['United States of America'],"['Short Film', 'Black-and-white', 'Comedy']",1940,0
1839695,Darkman,1990,['United States of America'],"['Action', 'Crime Fiction', 'Superhero', 'Action/Adventure', 'Thriller', 'Horror', 'Superhero movie', 'Science Fiction']",1990,0
3254543,Cardiac Arrest,1980,['United States of America'],"['Crime Fiction', 'Mystery', 'Thriller', 'Horror', 'Crime Thriller']",1980,0
365212,The Belly of an Architect,1987,"['United Kingdom', 'Italy', 'Netherlands']","['Indie', 'Avant-garde', 'Experimental film', 'Comedy-drama', 'Drama']",1980,7
24319174,Douthyam,1989,['India'],"['Action', 'Adventure', 'Thriller']",1980,9
18332500,Adiós gringo,1965,['Italy'],"['Western', 'Spaghetti Western']",1960,5
25895392,Hearts and Flowers for Tora-san,1982,['Japan'],['Japanese Movies'],1980,2
26694867,Yeh Vaada Raha,1982,['India'],"['Musical', 'Romantic drama', 'Bollywood', 'World cinema', 'Romance Film', 'Drama']",1980,2
25533870,Call Me: The Rise and Fall of Heidi Fleiss,2004,['Canada'],"['Biography', 'Biopic [feature]', 'Television movie', 'Drama']",2000,4
1615727,Hiroshima Mon Amour,1959,"['France', 'Japan']","['Art film', 'Japanese Movies', 'Romantic drama', 'World cinema', 'Romance Film', 'Drama']",1950,9
24998748,Face,2000,['Japan'],"['Japanese Movies', 'Comedy', 'Drama']",2000,0
29836913,Rent-a-Kid,1995,[],"['Family Film', 'Drama', 'Comedy film']",1990,5
6793410,Larry-Boy and the Rumor Weed,1999,['United States of America'],"['Musical', 'Animation', 'Short Film', ""Children's""]",1990,9
2638660,Monkeybone,2001,['United States of America'],"['Animation', 'Superhero', 'Heavenly Comedy', 'Action/Adventure', 'Comedy', 'Stop motion', 'Fantasy Comedy', 'Fantasy']",2000,1
24158848,Hollywood Vice Squad,1986,"['United States of America', 'Australia']","['Action', 'Crime Fiction', 'Parody', 'Action/Adventure', 'Comedy']",1980,6
32250995,When the Bough Breaks,1994,['United States of America'],"['Mystery', 'Thriller', 'Crime Thriller', 'Supernatural']",1990,4
26232501,Rain: The Terror Within...,2006,['India'],"['Thriller', 'World cinema']",2000,6
27110908,The Night Holds Terror,1955,['United States of America'],"['Film noir', 'Crime Fiction', 'Drama']",1950,5
7223822,Alien Contamination,1980,"['West Germany', 'Italy']","['Creature Film', 'Horror', 'World cinema', 'Alien Film', 'Science Fiction']",1980,0
10860957,Just Before Dawn,1981,['United States of America'],"['Slasher', 'Thriller', 'Horror', 'Road-Horror']",1980,1
21099785,Two a Penny,1970,['United Kingdom'],"['Romance Film', 'Drama']",1970,0
598346,Capturing the Friedmans,2003,['United States of America'],"['Interpersonal Relationships', 'Crime Fiction', 'Family & Personal Relationships', 'Mystery', 'Biography', 'Documentary', 'Culture & Society', 'Law & Crime']",2000,3
27997087,Murder at Glen Athol,1936,['United States of America'],"['Suspense', 'Mystery', 'Thriller', 'Crime Thriller']",1930,6
6042486,Sci-fighters,1996,['Canada'],"['Action', 'Action Thrillers', 'Action/Adventure', 'Science Fiction', 'Thriller']",1990,6
11401015,Private Parts,1972,['United States of America'],"['Black comedy', 'Comedy', 'Horror']",1970,2
2717390,Anjaam,1994,['India'],"['Drama', 'Thriller', 'Bollywood']",1990,4
4453691,Blood Diamond,2006,"['Germany', 'United States of America']","['Action', 'Crime Fiction', 'Private military company', 'Action/Adventure', 'Thriller', 'War film', 'Adventure', 'Drama', 'Tragedy', 'Political drama']",2000,6
2711768,One False Move,1991,['United States of America'],"['Suspense', 'Neo-noir', 'Indie', 'Thriller', 'Crime Thriller']",1990,1
30329313,Belinda,1988,[],['Drama'],1980,8
6415319,Cargo,2006,"['Sweden', 'United Kingdom', 'Spain']","['Psychological thriller', 'Indie', 'Thriller', 'Crime Thriller']",2000,6
32252,Unbreakable,2000,['United States of America'],"['Psychological thriller', 'Superhero', 'Action/Adventure', 'Thriller', 'Suspense', 'Superhero movie', 'Supernatural', 'Science Fiction']",2000,0
320496,Bad Santa,2003,"['Germany', 'United States of America']","['Crime Fiction', 'Christmas movie', 'Comedy', 'Crime Comedy', 'Black comedy', 'Holiday Film', 'Cult']",2000,3
26003683,Ee Puzhayum Kadannu,1996,['India'],['Romance Film'],1990,6
30714883,Nazrana,1987,['India'],"['Musical', 'Thriller', 'Bollywood', 'World cinema', 'Drama']",1980,7
1045986,Cop Land,1997,['United States of America'],"['Crime Fiction', 'Thriller', 'Crime Thriller', 'Drama']",1990,7
18413490,Woman Basketball Player No. 5,1957,['China'],"['Chinese Movies', 'Drama']",1950,7
26304712,Ma and Pa Kettle on Vacation,1953,['United States of America'],['Comedy film'],1950,3
11063492,Saving Shiloh,2006,['United States of America'],"['Coming of age', 'Family Drama', 'Childhood Drama', ""Children's/Family"", 'Drama', 'Family Film']",2000,6
28978870,Nightdreams,1981,[],"['Fantasy', 'Adult', 'Pornographic movie']",1980,1
2324069,Me Without You,2001,"['United Kingdom', 'Germany', 'England', 'United States of America']","['Period piece', 'Coming of age', 'Indie', 'Comedy', 'Drama']",2000,1
1160412,Rambo III,1988,['United States of America'],"['Action', 'Action Thrillers', 'Action/Adventure', 'Thriller', 'War film']",1980,8
7037167,Algol,1920,['Germany'],"['Black-and-white', 'Silent film', 'Science Fiction', 'Fantasy']",1920,0
30764244,Droid,1988,[],"['Science Fiction', 'Adult']",1980,8
16686844,The Slender Thread,1965,['United States of America'],"['Docudrama', 'Drama']",1960,5
3260200,Bugs Bunny's Christmas Carol,1979,['United States of America'],"['Animation', 'Short Film', 'Comedy']",1970,9
26503648,Fifty-Fifty,1925,['United States of America'],['Silent film'],1920,5
15684115,The Brute Man,1946,['United States of America'],"['Psychological thriller', 'Thriller', 'Horror', 'Crime Thriller']",1940,6
10610533,"PS, I Love You",2007,['United States of America'],"['Romantic drama', 'Comedy', 'Romance Film', 'Drama']",2000,7
11142433,Kanyakumari,1974,['India'],['Romance Film'],1970,4
31372259,Caillou's Holiday Movie,2003,[],"['Family Film', 'Animation']",2000,3
2936959,Skyscraper,1997,['United States of America'],"['Action', 'Adventure', 'Thriller']",1990,7
3594243,Kazhcha,2004,['India'],['Drama'],2000,4
35151292,Nirop,2007,[],[],2000,7
26315867,I Can Make You Love Me,1993,['United States of America'],"['Suspense', 'Thriller', 'Melodrama', 'Crime Thriller', 'Drama']",1990,3
24999963,A Story That Begins at the End,2003,['India'],['Drama'],2000,3
23847707,Pension Mimosas,1935,['France'],['Drama'],1930,5
3230447,"Lucy Must Be Traded, Charlie Brown",2003,['United States of America'],"['Family Film', 'Animation']",2000,3
31149350,Aakhri Baazi,1989,[],"['Action', 'Drama', 'Family Film']",1980,9
31509437,Checkered Flag or Crash,1977,[],"['Adventure', 'Comedy film']",1970,7
8945459,Familiar Strangers,2008,['United States of America'],"['Indie', 'Comedy']",2000,8
3543802,Fever Lake,1996,['United States of America'],"['Slasher', 'Teen', 'Horror', 'B-movie']",1990,6
13247285,Prehistoric Women,1967,['United Kingdom'],"['Action', 'Action/Adventure', 'Adventure', 'Fantasy']",1960,7
9299602,Lune de miel,1985,"['Canada', 'France']",['Thriller'],1980,5
18612867,Doraemon: Nobita's Little Star Wars,1985,['Japan'],['Japanese Movies'],1980,5
30844032,Mattoral,1988,[],"['Drama', 'Family Film']",1980,8
17807144,Cannes Man,2002,['France'],"['Drama', 'Indie', 'Parody', 'Comedy']",2000,2
7578779,Secret Things,2002,['France'],"['LGBT', 'Erotic Drama', 'Romantic drama', 'Comedy', 'World cinema', 'Romance Film', 'Drama', 'Fantasy']",2000,2
10233273,Rockets Galore!,1957,['United Kingdom'],"['Romance Film', 'Comedy']",1950,7
22196591,Balettan,2003,['India'],"['Drama', 'Comedy film']",2000,3
11350779,Sherlock Holmes and the Voice of Terror,1942,['United States of America'],"['Detective fiction', 'Black-and-white', 'Crime Fiction', 'Mystery', 'Thriller', 'Crime Thriller', 'Drama', 'Detective']",1940,2
188902,Gangs of New York,2002,"['Italy', 'United States of America']","['Crime Fiction', 'Gangster Film', 'Historical drama', 'Costume drama', 'Drama', 'Period piece', 'Historical fiction', 'Epic', 'Political drama']",2000,2
10950125,The Lonesome Mouse,1943,[],"['Animation', 'Short Film', 'Comedy', 'Family Film']",1940,3
5826081,Mivtsa Yonatan,1977,['Israel'],"['Action', 'Action/Adventure', 'Thriller', 'World cinema', 'War film', 'Drama']",1970,7
5885832,Luster,2002,['United States of America'],"['LGBT', 'Comedy', 'Romance Film', 'Drama', 'Gay Themed', 'Gay', 'Gay Interest', 'Romantic comedy', 'Comedy-drama']",2000,2
25724461,Stand Against Fear,1996,['United States of America'],['Drama'],1990,6
9143529,Ada,1961,['United States of America'],['Drama'],1960,1
2082558,Danny Deckchair,2003,"['New Zealand', 'Australia']","['Indie', 'Comedy', 'World cinema', 'Romance Film', 'Romantic comedy', 'Fantasy Comedy']",2000,3
28218079,"Learn How to Read and Write, Son",1981,['Greece'],"['Drama', 'Comedy']",1980,1
19872971,Cherry Blossoms,2008,"['France', 'Germany']","['Romantic drama', 'World cinema', 'Romance Film', 'Drama']",2000,8
2107054,The Sheik,1921,['United States of America'],"['Black-and-white', 'Costume Adventure', 'Indie', 'Romantic drama', 'Romance Film', 'Drama', 'Pre-Code', 'Silent film']",1920,1
8429675,Captain America,1944,['United States of America'],"['Superhero movie', 'Black-and-white']",1940,4
18218711,Rock Prophecies,2009,['United States of America'],"['Music', 'Rockumentary', 'Biography', 'Documentary', 'Graphic & Applied Arts']",2000,9
24658248,The Savage is Loose,1974,"['Mexico', 'United States of America']","['Family Drama', 'Adventure', 'Drama']",1970,4
1129847,Daredevil,2003,['United States of America'],"['Action', 'Crime Fiction', 'Thriller', 'Superhero movie', 'Fantasy']",2000,3
10286685,Jim Thorpe -- All-American,1951,['United States of America'],"['Black-and-white', 'Biographical film', 'Sports', 'Drama']",1950,1
10915521,Sword Stained with Royal Blood,1981,['Hong Kong'],"['Wuxia', 'Chinese Movies', 'Martial Arts Film']",1980,1
3842730,The Untouchables,1987,['United States of America'],"['Action', 'Crime Fiction', 'Gangster Film', 'Biography', 'Action/Adventure', 'Thriller', 'Crime Thriller', 'Drama', 'Period piece']",1980,7
88678,The Lion King,1994,['United States of America'],"['Music', 'Musical', 'Animation', 'Animated Musical', 'Comedy', ""Children's/Family"", ""Children's"", 'Adventure', 'Drama', ""Children's Fantasy"", 'Coming of age', 'Family Film', 'Fantasy']",1990,4
99022,"Rachel, Rachel",1968,['United States of America'],"['Romance Film', 'Drama', 'Feminist Film']",1960,8
8862866,Dracula II Ascension,2003,"['Romania', 'United States of America']",['Horror'],2000,3
13233891,Shred 2,2009,['Canada'],"['Sports', 'Comedy']",2000,9
7535009,Betty Boop's Life Guard,1934,['United States of America'],"['Animation', 'Short Film', 'Comedy', 'Family Film']",1930,4
5343273,Dogora,1964,['Japan'],"['Creature Film', 'Japanese Movies', 'Science Fiction', 'World cinema']",1960,4
12084993,Dog Bite Dog,2006,['Hong Kong'],"['Action/Adventure', 'Thriller', 'World cinema', 'Crime Thriller', 'Chinese Movies', 'Martial Arts Film', 'Drama']",2000,6
11562799,Like Grains of Sand,1995,['Japan'],"['LGBT', 'Japanese Movies', 'Romance Film', 'Drama']",1990,5
32182348,Baadal,1985,[],['Family Drama'],1980,5
3048488,The Honeymoon Killers,1970,['United States of America'],"['Crime Fiction', 'Biography', 'Thriller', 'Crime Thriller', 'Docudrama', 'Drama', 'Period piece', 'Crime Drama']",1970,0
217793,The Happy Ending,1969,['United States of America'],['Drama'],1960,9
10473207,Psychomania,1971,"['United Kingdom', 'United States of America']","['Biker Film', 'Horror', 'Zombie Film', 'Cult']",1970,1
25987938,Ekalavyan,1993,['India'],"['Action', 'Crime Fiction', 'Thriller']",1990,3
21225053,Cloudy With A Chance of Meatballs,2009,['United States of America'],"['Animation', 'Comedy', 'Disaster', ""Children's"", 'Adventure', 'Computer Animation', 'Family Film', 'Fantasy']",2000,9
1539714,Pink Floyd The Wall,1982,['United Kingdom'],"['Musical', 'Animation', 'Live action', 'Drama']",1980,2
5788437,The Name of the Rose,1986,"['France', 'Germany', 'West Germany', 'Italy']","['Film adaptation', 'Detective fiction', 'Crime Fiction', 'Mystery', 'Gothic Film', 'Thriller', 'World cinema', 'Whodunit', 'Crime Thriller', 'Costume drama', 'Drama', 'Period piece', 'Detective']",1980,6
22932514,The War of the Worlds: Next Century,1983,['Poland'],['Science Fiction'],1980,3
28681362,Uninvited,2000,"['Italy', 'United States of America']","['Thriller', 'Drama']",2000,0
10292462,The Desert Song,1929,['United States of America'],"['Musical', 'Black-and-white', 'Operetta', 'Roadshow theatrical release', 'Pre-Code']",1920,9
573469,Formula 17,2004,"['China', 'Taiwan']","['LGBT', 'Comedy', 'World cinema', 'Romance Film', 'Chinese Movies', 'Gay Themed', 'Gay', 'Gay Interest', 'Romantic comedy']",2000,4
25232018,They Came From Beyond Space,1967,['United Kingdom'],"['Alien Film', 'Science Fiction']",1960,7
16676697,Arctic Blue,1993,"['Canada', 'United States of America']","['Action', 'Action Thrillers', 'Action/Adventure', 'Thriller']",1990,3
3092405,Merry Christmas,2005,"['Belgium', 'United Kingdom', 'France', 'Germany', 'Romania']","['World cinema', 'War film', 'Christmas movie', 'Drama']",2000,5
11664753,The Nameless,1999,['Spain'],"['Psychological thriller', 'Detective fiction', 'Thriller', 'World cinema', 'Crime Thriller', 'Detective', 'Horror', 'Supernatural']",1990,9
6004827,Dragonlance: Dragons of Autumn Twilight,2008,['United States of America'],"['Animation', 'Sword and sorcery', 'Adventure', 'Fantasy', 'Science Fiction', 'Sword and sorcery films']",2000,8
3956816,The Flim-Flam Man,1967,['United States of America'],"['Drama', 'Comedy']",1960,7
10004055,Entertaining Mr Sloane,1970,"['Austria', 'United Kingdom']","['Film adaptation', 'LGBT', 'Parody', 'Comedy', 'Black comedy', 'Drama']",1970,0
6707631,Dead Man Walking,1995,"['United Kingdom', 'United States of America']","['Drama', 'Crime Fiction']",1990,5
10726486,Junoon,1978,['India'],"['Art film', 'Romantic drama', 'Bollywood', 'World cinema', 'Romance Film', 'Drama']",1970,8
594257,Walkabout,1971,['United Kingdom'],"['Coming of age', 'Action/Adventure', 'Adventure', 'Drama']",1970,1
15897180,Thodakkam,2008,['India'],['Drama'],2000,8
10705531,On the Beach,2000,"['United States of America', 'Australia']","['Action', 'Drama', 'Action/Adventure', 'Thriller', 'Television movie', 'Disaster', 'Science Fiction']",2000,0
14144320,Perils of the Wilderness,1956,['United States of America'],"['Adventure', 'Black-and-white']",1950,6
10605328,Challenge of the Masters,1976,['Hong Kong'],"['Action', 'Action/Adventure', 'World cinema', 'Chinese Movies', 'Martial Arts Film']",1970,6
4415256,Party Girl,1958,['United States of America'],['Film noir'],1950,8
180912,Theodora Goes Wild,1936,['United States of America'],"['Black-and-white', 'Screwball comedy', 'Comedy', 'Romantic comedy']",1930,6
240372,Gloria,1980,['United States of America'],"['Suspense', 'Crime Fiction', 'Gangster Film', 'Thriller', 'Crime Thriller', 'Drama']",1980,0
12224218,Hotel California,2008,['United States of America'],"['Action', 'Crime Fiction', 'Gangster Film', 'Indie', 'Action/Adventure', 'Thriller', 'Crime Thriller']",2000,8
4073694,The Bitch,1979,['United Kingdom'],"['Film adaptation', 'Romantic drama', 'Comedy', 'Romance Film', 'Erotica', 'Drama']",1970,9
1906459,The Hunchback of Notre Dame,1923,['United States of America'],"['Film adaptation', 'Black-and-white', 'Silent film', 'Costume drama', 'Drama']",1920,3
7072005,Ungu Violet,2005,['Indonesia'],['Drama'],2000,5
3642891,Road Rage,1999,['United States of America'],"['Psychological thriller', 'Thriller', 'Television movie', 'Drama']",1990,9
77609,Sergeant York,1941,['United States of America'],"['Action', 'Black-and-white', 'Biography', 'Action/Adventure', 'Biographical film', 'Costume drama', 'Drama', 'Biopic [feature]', 'War film']",1940,1
6810072,Rehna Hai Tere Dil Mein,2001,['India'],"['Drama', 'World cinema']",2000,1
67371,Clue,1985,['United States of America'],"['Crime Fiction', 'Mystery', 'Comedy', 'Thriller', 'Black comedy', 'Crime Thriller', 'Parody', 'Cult']",1980,5
19944246,Durai,2008,['India'],['Action'],2000,8
31230287,Adam and Evil,2004,['United States of America'],"['Slasher', 'Teen', 'Horror', 'B-movie']",2000,4
5979134,Tea for Two,1950,['United States of America'],"['Musical', 'Backstage Musical', 'Comedy', 'Comedy of manners', 'Romance Film', 'Romantic comedy', 'Drama']",1950,0
2678092,I Married a Monster from Outer Space,1958,['United States of America'],"['Thriller', 'Alien Film', 'Science Fiction']",1950,8
14924899,Ninette,2005,['Spain'],['Romantic comedy'],2000,5
13922038,The Other Side,2006,['United States of America'],"['Action', 'Thriller', 'Horror', 'B-movie']",2000,6
4379692,Children Shouldn't Play with Dead Things,1972,['United States of America'],"['Horror Comedy', 'Thriller', 'Zombie Film', 'Drama', 'Horror', 'B-movie', 'Supernatural', 'Cult']",1970,2
2506344,Aandhi,1975,['India'],"['Musical', 'Bollywood', 'World cinema', 'Political drama', 'Drama']",1970,5
24041290,Crash: The Mystery of Flight 1501,1990,['United States of America'],"['Mystery', 'Thriller', 'Television movie', 'Docudrama', 'Drama']",1990,0
1205454,The Broken Hearts Club: A Romantic Comedy,2000,['United States of America'],"['LGBT', 'Indie', 'Comedy', 'Romance Film', 'Drama', 'Gay Themed', 'Gay', 'Gay Interest', 'Romantic comedy', 'Comedy-drama', 'Ensemble Film']",2000,0
3830281,Mais où est donc passée la septième compagnie?,1973,"['France', 'Italy']","['Action', 'War film', 'Comedy']",1970,3
2961722,Dolly Dearest,1992,['United States of America'],"['Slasher', 'Horror']",1990,2
5095233,John Tucker Must Die,2006,"['Canada', 'United States of America']","['Comedy', 'Teen', 'Romance Film', 'Romantic comedy']",2000,6
4228138,Evil Aliens,2005,['United Kingdom'],"['Parody', 'Horror Comedy', 'Comedy', 'Horror', 'Slapstick', 'Science Fiction']",2000,5
8249745,Rowdy Alludu,1991,['India'],"['Musical', 'Thriller', 'Bollywood', 'World cinema']",1990,1
17139780,Don't Look Down,1998,['United States of America'],"['Psychological thriller', 'Thriller', 'Television movie', 'Supernatural']",1990,8
10849113,Punk attitude,2005,"['United Kingdom', 'United States of America']","['Music', 'Rockumentary', 'Documentary', 'Punk rock']",2000,5
25354309,Direct Hit,1994,['United States of America'],"['Action', 'Action Thrillers', 'Action/Adventure', 'Thriller']",1990,4
6179790,Veede,2003,['India'],"['Musical', 'Bollywood', 'World cinema', 'Drama']",2000,3
34364391,100 Tears,2007,['United States of America'],"['Slasher', 'B-movie', 'Horror']",2000,7
18926216,The Masked Bride,1925,['United States of America'],['Silent film'],1920,5
17387556,Det Sande Ansigt,1951,['Denmark'],['Crime Fiction'],1950,1
1902589,The Star Maker,1995,['Italy'],"['Comedy', 'World cinema', 'Romance Film', 'Drama']",1990,5
30635340,Kahani Kismat Ki,1999,[],['Action'],1990,9
24528819,Babang Luksa,2009,['Philippines'],['Filipino Movies'],2000,9
2249957,Twisted Nerve,1969,['United Kingdom'],"['Thriller', 'Drama']",1960,9
7145079,Rhythm on the Reservation,1939,['United States of America'],"['Musical', 'Animation', 'Short Film', 'Comedy']",1930,9
2886917,"I, Zombie",1999,['United Kingdom'],"['Creature Film', 'Horror', 'Zombie Film', 'Drama']",1990,9
10466979,Sadma,1983,['India'],"['Drama', 'Bollywood', 'World cinema']",1980,3
15518145,Frozen Stupid,2006,['United States of America'],"['Buddy film', 'Comedy']",2000,6
564986,The Princess Diaries,2003,['United States of America'],"['Comedy', 'Teen', 'Comedy of manners', 'Romance Film', 'Comedy-drama', 'Drama', 'Family Film']",2000,3
6838440,Homeland Security,2004,['United States of America'],"['Television movie', 'Political drama', 'Drama', 'Political thriller']",2000,4
3937957,The People That Time Forgot,1977,['United Kingdom'],"['Film adaptation', 'Adventure', 'Science Fiction', 'Fantasy']",1970,7
13875263,Adulthood,2008,['United Kingdom'],"['Crime Drama', 'Drama']",2000,8
11140865,Apoorva Sagodharargal,1989,['India'],['World cinema'],1980,9
9170067,Rawhide,1951,['United States of America'],"['Romance Film', 'Western', 'Drama']",1950,1
28352353,My Friend the King,1932,['United Kingdom'],['Comedy'],1930,2
3109686,It Happened Tomorrow,1944,['United States of America'],"['Romantic fantasy', 'Black-and-white', 'Comedy', 'Romance Film', 'Fantasy Comedy', 'Fantasy']",1940,4
28247074,Mickey's Rescue,1934,['United States of America'],['Short Film'],1930,4
565758,The Yards,2000,['United States of America'],"['Crime Fiction', 'Gangster Film', 'Family Drama', 'Thriller', 'Crime Thriller', 'Drama', 'Suspense', 'Crime Drama']",2000,0
9481844,Thunder on the Hill,1951,['United States of America'],"['Black-and-white', 'Mystery', 'Thriller', 'Melodrama', 'Drama']",1950,1
9514199,Demon Island,2002,['United States of America'],"['Teen', 'Horror']",2000,2
24592259,Anmol Ghadi,1946,['India'],"['Musical', 'Romance Film', 'Drama']",1940,6
406168,My Life on Ice,2002,['France'],"['LGBT', 'Coming of age', 'Teen', 'World cinema', 'Drama']",2000,2
26191454,In Fast Company,1946,['United States of America'],"['Action', 'Crime Fiction', 'Comedy', 'Adventure']",1940,6
23069508,Mother and Child,2009,"['Spain', 'United States of America']","['Romance Film', 'Romantic drama', 'Drama']",2000,9
8733905,"Hook, Line and Sinker",1930,['United States of America'],"['Romance Film', 'Comedy']",1930,0
32312042,Five Weeks in a Balloon,1962,['United States of America'],"['Adventure Comedy', 'Action', 'Comedy', 'Historical fiction', 'Family Film', 'Adventure', 'Drama']",1960,2
10852326,Iron Monkey,1977,"['China', 'Hong Kong']","['Chinese Movies', 'Martial Arts Film', 'World cinema']",1970,7
7597365,Sabrina the Teenage Witch,1996,['United States of America'],"['Comedy', 'Teen', 'Television movie', 'Fantasy Comedy', 'Family Film', 'Fantasy']",1990,6
13490092,Now That I Have You,2004,['Philippines'],"['Filipino Movies', 'Romantic drama', 'Comedy', 'World cinema', 'Romance Film', 'Drama']",2000,4
2156850,Khuda Ke Liye,2007,"['India', 'Pakistan', 'United States of America']","['Musical', 'Crime Fiction', 'Comedy', 'Thriller', 'Bollywood', 'World cinema', 'Drama', 'War film']",2000,7
12478569,Nazar,2006,"['India', 'Pakistan']","['Thriller', 'World cinema', 'Crime Thriller', 'Supernatural']",2000,6
14568591,Torrid Zone,1940,['United States of America'],"['Adventure Comedy', 'Black-and-white', 'Comedy', 'Romance Film', 'Romantic comedy', 'Adventure']",1940,0
4380389,The Young Americans,1993,"['United Kingdom', 'United States of America']","['Crime Fiction', 'Indie', 'Drama']",1990,3
15570371,Kasthoorimann,2003,['India'],"['Romance Film', 'Drama']",2000,3
17465733,Freelance,1971,"['Canada', 'United Kingdom']",['Thriller'],1970,1
9703081,The Brain Eaters,1958,['United States of America'],"['Science Fiction', 'Sci-Fi Horror', 'Horror']",1950,8
9459007,The Fighting Kentuckian,1949,['United States of America'],"['Action', 'Action/Adventure', 'Western', 'War film', 'Costume drama']",1940,9
8475191,Boogeyman 2,2008,['United States of America'],"['Supernatural', 'Horror']",2000,8
13333148,Rage in Heaven,1941,['United States of America'],"['Psychological thriller', 'Black-and-white', 'Marriage Drama', 'Film noir', 'Drama']",1940,1
965992,Big Top Pee-wee,1988,['United States of America'],"['Slapstick', 'Comedy', 'Adventure', 'Cult', 'Family Film']",1980,8
9606627,Sangamam,1999,['India'],['Romance Film'],1990,9
14620685,Karzzzz,2008,['India'],"['Action', 'Musical', 'Drama', 'Thriller', 'Romance Film']",2000,8
28932169,Looking for Danger,1957,['United States of America'],['Comedy'],1950,7
715207,Sleepaway Camp,1983,['United States of America'],"['Indie', 'Slasher', 'Teen', 'Horror', 'B-movie', 'Cult']",1980,3
19234163,Private Potter,1962,['United Kingdom'],"['War film', 'Drama']",1960,2
15216510,The Age of Success,1988,['South Korea'],['Melodrama'],1980,8
2933021,Che!,1969,['United States of America'],"['Drama', 'Biographical film', 'Biopic [feature]']",1960,9
4911472,The Shaolin Drunken Monk,1982,['Hong Kong'],"['Action', 'Chinese Movies', 'Martial Arts Film']",1980,2
8711666,The Wiz,1978,['United States of America'],"['Musical', 'Fantasy Adventure', 'Adventure', 'Family Film', 'Fantasy']",1970,8
8303428,Nanking,2007,['United States of America'],"['History', 'Biography', 'Documentary', 'War film', 'Political drama']",2000,7
2531044,Ode to Billy Joe,1976,['United States of America'],"['Period piece', 'LGBT', 'Drama', 'Coming of age', 'Indie', 'Romantic drama', 'Romance Film']",1970,6
11104130,"A Genius, Two Partners and a Dupe",1975,['Italy'],"['Action', 'Western', 'Comedy', 'Spaghetti Western', 'Adventure']",1970,5
24786448,Upswept Hare,1953,[],"['Animation', 'Short Film', 'Family Film']",1950,3
1399075,Alexandra's Project,2003,['Australia'],"['Psychological thriller', 'Suspense', 'Drama', 'Indie', 'Thriller', 'World cinema']",2000,3
25496559,The Fallen Sparrow,1943,['United States of America'],"['Spy', 'Film noir', 'War film']",1940,3
26772154,The Early Bird Dood It!,1942,['United States of America'],"['Animation', 'Short Film', 'Comedy', 'Family Film']",1940,2
2280078,Leroy & Stitch,2006,['United States of America'],"[""Children's Fantasy"", 'Animation', ""Children's/Family"", ""Children's"", 'Family Film']",2000,6
24260284,The Hotel Venus,2004,['Japan'],['Japanese Movies'],2000,4
23300204,I Am Really Sorry,1976,['South Korea'],['Drama'],1970,6
465470,The Prince of Egypt,1998,['United States of America'],"['Musical', 'Animation', 'Animated Musical', 'Christian film', ""Children's/Family"", 'Costume drama', 'Adventure', 'Drama', 'Epic', 'Family Film', 'Fantasy']",1990,8
89445,Practical Magic,1998,"['United States of America', 'Australia']","['Comedy', 'Romance Film', 'Romantic comedy', 'Drama', 'Fantasy']",1990,8
28398650,The Masked Gang,2005,['Turkey'],"['Comedy film', 'Crime Fiction']",2000,5
1732642,Night Watch,2004,['Russia'],"['Action', 'Action/Adventure', 'Thriller', 'Horror', 'World cinema', 'Fantasy']",2000,4
8770199,Danny,2002,['India'],"['Comedy-drama', 'Comedy', 'Drama']",2000,2
2163735,Big Business,1929,['United States of America'],"['Black-and-white', 'Short Film', 'Comedy', 'Silent film']",1920,9
3949045,Rocco and His Brothers,1960,"['France', 'Italy']","['Black-and-white', 'Art film', 'Family Drama', 'Thriller', 'World cinema', 'Drama', 'Melodrama', 'Sports']",1960,0
3472852,The Incredible Crash Dummies,1993,"['Canada', 'United States of America']","['Short Film', 'Computer Animation']",1990,3
9575832,Conrack,1974,['United States of America'],"['Drama', 'Docudrama', 'Biopic [feature]']",1970,4
2722209,Paranoiac,1963,['United Kingdom'],"['Drama', 'Thriller', 'Horror']",1960,3
21769648,Flesh and Blood,1922,['United States of America'],['Drama'],1920,2
1001945,My Learned Friend,1943,['United Kingdom'],"['Black-and-white', 'Comedy', 'Crime Comedy', 'Black comedy']",1940,3
312498,Yojimbo,1961,['Japan'],"['Action', 'Black-and-white', 'Costume Adventure', 'Crime Fiction', 'Samurai cinema', 'Art film', 'Action/Adventure', 'Thriller', 'World cinema', 'Adventure', 'Drama', 'Japanese Movies']",1960,1
32808179,A-List,2006,['United States of America'],[],2000,6
2259388,Session 9,2001,['United States of America'],"['Psychological thriller', 'Mystery', 'Psychological horror', 'Horror', 'Haunted House Film']",2000,1
25091604,Crazy Mama,1975,['United States of America'],"['Action', 'Crime Fiction', 'Indie', 'Action/Adventure', 'Comedy', 'Black comedy']",1970,5
23093539,The Man from Hong Kong,1975,['Australia'],"['Action', 'Drama', 'Thriller', 'Martial Arts Film', 'Adventure']",1970,5
4299486,Passed Away,1992,['United States of America'],"['Black comedy', 'Domestic Comedy', 'Comedy']",1990,2
17241398,The Triangle,2001,['United States of America'],"['Suspense', 'Supernatural', 'Thriller']",2000,1
13672363,See No Evil,1971,['United Kingdom'],"['Psychological thriller', 'Crime Fiction', 'Thriller', 'Horror', 'Drama']",1970,1
17379804,And the Spring Comes,2007,['China'],"['Drama', 'Chinese Movies', 'Slice of life story']",2000,7
19092127,The Miracle of Father Malachia,1961,"['Germany', 'West Germany']",['Drama'],1960,1
19127945,You Are Mine Eternally,2008,['India'],['Romance Film'],2000,8
2354228,Soapdish,1991,['United States of America'],"['LGBT', 'Parody', 'Satire', 'Comedy', 'Media Satire', 'Romantic comedy', 'Romance Film']",1990,1
9344774,A Red Bear,2004,"['Argentina', 'Spain', 'France']","['Crime Fiction', 'Family Drama', 'Indie', 'World cinema', 'Drama']",2000,4
5094131,The Indian in the Cupboard,1995,['United States of America'],"['Fantasy Adventure', ""Children's Fantasy"", 'Coming of age', ""Children's/Family"", 'Family Film', 'Fantasy']",1990,5
10953021,Quitting,2001,['China'],"['World cinema', 'Chinese Movies', 'Addiction Drama', 'Drama']",2000,1
16671760,Lisa and the Devil,1973,"['West Germany', 'Italy']","['Psychological thriller', 'Gothic Film', 'Thriller', 'World cinema', 'Horror', 'Supernatural', 'Cult', 'Fantasy']",1970,3
30265765,Sky Dragon,1949,['United States of America'],"['Crime Fiction', 'Mystery', 'Thriller', 'Comedy film', 'Adventure']",1940,9
33681220,Blessings,2003,['United States of America'],['Drama'],2000,3
20367637,Behind Enemy Lines: Colombia,2009,['United States of America'],"['Action', 'War film', 'Thriller']",2000,9
161897,Cool Hand Luke,1967,['United States of America'],"['Prison', 'Film adaptation', 'Drama', 'Crime Fiction', 'Prison film']",1960,7
27970727,The New Deal Show,1937,[],"['Short Film', 'Animation']",1930,7
5451433,Ethirum Pudhirum,1999,['India'],"['Action', 'Tamil cinema']",1990,9
8475523,Frequent Flyer,1996,['United States of America'],['Drama'],1990,6
11589473,I'm Just Wild About Jerry,1965,[],"['Animation', 'Short Film', 'Comedy', 'Family Film']",1960,5
1812238,A Bill of Divorcement,1932,['United States of America'],"['Black-and-white', 'Drama', 'Indie', 'Silent film']",1930,2
4863014,The Five Pennies,1959,['United States of America'],"['Musical', 'Musical Drama', 'Biography', 'Biopic [feature]', 'Drama']",1950,9
5187488,Bataan,1943,['United States of America'],"['Combat Films', 'Action', 'Black-and-white', 'War film']",1940,3
3176730,Thicker than Water,1935,['United States of America'],"['Short Film', 'Black-and-white', 'Comedy']",1930,5
12573816,My Favorite Spy,1951,['United States of America'],"['Action', 'Spy', 'Black-and-white', 'Action/Adventure', 'Comedy']",1950,1
29336355,South of Algiers,1953,['United Kingdom'],['Drama'],1950,3
3936140,Smokin' Aces,2006,"['United Kingdom', 'France', 'United States of America']","['Action', 'Crime Fiction', 'Action Thrillers', 'Gangster Film', 'Action/Adventure', 'Comedy', 'Thriller', 'Black comedy', 'Crime Thriller', 'Drama', 'Ensemble Film']",2000,6
479757,Blade II,2002,"['Germany', 'United States of America']","['Action', 'Action Thrillers', 'Superhero', 'Action/Adventure', 'Thriller', 'Horror', 'Superhero movie', 'Fantasy']",2000,2
36476665,Every 9 Seconds,1997,['United States of America'],['Drama'],1990,7
9336059,Wives Under Suspicion,1938,['United States of America'],"['Marriage Drama', 'Remake', 'Drama', 'Courtroom Drama']",1930,8
18844946,Puppy,2005,['Australia'],"['Psychological thriller', 'Crime Fiction', 'Indie', 'Thriller', 'Drama']",2000,5
33002637,Mafia,1996,['India'],['Action'],1990,6
2780947,Battles Without Honour and Humanity,1973,['Japan'],"['Crime Fiction', 'Japanese Movies', 'Drama']",1970,3
25091794,Saloon Bar,1940,['United Kingdom'],['Thriller'],1940,0
2241614,Barsaat,1995,['India'],"['Musical', 'Romantic drama', 'Bollywood', 'World cinema', 'Romance Film', 'Drama']",1990,5
7414946,The Earth Dies Screaming,1964,['United Kingdom'],"['Horror', 'Science Fiction']",1960,4
9910128,Azaad,1955,['India'],"['Action', 'Comedy', 'Bollywood', 'Adventure']",1950,5
11664293,Bheja fry,2007,['India'],"['Musical', 'Art film', 'Comedy', 'Bollywood', 'World cinema', 'Drama']",2000,7
11893853,Paperback Hero,1999,['Australia'],"['Romance Film', 'Comedy']",1990,9
9088038,Hot Saturday,1932,['United States of America'],"['Black-and-white', 'Comedy', 'Romance Film', 'Romantic comedy', 'Pre-Code', 'Drama']",1930,2
3136443,Reindeer Games,2000,['United States of America'],"['Action', 'Crime Fiction', 'Action/Adventure', 'Thriller', 'Crime Thriller', 'Drama', 'Heist', 'Caper story']",2000,0
31000989,The Little Dragons,1980,['United States of America'],"['Action', 'Comedy film']",1980,0
20682290,Jumbo,2008,['India'],"['Family Film', 'Animation']",2000,8
14304637,Sundara Purushan,1997,['India'],"['Romance Film', 'Comedy']",1990,7
9110863,Fedora,1978,"['France', 'West Germany', 'United States of America']","['Mystery', 'Thriller', 'World cinema', 'Drama']",1970,8
2817640,Star Wreck: In the Pirkinning,2005,['Finland'],"['Parody', 'Science Fiction', 'Adventure']",2000,5
27388121,My Friend Flicka,1943,['United States of America'],"['Coming of age', 'Family Drama', 'Drama', 'Family Film']",1940,3
26000417,No. 1 Snehatheeram Banglore North,1995,['India'],[],1990,5
6070722,Love Birds,1996,['India'],['Romance Film'],1990,6
21459905,Alien Abduction,2005,['United States of America'],"['Indie', 'Horror', 'Sci-Fi Horror', 'Science Fiction']",2000,5
23994191,Undertaking Betty,2005,"['United Kingdom', 'Germany', 'United States of America']","['Workplace Comedy', 'Comedy', 'Black comedy', 'Romantic comedy', 'Romance Film']",2000,5
6542399,Garden of Evil,1954,['United States of America'],['Western'],1950,4
2697545,The Unsuspected,1947,['United States of America'],"['Crime Fiction', 'Mystery', 'Film noir', 'Melodrama', 'Drama']",1940,7
5955514,Fled,1996,['United States of America'],"['Action', 'Crime Fiction', 'Action Thrillers', 'Action/Adventure', 'Buddy film', 'Thriller', 'Comedy', 'Chase Movie']",1990,6
154693,The Hasty Heart,1949,['United Kingdom'],"['War film', 'Drama']",1940,9
13238459,Red Roses and Petrol,2003,['United States of America'],"['Indie', 'Family Drama', 'Drama']",2000,3
2590780,For Love or Money,1993,['United States of America'],"['Romance Film', 'Romantic comedy', 'Comedy']",1990,3
14595727,Trancers III,1992,['United States of America'],"['Action', 'Action/Adventure', 'Indie', 'Science Fiction', 'Thriller']",1990,2
10638889,Anuraag,1972,['India'],['Bollywood'],1970,2
18728484,Oresama,2004,['Japan'],"['Japanese Movies', 'Musical Drama', 'World cinema', 'Drama']",2000,4
33551500,Hirer Angti,1992,[],['Fantasy'],1990,2
9538297,City of Joy,1992,"['United Kingdom', 'France', 'United States of America']","['Film adaptation', 'Comedy', 'Political drama', 'Drama']",1990,2
27687546,Lakshadhikari,1963,['India'],['Drama'],1960,3
25060688,Samurai Vendetta,1959,['Japan'],"['Japanese Movies', 'Action/Adventure', 'World cinema', 'Martial Arts Film']",1950,9
15696729,Killer Pad,2008,['United States of America'],"['B-movie', 'Comedy horror', 'Horror']",2000,8
9013552,Til Death Us Do Part,1969,['United Kingdom'],['Comedy'],1960,9
9985182,"Remember Me, My Love",2004,"['United Kingdom', 'France', 'Italy']","['Family Drama', 'Romantic drama', 'World cinema', 'Romance Film', 'Drama', 'Ensemble Film']",2000,4
6300081,Motorpsycho,1965,['United States of America'],['Outlaw biker film'],1960,5
3730809,The Facts of Life,1960,['United States of America'],"['Black-and-white', 'Romantic drama', 'Comedy', 'Romance Film', 'Romantic comedy', 'Comedy-drama', 'Drama']",1960,0
957991,A Walk in the Sun,1945,['United States of America'],"['Action', 'Period piece', 'Drama', 'War film']",1940,5
16922889,Cross My Heart,1987,['United States of America'],"['Romance Film', 'Comedy film']",1980,7
3796163,Anita: Swedish Nymphet,1973,"['Sweden', 'France']","['World cinema', 'Romance Film', 'Erotica', 'Drama']",1970,3
26188378,Treasure of the Golden Condor,1953,['United States of America'],"['Action', 'Adventure']",1950,3
2773215,Winnie the Pooh and the Blustery Day,1968,['United States of America'],"[""Children's Fantasy"", 'Animation', 'Short Film', 'Comedy', ""Children's/Family""]",1960,8
27178030,Liliom,1934,['France'],"['Romantic drama', 'Comedy', 'World cinema', 'Romance Film', 'Romantic comedy', 'Drama', 'Fantasy']",1930,4
14620261,Tarzan and the Slave Girl,1950,['United States of America'],"['Black-and-white', 'Adventure', 'Jungle Film']",1950,0
162446,Cadet Kelly,2002,"['Canada', 'United States of America']","['Coming of age', 'Comedy', 'Teen', ""Children's"", 'Family Film']",2000,2
3829543,Der Schuh des Manitu,2001,['Germany'],"['Parody', 'Western', 'Comedy']",2000,1
34084623,Last Known Address,1970,[],"['Crime Fiction', 'Thriller']",1970,0
4916683,Ong Bak 2: The Beginning,2008,['Thailand'],"['Action', 'Action/Adventure', 'World cinema', 'Martial Arts Film']",2000,8
24336540,Wedding Rehearsal,1932,['United Kingdom'],"['Romantic comedy', 'Black-and-white', 'Comedy']",1930,2
36301383,The Wizzard of Krudd,2007,['United States of America'],"['Short Film', 'Animation']",2000,7
28094170,Aakash,2005,['India'],"['Musical', 'Comedy', 'Bollywood', 'World cinema']",2000,5
1617626,Clear and Present Danger,1994,['United States of America'],"['Action', 'Film adaptation', 'Action Thrillers', 'Political thriller', 'Action/Adventure', 'Thriller', 'War film']",1990,4
7532215,Skinwalkers,2002,['United States of America'],"['Film adaptation', 'Crime Fiction', 'Mystery', 'Thriller', 'Crime Thriller', 'Drama', 'Horror', 'Television movie', 'Supernatural']",2000,2
339526,Breathless,1960,"['United States of America', 'France']","['Neo-noir', 'Black-and-white', 'Crime Fiction', 'Art film', 'World cinema', 'Romance Film', 'Drama']",1960,0
16133349,Fade to Black,2006,"['Serbia', 'United Kingdom', 'Italy']","['Period piece', 'Crime Fiction', 'Mystery', 'Thriller', 'Film noir', 'Crime Thriller', 'Drama']",2000,6
26946311,Children of the Corn,1984,['United States of America'],"['Film adaptation', 'Thriller', 'Horror', 'Supernatural', 'Cult']",1980,4
2137591,The Four Horsemen of the Apocalypse,1921,['United States of America'],"['Black-and-white', 'Drama', 'Indie', 'Silent film', 'Romance Film', 'War film']",1920,1
3237331,Kairo,2005,['Japan'],"['Psychological thriller', 'Japanese Movies', 'Horror']",2000,5
6121544,Angel on My Shoulder,1946,['United States of America'],"['Black-and-white', 'Gangster Film', 'Comedy', 'Religious Film', 'Fantasy']",1940,6
19687569,The Bleeding,2009,['United States of America'],"['Action', 'Crime Fiction', 'Action Thrillers', 'Action/Adventure', 'Thriller', 'Horror']",2000,9
12051274,Three Way,2004,['United States of America'],"['Film adaptation', 'Crime Fiction', 'Thriller', 'Drama']",2000,4
1128108,The Door in the Floor,2004,['United States of America'],"['Period piece', 'Film adaptation', 'Drama', 'Indie', 'Romantic drama', 'Marriage Drama', 'Romance Film']",2000,4
7329426,The Phantom Carriage,1921,['Sweden'],"['Black-and-white', 'Drama', 'Indie', 'Horror', 'World cinema', 'Silent film', 'Fantasy']",1920,1
5158963,Amos & Andrew,1993,['United States of America'],"['Action', 'Parody', 'Action/Adventure', 'Satire', 'Comedy']",1990,3
415055,The Unmentionables,1963,['United States of America'],"['Crime Fiction', 'Animation', 'Short Film', 'Comedy', 'Family Film']",1960,3
6616873,Shoeshine,1946,['Italy'],"['Black-and-white', 'Coming of age', 'World cinema', 'Drama']",1940,6
21977956,Imitation,2007,['Canada'],['Thriller'],2000,7
4567706,Roti Kapda Aur Makaan,1974,['India'],"['Bollywood', 'World cinema']",1970,4
16790346,Megalodon,2002,['United States of America'],"['Action/Adventure', 'Horror', 'Adventure', 'Natural horror films']",2000,2
5378058,The Outlaws IS Coming!,1965,['United States of America'],"['Black-and-white', 'Action/Adventure', 'Western', 'Comedy', 'Slapstick']",1960,5
20694344,Running Wild,2006,['South Korea'],"['Action Thrillers', 'Crime Fiction']",2000,6
26166877,Sunday Light,2007,['Spain'],"['Period piece', 'Drama']",2000,7
5454727,Cash McCall,1960,['United States of America'],"['Romance Film', 'Romantic comedy', 'Drama']",1960,0
1217079,The Killing Fields,1984,['United Kingdom'],"['War film', 'Drama', 'Political drama']",1980,4
16150640,Dragons II: The Metal Ages,2005,['Canada'],"['Adventure', 'Animation']",2000,5
10933656,The Leg Fighters,1980,['Hong Kong'],"['Action', 'Action/Adventure', 'World cinema', 'Chinese Movies', 'Martial Arts Film']",1980,0
511653,Dolls,2002,['Japan'],"['Japanese Movies', 'Romantic drama', 'World cinema', 'Romance Film', 'Drama']",2000,2
2312801,Milae,2002,['South Korea'],"['Romance Film', 'Drama']",2000,2
14935874,Fareb,2005,['India'],"['Romantic drama', 'Thriller', 'World cinema', 'Romance Film', 'Drama']",2000,5
19530330,You Were Never Duckier,1948,['United States of America'],"['Animation', 'Short Film', 'Comedy', 'Family Film']",1940,8
320032,Return to Mayberry,1986,['United States of America'],"['Americana', 'Comedy-drama']",1980,6
2119034,Kandahar,2001,"['France', 'Iran']","['Drama', 'World cinema']",2000,1
18293440,Honeymoon in Bali,1939,['United States of America'],"['Romance Film', 'Romantic comedy', 'Comedy']",1930,9
13118358,Les Enfants terribles,1950,['France'],['Drama'],1950,0
22634710,The Rose Technique,2002,['United States of America'],['Crime'],2000,2
1373852,Dirty Dancing: Havana Nights,2004,['United States of America'],"['Musical', 'Musical Drama', 'Indie', 'Romantic drama', 'Teen', 'Romance Film', 'Drama', 'Period piece', 'Coming of age', 'Dance']",2000,4
4228986,Hana & Alice,2004,['Japan'],"['Japanese Movies', 'Romantic drama', 'Comedy', 'World cinema', 'Romance Film', 'Romantic comedy', 'Drama']",2000,4
20649332,Art Museum by the Zoo,1998,['South Korea'],['Romantic comedy'],1990,8
13131974,The Riddle,2007,['United Kingdom'],"['Psychological thriller', 'Mystery', 'Thriller', 'Crime Thriller']",2000,7
26332461,Pattanathil Sundaran,2003,['India'],"['Drama', 'Comedy']",2000,3
3555758,La Belle Noiseuse,1991,"['Switzerland', 'France']","['Romantic drama', 'World cinema', 'Romance Film', 'Drama']",1990,1
9590685,The Bad Mother's Handbook,2007,['United Kingdom'],"['Film adaptation', 'Romantic drama', 'Comedy', 'Romance Film', 'Romantic comedy', 'Drama']",2000,7
23015340,The Poet,2007,['Canada'],['Drama'],2000,7
21987179,Quemar las Naves,2007,['Mexico'],"['LGBT', 'Drama', 'World cinema']",2000,7
18702022,The Man with Rain in His Shoes,1998,"['Spain', 'United Kingdom', 'France', 'Germany', 'United States of America']","['Romantic drama', 'Comedy', 'Romance Film', 'Romantic comedy', 'Drama', 'Fantasy']",1990,8
2171500,Time Out,2001,['France'],"['Psychological thriller', 'Mystery', 'Thriller', 'World cinema', 'Drama']",2000,1
12045578,Making the Grade,1984,['United States of America'],"['Coming of age', 'Comedy', 'Romance Film', 'Sports']",1980,4
362335,All Over the Guy,2001,['United States of America'],"['LGBT', 'Indie', 'Comedy', 'Romance Film', 'Gay Themed', 'Gay', 'Gay Interest', 'Romantic comedy']",2000,1
7983644,"Aloha, Scooby-Doo!",2005,['United States of America'],"['Animation', 'Adventure', 'Family Film']",2000,5
1439951,Swing Kids,1993,['United States of America'],"['Period piece', 'Coming of age', 'Musical Drama', 'Political drama', 'Drama']",1990,3
16840772,My Monster Mom,2008,['Philippines'],"['Filipino Movies', 'Comedy', 'World cinema', 'Comedy-drama', 'Drama']",2000,8
1180124,I Was a Teenage Werewolf,1957,['United States of America'],"['Black-and-white', 'Teen', 'Drama', 'Creature Film', 'Werewolf fiction', 'Horror', 'Melodrama', 'Science Fiction']",1950,7
5300894,Two Women,1999,['Iran'],"['Drama', 'World cinema']",1990,9
8942251,Doctor Strange: The Sorcerer Supreme,2007,['United States of America'],"['Action', 'Animation', 'Superhero', 'Action/Adventure', 'Superhero movie', 'Family Film', 'Fantasy']",2000,7
29119625,Canaries Sometimes Sing,1930,['United Kingdom'],['Comedy film'],1930,0
1752812,Love Liza,2002,"['France', 'Germany', 'United States of America']","['Indie', 'Comedy', 'Black comedy', 'Drama']",2000,2
16473441,Take a Deep Breath,2004,['Serbia and Montenegro'],"['LGBT', 'Drama']",2000,4
23419399,The Arab,1924,['United States of America'],"['Silent film', 'Black-and-white', 'Drama']",1920,4
14854948,Never Forever,2007,"['United States of America', 'South Korea']","['Romantic drama', 'Indie', 'Marriage Drama', 'Drama']",2000,7
16706073,"I Love You, Man",2009,['United States of America'],"['Romance Film', 'Buddy film', 'Comedy']",2000,9
29895019,Hero and the Terror,1988,['United States of America'],"['Action', 'Action Thrillers', 'Action/Adventure', 'Thriller', 'Crime Thriller']",1980,8
11958183,The Floating Landscape,2003,['Hong Kong'],"['Animation', 'Romantic drama', 'World cinema', 'Romance Film', 'Chinese Movies', 'Drama']",2000,3
9280225,Gang of Roses,2003,['United States of America'],"['Action', 'Revisionist Western', 'Indie', 'Action/Adventure', 'Western', 'Feminist Film']",2000,3
3320022,Ultraman: The Adventure Begins,1987,"['Japan', 'United States of America']","['Animation', 'Japanese Movies', 'Anime']",1980,7
10938283,Dushman Duniya Ka,1996,['India'],['Drama'],1990,6
6032221,Doc Savage: The Man of Bronze,1975,['United States of America'],"['Action', 'Superhero', 'Superhero movie', 'Adventure']",1970,5
6017841,Starchaser: The Legend of Orin,1985,"['United States of America', 'South Korea']","['Animation', 'Adventure', 'Science Fiction', 'Family Film']",1980,5
35033775,Trapped in the Closet Chapters 13–22,2007,[],['Musical'],2000,7
7782549,The McKenzie Break,1970,['United Kingdom'],"['Action', 'Escape Film', 'Action/Adventure', 'War film']",1970,0
19311240,The Love God?,1969,['United States of America'],"['Comedy', 'Satire']",1960,9
22726015,The Invention of Lying,2009,"['Canada', 'United States of America']","['Comedy', 'Romance Film', 'Romantic comedy', 'Fantasy Comedy', 'Fantasy']",2000,9
18459833,Linda Lovelace for President,1975,['United States of America'],"['Social issues', 'Parody', 'Comedy', 'Mockumentary']",1970,5
43452,Lawrence of Arabia,1962,"['United Kingdom', 'United States of America']","['British Empire Film', 'Action', 'LGBT', 'Action/Adventure', 'Biographical film', 'Roadshow theatrical release', 'Costume drama', 'Adventure', 'Drama', 'Historical fiction', 'Epic', 'War film']",1960,2
27553135,Your Mother Wears Combat Boots,1989,['United States of America'],['Comedy'],1980,9
3375635,Down by Law,1986,"['Germany', 'United States of America']","['Black-and-white', 'Indie', 'Buddy film', 'Comedy', 'Black comedy', 'Road movie']",1980,6
12831965,Meltdown: Days of Destruction,2006,['United States of America'],"['Action', 'Action/Adventure', 'Television movie', 'Disaster']",2000,6
2775082,Patthar Ke Phool,1991,['India'],['Romance Film'],1990,1
8664046,Tom & Jerry and the Fast and the Furry,2005,['United States of America'],"['Family Film', 'Animation']",2000,5
3690254,Transylvania 6-5000,1963,['United States of America'],['Comedy'],1960,3
9932514,Maid to Order,1987,['United States of America'],"['Comedy', 'Romance Film', 'Romantic comedy', 'Fantasy']",1980,7
547448,Starsky & Hutch,2004,['United States of America'],"['Action', 'Crime Fiction', 'Parody', 'Buddy film', 'Thriller', 'Comedy']",2000,4
74872,The Learning Tree,1969,['United States of America'],"['Drama', 'Americana', 'Coming of age']",1960,9
22707969,Gidget Grows Up,1969,['United States of America'],"['Romance Film', 'Romantic comedy', 'Comedy']",1960,9
6205827,Is It College Yet?,2002,['United States of America'],"['Animated cartoon', 'Comedy']",2000,2
9632030,Mystery Mountain,1934,['United States of America'],"['Action', 'Black-and-white', 'Mystery', 'Action/Adventure', 'Western', 'Thriller', 'Adventure']",1930,4
6343570,Return to House on Haunted Hill,2007,['United States of America'],['Horror'],2000,7
20557238,On Secret Service,1933,['United Kingdom'],"['Spy', 'Romance Film', 'War film']",1930,3
3202945,Pyaar Kiya To Darna Kya,1998,['India'],"['Comedy', 'Bollywood', 'World cinema', 'Romance Film', 'Romantic comedy']",1990,8
8721887,Undercover Kitty,2001,['Netherlands'],"['Adventure', 'Family Film']",2000,1
2952485,Avanti!,1972,"['Italy', 'United States of America']","['Comedy', 'Black comedy', 'Romantic comedy', 'Romance Film']",1970,2
42886,Gattaca,1997,['United States of America'],"['Dystopia', 'Future noir', 'Thriller', 'Film noir', 'Romance Film', 'Science Fiction', 'Drama']",1990,7
432364,Bully,2001,"['United States of America', 'France']","['Film adaptation', 'LGBT', 'Crime Fiction', 'Indie', 'Drama', 'Teen', 'Crime Thriller']",2000,1
28697428,Three Steps in the Dark,1953,['United Kingdom'],"['Drama', 'Crime Fiction']",1950,3
270759,The Hidden Fortress,1958,['Japan'],"['Action', 'Drama', 'Comedy film', 'Adventure']",1950,8
12154789,We Dive at Dawn,1943,['United Kingdom'],"['War film', 'Black-and-white']",1940,3
27200389,Seven Ways from Sundown,1960,['United States of America'],"['Action/Adventure', 'Western']",1960,0
8609643,Summer of My German Soldier,1978,['United States of America'],"['Romance Film', 'Drama']",1970,8
6795082,Unnai Kodu Ennai Tharuven,2000,['India'],['Romance Film'],2000,0
10133874,"Behemoth, the Sea Monster",1959,['United States of America'],"['Sci-Fi Horror', 'Creature Film', 'Monster movie', 'Natural horror films', 'Horror', 'B-movie', 'Stop motion', 'Science Fiction', 'Cult']",1950,9
24462238,Lights of Old Broadway,1925,['United States of America'],"['Comedy', 'Silent film', 'Comedy-drama', 'Slapstick']",1920,5
8451462,Adiós muchachos,1954,"['Argentina', 'Spain']",['Black-and-white'],1950,4
24569271,Kizhakku Vasal,1990,['India'],"['Romance Film', 'Drama']",1990,0
1519886,Sisters,1973,['United States of America'],"['Psychological thriller', 'Suspense', 'Mystery', 'Indie', 'Thriller', 'Horror', 'Crime Thriller']",1970,3
20354125,The Black Tent,1956,['United Kingdom'],"['Romantic drama', 'Action/Adventure', 'Romance Film', 'War film', 'Adventure', 'Drama']",1950,6
1923722,La Ronde,1950,['France'],"['Romantic drama', 'Comedy', 'World cinema', 'Romance Film', 'Romantic comedy', 'Drama']",1950,0
2347609,Little Boy Lost,1953,['United States of America'],"['Black-and-white', 'Drama']",1950,3
5672353,Lone Wolf and Cub: Baby Cart in Peril,1972,['Japan'],"['Japanese Movies', 'Action/Adventure', 'World cinema', 'Martial Arts Film']",1970,2
7490409,Betty Boop and the Little King,1936,['United States of America'],"['Animation', 'Short Film', 'Comedy film', 'Family Film']",1930,6
25851079,Meet the Baron,1933,['United States of America'],['Comedy'],1930,3
30787022,Secret,2009,[],['Thriller'],2000,9
21321778,Jackpot,2009,['India'],['Documentary'],2000,9
30198362,Neurosia: 50 Years of Perversity,1995,['Germany'],"['Biographical film', 'Drama', 'Documentary']",1990,5
24987997,Now Hare This,1958,['United States of America'],"['Animation', 'Short Film', 'Family Film']",1950,8
10815603,Fine Feathered Friend,1942,['United States of America'],"['Animation', 'Short Film', 'Comedy film', 'Family Film']",1940,2
24710617,Atithi,2002,['India'],"['Drama', 'World cinema']",2000,2
20985883,Credo,2008,['United Kingdom'],"['Indie', 'Horror']",2000,8
25340505,Wolfshead: The Legend of Robin Hood,1969,['United Kingdom'],['Adventure'],1960,9
20614656,Dushman,1990,['India'],['Drama'],1990,0
2651186,Kontroll,2003,['Hungary'],"['Psychological thriller', 'Crime Fiction', 'Comedy', 'Thriller', 'World cinema', 'Drama']",2000,3
23680613,The Market,1965,['South Korea'],['Drama'],1960,5
17346920,"Cala, My Dog!",2003,['China'],"['Chinese Movies', 'Comedy']",2000,3
1751324,George Washington,2000,['United States of America'],"['Coming of age', 'Indie', 'Drama']",2000,0
4878082,One More Time,1970,"['United Kingdom', 'United States of America']","['Action', 'Action/Adventure', 'Comedy', 'Slapstick']",1970,0
4610981,Intensity,1997,['United States of America'],['Thriller'],1990,7
3032361,"You, Me and Dupree",2006,['United States of America'],"['Comedy', 'Comedy of manners', 'Romance Film', 'Romantic comedy']",2000,6
2399419,The Happiness of the Katakuris,2002,['Japan'],"['Musical', 'Surrealism', 'Comedy', 'Horror Comedy', 'World cinema', 'Musical comedy', 'Japanese Movies', 'Horror']",2000,2
8856844,Rendez-vous,1985,['France'],"['Romantic drama', 'World cinema', 'Romance Film', 'Drama']",1980,5
2093621,Road House,1948,['United States of America'],"['Black-and-white', 'Crime Fiction', 'Romantic drama', 'Thriller', 'Film noir', 'Romance Film', 'Drama']",1940,8
1237909,Sweet Sweetback's Baadasssss Song,1971,['United States of America'],"['Action', 'Blaxploitation', 'Crime Fiction', 'Action Thrillers', 'Indie', 'Action/Adventure', 'Thriller']",1970,1
3212842,Neal N Nikki,2005,['India'],"['Musical', 'Romantic drama', 'Comedy', 'World cinema', 'Romance Film', 'Romantic comedy', 'Drama']",2000,5
8777711,Now I'll Tell One,1927,['United States of America'],"['Black-and-white', 'Indie', 'Short Film', 'Comedy', 'Silent film']",1920,7
20727881,A Muppets Christmas: Letters to Santa,2008,['United States of America'],"['Musical', 'Comedy', ""Children's/Family"", 'Holiday Film', 'Family Film']",2000,8
12694305,Beat,2000,['United States of America'],"['Period piece', 'Drama', 'Indie', 'Biography', 'Romantic drama', 'Romance Film']",2000,0
1789076,The 36th Chamber of Shaolin,1978,"['China', 'Hong Kong']","['Action', 'Action/Adventure', 'World cinema', 'Chinese Movies', 'Martial Arts Film']",1970,8
2746792,Memories of Murder,2003,['South Korea'],"['Crime Fiction', 'Mystery', 'Thriller', 'World cinema', 'Crime Thriller', 'Drama']",2000,3
17717339,Nuremberg,2000,"['Canada', 'United States of America']","['Docudrama', 'Historical drama']",2000,0
1484938,Broadway Melody of 1940,1940,['United States of America'],"['Musical', 'Black-and-white', 'Backstage Musical', 'Musical Drama', 'Romance Film']",1940,0
1581868,Joseph: King of Dreams,2000,['United States of America'],"['Music', 'Animation', 'Animated Musical', ""Children's"", ""Children's/Family"", 'Adventure', 'Family Film']",2000,0
6685734,Firecracker,2005,['United States of America'],"['Crime Fiction', 'Mystery', 'Thriller']",2000,5
4557151,Captain America,1990,"['Yugoslavia', 'United States of America']","['Action', 'Thriller', 'Adventure', 'Superhero movie', 'War film', 'Science Fiction', 'Fantasy']",1990,0
18698236,Six Degrees of Separation,1993,['United States of America'],"['Mystery', 'Comedy', 'Drama']",1990,3
8411320,Anna's Dream,2002,['United States of America'],"['Drama', 'Comedy']",2000,2
2756655,The Black Scorpion,1957,['United States of America'],"['Creature Film', 'Monster', 'Horror', 'B-movie', 'Stop motion', 'Science Fiction']",1950,7
1394462,Macross Dynamite 7,1997,['Japan'],"['Japanese Movies', 'Animation']",1990,7
9073201,A`isha,1953,['Egypt'],['Drama'],1950,3
26825241,Aastha: In the Prison of Spring,1997,['India'],['Drama'],1990,7
543433,A League of Their Own,1992,['United States of America'],"['Feminist Film', 'Comedy', 'Comedy-drama', 'Americana', 'Sports', 'Drama', 'Ensemble Film']",1990,2
9403496,The Holy Girl,2004,"['Spain', 'Netherlands', 'Argentina', 'Italy']","['Drama', 'Coming of age', 'Indie', 'World cinema']",2000,4
28417976,Bollywood Queen,2002,['United Kingdom'],"['Musical', 'Romantic drama', 'Romance Film', 'Drama']",2000,2
3137992,Explorers,1985,['United States of America'],"[""Children's Fantasy"", 'Adventure', ""Children's/Family"", 'Science Fiction', 'Family Film', 'Fantasy']",1980,5
10250805,Partition,2007,"['Canada', 'United Kingdom']","['Period piece', 'Drama', 'Indie', 'Romantic drama', 'Romance Film', 'Political drama']",2000,7
36475779,The Penguin Parade,1938,['United States of America'],"['Music', 'Animation', 'Short Film', 'Comedy film', 'Family Film']",1930,8
94028,The Tigger Movie,2000,"['Japan', 'United States of America']","['Musical', 'Animation', 'Japanese Movies', 'Family-Oriented Adventure', ""Children's/Family"", 'Adventure', 'Family Film']",2000,0
6963814,The Two Mrs. Carrolls,1947,['United States of America'],"['Psychological thriller', 'Black-and-white', 'Thriller', 'Film noir', 'Melodrama', 'Drama']",1940,7
3674330,Abduction: The Megumi Yokota Story,2006,['United States of America'],"['Social issues', 'Law & Crime', 'Political cinema', 'Documentary', 'Culture & Society']",2000,6
1827624,White Nights,1985,['United States of America'],"['Musical Drama', 'Thriller', 'Dance', 'Political drama', 'Escape Film', 'Drama', 'Political thriller']",1980,5
19286437,Enga Veettu Pillai,1965,['India'],['Family Film'],1960,5
29938038,Just Friends?,2009,['South Korea'],"['Gay Themed', 'LGBT', 'Short Film', 'Romance Film']",2000,9
8004988,March or Die,1977,"['United Kingdom', 'United States of America']","['Foreign legion', 'Action/Adventure', 'Adventure', 'War film', 'Drama']",1970,7
62115,Love Affair,1939,['United States of America'],"['Black-and-white', 'Romantic drama', 'Romance Film', 'Drama']",1930,9
14421585,Sick Nurses,2007,['Thailand'],"['World cinema', 'Horror']",2000,7
9285798,Jaii,2004,['India'],"['Romance Film', 'Drama']",2000,4
22619573,The Slugger's Wife,1985,['United States of America'],"['Music', 'Romantic drama', 'Comedy', 'Baseball', 'Romance Film', 'Drama', 'Romantic comedy', 'Sports']",1980,5
3257858,Gidget Goes Hawaiian,1961,['United States of America'],"['Musical', 'Comedy', 'Teen', 'Romance Film', 'Romantic comedy', 'Beach Film']",1960,1
6095468,Road to Zanzibar,1941,['United States of America'],"['Adventure Comedy', 'Musical', 'Black-and-white', 'Screwball comedy', 'Buddy film', 'Comedy', 'Road movie']",1940,1
20368447,The Pledge,2008,['United States of America'],"['Western', 'Television movie', 'Action/Adventure']",2000,8
11195154,A Christmas Tale,2008,['France'],"['Family Drama', 'World cinema', 'Drama', 'Ensemble Film']",2000,8
2293867,Queen Kelly,1929,['United States of America'],"['Black-and-white', 'Drama', 'Indie', 'Romantic drama', 'Silent film', 'Romance Film', 'Melodrama']",1920,9
1028910,Down with Love,2003,"['Germany', 'United States of America']","['Period piece', 'Screwball comedy', 'Parody', 'Comedy', 'Romance Film', 'Romantic comedy']",2000,3
13915018,Ponthan Mada,1994,['India'],['Drama'],1990,4
34032784,Sundara Kandam,1992,[],['Comedy film'],1990,2
26651195,Ups and Downs,1937,['United States of America'],"['Musical', 'Romance Film', 'Short Film']",1930,7
1308068,The Mack,1973,['United States of America'],"['Action', 'Blaxploitation', 'Crime Fiction', 'Action/Adventure', 'Thriller', 'Crime Thriller', 'Drama']",1970,3
702117,Spider-Man 3,2007,['United States of America'],"['Action', 'Action Thrillers', 'Superhero', 'Action/Adventure', 'Thriller', 'Adventure', 'Drama', 'Superhero movie', 'Science Fiction', 'Fantasy']",2000,7
19187200,La Classe américaine,1993,['France'],"['Parody', 'Comedy']",1990,3
3150787,Ballot Box Bunny,1951,['United States of America'],['Comedy'],1950,1
28288095,Murder in Peyton Place,1977,['United States of America'],['Mystery'],1970,7
1126356,Mr. Majestyk,1974,['United States of America'],"['Action', 'Crime Fiction', 'Action Thrillers', 'Gangster Film', 'Action/Adventure', 'Thriller']",1970,4
3479775,The Mechanic,1972,['United States of America'],"['Action', 'Crime Fiction', 'Gangster Film', 'Mystery', 'Action/Adventure', 'Thriller', 'Crime Thriller', 'Dogme 95']",1970,2
27486642,Sir,1993,['India'],"['Crime Fiction', 'Bollywood', 'World cinema', 'Drama']",1990,3
1846857,Cannibal Women in the Avocado Jungle of Death,1989,['United States of America'],"['Sexploitation', 'Parody', 'Horror Comedy', 'Comedy']",1980,9
8765205,Winter Solstice,2004,['United States of America'],"['Indie', 'Family Drama', 'Drama']",2000,4
1336534,Warlock,1959,['United States of America'],"['Time travel', 'Action/Adventure', 'Western', 'Drama']",1950,9
261107,Strangers on a Train,1951,['United States of America'],"['Psychological thriller', 'Film adaptation', 'Black-and-white', 'LGBT', 'Thriller', 'Film noir', 'Crime Thriller', 'Drama', 'Suspense']",1950,1
1394959,Dark Blue,2002,"['United Kingdom', 'Germany', 'United States of America']","['Action', 'Period piece', 'Crime Fiction', 'Thriller', 'Crime Drama', 'Crime Thriller', 'Drama']",2000,2
2541588,Lilies,1996,['Canada'],"['Film adaptation', 'LGBT', 'Romance Film', 'Drama', 'Period piece', 'Gay Themed', 'Gay', 'Gay Interest']",1990,6
3965765,After Death,1988,['Italy'],"['Horror', 'World cinema', 'Zombie Film', 'Drama']",1980,8
13590180,Magic Kitchen,2004,['Hong Kong'],"['Romantic drama', 'Comedy', 'World cinema', 'Romance Film', 'Romantic comedy', 'Chinese Movies', 'Drama']",2000,4
24094638,The Burning Court,1962,[],"['Mystery', 'Thriller', 'Horror', 'Drama']",1960,2
32656045,Grandad Rudd,1935,[],['Comedy film'],1930,5
44696,It Happened One Night,1934,['United States of America'],"['Black-and-white', 'Screwball comedy', 'Comedy', 'Romance Film', 'Romantic comedy', 'Road movie', 'Pre-Code']",1930,4
6079279,Barnacle Bill,1957,['United Kingdom'],"['Ealing Comedies', 'Comedy']",1950,7
24601600,Despoinis eton 39,1954,['Greece'],"['Drama', 'Comedy']",1950,4
28005392,"Oh, Men! Oh, Women!",1957,['United States of America'],"['Parody', 'Comedy']",1950,7
7837323,The Nun and the Devil,1973,"['France', 'Italy']","['Drama', 'Thriller', 'World cinema']",1970,3
9105327,The Walking Dead,1995,['United States of America'],"['Period piece', 'War film', 'Drama']",1990,5
6149282,It!,1966,"['United Kingdom', 'United States of America']","['Creature Film', 'Science Fiction', 'Horror']",1960,6
29102633,Texas Lightning,1981,[],"['Coming of age', 'Family Drama', 'Indie', 'Drama']",1980,1
11018115,The Fascist,1965,['Italy'],['Black-and-white'],1960,5
2312019,"Reigo, the Deep-Sea Monster vs. the Battleship Yamato",2008,['Japan'],"['Tokusatsu', 'Japanese Movies']",2000,8
1682871,Little Buddha,1994,"['United Kingdom', 'France', 'United States of America']","['Drama', 'Indie', 'Childhood Drama', 'Biopic [feature]', 'World cinema', 'Hagiography']",1990,4
1254881,Night of the Living Dead,1990,['United States of America'],"['Indie', 'Satire', 'Horror', 'Zombie Film', 'Cult']",1990,0
2077098,Carry On Abroad,1972,['United Kingdom'],"['Parody', 'Comedy', 'Comedy of manners']",1970,2
13192034,Young and Dangerous,1996,['Hong Kong'],"['Action', 'Crime Fiction', 'Thriller', 'Chinese Movies']",1990,6
3895377,Dirty Love,2005,['United States of America'],"['Indie', 'Comedy', 'Romance Film', 'Romantic comedy', 'Sex comedy']",2000,5
27669486,The Legend of Frenchie King,1971,"['Spain', 'United Kingdom', 'France', 'Italy']","['Western', 'Comedy']",1970,1
5937490,Vennela,2005,['India'],"['Romantic drama', 'World cinema', 'Romance Film', 'Drama']",2000,5
5999786,The Quiet American,1958,['United States of America'],"['Film adaptation', 'Thriller', 'Political drama', 'Drama', 'Political thriller']",1950,8
26443897,Agnes Browne,1999,['Ireland'],"['Period piece', 'Film adaptation', 'Comedy', 'Drama']",1990,9
2352648,Gunman in the Streets,1950,['France'],"['Black-and-white', 'Crime Fiction', 'Thriller', 'World cinema', 'Film noir', 'Crime Thriller', 'Drama', 'Suspense', 'Chase Movie']",1950,0
26182472,Hi-Riders,1978,['United States of America'],['Action'],1970,8
347000,Suspiria,1977,['Italy'],"['Coming of age', 'Gothic Film', 'Slasher', 'World cinema', 'Horror', 'Supernatural', 'Cult']",1970,7
7334748,Imtihaan,1995,['India'],"['Musical', 'Romantic drama', 'Bollywood', 'World cinema', 'Romance Film', 'Drama']",1990,5
2760461,Happily N'Ever After,2007,"['Germany', 'United States of America']","['Animation', 'Comedy', ""Children's/Family"", 'Computer Animation', 'Fairy tale', 'Parody', 'Family Film', 'Fantasy']",2000,7
12683776,Walking Tall: Lone Justice,2007,['United States of America'],"['Action', 'Crime Fiction', 'Action Thrillers', 'Action/Adventure', 'Thriller']",2000,7
24643223,Taqwacore,2009,['Canada'],"['Rockumentary', 'LGBT', 'Indie', 'Documentary']",2000,9
8527362,The True Story of Eskimo Nell,1975,['Australia'],"['Indie', 'Western', 'Comedy', 'Docudrama', 'Adventure']",1970,5
19612846,Tall Story,1960,['United States of America'],['Comedy'],1960,0
28569306,Helen of Four Gates,1920,['United Kingdom'],['Silent film'],1920,0
28788678,Lydia Bailey,1952,['United States of America'],"['Historical Epic', 'Epic', 'Adventure', 'Drama']",1950,2
6759912,The High Sign,1921,['United States of America'],"['Black-and-white', 'Indie', 'Short Film', 'Comedy', 'Silent film', 'Slapstick']",1920,1
76335,The Searchers,1956,['United States of America'],"['Revisionist Western', 'Action/Adventure', 'Western', 'Epic Western', 'Drama']",1950,6
9104588,Carousel,1956,['United States of America'],"['Musical', 'Romantic drama', 'Romance Film', 'Drama', 'Fantasy']",1950,6
28852030,The Warrens of Virginia,1924,['United States of America'],['Silent film'],1920,4
10206784,Torrent,1926,['United States of America'],"['Black-and-white', 'Drama', 'Indie', 'Silent film']",1920,6
25972862,The Projectionist,1971,['United States of America'],"['Drama', 'Comedy', 'Fantasy Comedy', 'Fantasy']",1970,1
19954049,The Attic Door,2008,['United States of America'],"['Psychological thriller', 'Drama', 'Thriller']",2000,8
10444955,Gracie,2007,['United States of America'],"['Period piece', 'Coming of age', 'Teen', 'Sports', 'Drama']",2000,7
2562663,The Idle Class,1921,['United States of America'],"['Black-and-white', 'Indie', 'Short Film', 'Comedy', 'Silent film', 'Slapstick']",1920,1
11140557,Nammavar,1995,['India'],[],1990,5
2912982,The Proposition,2005,"['United Kingdom', 'New Zealand', 'Australia']","['Psychological thriller', 'Crime Fiction', 'Action/Adventure', 'World cinema', 'Costume drama', 'Drama', 'Period piece', 'Western']",2000,5
15463100,The Big Empty,2003,['United States of America'],"['Indie', 'Comedy', 'Black comedy', 'Science Fiction']",2000,3
23229173,The Unnamable,1988,['United States of America'],"['Creature Film', 'Teen', 'Horror', 'Haunted House Film']",1980,8
21205985,Anu,2009,['India'],"['Drama', 'Feminist Film']",2000,9
12686338,Exils,2003,"['France', 'Japan']","['Japanese Movies', 'Drama', 'World cinema']",2000,3
461364,Cold Mountain,2003,"['Italy', 'United Kingdom', 'Romania', 'United States of America']","['Anti-war', 'Period piece', 'Anti-war film', 'Romance Film', 'War film', 'Drama']",2000,3
9755107,Maangamizi: The Ancient One,2001,['United States of America'],"['Drama', 'Medical fiction']",2000,1
30337907,Chamaram,1981,[],"['Romance Film', 'Drama']",1980,1
495585,Taiyō o Nusunda Otoko,1979,['Japan'],"['Japanese Movies', 'Comedy', 'Black comedy', 'Romance Film']",1970,9
1853636,Teenage Zombies,1959,['United States of America'],"['Teen', 'Horror', 'B-movie', 'Zombie Film', 'Science Fiction']",1950,9
1346428,Heist,2001,"['Canada', 'United States of America']","['Heist', 'Crime Fiction', 'Thriller', 'Crime Thriller', 'Drama']",2000,1
16478181,Kiss or Kill,1997,['Australia'],"['Crime Fiction', 'Indie', 'Thriller']",1990,7
2621487,Dirty Duck,1974,['United States of America'],"['Animation', 'Comedy', 'Pornographic movie', 'Adult']",1970,4
15477301,Kala Malam Bulan Mengambang,2008,['Malaysia'],['Comedy'],2000,8
7334454,Hamesha,1997,['India'],['World cinema'],1990,7
1328254,Eat Your Makeup,1968,['United States of America'],"['Comedy', 'Black-and-white']",1960,8
2233095,The Paper,1994,['United States of America'],"['Crime Fiction', 'Comedy', 'Comedy-drama', 'Drama']",1990,4
987370,New York Stories,1989,['United States of America'],"['Satire', 'Comedy', 'Comedy-drama', 'Anthology', 'Fantasy Comedy', 'Drama']",1980,9
6201886,The Winslow Boy,1948,['United Kingdom'],"['Black-and-white', 'Drama']",1940,8
210227,The Pumpkin Eater,1964,['United Kingdom'],"['Marriage Drama', 'Drama']",1960,4
1549716,Over the Top,1987,['United States of America'],"['Action', 'Drama', 'Action/Adventure', 'Sports']",1980,7
11467740,"Adiós, Sabata",1971,"['Spain', 'Italy']","['Action', 'Action/Adventure', 'Western', 'World cinema', 'Spaghetti Western']",1970,1
11534107,Fortress,1986,['Australia'],"['Action', 'Psychological thriller', 'Thriller', 'Horror', 'World cinema', 'Crime Thriller', 'Drama']",1980,6
28302378,Crashing Las Vegas,1956,['United States of America'],"['Action', 'Adventure', 'Comedy film']",1950,6
15394941,Gopi Kishan,1994,['India'],"['Action', 'Drama', 'Comedy', 'Crime']",1990,4
15541969,Fashion,2008,['India'],"['Romance Film', 'Drama']",2000,8
25926295,Tom Tom Tomcat,1953,['United States of America'],"['Animation', 'Short Film', 'Comedy film', 'Family Film']",1950,3
27686176,All Hat,2007,['Canada'],"['Film adaptation', 'Action/Adventure', 'Western', 'Drama']",2000,7
30173306,Ab Insaf Hoga,1995,[],['Drama'],1990,5
14267167,I Bought a Vampire Motorcycle,1990,"['United Kingdom', 'United States of America']","['Parody', 'Slasher', 'Horror Comedy', 'Horror']",1990,0
32169737,Casta diva,1935,['Italy'],"['Music', 'Drama', 'Biographical film']",1930,5
3302848,Frankenstein Meets the Wolf Man,1943,['United States of America'],"['Black-and-white', 'Horror']",1940,3
18953877,Corn on the Cop,1965,['United States of America'],"['Animation', 'Short Film', 'Comedy film', 'Family Film']",1960,5
737801,"Welcome Home, Roxy Carmichael",1990,['United States of America'],"['Coming of age', 'Indie', 'Satire', 'Comedy', 'Drama']",1990,0
26295794,Echoes of the Rainbow,2009,"['China', 'Hong Kong']","['Comedy', 'World cinema', 'Romance Film', 'Chinese Movies', 'Drama']",2000,9
5696226,The Water Margin,1972,"['Hong Kong', 'United States of America']","['Action', 'Action/Adventure', 'World cinema', 'Wuxia', 'Chinese Movies', 'Martial Arts Film', 'Drama']",1970,2
9251754,How She Move,2008,"['France', 'United States of America', 'Canada']","['Dance', 'Coming of age', 'Drama']",2000,8
97758,Doctor Zhivago,1965,"['Italy', 'United States of America']","['Period piece', 'Romantic drama', 'War film', 'Romance Film', 'Epic', 'Roadshow theatrical release', 'Drama']",1960,5
1005650,The Other Side of Heaven,2001,['United States of America'],"['Biography', 'Family Drama', 'Action/Adventure', 'Biographical film', 'Adventure', 'Drama', 'Period piece', 'Coming of age', 'Family Film']",2000,1
2627836,The Murder Man,1935,['United States of America'],"['Crime Drama', 'Black-and-white', 'Crime Fiction']",1930,5
4980311,Masoom,1983,['India'],"['Family Drama', 'Bollywood', 'Family Film']",1980,3
23659085,All That Falls Has Wings,1990,['South Korea'],"['Romance Film', 'Drama']",1990,0
2093425,Johnny Dangerously,1984,['United States of America'],"['Crime Fiction', 'Gangster Film', 'Parody', 'Comedy', 'Crime Comedy']",1980,4
3561650,Mexicali Shmoes,1959,[],"['Animation', 'Short Film', 'Comedy film', 'Family Film']",1950,9
1676282,Fair Game,1995,['United States of America'],"['Action', 'Crime Fiction', 'Action/Adventure', 'Thriller']",1990,5
994415,A Hole in My Heart,2004,"['Sweden', 'Denmark']","['Avant-garde', 'World cinema', 'Experimental film', 'Horror', 'Social problem film', 'Drama']",2000,4
27258038,Love Lies Bleeding,2008,['United States of America'],"['Action', 'Action/Adventure', 'Thriller', 'Crime Thriller']",2000,8
9053564,Angulimala,2004,['Thailand'],"['Horror', 'Adventure', 'Drama', 'Fantasy']",2000,4
20759334,Wrong Side Up,2004,['Czech Republic'],"['Comedy-drama', 'Comedy', 'Drama']",2000,4
33449688,Assassin,1969,['South Korea'],"['Thriller', 'Drama']",1960,9
28250117,Turtle Beach,1992,['Australia'],"['Thriller', 'Drama']",1990,2
1558966,Pokémon: Lucario and the Mystery of Mew,2006,"['United States of America', 'Canada', 'Japan']","['Animated cartoon', 'Japanese Movies', 'Action/Adventure', 'Adventure', 'Anime', 'Fantasy Comedy', 'Family Film']",2000,6
19167990,A Scandal in Paris,1946,['United States of America'],"['Black-and-white', 'Crime Fiction', 'Biography', 'Romantic drama', 'Biographical film', 'Romance Film', 'Adventure', 'Drama', 'Period piece', 'Biopic [feature]']",1940,6
2192166,Nostalghia,1983,"['Russia', 'Soviet Union', 'France', 'Italy']","['Romantic drama', 'World cinema', 'Romance Film', 'Drama']",1980,3
24159097,Our Time,1974,['United States of America'],['Drama'],1970,4
8906388,Full Moon Party,2002,['Netherlands'],['Romantic comedy'],2000,2
34129784,Design for Scandal,1941,['United States of America'],"['Romance Film', 'Romantic comedy', 'Comedy']",1940,1
948223,Mr. Destiny,1990,['United States of America'],"['Comedy', 'Romantic comedy', 'Romance Film', 'Sports', 'Fantasy Comedy', 'Fantasy']",1990,0
22325279,The Boys Are Back,2009,"['New Zealand', 'Australia']","['Film adaptation', 'Family Drama', 'Inspirational Drama', 'World cinema', 'Drama']",2000,9
14795399,Half Shot at Sunrise,1930,['United States of America'],"['Musical', 'Black-and-white', 'Comedy', 'Slapstick']",1930,0
2470135,In The Army Now,1994,['United States of America'],"['Comedy', 'War film', 'Slapstick', 'Adventure']",1990,4
28963028,The Lone Ranger,2003,['United States of America'],"['Action', 'Western']",2000,3
23862301,Maple Palm,2006,['United States of America'],"['LGBT', 'Drama', 'Indie']",2000,6
97646,Die Hard,1988,['United States of America'],"['Action', 'Crime Fiction', 'Action/Adventure', 'Thriller']",1980,8
6892078,The Garbage Picking Field Goal Kicking Philadelphia Phenomenon,1998,['United States of America'],"['Sports', 'Comedy', 'Drama']",1990,8
9473825,Gudachari No.1,1983,['India'],"['Action', 'Thriller']",1980,3
30861208,Gamera the Brave,2006,['Japan'],"['Creature Film', 'Monster movie', ""Children's Fantasy"", 'Japanese Movies', 'World cinema', 'Fantasy']",2000,6
27846279,Carnival,1989,['India'],"['Romance Film', 'Crime Fiction']",1980,9
6353227,Unearthed,2007,['United States of America'],"['Action', 'Monster movie', 'Indie', 'Horror']",2000,7
23809648,Sealed Cargo,1951,['United States of America'],"['Action', 'Black-and-white', 'Drama', 'Melodrama', 'War film']",1950,1
5501445,This Happy Feeling,1958,['United States of America'],"['Romantic drama', 'Comedy', 'Romance Film', 'Drama']",1950,8
31157090,Kichamani MBA,2007,['India'],['Action'],2000,7
6942315,One Wild Oat,1951,['United Kingdom'],"['Domestic Comedy', 'Comedy']",1950,1
13183460,Seventeen Years,1999,"['China', 'Italy']","['Chinese Movies', 'Family Drama', 'World cinema', 'Road movie', 'Drama']",1990,9
1748482,Recess: School's Out,2001,['United States of America'],"['Animation', 'Comedy', 'Adventure', 'Family Film']",2000,1
5664334,Book of Love,2004,['United States of America'],"['Romantic drama', 'Indie', 'Comedy', 'Romance Film', 'Drama']",2000,4
6342627,Ted Bundy,2002,"['United Kingdom', 'United States of America']","['Crime Fiction', 'Biographical film', 'Thriller', 'Drama']",2000,2
3763636,The Duke is Tops,1938,['United States of America'],"['Musical', 'Black-and-white']",1930,8
19929595,Vote for Change? 2004,2008,['United States of America'],['Documentary'],2000,8
19721654,Nice Guys,2005,['United States of America'],"['Heist', 'Crime Fiction', 'Comedy film']",2000,5
29831961,Nell'anno del Signore,1969,['Italy'],"['Historical drama', 'Comedy film']",1960,9
76387,The Thing,1951,['United States of America'],"['Monster movie', 'Horror', 'Therimin music', 'Science Fiction']",1950,1
8778114,Kim,1984,['United Kingdom'],"['Period piece', 'Film adaptation', 'Family Drama', 'Television movie', 'Drama', 'Family Film']",1980,4
4644031,Nick Fury: Agent of Shield,1998,['United States of America'],"['Action', 'Superhero movie', 'Superhero']",1990,8
10043194,Monobloc,2005,['Argentina'],"['Indie', 'Drama']",2000,5
8151807,Agentti 000 ja kuoleman kurvit,1983,['Finland'],"['Parody', 'Comedy']",1980,3
2565348,The Adventure of Sherlock Holmes' Smarter Brother,1975,"['United Kingdom', 'United States of America']","['Parody', 'Comedy', 'Thriller']",1970,5
21217240,The Graduates,2008,['United States of America'],"['Teen', 'Comedy film']",2000,8
33006259,The Teacher,1974,[],"['Coming of age', 'Thriller', 'Erotic thriller', 'Crime Thriller']",1970,4
21299883,The Officers' Ward,2001,['France'],"['Romance Film', 'War film', 'Drama']",2000,1
4069403,The Rapture,1991,['United States of America'],"['Mystery', 'Indie', 'Christian film', 'Drama']",1990,1
30210926,Huntingtower,1927,[],['Silent film'],1920,7
12725443,The Scarlet Coat,1955,['United States of America'],"['Spy', 'Historical fiction', 'Swashbuckler films', 'Adventure', 'Drama']",1950,5
76339,Shadow of a Doubt,1943,['United States of America'],"['Psychological thriller', 'Black-and-white', 'Crime Fiction', 'Mystery', 'Thriller', 'Film noir', 'Crime Thriller', 'Drama', 'Suspense']",1940,3
14452341,Bureau of Missing Persons,1933,['United States of America'],"['Black-and-white', 'Crime Fiction', 'Mystery', 'Comedy', 'Drama', 'Comedy of Errors', 'Crime Comedy', 'Comedy-drama']",1930,3
4153572,Southside 1-1000,1950,['United States of America'],"['Film noir', 'Crime Fiction', 'Mystery']",1950,0
8965027,Old Ironsides,1926,['United States of America'],"['Action', 'Black-and-white', 'Indie', 'Silent film', 'War film', 'Adventure', 'Drama']",1920,6
31743727,Down Under the Big Top,1996,[],"['Music', 'Comedy film']",1990,6
9210380,Felidae,1994,['Germany'],"['Fantasy Adventure', 'Detective fiction', 'Animation', 'Mystery', 'Detective', 'Fantasy']",1990,4
1637209,The Hedgehog in the Fog,1975,['Soviet Union'],"['Animation', 'Short Film', 'Stop motion']",1970,5
6426246,"Mitr, My Friend",2002,['India'],"['Musical', 'Art film', 'Bollywood', 'World cinema', 'Drama']",2000,2
706860,Waiting for Guffman,1997,['United States of America'],"['Mockumentary', 'Indie', 'Comedy']",1990,7
28713430,Jaan,1996,[],['Action'],1990,6
18713808,Country Justice,1997,['United States of America'],"['Television movie', 'Drama', 'Courtroom Drama']",1990,7
5096585,The Poseidon Adventure,2005,['United States of America'],"['Action', 'Action/Adventure', 'Thriller', 'Television movie', 'Disaster', 'Adventure']",2000,5
31122154,Society Mugs,1946,['United States of America'],['Short Film'],1940,6
1089230,Revenge of the Nerds III: The Next Generation,1992,['United States of America'],"['Comedy', 'Teen', 'Sex comedy']",1990,2
18616475,LollyPop,2008,['India'],['Drama'],2000,8
22146195,"For a Moment, Freedom",2008,"['France', 'Turkey', 'Austria']","['Drama', 'World cinema']",2000,8
11785619,The Paper Brigade,1997,['United States of America'],"[""Children's/Family"", 'Comedy', 'Adventure']",1990,7
11354643,Shikar,1968,['India'],['Bollywood'],1960,8
1131021,Elektra,2005,"['Canada', 'United States of America']","['Action', 'Crime Fiction', 'Action/Adventure', 'Thriller', 'Superhero movie', 'Martial Arts Film', 'Fantasy']",2000,5
2158246,Jules and Jim,1961,['France'],"['Period piece', 'Black-and-white', 'Art film', 'Romantic drama', 'World cinema', 'Romance Film', 'Drama']",1960,1
26025529,Vietnam Colony,1993,['India'],"['Action', 'Comedy', 'Bollywood', 'Drama']",1990,3
1126798,"Goodbye, Mr. Chips",1939,['United Kingdom'],"['Black-and-white', 'Drama']",1930,9
10436186,Loveaholic,2006,['Thailand'],"['Comedy', 'Romance Film', 'Romantic comedy', 'Drama']",2000,6
8348194,A byahme mladi,1961,['Bulgaria'],['Drama'],1960,1
14415759,Raffles,1930,['United States of America'],"['Black-and-white', 'Crime Fiction', 'Thriller', 'Romance Film', 'Drama']",1930,0
1597728,Love's Brother,2004,"['United Kingdom', 'Australia']","['Romance Film', 'Drama', 'Comedy film']",2000,4
21394464,Munna-A Love Story,2008,['India'],['Action'],2000,8
3027912,Best Men,1997,['United States of America'],"['Crime Fiction', 'Comedy', 'Crime Comedy', 'Romantic comedy', 'Romance Film', 'Ensemble Film']",1990,7
5570152,I Was a Male War Bride,1949,['United States of America'],"['Romance Film', 'Romantic comedy', 'Comedy']",1940,9
24892849,Pugachev,1978,"['Russia', 'Soviet Union']",['Historical drama'],1970,8
2706589,The Black Dahlia,2006,"['Germany', 'United States of America']","['Film adaptation', 'Neo-noir', 'Crime Fiction', 'Mystery', 'Thriller', 'Film noir', 'Crime Thriller', 'Drama', 'Period piece', 'Suspense']",2000,6
10825522,Brideshead Revisited,2008,"['United Kingdom', 'Morocco', 'Italy']","['Period piece', 'Film adaptation', 'LGBT', 'Romantic drama', 'Romance Film', 'Drama']",2000,8
89541,A Better Tomorrow,1986,"['China', 'Hong Kong']","['Action', 'Crime Fiction', 'Action Thrillers', 'Gangster Film', 'Action/Adventure', 'Buddy film', 'Thriller', 'World cinema', 'Chinese Movies', 'Martial Arts Film', 'Drama']",1980,6
1221565,Junior,1994,['United States of America'],"['Romance Film', 'Romantic comedy', 'Comedy']",1990,4
23687860,Ergastolo,1952,['Italy'],['Drama'],1950,2
448735,Elf,2003,"['Germany', 'United States of America']","['Comedy', ""Children's/Family"", 'Holiday Film', 'Christmas movie', 'Fantasy Comedy', 'Family Film', 'Fantasy']",2000,3
12607320,The Exile,1947,['United States of America'],"['Romance Film', 'Black-and-white', 'Adventure']",1940,7
2578654,Gie,2005,['Indonesia'],"['Biographical film', 'Biopic [feature]', 'Political drama', 'Drama']",2000,5
1749535,Crash,2004,"['Germany', 'United States of America']","['Crime Fiction', 'Indie', 'Drama']",2000,4
2026601,13 Moons,2002,['United States of America'],"['Indie', 'Comedy', 'Comedy-drama', 'Drama']",2000,2
4392496,Island of Fire,1990,"['Hong Kong', 'Taiwan']","['Action', 'Chinese Movies', 'Martial Arts Film']",1990,0
8436417,Les Bicyclettes de Belsize,1968,['United Kingdom'],"['Musical', 'Short Film']",1960,8
358684,The Return of Jafar,1994,['United States of America'],"['Animation', ""Children's/Family"", 'Adventure', 'Family Film']",1990,4
7548287,The Company,2007,['United States of America'],[],2000,7
24067673,My Sister Eileen,1942,['United States of America'],"['Musical', 'Black-and-white', 'Comedy']",1940,2
29745638,Break,2009,['Germany'],"['Action', 'Drama', 'Crime Fiction', 'Gangster Film', 'Crime Thriller']",2000,9
23616834,Page Miss Glory,1936,['United States of America'],"['Musical', 'Animation', 'Short Film', 'Family Film']",1930,6
31304530,Mark of the Devil Part II,1973,['West Germany'],['Horror'],1970,3
101910,The Towering Inferno,1974,['United States of America'],"['Action', 'Action/Adventure', 'Doomsday film', 'Disaster', 'Ensemble Film']",1970,4
27947112,Bony a klid,1987,['Czechoslovakia'],['Drama'],1980,7
31612180,Susanna,2000,[],['Social problem film'],2000,0
31598836,Waiting for the clouds,2003,"['France', 'Germany', 'Turkey', 'Greece']","['Drama', 'World cinema']",2000,3
6034754,Automaton transfusion,2008,['United States of America'],"['Creature Film', 'Action', 'Indie', 'Horror', 'Zombie Film', 'Science Fiction']",2000,8
3669763,Ultimate Deception,1999,['United States of America'],"['Drama', 'Crime Fiction']",1990,9
15087473,The Swan Princess III: The Mystery of the Enchanted Kingdom,1998,['United States of America'],"['Animation', 'Indie', 'Adventure', 'Family Film', 'Fantasy']",1990,8
77604,Hold Back the Dawn,1941,['United States of America'],"['Black-and-white', 'Romantic drama', 'Romance Film', 'Melodrama', 'Drama', 'Tragedy']",1940,1
5451599,Danika,2006,['United States of America'],"['Psychological thriller', 'Thriller', 'Horror', 'Drama']",2000,6
10869055,Maundy Thursday,2006,['South Korea'],['Drama'],2000,6
3122004,Magical Mystery Tour,1967,['United Kingdom'],['Musical'],1960,7
4070802,I Vampiri,1957,['Italy'],"['Black-and-white', 'Horror', 'World cinema']",1950,7
27901604,Karafuto 1945 Summer Hyosetsu no Mon,1974,[],['Drama'],1970,4
987910,La Boum,1980,['France'],"['Coming of age', 'Comedy', 'Teen', 'Romantic comedy']",1980,0
13111116,Jalsa,2008,['India'],"['Action', 'Romantic drama', 'Comedy', 'Thriller', 'World cinema', 'Romance Film', 'Drama', 'Romantic comedy']",2000,8
23001766,Oru Pennum Randaanum,2008,['India'],['Drama'],2000,8
4208760,R.O.T.O.R.,1989,['United States of America'],"['Action', 'Action/Adventure', 'Indie', 'Science Fiction']",1980,9
3181954,Agantuk,1991,['India'],"['Drama', 'Art film', 'Bollywood']",1990,1
7987443,Triple Crossed,1959,['United States of America'],"['Short Film', 'Black-and-white', 'Comedy']",1950,9
901489,Road House,1989,['United States of America'],"['Action', 'Drama', 'Action/Adventure', 'Thriller']",1980,9
24631539,Life Love Death,1969,"['France', 'Italy']",['Drama'],1960,9
36288910,The Fabulous Bastard from Chicago,1969,['United States of America'],"['Sexploitation', 'Drama']",1960,9
1533182,Pride of the Bowery,1941,['United States of America'],"['Black-and-white', 'Sports', 'Comedy']",1940,1
3954917,The Amityville Horror,1979,['United States of America'],"['Film adaptation', 'Horror', 'Supernatural', 'Drama', 'Cult']",1970,9
21616627,Sikuru Tharuwa,1963,['Sri Lanka'],['Drama'],1960,3
4619034,New Fist of Fury,1976,['Hong Kong'],"['Action', 'Action/Adventure', 'World cinema', 'Chinese Movies', 'Martial Arts Film']",1970,6
12122385,Absurd,1981,['Italy'],"['Slasher', 'World cinema', 'Horror']",1980,1
13412180,The Countess,2009,"['France', 'Germany', 'United States of America']","['Crime Fiction', 'Romantic drama', 'Biographical film', 'Thriller', 'World cinema', 'Romance Film', 'Crime Thriller', 'Drama', 'Period piece', 'History', 'Horror']",2000,9
10049290,Firehouse Dog,2007,['United States of America'],"['Action', 'Comedy', 'Animal Picture', 'Family-Oriented Adventure', ""Children's/Family"", 'Family Film']",2000,7
20518593,Chief Charlie Horse,1956,['United States of America'],"['Animation', 'Short Film', 'Western', 'Comedy film', 'Family Film']",1950,6
8625710,Seventh Heaven,1937,['United States of America'],"['Film adaptation', 'Black-and-white', 'Romance Film', 'Drama']",1930,7
2537424,Cookie,1989,['United States of America'],"['Crime Fiction', 'Indie', 'Comedy']",1980,9
21181180,The Virtuous Sin,1930,['United States of America'],"['Romantic drama', 'Comedy film', 'Romance Film', 'Comedy-drama', 'Drama']",1930,0
14704654,Edgar Allan Poe's Murders in the Rue Morgue,1971,['United States of America'],"['Film adaptation', 'Thriller', 'Horror', 'Crime Thriller', 'Drama']",1970,1
10641282,Sharmeelee,1971,['India'],"['Musical', 'Romance Film', 'Mystery']",1970,1
20691749,A Few Good Men,1992,['United States of America'],"['Crime Fiction', 'Mystery', 'Thriller', 'Legal drama', 'Drama', 'Courtroom Drama']",1990,2
1285833,The Men,1950,['United States of America'],"['Documentary', 'Romance Film', 'War film', 'Drama', 'Medical fiction']",1950,0
23618548,Trade In,2009,['United States of America'],['Comedy film'],2000,9
25229253,Deadly Lessons,1983,['United States of America'],['Thriller'],1980,3
12190400,Outlaw Blues,1977,['United States of America'],"['Chase Movie', 'Romantic comedy', 'Comedy-drama', 'Road movie', 'Drama']",1970,7
23977165,Valter Brani Sarajevo,1972,"['Yugoslavia', 'Socialist Federal Republic of Yugoslavia']",['War film'],1970,2
10122950,Pandora's Clock,1996,['United States of America'],"['Action', 'Drama', 'Action Thrillers', 'Thriller', 'Disaster']",1990,6
16570645,Brown on Resolution,1935,['United Kingdom'],"['War film', 'Black-and-white']",1930,5
22739770,In the Beginning,2009,['France'],"['Crime Fiction', 'Drama', 'World cinema']",2000,9
12290387,Aayirathil Oruvan,2008,['India'],['Adventure'],2000,8
8354866,Don't Go to Sleep,1982,['United States of America'],"['Mystery', 'Supernatural', 'Horror']",1980,2
4083283,Hell Night,1981,['United States of America'],"['Indie', 'Slasher', 'Teen', 'Horror']",1980,1
68047,The Caine Mutiny,1954,['United States of America'],"['War film', 'Drama', 'Courtroom Drama']",1950,4
3048122,Maladolescenza,1977,"['West Germany', 'Italy']","['Romance Film', 'Coming of age', 'Drama']",1970,7
2105280,Darr,1993,['India'],"['Bollywood', 'Thriller', 'Horror', 'World cinema']",1990,3
12394296,No Looking Back,1998,['United States of America'],"['Romantic drama', 'Indie', 'Comedy', 'Romance Film', 'Drama']",1990,8
31295173,Max and the Junkmen,1971,"['France', 'Italy']","['Romance Film', 'Crime Fiction', 'Drama']",1970,1
691154,The Teahouse of the August Moon,1956,['United States of America'],"['Comedy', 'Comedy of manners', 'Romantic comedy', 'Comedy-drama']",1950,6
3009141,When a Stranger Calls,2006,['United States of America'],"['Psychological thriller', 'Slasher', 'Thriller', 'Horror', 'Teen', 'Crime Thriller']",2000,6
10953000,Red Doors,2006,['United States of America'],"['LGBT', 'Drama', 'Indie', 'Family Drama', 'Comedy', 'Black comedy']",2000,6
3374760,A Geisha,1953,['Japan'],"['Melodrama', 'Japanese Movies', 'Drama']",1950,3
1678600,Phantom Below,2005,['United States of America'],"['Action', 'Drama', 'Action/Adventure', 'Thriller', 'War film']",2000,5
4227,Barry Lyndon,1975,"['United Kingdom', 'United States of America']","['Period piece', 'Film adaptation', 'New Hollywood', 'Romance Film', 'War film', 'Costume drama', 'Drama']",1970,5
8266218,Agni Sakshi,1996,['India'],"['Musical', 'Thriller', 'Bollywood', 'World cinema']",1990,6
7720166,Dead End Run,2003,['Japan'],['Japanese Movies'],2000,3
3439619,Read my Lips,2001,['France'],"['Psychological thriller', 'Crime Fiction', 'Romantic drama', 'Thriller', 'World cinema', 'Romance Film', 'Drama']",2000,1
9718353,The Browning Version,1994,['United Kingdom'],['Drama'],1990,4
18907092,Seagulls Over Sorrento,1954,['United Kingdom'],"['Black-and-white', 'War film', 'Drama']",1950,4
14291637,Fool's Gold,2008,['United States of America'],"['Action', 'Action/Adventure', 'Comedy', 'Adventure', 'Romance Film', 'Romantic comedy']",2000,8
26084708,Straight Into Darkness,2004,['United States of America'],"['Action', 'Period piece', 'Drama', 'War film']",2000,4
20580603,Satan Never Sleeps,1962,['United States of America'],['Drama'],1960,2
18702866,Horizons West,1952,['United States of America'],"['Action', 'Western']",1950,2
26678007,Skeleton Crew,2009,['Finland'],"['Slasher', 'Horror']",2000,9
14435996,Hokus Pokus,1949,['United States of America'],"['Black-and-white', ""Children's Fantasy"", 'Short Film', 'Comedy', ""Children's/Family"", 'Fantasy Comedy']",1940,9
30627782,Kalvanin Kadhali,1955,['India'],['Drama'],1950,5
4943020,One Leg Kicking,2001,['Singapore'],"['Sports', 'Comedy']",2000,1
33082891,No Picnic,1987,['United States of America'],['Drama'],1980,7
32297704,The Fifth Dimension of Sex,1984,['Brazil'],"['Adult', 'Pornographic movie']",1980,4
2642659,Sethurama Iyer CBI,2004,['India'],"['Mystery', 'Thriller']",2000,4
26740727,One More Chance,2005,['United States of America'],"['Short Film', 'Drama']",2000,5
88326,Ferris Bueller's Day Off,1986,['United States of America'],"['Coming of age', 'Comedy', 'Teen', 'Drama', 'Cult']",1980,6
89397,A Bridge Too Far,1977,"['United Kingdom', 'United States of America']","['Combat Films', 'Action', 'Film adaptation', 'Indie', 'Drama', 'Period piece', 'The Netherlands in World War II', 'War film']",1970,7
1238874,Matewan,1987,['United States of America'],"['Drama', 'History', 'Indie', 'Social problem film', 'Americana', 'Political drama', 'Ensemble Film']",1980,7
3546400,Busted,1996,['United States of America'],"['Parody', 'Comedy']",1990,6
3076353,Autograph,2004,['India'],"['Musical', 'Romantic drama', 'World cinema', 'Tamil cinema', 'Romance Film', 'Drama']",2000,4
22984649,I Sell The Dead,2008,['United States of America'],"['Comedy', 'Horror Comedy', 'Black comedy', 'Zombie Film', 'Costume Horror', 'Creature Film', 'Period piece', 'Horror']",2000,8
19347897,"Moan and Groan, Inc.",1929,['United States of America'],"['Short Film', 'Black-and-white', 'Comedy']",1920,9
26663186,To thyma,1965,['Greece'],['Drama'],1960,5
27626743,Jalopy,1953,['United States of America'],['Comedy'],1950,3
17016522,Beyond the Limits,2003,['Germany'],"['Thriller', 'Horror']",2000,3
31323950,The Rabbit Is Me,1965,['German Democratic Republic'],"['Romance Film', 'Drama']",1960,5
3147593,Kissing a Fool,1998,['United States of America'],"['Romance Film', 'Romantic comedy', 'Comedy']",1990,8
2676861,Kinky Boots,2005,"['United Kingdom', 'United States of America']","['Indie', 'Comedy', 'Buddy film', 'Comedy of manners']",2000,5
20903086,Kasauti,1974,['India'],"['Family Drama', 'Drama']",1970,4
1219909,Shōgun,1980,"['Japan', 'United States of America']","['Action', 'History', 'Japanese Movies', 'War film', 'Adventure', 'Drama']",1980,0
6034681,In Name Only,1939,['United States of America'],"['Romance Film', 'Black-and-white', 'Drama']",1930,9
4055603,Voodoo Dawn,1991,['United States of America'],"['Suspense', 'Thriller', 'Horror', 'Supernatural']",1990,1
23374451,The Sitter,1991,['United States of America'],"['Psychological thriller', 'Thriller']",1990,1
1138104,Beverly Hills Cop III,1994,['United States of America'],"['Action', 'Crime Fiction', 'Action Comedy', 'Action/Adventure', 'Buddy film', 'Comedy']",1990,4
3940964,Time of the Gypsies,1988,"['Yugoslavia', 'United Kingdom', 'Bosnia and Herzegovina', 'Italy']","['Coming of age', 'Comedy-drama', 'Tragicomedy', 'Drama', 'Fantasy']",1980,8
2654899,Pyaasa,1957,['India'],"['Musical', 'Bollywood', 'World cinema', 'Drama']",1950,7
5480296,Véronique et son cancre,1958,['France'],['Short Film'],1950,8
5458655,Staten Island Catapult,2005,['United States of America'],['Documentary'],2000,5
3235051,Tristan & Isolde,2006,"['United Kingdom', 'Germany', 'Czech Republic', 'United States of America']","['Action', 'Period piece', 'Romantic drama', 'Romance Film', 'Adventure', 'Drama', 'Tragedy']",2000,6
1275430,Patterns,1956,['United States of America'],"['Black-and-white', 'Indie', 'Drama']",1950,6
18317315,Kal Kisne Dekha,2009,['India'],"['Musical', 'Romantic drama', 'Bollywood', 'World cinema', 'Romance Film', 'Drama']",2000,9
9281461,Shangri-La,2002,['Japan'],"['Japanese Movies', 'Comedy', 'Drama']",2000,2
8893825,Purgatory,1999,['United States of America'],"['Action/Adventure', 'Western', 'Television movie', 'Fantasy']",1990,9
8090904,The Indian Runner,1991,"['Japan', 'United States of America']","['Period piece', 'Japanese Movies', 'Family Drama', 'Drama']",1990,1
24063376,The Payoff,1942,['United States of America'],"['Black-and-white', 'Crime Fiction', 'Mystery', 'Thriller', 'Crime Thriller', 'Drama']",1940,2
975900,Ghosts of Mars,2001,['United States of America'],"['Action', 'Thriller', 'Horror', 'Adventure', 'Space western', 'Supernatural', 'Science Fiction']",2000,1
23346166,Chastity,1969,['United States of America'],['Drama'],1960,9
8267372,The Painted Stallion,1937,['United States of America'],"['Action', 'Black-and-white', 'Western', 'Action/Adventure', 'Adventure']",1930,7
8058697,The Garden of the Finzi-Continis,1970,"['Germany', 'Italy']","['Romantic drama', 'Historical drama', 'World cinema', 'Romance Film', 'War film', 'Drama', 'History', 'Political drama']",1970,0
10019785,One Night Husband,2003,['Thailand'],"['Thriller', 'Drama']",2000,3
19033987,No Smoking,1955,['United Kingdom'],['Comedy'],1950,5
867935,High and Low,1963,['Japan'],"['Crime Fiction', 'Japanese Movies', 'Art film', 'Thriller', 'World cinema', 'Crime Thriller', 'Drama']",1960,3
4852728,"Sarah, Plain and Tall: Winter's End",1999,['United States of America'],['Drama'],1990,9
25885276,Nightmare Circus,1974,['United States of America'],"['Slasher', 'Horror', 'B-movie', 'Cult']",1970,4
18968628,The Cartier Affair,1984,['United States of America'],"['Heist', 'Comedy', 'Romance Film', 'Romantic comedy', 'Television movie']",1980,4
1870332,The Big Broadcast of 1938,1938,['United States of America'],"['Musical', 'Black-and-white', 'Comedy', 'Musical comedy', 'Ensemble Film']",1930,8
30581698,The Kettles in the Ozarks,1956,['United States of America'],"['Slapstick', 'Comedy film']",1950,6
2108624,Porky's Revenge,1985,"['Canada', 'United States of America']","['Comedy', 'Teen', 'Sports', 'Sex comedy']",1980,5
5443046,Slaughter Disc,2005,['United States of America'],"['Indie', 'Horror']",2000,5
20815259,Dindigul Sarathy,2008,['India'],['Drama'],2000,8
3644380,Cleo from 5 to 7,1962,"['France', 'Italy']","['Music', 'Comedy', 'World cinema', 'Drama']",1960,2
4907371,The Howards of Virginia,1940,['United States of America'],"['Period piece', 'Black-and-white', 'Romantic drama', 'Romance Film', 'Historical fiction', 'War film', 'Drama']",1940,0
25759036,Cow,2009,['China'],"['Chinese Movies', 'Drama']",2000,9
28934114,The Ceremony,1971,['Japan'],"['Japanese Movies', 'Drama']",1970,1
17775028,Tarzan and the Trappers,1958,['United States of America'],"['Action', 'Action/Adventure', 'Jungle Film', 'Adventure']",1950,8
14572142,Diksha,1991,['India'],['Art film'],1990,1
176730,Anarchists,2000,['South Korea'],"['Action', 'Gangster Film', 'Action/Adventure', 'Thriller', 'World cinema', 'Crime Thriller', 'Martial Arts Film', 'Drama', 'Period piece']",2000,0
35965448,The Devil's Advocate,1977,['West Germany'],['Drama'],1970,7
894309,"The Beast from 20,000 Fathoms",1953,['United States of America'],"['Creature Film', 'Monster', 'Horror', 'Stop motion', 'Science Fiction', 'Cult', 'Fantasy']",1950,3
1440478,The Absent-Minded Professor,1961,['United States of America'],"['Fantasy Comedy', 'Comedy', ""Children's/Family"", 'Slapstick', 'Science Fiction', 'Drama', 'Family Film']",1960,1
10669385,Space Raiders,1983,['United States of America'],"['Action', 'Adventure', 'Science Fiction', 'Family Film']",1980,3
9129303,Blind Chance,1987,['Poland'],"['World cinema', 'Political drama', 'Drama', 'Fantasy']",1980,7
21041587,The Indian Fighter,1956,['United States of America'],"['Action', 'Action/Adventure', 'Western', 'Indian Western']",1950,6
13308338,Forward March Hare,1953,['United States of America'],"['Animated cartoon', 'Short Film', 'Family Film']",1950,3
20857500,Pin Up Girl,1944,['United States of America'],"['Musical', 'Romance Film', 'Romantic comedy']",1940,4
18185435,Treasure Island,1920,['United States of America'],"['Silent film', 'Black-and-white']",1920,0
1296982,Tweetie Pie,1947,['United States of America'],"['Animation', 'Short Film', 'Comedy', 'Family Film']",1940,7
538455,Dawn of the Dead,2004,"['Canada', 'Japan', 'France', 'United States of America']","['Action', 'Thriller', 'Zombie Film', 'Drama', 'Horror', 'Doomsday film', 'Science Fiction', 'Cult']",2000,4
25644434,Peacemaker,1990,['United States of America'],"['Action', 'Science Fiction']",1990,0
1087247,The Mark of Zorro,1940,['United States of America'],"['Action', 'Action/Adventure', 'Romance Film', 'Swashbuckler films', 'Adventure', 'Drama', 'Western', 'Superhero movie']",1940,0
27686503,American Samurai,1992,['United States of America'],"['Action', 'Action/Adventure', 'Thriller', 'Martial Arts Film']",1990,2
4815029,The War Within,2005,['United States of America'],"['Indie', 'Political drama', 'Drama']",2000,5
3785749,The Search for Animal Chin,1987,"['Canada', 'United States of America']",['Action'],1980,7
3230122,Sympathy for the Devil,1968,"['United Kingdom', 'France', 'England']","['Music', 'Musical', 'Rockumentary', 'Documentary', 'Film', 'Culture & Society', 'Social issues', 'Political cinema']",1960,8
6014292,Clay Pigeons,1998,"['Germany', 'United States of America']","['Psychological thriller', 'Crime Fiction', 'Indie', 'Comedy', 'Thriller', 'Black comedy', 'Crime Thriller', 'Drama', 'Comedy Thriller']",1990,8
2771118,Mulholland Falls,1996,['United States of America'],"['Neo-noir', 'Crime Fiction', 'Mystery', 'Indie', 'Thriller', 'Crime Thriller', 'Drama', 'Period piece']",1990,6
12001,Terror of Mechagodzilla,1975,['Japan'],"['Monster', 'World cinema', ""Children's"", 'Creature Film', 'Japanese Movies', 'Horror', 'Science Fiction', 'Cult', 'Fantasy']",1970,5
10598361,Lion Vs. Lion,1981,['Hong Kong'],"['Action', 'Martial Arts Film', 'Drama']",1980,1
31097634,My Dear Karadi,1999,[],"['Drama', 'Comedy film']",1990,9
31326554,The Bad Bunch,1973,['United States of America'],['Blaxploitation'],1970,3
5208755,Premante Idera,1998,['India'],"['Romance Film', 'Romantic comedy', 'Romantic drama']",1990,8
19578367,Brainwashed,1960,['Germany'],['Drama'],1960,0
185783,Time Indefinite,1993,['United States of America'],"['Interpersonal Relationships', 'Biography', 'Documentary', 'Culture & Society']",1990,3
20088245,The Sensei,2007,['United States of America'],"['LGBT', 'Indie', 'Action/Adventure', 'Martial Arts Film', 'Drama']",2000,7
2877925,Bambi II,2006,['United States of America'],"['Animation', 'Coming of age', 'Family-Oriented Adventure', ""Children's/Family"", 'Adventure', 'Family Film']",2000,6
27131059,Saddle the Wind,1958,['United States of America'],"['Action', 'Western', 'Action/Adventure']",1950,8
5221381,Dogs of War,1923,['United States of America'],"['Black-and-white', 'Indie', 'Short Film', 'Comedy', 'Silent film', 'Family Film']",1920,3
24165863,The Big Gamble,1961,['United States of America'],"['Action', 'Drama', 'Comedy']",1960,1
217800,Women in Love,1969,['United Kingdom'],"['Period piece', 'Erotic Drama', 'Romance Film', 'Drama']",1960,9
24792875,Napoleon Bunny-Part,1956,[],"['Animation', 'Short Film', 'Comedy film', 'Family Film']",1950,6
10128536,The Mating Game,1959,['United States of America'],['Romance Film'],1950,9
2399020,Black Friday,2004,['India'],"['Drama', 'Bollywood', 'World cinema']",2000,4
25915397,Uyarangalil,1984,['India'],"['Drama', 'Crime Fiction', 'Thriller']",1980,4
22439052,Shadow Dancing,1988,['Canada'],"['Psychological thriller', 'Mystery', 'Thriller']",1980,8
26136065,Aşk Tutulması,2008,['Turkey'],"['Romance Film', 'Comedy film']",2000,8
13644074,1612,2007,['Russia'],"['War film', 'Drama', 'World cinema']",2000,7
21873890,Zameer: The Fire Within,2005,['India'],"['Romantic drama', 'World cinema', 'Romance Film', 'Drama']",2000,5
33526115,Eloïse,2009,['Spain'],"['LGBT', 'World cinema', 'Romance Film', 'Drama']",2000,9
31083375,The Doctor and the Girl,1949,['United States of America'],"['Romance Film', 'Drama']",1940,9
17987447,Subramaniapuram,2008,['India'],"['Action', 'Drama']",2000,8
15156718,The Mating Call,1928,['United States of America'],"['Silent film', 'Black-and-white', 'Pre-Code']",1920,8
21955983,Dil Ka Kya Kasoor,1992,['India'],['World cinema'],1990,2
5392217,Tere Ghar ke Saamne,1963,['India'],"['Musical', 'Comedy', 'Romance Film', 'Romantic comedy']",1960,3
36157703,Tohfa,1984,['India'],"['Action', 'Drama', 'Romance Film', 'Family Film']",1980,4
1399634,Max,2002,"['Hungary', 'Canada']","['Period piece', 'Biography', 'War film', 'Political drama', 'Drama']",2000,2
26334725,Ventriloquist Cat,1950,['United States of America'],"['Animation', 'Short Film', 'Comedy']",1950,0
9003163,Aag,1994,['India'],['Action'],1990,4
10388844,The Best Bet,2004,['Singapore'],"['Drama', 'Comedy']",2000,4
1363646,Rad,1986,['United States of America'],"['Sports', 'Drama']",1980,6
25117126,Pope Dreams,2006,['United States of America'],"['Romantic drama', 'Indie', 'Romance Film', 'Drama']",2000,6
915192,A Life Less Ordinary,1997,"['United Kingdom', 'United States of America']","['Romantic fantasy', 'Heavenly Comedy', 'Comedy', 'Romantic comedy', 'Black comedy', 'Romance Film', 'Fantasy']",1990,7
5371282,The Ex,1997,"['Canada', 'United States of America']","['Psychological thriller', 'Indie', 'Thriller']",1990,7
2339579,Fat City,1972,['United States of America'],"['Boxing', 'Film adaptation', 'New Hollywood', 'Sports', 'Drama']",1970,2
35790649,Honest Raj,1994,['India'],['Crime Fiction'],1990,4
7342730,Waiter,2006,"['Netherlands', 'Belgium']",['Black comedy'],2000,6
17906343,Vellanakalude Nadu,1988,['India'],"['Drama', 'Comedy film']",1980,8
5339355,Blood & Orchids,1986,['United States of America'],['Drama'],1980,6
11507219,You Must Be Joking!,1986,['South Africa'],['Comedy'],1980,6
1971307,To Have and Have Not,1944,['United States of America'],"['Music', 'Black-and-white', 'Romantic drama', 'Thriller', 'Film noir', 'Romance Film', 'Adventure', 'Drama', 'War film']",1940,4
8018380,The Browning Version,1951,['United Kingdom'],['Drama'],1950,1
4330835,Immoral Tales,1974,['France'],"['Drama', 'Softcore Porn', 'Erotic Drama', 'Avant-garde', 'Experimental film', 'Erotica', 'Adult']",1970,4
1854612,Casper: A Spirited Beginning,1997,['United States of America'],"['Comedy', 'Family Film']",1990,7
10612874,A Man to Remember,1938,['United States of America'],"['Black-and-white', 'Drama']",1930,8
5632013,Mr. Freedom,1969,['France'],"['Art film', 'Comedy', 'World cinema', 'Drama']",1960,9
441280,Dungeons & Dragons,2000,['United States of America'],"['Action/Adventure', 'Sword and sorcery', 'Sword and sorcery films', 'Mockumentary', 'Fantasy']",2000,0
16276017,Densen Uta,2007,['Japan'],"['Japanese Movies', 'World cinema', 'Horror']",2000,7
5498248,The King Maker,2005,['Thailand'],"['Romantic drama', 'Historical drama', 'World cinema', 'Romance Film', 'Costume drama', 'Adventure', 'Drama', 'Period piece', 'Historical Epic']",2000,5
1138831,True Stories,1986,['United States of America'],"['Musical', 'Indie', 'Satire', 'Comedy', 'Americana', 'Parody', 'Cult', 'Ensemble Film']",1980,6
33035751,Soft Pedal,1996,['France'],['Comedy'],1990,6
1815221,The Gathering Storm,2002,"['United Kingdom', 'United States of America']","['Period piece', 'History', 'Biography', 'Television movie', 'Political drama', 'Drama']",2000,2
19843417,Aai,2004,['India'],['Drama'],2000,4
24160921,Body Slam,1987,['United States of America'],"['Action', 'Action/Adventure', 'Comedy', 'Sports']",1980,7
16941996,House of Memories,2000,['India'],"['Art film', 'Drama', 'Family Film']",2000,0
26494309,Pookkalam Varavayi,1991,['India'],"['Comedy', 'Drama', 'Family Film']",1990,1
4012556,Ernest Scared Stupid,1991,['United States of America'],"['Slapstick', 'Comedy', 'Holiday Film', ""Children's"", 'Family Film']",1990,1
14155548,Donald's Tire Trouble,1943,['United States of America'],"['Animation', 'Short Film', 'Comedy film', 'Propaganda film', 'Family Film']",1940,3
3231682,The Texas Chainsaw Massacre,2003,['United States of America'],"['Mystery', 'Thriller', 'Remake', 'Teen', 'Slasher', 'Horror', 'Road-Horror', 'Cult']",2000,3
398934,10 Things I Hate About You,1999,['United States of America'],"['Coming of age', 'Comedy', 'Teen', 'Romance Film', 'Romantic comedy']",1990,9
16489470,Vaitheeswaran,2008,['India'],"['Romance Film', 'Drama']",2000,8
7586065,Raja Babu,1994,['India'],"['Melodrama', 'Romantic drama', 'Drama']",1990,4
2954138,Hide-Out,1934,['United States of America'],"['Black-and-white', 'Romantic drama', 'Comedy', 'Crime Drama', 'Film noir', 'Melodrama', 'Drama']",1930,4
19507658,Shri Krishna Pandaviyam,1966,['India'],"['Musical', 'Drama']",1960,6
10558683,Ay Carmela,1990,['Spain'],"['War film', 'Drama']",1990,0
5603801,A/k/a Tommy Chong,2006,['United States of America'],"['Law & Crime', 'Biography', 'Documentary', 'Culture & Society']",2000,6
9951507,Once Upon a Time in China IV,1994,"['China', 'Hong Kong']","['Chinese Movies', 'Martial Arts Film', 'Adventure']",1990,4
10962872,Hattrick,2007,['India'],"['Musical', 'Romantic drama', 'Comedy', 'Bollywood', 'World cinema', 'Romance Film', 'Drama', 'Sports']",2000,7
23647555,Gunshy,1998,['United States of America'],"['Action', 'Gangster Film', 'Mystery', 'Action/Adventure', 'Thriller', 'Crime Thriller', 'Drama', 'Crime Drama']",1990,8
18898096,Just One of the Girls,1993,"['Canada', 'United States of America']","['Comedy', 'Teen', 'Romantic comedy', 'Romance Film', 'Sports', 'Comedy of Errors']",1990,3
16143348,Gawain and the Green Knight,1973,['United Kingdom'],"['Action', 'Fantasy Adventure', 'Fantasy']",1970,3
355807,Second Skin,2000,['Spain'],"['LGBT', 'Romantic drama', 'World cinema', 'Romance Film', 'Drama']",2000,0
781946,Breaking the Waves,1996,"['Denmark', 'Iceland', 'Sweden', 'Norway', 'France', 'Germany', 'Netherlands']","['Drama', 'Indie', 'Erotic Drama', 'Romantic drama', 'World cinema', 'Romance Film', 'Melodrama']",1990,6
17610367,Lady from Chungking,1942,['United States of America'],"['Black-and-white', 'War film', 'Propaganda film', 'Drama']",1940,2
2371912,Jesse James,1939,['United States of America'],"['Action', 'Action/Adventure', 'Western', 'Biographical film']",1930,9
14508376,Akkara Paha,1969,['Sri Lanka'],"['Black-and-white', 'Drama']",1960,9
18253791,Chris & Don: A Love Story,2007,['United States of America'],"['Gay Themed', 'LGBT', 'Indie', 'Documentary']",2000,7
24086619,Everyday is a Holiday,2009,['France'],"['Comedy', 'World cinema', 'Road movie', 'Drama']",2000,9
3650182,Undercover Angel,1999,"['Canada', 'United States of America']","['Comedy film', 'Romance Film', 'Romantic comedy', 'Drama']",1990,9
2317985,Melvin Goes to Dinner,2003,['United States of America'],"['Indie', 'Comedy', 'Ensemble Film']",2000,3
27147259,Kakashi,2001,['Japan'],"['Japanese Movies', 'Fantasy', 'Horror']",2000,1
29823857,Sette note in nero,1977,['Italy'],"['Drama', 'Mystery', 'Thriller']",1970,7
5904965,Perfect Friday,1970,['United Kingdom'],"['Crime Fiction', 'Caper story', 'Comedy', 'Crime Comedy']",1970,0
4666906,Tengoku no honya,2004,['Japan'],['Japanese Movies'],2000,4
447139,Sorcerer,1977,['United States of America'],"['Action', 'Crime Fiction', 'Action/Adventure', 'Thriller', 'Crime Thriller', 'Cult', 'Adventure', 'Drama', 'Suspense', 'Existentialism', 'New Hollywood']",1970,7
3843721,Hiroshima,1995,"['Canada', 'Japan']","['Period piece', 'Japanese Movies', 'Television movie', 'Political drama', 'Drama']",1990,5
7260058,Werewolf,1996,['United States of America'],"['Indie', 'Horror', 'B-movie', 'Science Fiction']",1990,6
2199665,Fortress,1993,"['New Zealand', 'Australia', 'United States of America']","['Dystopia', 'Indie', 'World cinema', 'Science Fiction']",1990,3
28376341,Voices,1973,['United Kingdom'],['Horror'],1970,3
1998309,The Circle,2000,"['Switzerland', 'Iran', 'Italy']","['Drama', 'World cinema']",2000,0
12592974,La prima Angélica,1974,['Spain'],['Drama'],1970,4
6302293,Stariki-razboyniki,1971,['Soviet Union'],['Comedy'],1970,1
13084559,Manorama Six Feet Under,2007,['India'],"['Musical', 'Thriller', 'Bollywood', 'World cinema']",2000,7
15392312,Collier & Co.,2006,['United States of America'],"['Action', 'Action/Adventure', 'Comedy', 'Adventure', 'Family Film']",2000,6
8324810,National Lampoon's TV: The Movie,2006,['United States of America'],"['Parody', 'Satire', 'Comedy', 'Media Satire', 'Slapstick']",2000,6
17786854,Five Dollars a Day,2008,['United States of America'],"['Drama', 'Crime Fiction', 'Indie', 'Comedy', 'Comedy-drama', 'Road movie']",2000,8
2193661,Taras Bulba,1962,"['Argentina', 'Yugoslavia', 'United States of America']","['Action', 'Film adaptation', 'Romantic drama', 'Action/Adventure', 'Romance Film', 'Adventure', 'Drama', 'Epic']",1960,2
5016298,Bronco Billy,1980,['United States of America'],"['Action/Adventure', 'Western', 'Comedy', 'Romance Film', 'Adventure', 'Drama']",1980,0
19576286,Bussen,1961,['Norway'],['Comedy'],1960,1
8603532,Dharam Veer,1977,['India'],['World cinema'],1970,7
20394155,A Tale of Legendary Libido,2008,['South Korea'],"['Comedy', 'Comedy film', 'Fantasy']",2000,8
3595521,Birdcage Inn,1998,['South Korea'],['Drama'],1990,8
877220,The Crow: City of Angels,1996,['United States of America'],"['Action', 'Crime Fiction', 'Superhero', 'Action Thrillers', 'Thriller', 'Superhero movie', 'Fantasy']",1990,6
2495320,Bill and Coo,1948,['United States of America'],"['Musical', 'Family Film', 'Fantasy']",1940,8
12300854,Khandhar,1984,['India'],['Art film'],1980,4
21254725,Two Tickets to Paradise,2006,['United States of America'],"['Indie', 'Comedy', 'Comedy-drama', 'Road movie']",2000,6
21456296,America,2009,['United States of America'],"['Drama', 'Television movie']",2000,9
9928913,Fakers,2004,"['United Kingdom', 'Spain']","['Action', 'Action/Adventure', 'Comedy']",2000,4
3717818,Colorado Territory,1949,['United States of America'],"['Film noir', 'Crime Drama', 'Western']",1940,9
3653800,A Story of Floating Weeds,1934,['Japan'],"['Black-and-white', 'Drama', 'Japanese Movies', 'Indie', 'World cinema', 'Silent film']",1930,4
11669128,Big Bad Wolf,2006,['United States of America'],"['Creature Film', 'Horror Comedy', 'Horror', 'B-movie']",2000,6
605676,Them!,1954,['United States of America'],"['Creature Film', 'Monster', 'Horror', 'B-movie', 'Sci-Fi Horror', 'Science Fiction', 'Natural horror films']",1950,4
4492505,Come and See,1985,"['Russia', 'Soviet Union']","['Coming of age', 'Action/Adventure', 'World cinema', 'War film', 'Drama']",1980,5
3470692,Julius Caesar,2002,"['Netherlands', 'Germany', 'Italy', 'United States of America']",['Costume drama'],2000,2
1923292,The Pleasure Seekers,1964,['United States of America'],"['Musical', 'Comedy', 'Romance Film', 'Romantic comedy']",1960,4
32467498,Lone Hero,2002,"['Canada', 'United States of America']","['Action', 'Suspense', 'Action/Adventure', 'Thriller']",2000,2
22092460,Universal Soldiers: Regeneration,2009,['United States of America'],"['Action', 'Action/Adventure', 'Science Fiction', 'Thriller', 'Martial Arts Film']",2000,9
12312480,Voice,1982,"['Russia', 'Soviet Union']","['Romance Film', 'Drama']",1980,2
2849958,Samurai Rebellion,1967,['Japan'],"['Period piece', 'Samurai cinema', 'Art film', 'Japanese Movies', 'World cinema', 'Historical fiction', 'Drama']",1960,7
18413929,"Bleach: Fade to Black, I Call Your Name",2008,['Japan'],"['Anime', 'Animation']",2000,8
3985680,Human Highway,1982,['United States of America'],"['Science Fiction', 'Comedy', 'Fantasy Comedy']",1980,2
8807172,Poi,2006,['India'],"['Musical', 'Bollywood', 'World cinema', 'Drama']",2000,6
12156677,Amphitryon,1935,['Germany'],"['Musical', 'Mythological Fantasy']",1930,5
6270677,The Brand Upon the Brain,2006,"['Canada', 'United States of America']","['Indie', 'Experimental film', 'Silent film', 'Drama', 'Fantasy']",2000,6
33366105,1981,2009,['Canada'],"['Coming of age', 'Indie', 'Comedy', 'World cinema']",2000,9
6641931,I Am Legend,2007,['United States of America'],"['Film adaptation', 'Action/Adventure', 'Thriller', 'Plague', 'Zombie Film', 'Apocalyptic and post-apocalyptic fiction', 'Disaster', 'Drama', 'Doomsday film', 'Dystopia', 'Horror', 'Albino bias', 'Science Fiction']",2000,7
6368709,The Class of Nuke 'Em High Part II: Subhumanoid Meltdown,1991,['United States of America'],"['Comedy', 'Horror', 'Black comedy', 'B-movie', 'Science Fiction', 'Cult']",1990,1
11554728,Odeyil Ninnu,1965,['India'],['Social problem film'],1960,5
23821597,Cat Chaser,1989,['United States of America'],"['Action', 'Crime Fiction', 'Indie', 'Action/Adventure', 'Thriller', 'Crime Thriller', 'Drama', 'Suspense']",1980,9
1346905,The Kid,1921,['United States of America'],"['Black-and-white', 'Drama', 'Indie', 'Comedy', 'Silent film']",1920,1
2295249,A Killer Among Us,1990,['United States of America'],"['Psychological thriller', 'Detective fiction', 'Mystery', 'Thriller', 'Detective']",1990,0
2376744,Sympathy for Mr. Vengeance,2002,['South Korea'],"['Action', 'Action Thrillers', 'Action/Adventure', 'Thriller', 'World cinema', 'Crime Thriller']",2000,2
6252532,Quicksilver,1986,['United States of America'],"['Drama', 'Crime Fiction']",1980,6
31361887,Seeding of a Ghost,1983,['Hong Kong'],"['Chinese Movies', 'Thriller', 'Horror', 'World cinema']",1980,3
26541,Repo Man,1984,['United States of America'],"['Action', 'Comedy', 'Crime Comedy', 'Science Fiction', 'Cult']",1980,4
5480052,The Sun,2005,"['Switzerland', 'Japan', 'Russia', 'France', 'Italy']","['History', 'Japanese Movies', 'Biographical film', 'World cinema', 'War film', 'Drama']",2000,5
23560481,Sakay,1993,['Philippines'],"['Filipino Movies', 'Historical fiction', 'Drama']",1990,3
2060144,Adventures of Captain Marvel,1941,['United States of America'],"['Black-and-white', 'Action/Adventure', 'Superhero movie', 'Drama', 'Family Film', 'Fantasy']",1940,1
27420904,The Uncanny,1977,"['Canada', 'United Kingdom']",['Horror'],1970,7
15877550,Ek Din 24 Ghante,2003,['India'],"['Musical', 'Romantic drama', 'Thriller', 'Bollywood', 'World cinema', 'Romance Film', 'Drama']",2000,3
28091621,Bitter Sweet,2004,"['France', 'Japan']","['Japanese Movies', 'Romantic drama', 'World cinema', 'Pinku eiga', 'Romance Film', 'Drama']",2000,4
1699256,Duplex,2003,"['Germany', 'United States of America']","['Black comedy', 'Comedy']",2000,3
24232205,Treloi polyteleias,1963,['Greece'],['Comedy'],1960,3
23484650,The Rookie,1959,['United States of America'],['Comedy film'],1950,9
2350630,Wake of Death,2004,['United States of America'],"['Action', 'Crime Fiction', 'Action Thrillers', 'Action/Adventure', 'Thriller', 'Crime Thriller']",2000,4
13914278,Nirakkoottu,1985,['India'],"['Action', 'Drama', 'Crime Fiction', 'Mystery', 'Thriller']",1980,5
29688997,The Return of Dracula,1958,['United States of America'],"['Horror', 'B-movie']",1950,8
17239935,Caged Fury,1989,['United States of America'],"['Action', 'Exploitation', 'Crime Fiction', 'Action/Adventure', 'Thriller', 'Women in prison films']",1980,9
2320355,The Closet,2001,['France'],"['LGBT', 'Comedy', 'World cinema']",2000,1
3188242,Cause for Alarm!,1951,['United States of America'],"['Psychological thriller', 'Black-and-white', 'Mystery', 'Thriller', 'Film noir', 'Drama']",1950,1
28694630,Sunset Strip,2000,['United States of America'],"['Parody', 'Comedy']",2000,0
35677133,The Mighty Gorga,1969,['United States of America'],['Science Fiction'],1960,9
1815267,NetForce,1999,['United States of America'],"['Action', 'Spy', 'Thriller', 'Television movie', 'War film', 'Science Fiction']",1990,9
8205068,Sayonara Jupiter,1984,['Japan'],"['Japanese Movies', 'Sci-Fi Adventure', 'World cinema', 'Adventure', 'Disaster', 'Science Fiction']",1980,4
1020511,The Final Cut,2004,"['Germany', 'United States of America', 'Canada']","['Mystery', 'Future noir', 'Thriller', 'Science Fiction', 'Drama']",2000,4
6276851,The Boy and the Pirates,1960,['United States of America'],"['Adventure', 'Drama', 'Family Film', 'Fantasy']",1960,0
15677758,Veerasamy,2007,['India'],['Romance Film'],2000,7
100700,John Q,2002,['United States of America'],"['Thriller', 'Drama']",2000,2
1330877,A Dirty Shame,2004,['United States of America'],"['Gross out', 'Gross-out film', 'Parody', 'Comedy', 'Black comedy', 'Cult', 'Sex comedy']",2000,4
2465576,Silent Hill,2006,"['Canada', 'Japan', 'France', 'United States of America']","['Japanese Movies', 'Gothic Film', 'Horror', 'Adventure']",2000,6
7406383,Hanbando,2006,['South Korea'],"['Drama', 'Mystery', 'Thriller']",2000,6
5792459,Dracula: Pages from a Virgin's Diary,2002,['Canada'],"['Musical', 'Indie', 'Comedy', 'Horror', 'Experimental film', 'Silent film', 'Dance']",2000,2
4605877,7G Rainbow Colony,2005,['India'],"['Drama', 'Tamil cinema']",2000,5
9170349,Murder in the Senate,1984,['Argentina'],"['Crime Fiction', 'History', 'Drama']",1980,4
24327688,The Comedians,1941,['Germany'],"['Drama', 'Biographical film']",1940,1
11582801,Children of the Night,1991,['United States of America'],"['Supernatural', 'Teen', 'Horror']",1990,1
30656210,Ambikapathy,1957,['India'],['Drama'],1950,7
1411408,Shadows and Fog,1992,['United States of America'],"['Mystery', 'Indie', 'Comedy Thriller', 'Thriller', 'Comedy', 'Black comedy', 'Comedy of Errors']",1990,2
851645,Andaz apna apna,1994,['India'],"['Romantic drama', 'Comedy', 'Bollywood', 'World cinema', 'Romance Film', 'Drama', 'Crime Comedy', 'Romantic comedy']",1990,4
13914120,Yathra,1985,['India'],"['Romance Film', 'Drama']",1980,5
23525900,32A,2007,"['Ireland', 'Germany']","['Coming of age', 'Drama']",2000,7
113013,Stand and Deliver,1988,['United States of America'],"['Coming of age', 'Comedy', 'Biographical film', 'Drama']",1980,8
3511167,George Wallace,1997,['United States of America'],"['Period piece', 'Biography', 'Biographical film', 'Biopic [feature]', 'Political drama', 'Drama']",1990,7
77658,In Which We Serve,1942,['United Kingdom'],"['Black-and-white', 'War film', 'Drama']",1940,2
23114401,Acolytes,2008,"['New Zealand', 'Australia']","['Psychological thriller', 'Mystery', 'Thriller', 'Horror', 'World cinema', 'Crime Thriller']",2000,8
25528994,Toytown Hall,1936,[],"['Animation', 'Short Film', 'Comedy film', 'Family Film']",1930,6
10428115,Strawberry Fields,1997,['United States of America'],"['Drama', 'Political drama']",1990,7
6823611,This Girl's Life,2004,['United States of America'],"['Indie', 'Drama']",2000,4
1664884,Night Train,1959,['Poland'],"['Mystery', 'Thriller', 'World cinema', 'Drama']",1950,9
2113200,There's Always Vanilla,1971,['United States of America'],"['Romantic drama', 'Comedy', 'Melodrama', 'Drama']",1970,1
76353,The Shop Around the Corner,1940,['United States of America'],"['Black-and-white', 'Comedy', 'Romance Film', 'Romantic comedy', 'Workplace Comedy', 'Drama']",1940,0
5907567,Takkari Donga,2002,['India'],"['Action', 'Western', 'Adventure']",2000,2
7267220,The Magic Christian,1969,['United Kingdom'],"['Parody', 'Satire', 'Comedy', 'Black comedy', 'Cult', 'Absurdism']",1960,9
22831361,Cactus,2008,['Australia'],"['Psychological thriller', 'Crime Fiction', 'Mystery', 'Thriller', 'Drama']",2000,8
14726546,Tom Brown's Schooldays (2005),2005,['United Kingdom'],"['Period piece', 'Film adaptation', 'Coming of age', 'Drama']",2000,5
26016562,Racket Girls,1951,['United States of America'],"['Crime Fiction', 'Crime Thriller']",1950,1
574725,Something Big,1971,['United States of America'],['Western'],1970,1
5645786,Sainikudu,2006,['India'],['Action'],2000,6
6017325,On a Clear Day,2005,['United Kingdom'],"['Family Drama', 'Indie', 'Comedy-drama', 'Sports', 'Drama']",2000,5
15124157,"Drive, He Said",1971,['United States of America'],"['Indie', 'Comedy', 'Sports', 'Drama']",1970,1
1006812,The Beautician and the Beast,1997,['United States of America'],"['Comedy', 'Comedy of manners', 'Romance Film', 'Romantic comedy', 'Family Film']",1990,7
12947954,Bachke Rehna Re Baba,2005,['India'],"['Romantic drama', 'Comedy', 'World cinema', 'Romance Film', 'Romantic comedy', 'Drama']",2000,5
12181468,Back Street,1941,['United States of America'],"['Black-and-white', 'Drama']",1940,1
20854403,Karpagam,1963,['India'],"['Drama', 'World cinema']",1960,3
6126096,The Jennie Project,2001,['United States of America'],"['Adventure', 'Drama', 'Family Film']",2000,1
4041345,Are We Done Yet?,2007,"['Canada', 'United States of America']","['Buddy film', 'Comedy', 'Domestic Comedy', ""Children's"", 'Drama', 'Family Film']",2000,7
3068509,The Monster,1994,"['France', 'Italy']","['Comedy', 'World cinema']",1990,4
10616876,Aap Ki Kasam,1974,['India'],"['Romance Film', 'Drama']",1970,4
13992681,Dick Tracy's Dilemma,1947,['United States of America'],"['Action', 'Detective fiction', 'Black-and-white', 'Crime Fiction', 'Mystery', 'Superhero', 'Film noir', 'Drama', 'Detective', 'Superhero movie']",1940,7
7005141,The Tender Trap,1955,['United States of America'],"['Musical', 'Comedy', 'Romance Film', 'Romantic comedy', 'Sex comedy']",1950,5
2450308,The Fountain,2006,['United States of America'],"['Romantic drama', 'Romance Film', 'Costume drama', 'Science Fiction', 'Drama']",2000,6
12073859,Porky's Pet,1936,['United States of America'],"['Animation', 'Short Film', 'Comedy']",1930,6
25676395,In My Life,2009,"['Philippines', 'United States of America']","['Filipino Movies', 'LGBT', 'World cinema', 'Drama']",2000,9
19460856,Adventures of Power,2009,['United States of America'],"['Musical', 'Indie', 'Comedy', 'Road movie', 'Slice of life story']",2000,9
28958853,The Vigilantes Return,1947,['United States of America'],"['Music', 'Action', 'Western', 'Adventure']",1940,7
1941497,Kin-Dza-Dza,1986,['Soviet Union'],"['Satire', 'Comedy', 'Adventure', 'Science Fiction', 'Fantasy Comedy', 'Fantasy']",1980,6
2160215,Lupin the Third: The Movie - Lupin vs. the Clones,1995,['Japan'],"['Animation', 'Japanese Movies', 'Anime']",1990,5
35870828,4th Period Mystery,2009,['South Korea'],['Thriller'],2000,9
30586621,A Feast at Midnight,1994,['United Kingdom'],"['Comedy', 'Family Film']",1990,4
1271371,Phantom of the Opera,1943,['United States of America'],"['Musical', 'Horror', 'Romance Film', 'Drama']",1940,3
14746483,The Girl Next Door,2007,['United States of America'],"['Psychological thriller', 'Crime Fiction', 'Thriller', 'Teen', 'Drama', 'Slasher', 'Horror', 'Cult']",2000,7
3203830,Escape from Hong Kong Island,2004,['Hong Kong'],"['Comedy', 'World cinema', 'Black comedy', 'Chinese Movies']",2000,4
32809141,Smiley Gets a Gun,1958,[],"['Drama', 'Comedy film']",1950,8
6154618,Terminal Entry,1986,['United States of America'],['Drama'],1980,6
10784436,La Doublure,2007,"['France', 'Italy', 'Belgium']","['Comedy', 'World cinema']",2000,7
5453093,Waco,1966,['United States of America'],"['Action', 'Film adaptation', 'Action/Adventure', 'Western']",1960,6
8699491,L'Aveu,1970,"['France', 'Italy']","['Thriller', 'World cinema', 'Political drama', 'Drama', 'Political thriller']",1970,0
28378769,Mademoiselle from Armentieres,1926,['United Kingdom'],"['Silent film', 'Black-and-white', 'Indie']",1920,6
6030583,Sugar Hill,1974,['United States of America'],"['Action', 'Blaxploitation', 'Crime Fiction', 'Action/Adventure', 'Horror', 'Zombie Film']",1970,4
18812346,The Backyard,2002,['United States of America'],['Documentary'],2000,2
317873,Xanadu,1980,['United States of America'],"['Musical', 'Romance Film', 'Family Film', 'Fantasy']",1980,0
19283683,Shibaji,2008,['India'],"['Action', 'Thriller', 'Drama']",2000,8
20160611,Stowaway,2001,['Hong Kong'],"['Action', 'Action/Adventure', 'Thriller', 'World cinema', 'Chinese Movies']",2000,1
26347112,An American Dream,1966,['United States of America'],['Drama'],1960,6
2983487,Ultraviolet,2006,['United States of America'],"['Action', 'Dystopia', 'Action/Adventure', 'Thriller', 'Superhero movie', 'Martial Arts Film', 'Science Fiction']",2000,6
22281789,Martin and Lewis,2002,['United States of America'],"['Drama', 'Slapstick', 'Biopic [feature]']",2000,2
4762630,"The Book of Mormon Movie, Vol. 1: The Journey",2003,['United States of America'],"['Adventure', 'Drama']",2000,3
12334882,Dr. Renault's Secret,1942,['United States of America'],"['Creature Film', 'Black-and-white', 'Mystery', 'Thriller', 'Horror', 'Crime Thriller', 'Science Fiction']",1940,2
23108273,Five Cartridges,1960,['German Democratic Republic'],['War film'],1960,0
24587410,The Kiss,1929,['United States of America'],['Silent film'],1920,9
12776387,Hamari Bahu Alka,1982,['India'],"['Drama', 'World cinema']",1980,2
9857629,Angel,1984,['United States of America'],"['Action', 'Psychological thriller', 'Crime Fiction', 'Sexploitation', 'Thriller', 'Erotic thriller', 'Crime Thriller']",1980,4
27271852,Pariah,1998,['United States of America'],"['Indie', 'Drama']",1990,8
12794630,You Can't Run Away from It,1956,['United States of America'],"['Musical', 'Screwball comedy', 'Comedy', 'Musical comedy']",1950,6
31882884,Kill Kill Faster Faster,2008,['United Kingdom'],"['Film adaptation', 'Drama', 'Indie', 'Thriller', 'World cinema', 'Erotic thriller']",2000,8
12256928,In Search Of,2008,['United States of America'],"['Romance Film', 'Indie', 'Drama']",2000,8
17437774,Mistress,1992,['United States of America'],"['Drama', 'Comedy']",1990,2
319017,Addicted to Love,1997,['United States of America'],"['Comedy', 'Black comedy', 'Romantic comedy', 'Romance Film']",1990,7
17171735,D@bbe,2006,['Turkey'],"['Thriller', 'Horror']",2000,6
18890333,The Likely Lads,1976,['United Kingdom'],['Comedy'],1970,6
23571690,Borsalino,1970,"['France', 'Italy']","['Crime Fiction', 'Gangster Film', 'Buddy film']",1970,0
19394134,Anthropos yia oles tis doulies,1966,['Greece'],['Comedy'],1960,6
34587102,Proof of the Man,1977,"['Japan', 'United States of America']","['Drama', 'Crime Fiction']",1970,7
18359410,Los Andes no creen en Dios,2007,['Bolivia'],['Drama'],2000,7
11669228,Ice Spiders,2007,['United States of America'],"['Creature Film', 'Thriller', 'Horror', 'Science Fiction', 'Natural horror films']",2000,7
21448351,Magic Kid 2,1994,['United States of America'],"['Comedy', 'Family Film']",1990,4
6452746,Jan Dara,2001,['Thailand'],"['Erotic Drama', 'Romantic drama', 'World cinema', 'Romance Film', 'Drama']",2000,1
8913027,"Sarah, Plain and Tall",1991,['United States of America'],"['Family Drama', 'Americana', 'Adventure', 'Drama']",1990,1
31107105,Ullasapoongattu,1997,[],['Romantic comedy'],1990,7
26600932,Oru Black And White Kudumbam,2009,['India'],"['Drama', 'Comedy']",2000,9
2323936,Prison on Fire,1987,"['China', 'Hong Kong']","['Action', 'Prison', 'Action Thrillers', 'Thriller', 'Chinese Movies', 'Drama']",1980,7
7299774,Circus of Horrors,1960,['United Kingdom'],"['Crime Fiction', 'Horror', 'B-movie', 'Crime Thriller', 'Science Fiction', 'Drama']",1960,0
61186,The Big House,1930,['United States of America'],"['Black-and-white', 'Crime Fiction', 'Drama']",1930,0
9708819,Socket,2007,['United States of America'],"['LGBT', 'Erotic Drama', 'Indie', 'Thriller', 'Drama', 'Gay Themed', 'Gay', 'Gay Interest', 'Horror']",2000,7
27284278,Secret of the Blue Room,1933,['United States of America'],"['Crime Fiction', 'Mystery', 'Thriller', 'Horror', 'Romance Film', 'Drama']",1930,3
26284997,The Lady Confesses,1945,['United States of America'],"['Mystery', 'Thriller']",1940,5
14301855,Heart of a Dog,1988,['Soviet Union'],"['Black-and-white', 'Political satire', 'Satire', 'Comedy-drama']",1980,8
11225668,Dark River,1990,['United Kingdom'],['Drama'],1990,0
11301002,Allegro s ognyom,1980,['Soviet Union'],"['Action', 'Feature film', 'War film']",1980,0
28049793,Date Bait,1960,['United States of America'],['Drama'],1960,0
17807776,The Magic Hour,2008,['Japan'],"['Japanese Movies', 'Comedy', 'World cinema']",2000,8
1184428,The Ladies Man,1961,['United States of America'],"['Slapstick', 'Comedy']",1960,1
2160135,"Tombstone, the Town Too Tough to Die",1942,['United States of America'],"['Western', 'Black-and-white']",1940,2
5778040,Om Shanti Om,2007,['India'],"['Action', 'Musical', 'Comedy', 'Thriller', 'Bollywood', 'Romance Film', 'Drama']",2000,7
8188906,The Thing That Couldn't Die,1958,['United States of America'],['Horror'],1950,8
13464081,Crime Unlimited,1935,['United Kingdom'],"['Detective fiction', 'Crime Fiction', 'Mystery', 'Detective']",1930,5
1275551,Cheech & Chong's Next Movie,1980,['United States of America'],"['Comedy', 'Cult']",1980,0
10617221,Do Badan,1966,['India'],"['Romance Film', 'Family Film']",1960,6
4650594,L'Argent,1983,"['Switzerland', 'France']","['Crime Fiction', 'Art film', 'World cinema', 'Drama']",1980,3
24479824,B.O.B.'s Big Break,2009,['United States of America'],"['Animation', 'Short Film', ""Children's/Family"", 'Escape Film', 'Family Film']",2000,9
6843857,The Bermuda Depths,1978,"['Japan', 'United States of America']","['Television movie', 'Adventure', 'Fantasy']",1970,8
26007224,Mystery Monsters,1997,['United States of America'],"['Fantasy Adventure', ""Children's Fantasy"", ""Children's/Family"", 'Alien Film', 'Science Fiction', 'Fantasy']",1990,7
20831484,Buddies,1983,['Australia'],"['Drama', 'Comedy']",1980,3
5589714,It's My Party,1996,['United States of America'],"['LGBT', 'Drama']",1990,6
1852386,Bayside Shakedown: The Movie,1998,['Japan'],"['Action', 'Crime Fiction', 'Japanese Movies', 'Parody', 'Comedy']",1990,8
4700217,The Spider Woman,1944,['United States of America'],"['Suspense', 'Black-and-white', 'Mystery', 'Thriller', 'Crime Thriller']",1940,4
8595798,The Face Behind The Mask,1974,['Hong Kong'],"['Action/Adventure', 'World cinema', 'Wuxia', 'Chinese Movies', 'Martial Arts Film']",1970,4
2995876,Pet Sematary II,1992,['United States of America'],"['Horror', 'Zombie Film']",1990,2
798377,61*,2001,['United States of America'],"['Period piece', 'History', 'Television movie', 'Sports', 'Drama']",2000,1
28353477,Flight from Singapore,1962,[],['Adventure'],1960,2
9521920,Camp Slaughter,2005,['United States of America'],"['Slasher', 'Teen', 'Horror', 'Sci-Fi Horror', 'Science Fiction']",2000,5
24598397,Bank Robber,1993,['United States of America'],"['Romance Film', 'Crime Fiction', 'Comedy']",1990,3
4129413,Nankyoku Monogatari,1983,['Japan'],['Japanese Movies'],1980,3
11901160,The Champ,1979,['United States of America'],"['Boxing', 'Family Drama', 'Sports', 'Drama', 'Family Film']",1970,9
3123751,Tightrope,1984,['United States of America'],"['Action', 'Psychological thriller', 'Crime Fiction', 'Mystery', 'Action/Adventure', 'Thriller', 'Crime Thriller', 'Drama']",1980,4
6996808,Mickey's 60th Birthday,1988,['United States of America'],"['Animation', 'Comedy', 'Family Film']",1980,8
6947166,The Nifty Nineties,1941,['United States of America'],['Short Film'],1940,1
26307709,Yathrakarude Sradhakku,2002,['India'],"['Romantic drama', 'Comedy']",2000,2
11050727,Messiah of Evil,1973,['United States of America'],"['Horror', 'Zombie Film']",1970,3
3566585,The Unknown,1927,['United States of America'],"['Black-and-white', 'Indie', 'Horror', 'Silent film', 'Drama']",1920,7
26206182,Mizhi Randilum,2003,['India'],"['Drama', 'Comedy']",2000,3
14674285,Hokkabaz,2006,['Turkey'],"['Drama', 'Comedy']",2000,6
161866,Days of Wine and Roses,1962,['United States of America'],"['Black-and-white', 'Romantic drama', 'Marriage Drama', 'Romance Film', 'Addiction Drama', 'Drama']",1960,2
20888275,Home Movie,2008,['United States of America'],"['Indie', 'Slasher', 'Thriller', 'Horror']",2000,8
19163688,The Captain's Table,1959,['United Kingdom'],['Comedy'],1950,9
9523212,Thoda Tum Badlo Thoda Hum,2004,['India'],['Romantic comedy'],2000,4
6529458,One Body Too Many,1944,['United States of America'],"['Black-and-white', 'Mystery', 'Indie', 'Comedy', 'Thriller', 'Parody', 'Horror', 'Cult']",1940,4
4021666,Calendar Girl,1993,['United States of America'],"['Drama', 'Comedy']",1990,3
2572851,Beowulf,2007,['United States of America'],"['Action', 'Animation', 'Fantasy', 'Adventure', 'Computer Animation']",2000,7
15533528,Riel,1979,['Canada'],"['War film', 'Biographical film', 'Drama']",1970,9
27411835,Anton Chekhov's The Duel,2009,['United States of America'],"['Period piece', 'Film adaptation', 'Drama']",2000,9
5855933,Bhadra,2005,['India'],"['Tollywood', 'Action/Adventure', 'World cinema', 'Drama']",2000,5
22674455,Río Escondido,1948,['Mexico'],"['Black-and-white', 'Drama']",1940,8
24269284,The Memory Thief,2007,['United States of America'],"['Psychological thriller', 'Drama', 'Indie', 'Thriller']",2000,7
33830044,The Ode,2008,[],['Drama'],2000,8
9769927,Mala Época,1998,['Argentina'],"['Indie', 'Drama']",1990,8
9622468,Agneepath,1990,['India'],"['Action', 'Drama', 'Crime Fiction', 'Crime Drama', 'Family Film']",1990,0
11590454,Case Closed: Countdown to Heaven,2001,['Japan'],"['Action', 'Animation', 'Japanese Movies', 'Thriller', 'World cinema', 'Anime']",2000,1
24578705,Doctor in Love,1960,['United Kingdom'],"['Romance Film', 'Comedy']",1960,0
5710780,The Legend of Zu,2001,['Hong Kong'],"['Fantasy Adventure', 'World cinema', 'Chinese Movies', 'Martial Arts Film', 'Adventure', 'Wuxia', 'Science Fiction', 'Fantasy']",2000,1
30033474,Aadmi,1993,[],"['Action', 'Drama', 'Crime Fiction', 'Romance Film']",1990,3
7774827,Diary of the Dead,1976,['United States of America'],"['Crime Fiction', 'Splatter film', 'Drama']",1970,6
3509709,Curse of the Fly,1965,"['United Kingdom', 'United States of America']","['Science Fiction', 'Cult', 'Horror']",1960,5
5958413,A Mighty Heart,2007,"['United Kingdom', 'United States of America']","['Film adaptation', 'Biographical film', 'Political drama', 'Docudrama', 'War film', 'Drama']",2000,7
2073222,My Little Chickadee,1940,['United States of America'],"['Black-and-white', 'Comedy Western', 'Western', 'Comedy', 'Slapstick']",1940,0
10533451,The Butcher Boy,1998,"['Ireland', 'United States of America']","['Film adaptation', 'Indie', 'Drama']",1990,8
18521791,Love Chronicles,2003,['United States of America'],"['Romantic drama', 'Comedy', 'Romance Film', 'Romantic comedy', 'Comedy-drama', 'Drama']",2000,3
5638004,Missing in Action 2: The Beginning,1985,['United States of America'],"['Action', 'Escape Film', 'Adventure']",1980,5
2084008,Hotel,1967,['United States of America'],"['Film adaptation', 'Drama']",1960,7
18534112,Apes of Wrath,1959,['United States of America'],"['Animation', 'Short Film', 'Family Film']",1950,9
19169351,Dentally Disturbed,2004,['Australia'],"['Short Film', 'Comedy']",2000,4
31858511,Daivathinte Vikrithikal,1992,['India'],['Drama'],1990,2
21437273,Aadhavan,2009,['India'],['Action'],2000,9
31228853,When Every Day Was the Fourth of July,1978,['United States of America'],['Drama'],1970,8
5446012,Daggers,1994,['United States of America'],"['Action', 'Adventure', 'Science Fiction', 'Family Film']",1990,4
1359571,The Wind and the Lion,1975,['United States of America'],"['Period piece', 'Action', 'Costume Adventure', 'Action/Adventure', 'Historical fiction', 'War film', 'Adventure']",1970,5
401152,The Great McGinty,1940,['United States of America'],"['Black-and-white', 'Political cinema', 'Screwball comedy', 'Political satire', 'Satire', 'Comedy']",1940,0
5128234,Basha,1995,['India'],['Thriller'],1990,5
15458602,Cuci,2008,['Malaysia'],['Comedy'],2000,8
26106476,Brocéliande,2002,['France'],"['Monster movie', 'B-movie', 'Horror']",2000,2
4653208,Sgt. Kabukiman N.Y.P.D.,1991,['United States of America'],"['Action', 'Action/Adventure', 'Comedy', 'Superhero movie', 'Black comedy', 'Cult']",1990,1
12558882,Nishant,1975,['India'],"['Period piece', 'Crime Fiction', 'Art film', 'World cinema', 'Drama']",1970,5
3960247,The Plot of the Fuma Clan,1987,['Japan'],"['Action', 'Animation', 'Japanese Movies', 'Comedy', 'Anime', 'Adventure']",1980,7
1476567,Dangerous Minds,1995,['United States of America'],"['Crime Fiction', 'Biographical film', 'Thriller', 'Biopic [feature]', 'Teen', 'Drama']",1990,5
10620414,Dharam Karam,1975,['India'],"['Drama', 'World cinema']",1970,5
6083088,The Spirit of '43,1943,['United States of America'],"['Animation', 'Short Film', 'Comedy film', 'Documentary', 'Propaganda film', 'Drama']",1940,3
29084258,Submarine,1928,['United States of America'],"['Action', 'Drama']",1920,8
17111194,Cuba,1979,['United States of America'],"['Action', 'Romantic drama', 'Action/Adventure', 'Thriller', 'Romance Film', 'War film', 'Drama', 'Adventure', 'Political drama', 'Political thriller']",1970,9
5076487,The Sisterhood of the Traveling Pants,2005,['United States of America'],"['Coming of age', 'Comedy', 'Romance Film', 'Comedy-drama', 'Adventure', 'Drama', 'Ensemble Film']",2000,5
27661332,Applause,2009,"['Denmark', 'United States of America']","['Drama', 'World cinema']",2000,9
193867,BUtterfield 8,1960,['United States of America'],"['Melodrama', 'Romantic drama', 'Drama']",1960,0
22359916,Ring of Death,2008,['United States of America'],"['Action', 'Action/Adventure', 'Thriller']",2000,8
5722084,Yogi,2007,['India'],"['Musical', 'Bollywood', 'World cinema', 'Drama']",2000,7
359014,Daleks - Invasion Earth 2150 AD,1966,['United Kingdom'],['Science Fiction'],1960,6
26662542,Fonazei o kleftis,1965,['Greece'],['Comedy film'],1960,5
567508,Journey to the Center of the Earth,1959,['United States of America'],"['Adventure', 'Steampunk', 'Science Fiction', 'Family Film', 'Fantasy']",1950,9
3581163,Welcome to Dongmakgol,2005,['South Korea'],"['War film', 'Comedy', 'Drama']",2000,5
3439529,The Doctor,1991,['United States of America'],['Drama'],1990,1
21705780,American Violet,2009,['United States of America'],"['Courtroom Drama', 'Drama']",2000,9
25746139,"Those Lips, Those Eyes",1980,['United States of America'],"['Coming of age', 'Romance Film', 'Romantic comedy', 'Melodrama']",1980,0
18491069,The Reckless Driver,1946,['United States of America'],"['Animation', 'Short Film', 'Comedy film', 'Family Film']",1940,6
14641156,For Heaven's Sake,1950,['United States of America'],"['Romance Film', 'Black-and-white', 'Fantasy']",1950,0
20925565,Gas Pump Girls,1979,['United States of America'],"['Comedy', 'Workplace Comedy']",1970,9
5735624,The Master,1989,['Hong Kong'],"['Action/Adventure', 'World cinema', 'Chinese Movies', 'Martial Arts Film']",1980,9
21375848,Little Girl Lost: The Delimar Vera Story,2008,"['Canada', 'United States of America']",['Drama'],2000,8
4798258,What We Do Is Secret,2007,['United States of America'],"['Musical', 'Period piece', 'Musical Drama', 'Biopic [feature]', 'Biographical film', 'Punk rock', 'Drama']",2000,7
11457604,Brick Bradford,1947,['United States of America'],"['Action', 'Black-and-white', 'Adventure', 'Science Fiction']",1940,7
35534554,Donkey Xote,2007,"['Spain', 'Italy']","['Action', 'Animation', 'Action/Adventure', 'Comedy', 'World cinema', 'Anime']",2000,7
32456593,An französischen Kaminen,1962,['German Democratic Republic'],"['War film', 'Drama']",1960,2
6823327,Man Push Cart,2005,"['Iran', 'United States of America']","['Indie', 'Drama']",2000,5
180974,White Banners,1938,['United States of America'],"['Black-and-white', 'Drama']",1930,8
8499528,She-Devil,1989,['United States of America'],"['Screwball comedy', 'Comedy', 'Black comedy', 'Domestic Comedy']",1980,9
3326231,The Longest Yard,2005,['United States of America'],"['LGBT', 'Drama', 'Prison film', 'Comedy', 'Remake', 'Black comedy', 'Sports']",2000,5
21026999,Merikoi to protimoun kryo,1963,['Greece'],"['Musical', 'Comedy']",1960,3
24680494,"Me Ivan, You Abraham",1993,['France'],['Drama'],1990,3
19011322,Lili Marleen,1981,['Germany'],"['War film', 'Drama', 'Political drama']",1980,1
36165939,Vietnam Colony,1994,['India'],['Comedy film'],1990,4
23288456,Blind Love,2005,['Japan'],"['Japanese Movies', 'Pornographic movie', 'Romance Film', 'Erotica']",2000,5
23664512,The Hive,2008,['United States of America'],"['Horror', 'Television movie', 'Sci-Fi Horror', 'Science Fiction']",2000,8
19479881,Thirakkatha,2008,['India'],"['Musical', 'Romantic drama', 'Bollywood', 'World cinema', 'Romance Film', 'Drama']",2000,8
2560747,Mohre,1987,['India'],['Bollywood'],1980,7
1020702,The House of the Spirits,1993,"['Portugal', 'Denmark', 'Germany', 'United States of America']","['Film adaptation', 'Mystery', 'Indie', 'Family Drama', 'Romantic drama', 'Thriller', 'Political drama', 'Romance Film', 'Drama', 'Suspense', 'Period piece', 'Epic', 'Supernatural']",1990,3
5249016,The Gingerdead Man,2005,['United States of America'],"['Monster movie', 'Slasher', 'Horror Comedy', 'Horror', 'Comedy', 'B-movie']",2000,5
5831892,Bickford Shmeckler's Cool Ideas,2006,['United States of America'],"['Indie', 'Comedy', 'Sex comedy']",2000,6
10731337,The 25th Hour,1967,"['France', 'Yugoslavia', 'Italy']","['War film', 'Drama']",1960,7
35501869,Trivial,2007,['France'],"['Psychological thriller', 'Thriller']",2000,7
6817168,Mad Cowgirl,2006,['United States of America'],"['Psychological thriller', 'Comedy', 'Avant-garde', 'Martial Arts Film', 'Slasher', 'Horror', 'Experimental film', 'B-movie']",2000,6
19909324,Captain Abu Raed,2008,['Jordan'],"['Drama', 'World cinema']",2000,8
16948290,Max Manus,2008,"['Norway', 'Germany', 'Denmark']","['Action', 'Biography', 'Action/Adventure', 'Biographical film', 'World cinema', 'Drama', 'History', 'Historical fiction', 'War film']",2000,8
27382003,Myrt and Marge,1933,[],['Comedy film'],1930,3
2875397,Empire of the Ants,1977,['United States of America'],"['Creature Film', 'Monster', 'Horror', 'B-movie', 'Cult', 'Science Fiction', 'Natural horror films']",1970,7
3598844,Five Came Back,1939,['United States of America'],"['Action', 'Airplanes and airports', 'Black-and-white', 'Disaster', 'Adventure', 'Drama']",1930,9
16814012,Everything's Jake,2007,['United States of America'],"['Indie', 'Comedy', 'Drama']",2000,7
3751746,The Wings of the Dove,1997,"['United Kingdom', 'United States of America']","['Period piece', 'Film adaptation', 'Drama', 'Indie', 'Romantic drama', 'Romance Film']",1990,7
3592692,Inside Man,2006,['United States of America'],"['Action', 'Crime Fiction', 'Action/Adventure', 'Thriller', 'Crime Thriller', 'Master Criminal Films', 'Drama']",2000,6
20344329,Tomie: Re-birth,2001,['Japan'],"['Japanese Movies', 'World cinema', 'Horror']",2000,1
21448296,The Image,1990,['United States of America'],"['Drama', 'Television movie']",1990,0
3894336,Sadgati,1981,['India'],"['Social problem film', 'Satire', 'Drama']",1980,1
22369520,"Me, Mom, Dad and Her",2008,['Canada'],['Drama'],2000,8
15453790,While the City Sleeps,1928,['United States of America'],"['Silent film', 'Black-and-white']",1920,8
8880229,Squanto: A Warrior's Tale,1994,['United States of America'],"['Family Drama', 'Historical fiction', 'Docudrama', 'Adventure', 'Drama', 'Family Film']",1990,4
1904367,Das schreckliche Mädchen,1990,"['Germany', 'West Germany']","['Political cinema', 'Comedy', 'World cinema', 'Political drama', 'Drama']",1990,0
3229741,Shattered,1991,['United States of America'],"['Psychological thriller', 'Suspense', 'Crime Fiction', 'Mystery', 'Thriller']",1990,1
3932916,Draftee Daffy,1945,['United States of America'],"['Animation', 'Short Film', 'Comedy film', 'War film', 'Family Film']",1940,5
14736759,Horsing Around,1957,['United States of America'],"['Short Film', 'Black-and-white', 'Comedy']",1950,7
26653768,Keelu Gurram,1949,['India'],[],1940,9
4637428,The Horseman on the Roof,1995,['France'],"['Costume Adventure', 'Romantic drama', 'World cinema', 'Romance Film', 'Adventure', 'Drama']",1990,5
4102452,Devdas,2002,['India'],"['Musical', 'Romantic drama', 'Bollywood', 'World cinema', 'Romance Film', 'Drama']",2000,2
3463730,Jack the Bear,1993,['United States of America'],"['Period piece', 'Film adaptation', 'Family Drama', 'Comedy', 'Comedy-drama', 'Drama']",1990,3
33876872,The Legion of Missing Men,1937,[],"['Action', 'Action/Adventure', 'Adventure']",1930,7
21761019,Clay,1965,['Australia'],"['Black-and-white', 'Drama']",1960,5
2970638,Gaja Gamini,2000,['India'],"['Drama', 'Fantasy']",2000,0
9952965,Tailspin Tommy,1934,['United States of America'],"['Action', 'Black-and-white', 'Adventure']",1930,4
17897345,Orders to Kill,1958,['United Kingdom'],"['Spy', 'Action', 'Drama', 'War film']",1950,8
29858189,Car of Dreams,1935,['United Kingdom'],"['Musical', 'Romantic drama', 'Romance Film', 'Drama']",1930,5
2016701,Empire Falls,2005,['United States of America'],"['Comedy-drama', 'Family Drama', 'Drama']",2000,5
26666439,Vellathooval,2009,['India'],['Romance Film'],2000,9
1079824,Ballad of a Soldier,1959,"['Russia', 'Soviet Union']","['Art film', 'Romantic drama', 'World cinema', 'Romance Film', 'War film', 'Drama']",1950,9
22375764,The Land That Time Forgot,2009,['United States of America'],"['Film adaptation', 'Indie', 'Adventure', 'Fantasy', 'Science Fiction']",2000,9
1961602,Sometimes They Come Back... Again,1996,['United States of America'],['Horror'],1990,6
10293026,Monster Man,2004,['United States of America'],"['Creature Film', 'Monster movie', 'Road movie', 'Comedy', 'Horror Comedy', 'Horror', 'Road-Horror']",2000,4
1409356,Next Friday,2000,['United States of America'],['Comedy'],2000,0
1844566,Bio Zombie,1998,['Hong Kong'],"['Comedy', 'Comedy film', 'World cinema', 'Horror', 'Horror Comedy', 'Zombie Film', 'Chinese Movies']",1990,8
1646067,Flight of the Navigator,1986,"['Norway', 'United States of America']","['Action', 'Fantasy Adventure', 'Adventure', 'Family-Oriented Adventure', ""Children's/Family"", 'Science Fiction', 'Family Film']",1980,6
11791674,Splendor,1989,"['France', 'Italy', 'United States of America']","['LGBT', 'Drama']",1980,9
4822104,Hero Hiralal,1988,['India'],"['Romantic drama', 'Bollywood', 'World cinema', 'Romance Film', 'Drama']",1980,8
5411035,Eijanaika,1981,['Japan'],"['Period piece', 'Japanese Movies', 'Satire', 'Marriage Drama', 'Black comedy', 'Comedy-drama', 'Drama']",1980,1
27759948,The Flying Missile,1950,['United States of America'],"['War film', 'Drama']",1950,0
12746058,Towelhead,2007,['United States of America'],"['Film adaptation', 'Drama', 'Coming of age', 'Indie']",2000,7
113427,Terms of Endearment,1983,['United States of America'],"['Film adaptation', 'Family Drama', 'Romance Film', 'Tragicomedy', 'Drama', 'Tragedy', 'Comedy film', 'Romantic comedy', 'Comedy-drama', 'Family Film']",1980,3
36422528,Nick Carter va tout casser,1964,"['France', 'Italy']","['Action', 'Drama', 'Crime Fiction', 'Adventure']",1960,4
20697583,A Monkey's Tale,1999,"['United Kingdom', 'France', 'Germany', 'Hungary']","['Animation', 'Animated Musical', 'World cinema', ""Children's/Family"", 'Family Film']",1990,9
6156561,All About Love,2005,"['Hong Kong', 'United States of America']","['Short Film', 'Romance Film', 'Chinese Movies', 'Drama']",2000,5
4222309,The Simian Line,2000,['United States of America'],"['Drama', 'Indie', 'Comedy', 'Marriage Drama', 'Romance Film', 'Romantic comedy']",2000,0
14433451,Hell's House,1932,['United States of America'],"['Prison', 'Black-and-white', 'Crime Fiction', 'Film noir', 'Juvenile Delinquency Film', 'Drama']",1930,2
18935472,The Elm-Chanted Forest,1988,"['Yugoslavia', 'Croatia', 'United States of America']","['Musical', 'Animation', 'Family Film', 'Fantasy']",1980,8
3759065,Wishing Stairs,2003,['South Korea'],"['Thriller', 'Horror', 'World cinema', 'Supernatural', 'Drama']",2000,3
14487819,La Menace,1977,"['Canada', 'France']","['Action', 'Crime Fiction', 'Thriller']",1970,7
7269491,C'eravamo tanto amati,1974,['Italy'],"['Drama', 'Comedy']",1970,4
17916020,Chicken and Duck Talk,1988,['Hong Kong'],"['Chinese Movies', 'Comedy']",1980,8
5329389,Gaav,1968,['Iran'],['Drama'],1960,8
1885523,Teorema,1968,['Italy'],"['LGBT', 'Art film', 'Mystery', 'World cinema', 'Drama']",1960,8
3080704,Cronos,1993,['Mexico'],"['Gothic Film', 'Comedy', 'Thriller', 'Horror', 'World cinema', 'Drama']",1990,3
24361114,Janumada Jodi,1996,[],"['Romance Film', 'Drama']",1990,6
935194,In Harm's Way,1965,['United States of America'],"['War film', 'Drama']",1960,5
21532286,Beder Meye Josna,1991,"['India', 'Bangladesh']","['Romance Film', 'Drama']",1990,1
16166535,Seerivarum Kaalai,2001,['India'],"['Romance Film', 'Drama']",2000,1
1374740,Continental Divide,1981,['United States of America'],"['Romance Film', 'Romantic comedy', 'Comedy']",1980,1
3844809,Tempest,1928,['United States of America'],"['Black-and-white', 'Drama', 'Romantic drama', 'Indie', 'Silent film', 'Romance Film', 'Epic']",1920,8
15868613,Aurora,2006,['Ukraine'],['Drama'],2000,6
29744735,Hatya: The Murder,2004,['India'],"['Action/Adventure', 'Thriller', 'World cinema', 'Drama']",2000,4
20581179,Gambler,1971,['India'],"['Mystery', 'Thriller']",1970,1
2608771,The Truth About Love,2005,['United Kingdom'],"['Romance Film', 'Romantic comedy', 'Comedy']",2000,5
1804374,The Hanging Tree,1959,['United States of America'],"['Western', 'Drama']",1950,9
10575289,Neo Tokyo,1986,['Japan'],"['Action', 'Auto racing', 'Animation', 'Japanese Movies', 'Anime', 'Science Fiction', 'Fantasy']",1980,6
7672286,The Thief,1997,['Russia'],"['Drama', 'World cinema']",1990,7
14760548,Trio,1950,['United Kingdom'],"['Black-and-white', 'Comedy', 'Drama']",1950,0
12289886,The Mountain,1956,['United States of America'],"['Action', 'Film adaptation', 'Action/Adventure', 'Adventure', 'Sports', 'Drama']",1950,6
3130706,Kingdom Come,2001,['United States of America'],"['Comedy', 'Drama', 'Family Film']",2000,1
36057869,Ettupatti Rasa,1997,['India'],['Drama'],1990,7
3583342,Jawbreaker,1999,['United States of America'],"['Black comedy', 'Satire', 'Comedy']",1990,9
10453329,The Solid Tin Coyote,1966,['United States of America'],"['Animation', 'Short Film', 'Family Film']",1960,6
1703792,Kissing Jessica Stein,2002,['United States of America'],"['LGBT', 'Indie', 'Comedy', 'Romance Film', 'Drama', 'Gay Themed', 'Gay', 'Gay Interest', 'Romantic comedy', 'Comedy-drama']",2000,2
2935386,School of Life,2005,"['Canada', 'United States of America']","['Family Drama', 'Comedy', 'Television movie', 'Sports', 'Drama', 'Family Film']",2000,5
6135781,Shadows of Forgotten Ancestors,1964,"['Russia', 'Soviet Union', 'Ukrainian SSR']","['History', 'World cinema', 'Romance Film', 'Drama']",1960,4
2498402,Once Upon a Time in China VI,1997,"['China', 'Hong Kong']","['Action', 'Action/Adventure', 'World cinema', 'Chinese Movies', 'Martial Arts Film', 'Adventure', 'History', 'Western']",1990,7
20378794,A Pizza Tweety Pie,1958,['United States of America'],['Short Film'],1950,8
6227263,Suffering Man's Charity,2007,['United States of America'],"['Psychological thriller', 'LGBT', 'Comedy', 'Horror', 'Black comedy', 'Comedy-drama']",2000,7
5329751,A Far Off Place,1993,['United States of America'],"['Family Drama', 'Family-Oriented Adventure', 'Adventure', 'Drama', 'Family Film']",1990,3
24516881,W.W. and the Dixie Dancekings,1975,['United States of America'],['Comedy film'],1970,5
103325,Royal Space Force: The Wings of Honneamise,1987,['Japan'],"['Action', 'Animation', 'Japanese Movies', 'Romance Film', 'Anime', 'Science Fiction', 'Drama']",1980,7
25856406,Tora-san Meets His Lordship,1977,['Japan'],['Japanese Movies'],1970,7
8463784,Christmas Evil,1980,['United States of America'],"['Psychological thriller', 'Slasher', 'Thriller', 'Horror', 'B-movie']",1980,0
36039685,Stranger by Night,1994,['United States of America'],"['Action', 'Thriller']",1990,4
28660054,Vrudhanmare Sookshikkuka,1995,['India'],"['Action', 'Comedy', 'Thriller']",1990,5
2699519,Employee of the Month,2004,['United States of America'],"['Heist', 'Indie', 'Comedy', 'Black comedy']",2000,4
5378148,Mausam,1975,['India'],"['Musical', 'Bollywood', 'World cinema', 'Drama']",1970,5
21244282,Batang PX,2007,['Philippines'],"['Filipino Movies', 'Drama', 'World cinema']",2000,7
31823746,Odessa in Flames,1942,"['Romania', 'Italy']",['War film'],1940,2
12688941,Bye Bye Africa,1999,['France'],"['Drama', 'Documentary']",1990,9
1884712,Dark City,1998,"['United States of America', 'Australia']","['Neo-noir', 'Mystery', 'Thriller', 'Science Fiction']",1990,8
9208743,It's Murder!,1977,['United States of America'],['Short Film'],1970,7
23005715,The Princess and the Marine,2001,['United States of America'],"['Romance Film', 'Drama']",2000,1
144637,After the Thin Man,1936,['United States of America'],"['Detective fiction', 'Black-and-white', 'Crime Fiction', 'Screwball comedy', 'Mystery', 'Comedy', 'Thriller', 'Crime Thriller', 'Comedy Thriller', 'Detective']",1930,6
3756444,Blood Rain,2005,['South Korea'],"['Detective fiction', 'Mystery', 'Thriller', 'Detective', 'World cinema', 'Crime Thriller']",2000,5
31641294,Jump,2009,['Hong Kong'],"['Comedy film', 'World cinema', 'Chinese Movies', 'Drama']",2000,9
36467457,Count Me Out,1938,['United States of America'],"['Short Film', 'Animation']",1930,8
23878965,Road Trip: Beer Pong,2009,['United States of America'],['Comedy'],2000,9
4271952,Rob-B-Hood,2006,['Hong Kong'],"['Action', 'Action/Adventure', 'Comedy', 'World cinema', 'Chinese Movies', 'Martial Arts Film']",2000,6
462764,Run Lola Run,1998,['Germany'],"['Crime Fiction', 'Chase Movie', 'Thriller', 'Crime Thriller']",1990,8
11151160,Badalte Rishtey,1978,['India'],"['Romantic drama', 'World cinema', 'Romance Film', 'Drama']",1970,8
561006,What's the Worst That Could Happen?,2001,['United States of America'],"['Action', 'Crime Fiction', 'Action/Adventure', 'Comedy', 'Crime Comedy', 'Albino bias']",2000,1
7660385,First Man into Space,1959,['United Kingdom'],"['Black-and-white', 'Thriller', 'Horror', 'Adventure', 'Science Fiction']",1950,9
27809124,The Last Days of Dolwyn,1949,['United Kingdom'],['Drama'],1940,9
25921824,Jimmy,2008,['India'],"['Musical', 'Thriller', 'Bollywood', 'World cinema', 'Crime Thriller']",2000,8
8981188,Sunset Grill,1993,['United States of America'],"['Crime Fiction', 'Mystery', 'Indie', 'Thriller', 'Crime Thriller']",1990,3
12580316,Ranmuthu Duwa,1962,['Sri Lanka'],['Romance Film'],1960,2
2137362,Puss Gets the Boot,1940,['United States of America'],"['Short Film', 'Comedy']",1940,0
1400747,School Ties,1992,['United States of America'],"['Period piece', 'Coming of age', 'School story', 'Teen', 'Sports', 'Drama']",1990,2
29409425,Dot and the Whale,1986,['Australia'],"['Family Film', 'Animation']",1980,6
22889107,The Photographer,2000,[],"['Indie', 'Comedy']",2000,0
15304261,"Hawaii, Oslo",2004,"['Norway', 'Sweden', 'Denmark']","['Ensemble Film', 'Drama', 'World cinema']",2000,4
859655,Vampyr,1932,"['Denmark', 'Weimar Republic', 'France', 'Germany']","['Black-and-white', 'Gothic Film', 'Horror', 'World cinema', 'Drama']",1930,2
5464104,Block-Heads,1938,['United States of America'],"['Buddy film', 'Black-and-white', 'Comedy']",1930,8
2354462,Romeo and Juliet in Sarajevo,1994,['Canada'],"['News', 'Music', 'History', 'Documentary', 'Crime', 'Sports']",1990,4
6640006,Kalvanin Kadhali,2005,['India'],"['Romantic drama', 'World cinema', 'Romance Film', 'Drama']",2000,5
5858177,Pathfinder,2007,['United States of America'],"['Action', 'Period piece', 'Action/Adventure', 'Adventure', 'Sword and Sandal']",2000,7
11567446,My Mother's Smile,2003,['Italy'],"['Comedy-drama', 'Drama', 'World cinema']",2000,3
1825914,The Warrior,2001,"['China', 'South Korea']","['Action', 'Action/Adventure', 'World cinema', 'Chinese Movies', 'Martial Arts Film', 'Drama', 'History', 'Wuxia', 'War film']",2000,1
11651362,Count Three and Pray,1955,['United States of America'],"['Western', 'Drama']",1950,5
26730077,The Interrupted Journey,1949,['United Kingdom'],['Thriller'],1940,9
23666645,Piège pour Cendrillon,1965,"['France', 'Italy']","['Mystery', 'Psychological thriller']",1960,5
5221915,The Beast,1996,['United States of America'],"['Action', 'Film adaptation', 'Thriller', 'Horror', 'Television movie', 'Natural horror films']",1990,6
10837755,Everybody's All-American,1988,['United States of America'],"['Romantic drama', 'Romance Film', 'Sports', 'Drama']",1980,8
4877373,Shutter,2004,['Thailand'],"['World cinema', 'Horror']",2000,4
33272661,El sacerdote,1978,['Spain'],['Drama'],1970,8
1585890,Tiny Toon Adventures: How I Spent My Vacation,1992,['United States of America'],"['Animation', 'Comedy', 'Adventure', 'Drama', 'Family Film']",1990,2
5640372,Drillbit Taylor,2008,['United States of America'],"['Comedy', 'Teen']",2000,8
23215354,The Green Elephant,1999,['Russia'],"['Thriller', 'Horror']",1990,9
21244773,Karnaval,1999,"['France', 'Belgium']",['Drama'],1990,9
7300880,Zzyzx,2007,['United States of America'],"['Psychological thriller', 'Indie', 'Thriller', 'Crime Thriller', 'Road movie']",2000,7
2563340,Death Hunt,1981,"['Hong Kong', 'United States of America']","['Action', 'Crime Fiction', 'Thriller', 'Adventure']",1980,1
26394165,The Boudoir Diplomat,1930,['United States of America'],"['Romantic comedy', 'Comedy']",1930,0
644845,EdTV,1999,['United States of America'],"['Parody', 'Comedy', 'Media Satire', 'Romantic comedy', 'Domestic Comedy', 'Mockumentary']",1990,9
5097084,Cat-Women of the Moon,1953,['United States of America'],"['Science Fiction', 'Adventure']",1950,3
2256779,Code Unknown,2000,"['France', 'Germany', 'Romania']","['Art film', 'World cinema', 'Social problem film', 'Romance Film', 'War film', 'Drama', 'Ensemble Film']",2000,0
10541514,High Heels and Low Lifes,2001,"['United Kingdom', 'United States of America']","['Action', 'Action/Adventure', 'Comedy', 'Buddy film', 'Crime Comedy', 'Drama']",2000,1
3701117,Foolproof,2003,['Canada'],"['Action', 'Crime Fiction', 'Action Thrillers', 'Caper story', 'Comedy', 'Thriller', 'Crime Thriller']",2000,3
21654938,Hatching Pete,2009,"['United Kingdom', 'United States of America', 'Canada']","['Comedy', 'Family Film']",2000,9
1138292,5x2,2004,['France'],"['Romantic drama', 'Marriage Drama', 'World cinema', 'Romance Film', 'Drama']",2000,4
19944695,Code Name: Wild Geese,1984,"['West Germany', 'Italy']","['Action/Adventure', 'World cinema']",1980,4
4600218,Gymkata,1985,['United States of America'],"['Action', 'Action/Adventure', 'Adventure', 'Martial Arts Film']",1980,5
244897,Fanboys,2009,['United States of America'],"['Indie', 'Parody', 'Comedy', 'Adventure', 'Drama']",2000,9
2323591,Return to Sleepaway Camp,2008,['United States of America'],"['Slasher', 'Horror Comedy', 'Horror']",2000,8
2144178,U.S. Marshals,1998,['United States of America'],"['Action', 'Crime Fiction', 'Action Thrillers', 'Chase Movie', 'Thriller']",1990,8
2371819,D-Tox,2002,"['Germany', 'United States of America']","['Action', 'Psychological thriller', 'Film adaptation', 'Action/Adventure', 'Thriller', 'Crime Thriller', 'Drama', 'Suspense', 'Horror']",2000,2
3142046,Dumplings,2004,"['China', 'Hong Kong']","['Satire', 'Thriller', 'Comedy', 'World cinema', 'Black comedy', 'Chinese Movies', 'Drama', 'Horror']",2000,4
5443343,Giant Gila Monster,1959,['United States of America'],"['Black-and-white', 'Monster', 'Horror', 'Science Fiction']",1950,9
31341418,Nool Veli,1979,['India'],['Drama'],1970,9
5781761,The Diary of Ellen Rimbauer,2003,['United States of America'],"['Psychological thriller', 'Film adaptation', 'Mystery', 'Thriller', 'Costume Horror', 'Drama', 'Haunted House Film', 'Horror', 'Television movie']",2000,3
16029585,The Tit and the Moon,1994,"['France', 'Spain']","['Coming of age', 'Comedy', 'Childhood Drama', 'World cinema', 'Erotica', 'Drama']",1990,4
19285721,Hello Kolkata,2008,['India'],['Drama'],2000,8
22031823,Perumthachan,1990,['India'],['Drama'],1990,0
31323110,The Sailor's Song,1958,['German Democratic Republic'],[],1950,8
26622049,Oblivion,1994,['United States of America'],"['Action/Adventure', 'Western', 'Science Fiction', 'Space western']",1990,4
5251162,Kinamand,2002,"['China', 'Denmark']","['Romantic drama', 'Comedy', 'World cinema', 'Romance Film', 'Romantic comedy', 'Chinese Movies', 'Drama']",2000,2
16791637,Love at Stake,1988,['United States of America'],"['Parody', 'Satire', 'Comedy']",1980,8
7596042,Lawnmower Man 2: Beyond Cyberspace,1996,['United States of America'],"['Horror', 'Science Fiction']",1990,6
4746060,Blow Dry,2001,"['United Kingdom', 'Germany', 'United States of America']","['Indie', 'Comedy']",2000,1
11104554,Waris Shah-Ishq Da Waaris,2006,['India'],"['Romantic drama', 'World cinema', 'Romance Film', 'Drama']",2000,6
24368095,The Dunwich Horror,1970,['United States of America'],"['Film adaptation', 'Horror', 'B-movie', 'Drama']",1970,0
2918399,Virrudh... Family Comes First,2005,['India'],"['Drama', 'Bollywood', 'World cinema']",2000,5
8456500,This Thing of Ours,2003,['United States of America'],"['Crime Fiction', 'Gangster Film', 'Caper story', 'Crime Drama', 'Crime Thriller', 'Drama']",2000,3
6103640,Clancy Street Boys,1943,['United States of America'],['Comedy'],1940,3
956388,Eight Legged Freaks,2002,"['United States of America', 'Australia']","['Monster', 'Comedy', 'Horror Comedy', 'Horror', 'B-movie', 'Science Fiction', 'Natural horror films']",2000,2
3566511,Werewolf of London,1935,['United States of America'],"['Black-and-white', 'Werewolf fiction', 'Horror']",1930,5
1579705,A Man from the Boulevard des Capuchines,1987,['Soviet Union'],['Comedy'],1980,7
8413472,Half Shot Shooters,1936,['United States of America'],"['Short Film', 'Black-and-white', 'Comedy']",1930,6
20891196,Terror Inside,2008,['United States of America'],['Thriller'],2000,8
24844921,Porky's Party,1938,[],"['Short Film', 'Animation']",1930,8
10394188,The Phantom President,1932,['United States of America'],"['Musical', 'Black-and-white', 'Political satire', 'Comedy']",1930,2
2829485,The NeverEnding Story,1984,"['West Germany', 'United States of America']","['Fantasy Adventure', ""Children's Fantasy"", ""Children's/Family"", 'Adventure', 'Drama', 'Family Film', 'Fantasy']",1980,4
306812,The Great Mouse Detective,1986,['United States of America'],"['Musical', 'Detective fiction', 'Animation', 'Mystery', ""Children's/Family"", 'Adventure', ""Children's Fantasy"", 'Detective', 'Family Film']",1980,6
2534248,"Red Firecracker, Green Firecracker",1994,"['China', 'Hong Kong']","['Period piece', 'Romantic drama', 'World cinema', 'Romance Film', 'Chinese Movies', 'Drama']",1990,4
4828849,Compulsion,1959,['United States of America'],"['Crime Fiction', 'Film noir', 'Drama', 'Courtroom Drama']",1950,9
12421924,Don't Deliver Us from Evil,1971,['France'],"['World cinema', 'Horror']",1970,1
4231,Buffy the Vampire Slayer,1992,['United States of America'],"['Action', 'Comedy', 'Horror Comedy', 'Horror']",1990,2
29351561,Sanam Teri Kasam,2009,['India'],"['Action', 'Romance Film', 'Drama']",2000,9
5080311,The Badlanders,1958,['United States of America'],"['Action', 'Heist', 'Crime Fiction', 'Action/Adventure', 'Western']",1950,8
7101280,Sweeney Todd: The Demon Barber Of Fleet Street,1936,['United Kingdom'],"['Black-and-white', 'Slasher', 'Horror']",1930,6
574210,My Life Without Me,2003,"['Canada', 'Spain']","['Indie', 'World cinema', 'Romance Film', 'Melodrama', 'Drama']",2000,3
12813263,All I Want for Christmas,1991,['United States of America'],"[""Children's"", 'Comedy', 'Christmas movie', 'Drama', 'Family Film']",1990,1
2172156,Kireedam,1989,['India'],"['Action', 'Drama', 'Bollywood']",1980,9
20480238,The Baltimore Bullet,1980,['United States of America'],['Comedy-drama'],1980,0
6058681,Bommarillu,2006,['India'],"['Musical', 'Romantic drama', 'Bollywood', 'World cinema', 'Romance Film', 'Drama']",2000,6
3108902,Angels of the Universe,2000,['Iceland'],"['Biography', 'Drama']",2000,0
24583027,The Garden of Allah,1927,['United States of America'],['Silent film'],1920,7
4905605,Roger Dodger,2002,['United States of America'],"['Comedy', 'Comedy of manners', 'Comedy-drama', 'Drama', 'Sex comedy']",2000,2
8602490,The Devil Makes Three,1952,['United States of America'],"['Action', 'Black-and-white', 'Crime Fiction', 'Thriller', 'Romance Film']",1950,2
14222093,Postcards from Leningrad,2007,"['Venezuela', 'Peru']",['Drama'],2000,7
22145673,Sila Nerangalil Sila Manithargal,1975,['India'],['Drama'],1970,5
2569417,Color of Night,1994,['United States of America'],"['Psychological thriller', 'Mystery', 'Indie', 'Thriller', 'Erotic thriller', 'Crime Thriller', 'Erotica']",1990,4
16054119,The Great Santa Claus Switch,1970,['United States of America'],"['Comedy', 'Family Film']",1970,0
7350872,Let George Do It,1940,['United Kingdom'],"['Musical', 'Comedy']",1940,0
24652213,The Lost Continent,1968,[],"['Action', 'Action/Adventure', 'Adventure', 'Science Fiction', 'Fantasy']",1960,8
7313334,Lost in a Harem,1944,['United States of America'],"['Slapstick', 'Comedy']",1940,4
643850,Down Periscope,1996,['United States of America'],"['Slapstick', 'Comedy']",1990,6
963021,Flirting,1991,"['New Zealand', 'Australia']","['Film à clef', 'Indie', 'Romantic drama', 'World cinema', 'Romance Film', 'Drama', 'Period piece', 'Coming of age', 'Comedy-drama']",1990,1
6589975,Sivappathigaram,2006,['India'],['Action'],2000,6
17671802,Orphan,2009,"['Canada', 'France', 'Germany', 'United States of America']","['Psychological thriller', 'Suspense', 'Mystery', 'Thriller', 'Horror', 'Drama', 'Political thriller']",2000,9
19078976,Funny People,2009,['United States of America'],"['Comedy-drama', 'Comedy', 'Drama']",2000,9
33033015,Moss Rose,1947,['United States of America'],"['Mystery', 'Crime Fiction']",1940,7
33747977,Jitter Bughouse,1948,[],['Short Film'],1940,8
30331632,Jeevan Yudh,1997,['India'],"['Musical', 'Bollywood', 'World cinema', 'Drama']",1990,7
31257401,Sherina's Adventure,2000,['Indonesia'],['Musical'],2000,0
2016956,Demetrius and the Gladiators,1954,['United States of America'],"['Action', 'Action/Adventure', 'Christian film', 'Sword and Sandal', 'Epic', 'Drama', 'Movies About Gladiators']",1950,4
9723255,Out of the Dark,1988,['United States of America'],"['Psychological thriller', 'Mystery', 'Slasher', 'Comedy', 'Thriller', 'Horror', 'Erotica']",1980,8
409817,The Story of Vernon and Irene Castle,1939,['United States of America'],"['Musical', 'Black-and-white', 'Biography', 'Musical Drama', 'Biographical film', 'Romance Film', 'Biopic [feature]', 'War film']",1930,9
8190800,La Bête humaine,1938,['France'],"['Black-and-white', 'Crime Fiction', 'Art film', 'Thriller', 'World cinema', 'Crime Thriller', 'Drama', 'Crime Drama']",1930,8
2792566,Because You're Mine,1952,['United States of America'],"['Musical', 'Romance Film']",1950,2
8376209,Pedar,1996,['Iran'],"['Drama', 'World cinema']",1990,6
12297005,The littlest outlaw,1955,"['Mexico', 'United States of America']","[""Children's/Family"", 'Adventure', 'Drama', 'Family Film']",1950,5
3873399,The Madagascar Penguins in a Christmas Caper,2005,['United States of America'],"['Short Film', 'Comedy', 'Family Film', 'Computer Animation']",2000,5
1498491,Southland Tales,2006,"['France', 'Germany', 'United States of America']","['Comedy', 'Thriller', 'Black comedy', 'Drama', 'Ensemble Film', 'Comedy-drama', 'Science Fiction', 'Fantasy']",2000,6
612752,Wizards,1977,['United States of America'],"['Action', 'Fantasy Adventure', 'Animation', 'Adventure', 'Science Fiction', 'Cult', 'Fantasy']",1970,7
35429727,Inch By Inch,1985,['United States of America'],['Gay pornography'],1980,5
3156200,Hang 'Em High,1968,['United States of America'],"['Western', 'Revisionist Western', 'Action/Adventure']",1960,8
18890518,The Captain Hates the Sea,1934,['United States of America'],"['Detective fiction', 'Mystery', 'Comedy', 'Detective', 'Adventure']",1930,4
164395,The Stunt Man,1980,['United States of America'],"['Action', 'Action/Adventure', 'Comedy', 'Thriller', 'Black comedy', 'Drama', 'Anti-war film', 'Comedy Thriller', 'Comedy-drama']",1980,0
3330285,Deadly Drifter,1982,['United States of America'],"['Film adaptation', 'Drama', 'Indie', 'Parody', 'Satire', 'Comedy', 'Road movie']",1980,2
18929976,My Mom's New Boyfriend,2008,"['Germany', 'United States of America']","['Romance Film', 'Romantic comedy', 'Comedy']",2000,8
14513043,Eve of Destruction,1991,['United States of America'],"['Action', 'Action/Adventure', 'Science Fiction', 'Thriller']",1990,1
7133211,Catch a Fire,2006,"['United Kingdom', 'France', 'South Africa', 'United States of America']","['Action', 'Biography', 'Action/Adventure', 'Thriller', 'Drama', 'History', 'Political drama', 'Political thriller']",2000,6
8734067,Last Hour,2008,"['France', 'Hong Kong']","['Action', 'Crime Fiction', 'Action/Adventure', 'Thriller', 'World cinema', 'Chinese Movies', 'Drama', 'Suspense']",2000,8
29381531,Billa No. 786,2000,['India'],['Action'],2000,0
18445420,Happily N'Ever After 2: Snow White Another Bite @ the Apple,2009,['United States of America'],"['Computer Animation', 'Animation', 'Comedy', 'Adventure', 'Family Film', 'Fantasy']",2000,9
1660834,Shadow,1956,['Poland'],"['Action', 'Black-and-white', 'Crime Fiction', 'Thriller', 'World cinema', 'Crime Thriller', 'Drama', 'Political drama', 'Political thriller']",1950,6
17422419,Chato's Land,1972,['United States of America'],"['Action', 'Crime Fiction', 'Revisionist Western', 'Action/Adventure', 'Western']",1970,2
5215066,The Nutty Professor,1996,['United States of America'],"['Comedy', 'Romance Film', 'Romantic comedy', 'Science Fiction']",1990,6
1404035,Last Life in the Universe,2003,"['Japan', 'Thailand']","['Crime Fiction', 'Japanese Movies', 'Comedy', 'Thriller', 'World cinema', 'Romance Film', 'Drama']",2000,3
11843004,Particles of Truth,2003,['United States of America'],"['Romantic drama', 'Family Drama', 'Indie', 'Romance Film', 'Drama']",2000,3
6852771,Pasa Kiligal,2006,['India'],['Action'],2000,6
2423367,She's So Lovely,1997,"['France', 'United States of America']","['Psychological thriller', 'Drama', 'Indie', 'Romantic drama', 'Marriage Drama', 'Comedy', 'Romance Film']",1990,7
5583702,The Opportunists,2000,"['United Kingdom', 'United States of America']","['Crime Fiction', 'Caper story', 'Comedy', 'Crime Drama', 'Romance Film', 'Drama']",2000,0
3610519,The Desert Trail,1935,['United States of America'],"['Western', 'Black-and-white', 'Action/Adventure']",1930,5
26371311,Invitation to a Gunfighter,1964,['United States of America'],"['Action', 'Western', 'Action/Adventure']",1960,4
29160333,Attack of the Killer Tomatoes,1978,['United States of America'],"['Parody', 'Satire', 'Horror', 'B-movie', 'Science Fiction']",1970,8
15149007,Young Sherlocks,1922,[],"['Black-and-white', 'Indie', 'Short Film', 'Comedy', 'Silent film', ""Children's/Family"", 'Family Film']",1920,2
946164,The Green Mile,1999,['United States of America'],"['Period piece', 'Prison', 'Film adaptation', 'Crime Fiction', 'Mystery', 'Drama', 'Fantasy']",1990,9
20747730,If You Could Say It in Words,2008,['United States of America'],"['Romantic drama', 'Indie', 'Romance Film', 'Drama']",2000,8
3188479,Joe's Apartment,1996,['United States of America'],"['Musical', 'Gross out', 'Gross-out film', 'Comedy', 'Musical comedy', 'Black comedy']",1990,6
26372685,Dust,2009,"['Luxembourg', 'Austria']",['Drama'],2000,9
20198389,Walled In,2008,"['France', 'United States of America', 'Canada']","['Psychological thriller', 'Mystery', 'Indie', 'Thriller', 'Horror', 'Supernatural']",2000,8
12440160,Ball & Chain,2006,['United States of America'],"['Romance Film', 'Romantic comedy', 'Comedy']",2000,6
214324,The Shop on Main Street,1965,"['Czech Republic', 'Czechoslovakia']","['World cinema', 'Czechoslovak New Wave', 'War film', 'Drama']",1960,5
24817014,Mr. Billion,1977,['United States of America'],"['Action/Adventure', 'Comedy', 'Adventure']",1970,7
154956,Ocean's Eleven,1960,['United States of America'],"['Action', 'Heist', 'Crime Fiction', 'Action/Adventure', 'Comedy']",1960,0
2694167,The Myth,2005,['Hong Kong'],"['Action', 'Adventure Comedy', 'Action/Adventure', 'Comedy', 'World cinema', 'Chinese Movies', 'Martial Arts Film', 'Adventure', 'Drama', 'Period piece', 'Epic']",2000,5
499147,Blackboard Jungle,1955,['United States of America'],"['Drama', 'Coming of age', 'Teen']",1950,5
22603414,Namets!,2008,['Philippines'],['Filipino Movies'],2000,8
4447058,Eating Out,2004,['United States of America'],"['Gay Themed', 'LGBT', 'Gay', 'Gay Interest', 'Comedy', 'Romance Film', 'Romantic comedy']",2000,4
2621094,King of Comedy,1999,['Hong Kong'],"['Parody', 'Comedy', 'World cinema', 'Romantic comedy', 'Chinese Movies']",1990,9
4604905,Macario,1960,['Mexico'],"['Black-and-white', 'Mystery', 'World cinema', 'Drama', 'Fantasy']",1960,0
8332233,The Keeper: The Legend of Omar Khayyam,2005,['United States of America'],"['Family Drama', 'Childhood Drama', ""Children's/Family"", 'Adventure', 'Drama', 'Family Film']",2000,5
219033,Hellcats of the Navy,1957,['United States of America'],"['Action', 'Combat Films', 'Action/Adventure', 'Docudrama', 'War film', 'Drama']",1950,7
5179911,Fortress 2: Re-Entry,1993,"['Luxembourg', 'United States of America']","['Action', 'Indie', 'Adventure', 'Science Fiction']",1990,3
10815398,Buddha Assassinator,1980,"['Hong Kong', 'Taiwan']","['Action', 'Drama', 'Chinese Movies', 'Martial Arts Film']",1980,0
16506358,Under the Same Moon,2008,"['Mexico', 'United States of America']","['Drama', 'Comedy film', 'World cinema']",2000,8
31081310,The Adventures of Martin Eden,1942,['United States of America'],"['Adventure', 'Drama']",1940,2
1979318,The Cookout,2004,['United States of America'],"['Comedy', 'Comedy of manners', 'Domestic Comedy', 'Sports']",2000,4
1681132,Harlem Nights,1989,['United States of America'],"['Action', 'Crime Fiction', 'Gangster Film', 'Action/Adventure', 'Comedy', 'Drama', 'Period piece', 'Crime Comedy', 'Comedy-drama']",1980,9
23972618,Hercules and the Conquest of Atlantis,1961,"['France', 'Italy']","['Indie', 'Action/Adventure', 'World cinema', 'Sword and Sandal', 'Fantasy']",1960,1
16999974,Glago's Guest,2008,['United States of America'],"['Short Film', 'Animation']",2000,8
14696485,The Gate II: Trespassers,1992,"['Canada', 'United States of America']","['B-movie', 'Indie', 'Horror']",1990,2
18519065,The Job,2003,['United States of America'],"['Drama', 'Crime Fiction', 'Indie', 'Comedy', 'Black comedy', 'Crime Thriller']",2000,3
14916202,Ashanti,1979,['United States of America'],"['Action', 'Film adaptation', 'Drama', 'Action/Adventure', 'Adventure']",1970,9
5248778,Sahib Bibi Aur Ghulam,1962,['India'],"['Musical', 'Bollywood', 'World cinema', 'Drama']",1960,2
24399511,A Yank in Libya,1942,['United States of America'],"['Action', 'Drama', 'Action/Adventure', 'Romance Film', 'War film']",1940,2
2136164,Soul Man,1986,['United States of America'],"['Parody', 'Satire', 'Comedy', 'Teen', 'Comedy of Errors']",1980,6
25344852,Every Mother's Worst Fear,1998,['United States of America'],"['Crime Drama', 'Drama']",1990,8
2323811,Into the Sun,2005,['United States of America'],"['Action', 'Crime Fiction', 'Action/Adventure', 'Thriller', 'Martial Arts Film', 'Adventure']",2000,5
4964365,Lupin the Third: Farewell to Nostradamus,1995,['Japan'],"['Anime', 'Japanese Movies']",1990,5
20072102,Sonny,2002,['United States of America'],"['Period piece', 'Crime Fiction', 'Indie', 'Drama']",2000,2
12845913,The Last Frontier,1932,[],"['Western', 'Black-and-white', 'Action/Adventure']",1930,2
3716313,Bela Lugosi Meets a Brooklyn Gorilla,1952,['United States of America'],"['Adventure Comedy', 'Parody', 'Comedy', 'Adventure', 'Science Fiction', 'Comedy of Errors']",1950,2
7416992,The Impractical Joker,1937,['United States of America'],"['Animation', 'Short Film', 'Comedy', 'Family Film']",1930,7
30007,The Matrix,1999,"['United States of America', 'Australia']","['Action', 'Action/Adventure', 'Thriller', 'Martial Arts Film', 'Adventure', 'Existentialism', 'Doomsday film', 'Science Fiction']",1990,9
21259864,Ratko: The Dictator's Son,2009,"['Canada', 'United States of America']","['Comedy', 'Thriller']",2000,9
12723089,Bandh Darwaza,1990,['India'],"['World cinema', 'Horror']",1990,0
6816652,Teen Titans: Trouble in Tokyo,2007,['United States of America'],"['Adventure Comedy', 'Animation', 'Superhero', 'Action/Adventure', 'Comedy', 'Adventure', 'Superhero movie', 'Family Film', 'Fantasy']",2000,7
16253552,Saint Mary,2002,['Iran'],"['Hagiography', 'Drama']",2000,2
3060279,The Helix...Loaded,2005,['United States of America'],"['Action', 'Parody', 'Action/Adventure', 'Comedy', 'Martial Arts Film', 'Science Fiction']",2000,5
6170246,Khiladiyon Ka Khiladi,1996,['India'],"['Action/Adventure', 'Thriller', 'World cinema']",1990,6
12982972,Bedlam in Paradise,1955,['United States of America'],"['Short Film', 'Black-and-white', 'Comedy']",1950,5
19593154,Babu,1985,['India'],['Romance Film'],1980,5
13759088,Blood Trails,2007,['Germany'],"['Slasher', 'Horror']",2000,7
5192463,Kaise Kahoon Ke... Pyaar Hai,2003,['India'],"['Romance Film', 'Crime Fiction']",2000,3
678603,Gross Anatomy,1989,['United States of America'],"['Comedy', 'Romance Film', 'Romantic comedy', 'Comedy-drama', 'Drama']",1980,9
9083648,Raaja Paarvai,1981,['India'],"['Romance Film', 'Drama']",1980,1
2502339,Brother,1997,['Russia'],"['Music', 'Crime Fiction', 'Gangster Film', 'Thriller', 'World cinema', 'Drama']",1990,7
3536397,Ali: Fear Eats the Soul,1974,"['Germany', 'West Germany']","['Romantic drama', 'World cinema', 'Romance Film', 'Melodrama', 'Drama']",1970,4
155785,A Goofy Movie,1995,['United States of America'],"['Musical', 'Animation', 'Comedy', 'Romance Film', ""Children's/Family"", 'Adventure', 'Family Film']",1990,5
900584,The Seventh Sign,1988,['United States of America'],"['Horror', 'Christian film']",1980,8
4089762,Vaastav: The Reality,1999,['India'],"['Musical', 'Bollywood', 'World cinema']",1990,9
6917005,The Music Man,2003,['United States of America'],"['Musical', 'Comedy film', 'Romance Film', 'Drama', 'Family Film']",2000,3
8930957,Twister,1989,['United States of America'],"['Film adaptation', 'Indie', 'Comedy', 'Black comedy', 'Drama']",1980,9
11936219,Advance to the Rear,1964,['United States of America'],"['Western', 'Slapstick', 'Comedy']",1960,4
900780,200 Motels,1971,['United States of America'],"['Musical', 'Surrealism', 'Rockumentary', 'Road movie', 'Fantasy']",1970,1
20084310,Rooster's Breakfast,2007,"['Croatia', 'Slovenia']","['Comedy-drama', 'Drama', 'Slice of life story']",2000,7
10791485,My Big Break,2008,['United States of America'],"['Culture & Society', 'Documentary']",2000,8
2180950,The Boy Who Could Fly,1986,['United States of America'],"['Coming of age', 'Family Drama', 'Childhood Drama', 'Teen', 'Drama', 'Family Film', 'Fantasy']",1980,6
692785,The Vanishing,1993,['United States of America'],"['Psychological thriller', 'Mystery', 'Thriller', 'Remake', 'Crime Thriller', 'Drama']",1990,3
6177577,Interview,2007,"['United States of America', 'Canada', 'Netherlands']","['Indie', 'Drama', 'Remake']",2000,7
13182925,Fear,1990,['United States of America'],"['Slasher', 'Thriller', 'Horror', 'Supernatural']",1990,0
15703454,The Ruins,2008,"['Germany', 'United States of America', 'Australia']","['Film adaptation', 'Thriller', 'Jungle Film', 'Horror', 'Drama', 'Natural horror films']",2000,8
8008665,Juan & Ted: Wanted,2000,['Philippines'],"['Filipino Movies', 'Comedy']",2000,0
2984225,Night Skies,2006,['United States of America'],"['Mystery', 'Thriller', 'Horror', 'Science Fiction', 'Drama']",2000,6
14527359,A Bird in the Head,1946,['United States of America'],"['Black-and-white', 'Short Film', 'Comedy', 'Slapstick']",1940,6
6942361,A New Kind of Love,1963,['United States of America'],"['Romance Film', 'Romantic comedy', 'Comedy']",1960,3
24735632,Heart is...,2006,['South Korea'],"['Drama', 'Family Film']",2000,6
7543025,Everything You Want,2005,['United States of America'],"['Comedy', 'Romance Film', 'Romantic comedy', 'Television movie']",2000,5
24874106,Kandhakottai,2009,['India'],['Action'],2000,9
25745885,"Paree, Paree",1934,[],"['Musical', 'Short Film', 'Comedy film']",1930,4
32083680,Dashyu Ratnakar,1962,['India'],['Drama'],1960,2
15161999,Milk,2008,['United States of America'],"['LGBT', 'Biography', 'Indie', 'Biographical film', 'Drama', 'Tragedy', 'Period piece', 'History', 'Political drama']",2000,8
23691080,Cowboy and the Senorita,1944,['United States of America'],"['Action', 'Western', 'Action/Adventure']",1940,4
3427182,Jumper,2008,"['Canada', 'United States of America']","['Action', 'Film adaptation', 'Action/Adventure', 'Thriller', 'Adventure', 'Science Fiction', 'Drama']",2000,8
10933963,Shaolin Traitorous,1976,['Hong Kong'],"['Action/Adventure', 'World cinema', 'Chinese Movies', 'Martial Arts Film']",1970,6
9164973,All of a Sudden,1996,['Hong Kong'],"['Action/Adventure', 'Thriller', 'World cinema', 'Erotic thriller', 'Chinese Movies']",1990,6
14338180,Immortal Sergeant,1943,['United States of America'],"['Black-and-white', 'War film', 'Drama']",1940,3
7023676,The Pride and the Passion,1957,['United States of America'],"['Action', 'Drama', 'Action/Adventure', 'Historical Epic', 'Historical fiction']",1950,7
1729333,The Decks Ran Red,1958,['United States of America'],"['Crime Fiction', 'Adventure', 'Thriller']",1950,8
30972924,The Circuit,2002,['Canada'],"['Action', 'Crime Fiction', 'Action/Adventure', 'Thriller', 'Martial Arts Film']",2000,2
6614056,The Overture,2004,['Thailand'],"['Musical', 'World cinema', 'Political drama', 'Drama']",2000,4
16166532,Samudhiram,2001,['India'],"['Drama', 'World cinema']",2000,1
4158685,The Aviator,1985,['United States of America'],"['Period piece', 'Biography', 'Adventure', 'Drama']",1980,5
17778996,The Happiness Cage,1972,['United States of America'],"['Drama', 'Science Fiction', 'Thriller']",1970,2
2109324,Moonlight Express,1999,['Hong Kong'],"['Romantic drama', 'Action/Adventure', 'World cinema', 'Romance Film', 'Chinese Movies', 'Drama']",1990,9
29530961,The Tenant of Wildfell Hall,2008,['United Kingdom'],"['Period piece', 'Romantic drama', 'Melodrama', 'Drama']",2000,8
1769626,Frankie and Johnny,1966,['United States of America'],"['Musical', 'Western', 'Comedy', 'Romance Film', 'Romantic comedy', 'Drama']",1960,6
10109051,The Law and Jake Wade,1958,['United States of America'],"['Action', 'Western', 'Action/Adventure']",1950,8
1473196,Underworld: Evolution,2006,['United States of America'],"['Action', 'Action Thrillers', 'Action/Adventure', 'Gothic Film', 'Thriller', 'Horror', 'Fantasy']",2000,6
2967115,Hardball,2001,"['Germany', 'United States of America']","['Sports', 'Comedy', 'Drama']",2000,1
8471717,East/West,1999,"['Spain', 'Bulgaria', 'Ukraine', 'Russia', 'France']","['Romance Film', 'History', 'Drama']",1990,9
12327474,Blame It on Fidel,2007,['France'],"['Political drama', 'Drama', 'World cinema']",2000,7
17216382,Love of Blood Relations,1976,['South Korea'],['Drama'],1970,6
17522069,Head Against the Wall,1958,['France'],['Drama'],1950,8
6945913,The Loves of Madame Dubarry,1938,['United Kingdom'],"['Romance Film', 'Black-and-white', 'Drama']",1930,8
19885354,Faltu,2006,['India'],['Drama'],2000,6
22129442,Moonnam Pakkam,1988,['India'],['Drama'],1980,8
3257025,Glorious Betsy,1928,['United States of America'],"['Black-and-white', 'History', 'Indie', 'Silent film', 'Drama']",1920,8
34052824,Another Romance of Celluloid,1938,[],['Short Film'],1930,8
31650028,Cucumber Castle,1970,['United Kingdom'],"['Musical', 'Comedy film']",1970,0
3310092,Harlequin,1980,['Australia'],"['Action', 'Mystery', 'Indie', 'Action/Adventure', 'Thriller', 'Drama', 'Fantasy', 'Supernatural', 'Political thriller']",1980,0
15103329,Over Her Dead Body,2008,['United States of America'],"['Heavenly Comedy', 'Comedy', 'Romantic comedy', 'Romance Film', 'Fantasy Comedy', 'Fantasy']",2000,8
14344031,1971,2007,['India'],"['Musical', 'Action/Adventure', 'Bollywood', 'World cinema', 'Drama']",2000,7
25826924,Decalogue X,1988,['Poland'],['Drama'],1980,8
12415647,Who Can Kill a Child?,1976,['Spain'],"['Psychological thriller', 'Slasher', 'Horror', 'World cinema', 'Cult']",1970,6
3454625,The Sleeping Dictionary,2003,['United States of America'],"['Period piece', 'Romantic drama', 'Romance Film', 'Drama']",2000,3
961459,Girls Town,1959,['United States of America'],"['Teen', 'Drama']",1950,9
19396265,Ente Mamattikkuttiyammakku,1983,['India'],['Drama'],1980,3
2458475,Semne în pustiu,1996,['Romania'],"['Short Film', 'Drama']",1990,6
20211414,From a Whisper to a Scream,1987,['United States of America'],['Horror'],1980,7
2195842,Guarding Tess,1994,['United States of America'],"['Political cinema', 'Comedy', 'Thriller', 'Comedy Thriller', 'Comedy of manners']",1990,4
22141009,La Visa Loca,2005,['Philippines'],"['Filipino Movies', 'Comedy', 'World cinema']",2000,5
4073660,Land of the Pharaohs,1955,['United States of America'],"['Action', 'Action/Adventure', 'Historical fiction', 'Historical Epic', 'Epic', 'Adventure', 'Drama']",1950,5
26063060,Yamagola,1977,['India'],"['Comedy film', 'Fantasy']",1970,7
27960307,Blow Me Down!,1933,[],"['Animation', 'Short Film', 'Comedy film', 'Family Film']",1930,3
31556,The Magnificent Seven,1960,['United States of America'],"['Western', 'Action/Adventure', 'Drama']",1960,0
28493483,Deepasthambham Mahascharyam,1999,['India'],"['Musical', 'Comedy', 'Drama']",1990,9
23420352,One Night in Rome,1924,['United States of America'],"['Silent film', 'Black-and-white', 'Drama']",1920,4
4221457,The Ice Pirates,1984,['United States of America'],"['Parody', 'Western', 'Comedy', 'Adventure', 'Science Fiction']",1980,4
33493539,Wenn Ludwig ins Manöver zieht,1967,['Germany'],['Comedy film'],1960,7
2450370,Must Love Dogs,2005,['United States of America'],"['Romance Film', 'Romantic comedy', 'Comedy']",2000,5
11942501,Tropic Thunder,2008,"['United Kingdom', 'Germany', 'United States of America']","['Action', 'Parody', 'Action Comedy', 'Action/Adventure', 'Satire', 'Comedy', 'Adventure']",2000,8
17751093,Tarzan and the Lost Safari,1957,['United Kingdom'],"['Action', 'Adventure', 'Jungle Film']",1950,7
2057905,Earth vs. the Flying Saucers,1956,['United States of America'],"['Doomsday film', 'Alien Film', 'Stop motion', 'Science Fiction', 'Fantasy']",1950,6
2523915,Going Overboard,1989,"['Canada', 'United States of America']","['Indie', 'Stand-up comedy', 'Comedy']",1980,9
29229416,The Olsen Gang Goes Crazy,1973,['Denmark'],"['Comedy film', 'Crime Fiction']",1970,3
14733483,The Day the Earth Stood Still,2008,"['Canada', 'United States of America']","['Thriller', 'Remake', 'Doomsday film', 'Science Fiction', 'Drama']",2000,8
2385928,The Break-Up,2006,['United States of America'],"['Romantic drama', 'Comedy', 'Black comedy', 'Romantic comedy', 'Comedy-drama', 'Romance Film', 'Drama']",2000,6
13720693,La caza,1966,['Spain'],"['Black-and-white', 'Thriller', 'Adventure', 'Drama']",1960,6
27434965,Parivartana,1954,['India'],['Drama'],1950,4
7320866,Water Drops on Burning Rocks,2000,"['France', 'Japan']","['LGBT', 'Erotic Drama', 'Romantic drama', 'World cinema', 'Romance Film', 'Drama', 'Gay Themed', 'Gay', 'Japanese Movies', 'Gay Interest']",2000,0
4198067,Mammoth,2006,['United States of America'],"['Indie', 'Comedy', 'Horror', 'Adventure', 'Television movie', 'Science Fiction', 'Fantasy']",2000,6
13235461,Cujo,1983,['United States of America'],"['Film adaptation', 'Thriller', 'Horror', 'Natural horror films']",1980,3
13439139,27 Dresses,2008,['United States of America'],"['Romance Film', 'Romantic comedy', 'Comedy']",2000,8
2170052,Return of the Ewok,1982,['United States of America'],"['Mockumentary', 'Short Film']",1980,2
1613245,Kadhalan,1994,['India'],"['Romantic drama', 'World cinema', 'Romance Film', 'Drama']",1990,4
5650338,The Heartbreak Kid,1993,['Australia'],['Comedy'],1990,3
16174644,Shelter,2007,['United States of America'],"['Gay Themed', 'LGBT', 'Romance Film', 'Drama']",2000,7
2046763,Bustin' Loose,1981,['United States of America'],"['Action', 'Action/Adventure', 'Comedy']",1980,1
10716714,Fishtales,2007,"['United Kingdom', 'Greece']","['Family Drama', 'Romantic drama', 'Comedy', 'Romance Film', 'Adventure', 'Drama', 'Fantasy Comedy', 'Family Film', 'Fantasy']",2000,7
5374123,Aksar,2006,['India'],"['Romantic drama', 'Thriller', 'Bollywood', 'World cinema', 'Romance Film', 'Drama']",2000,6
7265771,Flourish,2006,['United States of America'],"['Drama', 'Mystery', 'Indie', 'Comedy Thriller', 'Thriller', 'Crime Thriller']",2000,6
14204820,Steal Wool,1957,['United States of America'],"['Animation', 'Short Film', 'Comedy', 'Family Film']",1950,7
16067557,Kitty,1946,['United States of America'],['Black-and-white'],1940,6
31826936,Badla Jatti Da,1991,['India'],"['Action', 'Crime Fiction', 'Drama']",1990,1
24572033,"Time, the Comedian",1925,['United States of America'],"['Silent film', 'Drama']",1920,5
16955171,Faith of My Fathers,2005,['United States of America'],"['Biography', 'Biographical film', 'Television movie', 'War film', 'Drama']",2000,5
27856740,Dada Sahib,2000,['India'],"['Action', 'Drama', 'Bollywood']",2000,0
6917678,It Started with a Kiss,1959,['United States of America'],"['Comedy', 'Sex comedy']",1950,9
24166379,P.J.,1968,['United States of America'],"['Action', 'Mystery', 'Drama']",1960,8
16852170,Bad Girls From Valley High,2000,['United States of America'],"['Comedy', 'Thriller', 'Horror', 'Teen', 'Black comedy', 'Supernatural']",2000,0
6992578,The Billion Dollar Hobo,1977,['United States of America'],"['Slapstick', 'Comedy', 'Melodrama', 'Drama', 'Family Film']",1970,7
3104876,Pooh's Grand Adventure: The Search for Christopher Robin,1997,['United States of America'],"[""Children's Fantasy"", ""Children's/Family""]",1990,7
5443770,The Crimson Rivers,2000,['France'],"['Psychological thriller', 'Crime Fiction', 'Thriller', 'World cinema', 'Crime Thriller']",2000,0
10792104,Polladhavan,1980,['India'],[],1980,0
9678533,The Truce Hurts,1948,['United States of America'],"['Animation', 'Short Film', 'Family Film']",1940,8
35230571,Mr. Madras,1995,['India'],['Comedy film'],1990,5
8275921,Chavit,2003,['Philippines'],"['Filipino Movies', 'Drama', 'World cinema']",2000,3
34311479,Final Reprisal,1988,['Philippines'],"['Action', 'War film']",1980,8
1889288,Babylon 5: In the Beginning,1998,['United States of America'],"['Adventure', 'Television movie', 'Science Fiction', 'Drama']",1990,8
3820380,Quiet Please!,1945,['United States of America'],['Comedy'],1940,5
20917489,The Far Paradise,1928,['Australia'],"['Silent film', 'Romance Film', 'Drama']",1920,8
20904680,Shodh,1981,['India'],['Drama'],1980,1
26304324,Nokketha Dhoorathu Kannum Nattu,1984,['India'],['Drama'],1980,4
1673325,The Phantom of the Opera,1989,['United States of America'],"['Monster movie', 'Horror']",1980,9
19218944,Ashta Chamma,2008,['India'],"['Romantic comedy', 'Comedy']",2000,8
7595972,The Boy with Green Hair,1948,['United States of America'],"['Family Drama', 'Comedy', 'Childhood Drama', 'Comedy-drama', 'Drama', 'Family Film']",1940,8
1482867,So Proudly We Hail!,1943,['United States of America'],"['Action', 'Black-and-white', 'Drama', 'Action/Adventure', 'War film']",1940,3
13161720,Buddha Mar Gaya,2007,['India'],"['Musical', 'Comedy', 'Bollywood', 'World cinema', 'Black comedy']",2000,7
3679431,The Audrey Hepburn Story,2000,['United States of America'],"['Period piece', 'Biography', 'Biographical film', 'Biopic [feature]', 'Television movie', 'Drama']",2000,0
1572108,The Red Balloon,1956,['France'],"['Short Film', 'World cinema', 'Family-Oriented Adventure', ""Children's/Family"", ""Children's"", 'Fantasy']",1950,6
113464,Hannah and Her Sisters,1986,['United States of America'],"['Indie', 'Romantic drama', 'Comedy', 'Romance Film', 'Drama', 'Romantic comedy', 'Comedy-drama', 'Ensemble Film']",1980,6
3291478,Jamaica Inn,1939,['United Kingdom'],"['Film adaptation', 'Black-and-white', 'Thriller']",1930,9
1565181,The Money Pit,1986,['United States of America'],"['Musical', 'Comedy', 'Romance Film', 'Romantic comedy', 'Domestic Comedy', 'Slapstick']",1980,6
25075517,If Winter Comes,1947,['United States of America'],['War film'],1940,7
9391085,High School Musical 3: Senior Year,2008,['United States of America'],"['Musical', 'Comedy', 'Teen', 'Musical comedy', 'Romance Film', 'Drama', 'Family Film']",2000,8
2082089,Trixie,2000,['United States of America'],"['Action', 'Detective fiction', 'Crime Fiction', 'Mystery', 'Action/Adventure', 'Comedy', 'Thriller', 'Crime Thriller', 'Drama', 'Comedy Thriller', 'Detective', 'Comedy-drama']",2000,0
4305002,Art School Confidential,2006,['United States of America'],"['Film adaptation', 'LGBT', 'Indie', 'Action/Adventure', 'Satire', 'Comedy', 'Black comedy', 'Drama']",2000,6
1119341,Purple Butterfly,2003,"['China', 'France']","['World cinema', 'War film', 'Chinese Movies', 'Political drama', 'Drama']",2000,3
11351598,Sherlock Holmes Faces Death,1943,['United States of America'],"['Detective fiction', 'Black-and-white', 'Crime Fiction', 'Mystery', 'Thriller', 'Crime Thriller', 'Drama', 'Detective']",1940,3
10176837,Boston Quackie,1957,['United States of America'],"['Animation', 'Short Film', 'Comedy', 'Family Film']",1950,7
1308304,Sidekicks,1992,['United States of America'],"['Action', 'Coming of age', 'Family Drama', 'Teen', 'Adventure', 'Drama', 'Family Film']",1990,2
5909614,Kalyug,1981,['India'],"['Bollywood', 'Art film']",1980,1
3541767,Kibakichi,2004,['Japan'],"['Action', 'Creature Film', 'Japanese Movies', 'Horror', 'Fantasy']",2000,4
14706880,Four Christmases,2008,"['Germany', 'United States of America']","['Comedy', 'Romance Film', 'Romantic comedy', 'Holiday Film', 'Christmas movie']",2000,8
17326580,Recount,2008,['United States of America'],"['Television movie', 'Docudrama', 'Political drama', 'Drama']",2000,8
33817228,"Rosolino Paternò, soldato...",1970,[],"['Action', 'Drama', 'Comedy film', 'War film']",1970,0
76617,Vertigo,1958,['United States of America'],"['Psychological thriller', 'Film adaptation', 'Crime Fiction', 'Mystery', 'Thriller', 'Film noir', 'Romance Film', 'Crime Thriller', 'Drama', 'Suspense', 'Detective']",1950,8
27036009,Preminchi Choodu,1965,['India'],"['Drama', 'Comedy film']",1960,5
3552642,The Scorned,2005,['United States of America'],"['Psychological thriller', 'Slasher', 'Comedy', 'Thriller', 'Horror', 'Erotic thriller']",2000,5
23587009,Evil Bong 2: King Bong,2009,['United States of America'],"['Black comedy', 'Comedy', 'Cult']",2000,9
14277334,Twilight,2008,['United States of America'],"['Film adaptation', 'Romantic drama', 'Teen', 'Romance Film', 'Fantasy', 'Adventure', 'Drama']",2000,8
19594027,The Bohemian Life,1992,"['Sweden', 'Finland', 'France', 'Germany', 'Italy']","['Black-and-white', 'Comedy', 'Drama']",1990,2
2307251,Salaam Namaste,2005,['India'],"['Musical', 'Comedy', 'Romance Film', 'Drama']",2000,5
3600737,Jeopardy,1953,['United States of America'],"['Psychological thriller', 'Film noir', 'Thriller']",1950,3
31132665,The Legend of the Golden Gun,1979,['United States of America'],"['Western', 'Fantasy']",1970,9
31095423,Caught Plastered,1931,[],['Musical'],1930,1
33764171,"Kapag Tumibok Ang Puso: Not Once, But Twice",2006,['Philippines'],"['Filipino Movies', 'Comedy', 'World cinema']",2000,6
34296596,Surakshaa,1995,['India'],"['Action', 'Drama', 'Crime Fiction', 'Romance Film']",1990,5
5137665,Five Finger Exercise,1962,['United States of America'],"['Melodrama', 'Drama']",1960,2
6406105,Run,1991,['United States of America'],"['Action', 'Thriller', 'Drama']",1990,1
25080835,The Angry Hills,1959,"['United Kingdom', 'United States of America']","['Spy', 'Action', 'Drama', 'Thriller', 'War film']",1950,9
159447,The Negotiator,1998,"['Germany', 'United States of America']","['Action', 'Suspense', 'Crime Fiction', 'Mystery', 'Thriller', 'Crime Thriller', 'Drama']",1990,8
21180653,Das Fräulein,2006,"['Switzerland', 'Germany']","['Indie', 'Drama', 'World cinema']",2000,6
17177246,Triage,2009,"['Spain', 'Belgium', 'France', 'Ireland']","['Psychological thriller', 'Drama', 'Indie', 'Thriller', 'World cinema', 'War film']",2000,9
35737836,The Gateway of the Moon,1928,['United States of America'],"['Silent film', 'Drama']",1920,8
10025286,The Jazz Singer,1952,['United States of America'],"['Musical', 'Drama']",1950,2
15724834,Sadhu Miranda,2008,['India'],"['Thriller', 'Drama']",2000,8
2122882,Bitter Jester,2003,['United States of America'],"['Biography', 'Indie', 'Comedy', 'Stand-up comedy', 'Documentary', 'Culture & Society']",2000,3
23438376,Paper Man,2009,['United States of America'],"['Drama', 'Indie', 'Comedy', 'Comedy-drama']",2000,9
9633533,Vandanam,1989,['India'],['Action'],1980,9
6795151,Rajavin Parvaiyile,1995,['India'],['Drama'],1990,5
11507281,Arctic Tale,2007,['United States of America'],"['Animals', 'Environmental Science', 'Documentary', 'Family Film', 'Culture & Society', 'Nature']",2000,7
14734625,Jhoomar,2007,['Pakistan'],['Drama'],2000,7
29141687,Aithe,2003,['India'],"['Adventure', 'Thriller']",2000,3
3194428,The Mod Squad,1999,['United States of America'],"['Action', 'Crime Fiction', 'Mystery', 'Action Thrillers', 'Action/Adventure', 'Thriller', 'Crime Thriller']",1990,9
23022495,Island of the Dead,2000,['United States of America'],"['Indie', 'Horror']",2000,0
3365741,A Better Tomorrow 2,1987,"['China', 'Hong Kong']","['Action', 'Crime Fiction', 'Gangster Film', 'Action/Adventure', 'Thriller', 'World cinema', 'Chinese Movies', 'Drama']",1980,7
4750168,Blackbeard's Ghost,1968,['United States of America'],"['Heavenly Comedy', 'Comedy', 'Slapstick', ""Children's"", 'Adventure', 'Drama', 'Family Film', 'Fantasy']",1960,8
15851039,Davy Crockett and the River Pirates,1956,['United States of America'],"['Action', 'Adventure']",1950,6
1449222,La Grande Bouffe,1973,"['France', 'Italy']","['Satire', 'Comedy', 'World cinema', 'Black comedy', 'Comedy-drama', 'Drama']",1970,3
14878446,Wee Willie Winkie,1937,['United States of America'],"['British Empire Film', 'Action', 'Black-and-white', 'Action/Adventure', ""Children's/Family"", 'War film', ""Children's"", 'Adventure', 'Drama', 'Family Film']",1930,7
2052143,Titanic,1943,['Germany'],"['Black-and-white', 'World cinema', 'Disaster', 'Propaganda film', 'Drama']",1940,3
27880897,Dr. Heckyl and Mr. Hype,1980,['United States of America'],"['Parody', 'Comedy film']",1980,0
9089380,La Cage aux Folles,1978,"['France', 'Italy']",['Comedy'],1970,8
3674173,The Thief,1952,['United States of America'],"['Film noir', 'Crime Fiction', 'Drama']",1950,2
30875429,Chairman of the Board,1998,['United States of America'],"['Workplace Comedy', 'Slapstick', 'Comedy']",1990,8
21250867,The Vicious Circle,1957,['United Kingdom'],"['Crime Fiction', 'Mystery', 'Thriller']",1950,7
761361,Dog Park,1998,"['Canada', 'United States of America']","['Romance Film', 'Romantic comedy', 'Comedy']",1990,8
23398349,Sankat City,2009,['India'],"['Comedy', 'World cinema']",2000,9
28370824,Night of the Juggler,1980,['United States of America'],"['Action', 'Crime Fiction', 'Drama']",1980,0
1599486,Project Grizzly,1996,['Canada'],"['Inventions & Innovations', 'Indie', 'Comedy', 'Documentary', 'Nature']",1990,6
3251133,Garfield: A Tail of Two Kitties,2006,"['United Kingdom', 'United States of America']","['Comedy', 'Animal Picture', 'Family-Oriented Adventure', ""Children's/Family"", 'Family Film']",2000,6
18844830,Juha,1999,['Finland'],"['Romance Film', 'Drama', 'Comedy film']",1990,9
1722156,Space Cowboys,2000,"['United States of America', 'Australia']","['Action', 'Action/Adventure', 'Buddy film', 'Thriller', 'Comedy', 'Adventure', 'Drama', 'Comedy-drama', 'Science Fiction']",2000,0
19998351,Shesha Drushti,1997,['India'],['Drama'],1990,7
10566880,The Lost Honour of Katharina Blum,1975,"['Germany', 'West Germany']","['Political drama', 'Drama', 'World cinema']",1970,5
36057887,Vedan,1993,['India'],['Crime Fiction'],1990,3
1471772,Apur Sansar,1959,['India'],"['Art film', 'Coming of age', 'Bengali Cinema', 'World cinema', 'Drama']",1950,9
826441,Death Wish II,1982,['United States of America'],"['Action', 'Crime Fiction', 'Action/Adventure', 'Thriller', 'Crime Thriller']",1980,2
12764766,Tom and Jerry Blast Off to Mars,2004,['United States of America'],"['Family Film', 'Animation']",2000,4
8664385,The Uninvited,2003,['South Korea'],"['World cinema', 'Horror']",2000,3
21287122,Princess Protection Program,2009,"['Canada', 'United States of America']","['Family Drama', 'Comedy', 'Television movie', ""Children's/Family"", 'Drama', 'Family Film']",2000,9
12576364,Thottal Poo Malarum,2007,['India'],['Musical'],2000,7
5827942,Blackwoods,2002,['Canada'],"['Psychological thriller', 'Thriller', 'Crime Thriller', 'Drama']",2000,2
18397288,Waterhole #3,1967,['United States of America'],"['Comedy Western', 'Action/Adventure', 'Western', 'Comedy']",1960,7
10142493,Where's That Fire?,1940,['United Kingdom'],"['Black-and-white', 'Crime Fiction', 'Comedy']",1940,0
12160078,Town Creek,2009,['United States of America'],"['Thriller', 'Horror', 'Zombie Film', 'Drama']",2000,9
2109826,American Desi,2001,['United States of America'],"['Indie', 'Comedy', 'Teen', 'Musical comedy', 'Romance Film', 'Romantic comedy']",2000,1
36694867,Ceddo,1977,['Senegal'],"['Avant-garde', 'Experimental film', 'Political drama', 'Drama']",1970,7
1571083,Mr. & Mrs. Smith,1941,['United States of America'],"['Black-and-white', 'Screwball comedy', 'Comedy', 'Romance Film', 'Romantic comedy']",1940,1
4304543,Bunker Hill Bunny,1950,['United States of America'],"['Comedy', 'Family Film']",1950,0
3956788,The Swan Princess,1994,['United States of America'],"['Musical', 'Animation', 'Comedy', 'Romance Film', ""Children's/Family"", 'Fairy tale', ""Children's Fantasy"", 'Family Film', 'Fantasy']",1990,4
2508590,Keys to Tulsa,1996,['United States of America'],"['Neo-noir', 'Crime Fiction', 'Mystery', 'Indie', 'Thriller', 'Crime Thriller', 'Drama', 'Suspense', 'Crime Drama']",1990,6
8153526,Pittsburgh,1942,['United States of America'],"['Black-and-white', 'Drama']",1940,2
20219598,Stamboul Quest,1934,['United States of America'],"['Action', 'Spy', 'Romantic drama', 'Thriller', 'Romance Film', 'Docudrama', 'Drama', 'Biopic [feature]']",1930,4
33489050,Kavya's Diary,2009,['India'],['Thriller'],2000,9
5057034,Mixed Nuts,1994,['United States of America'],"['Black comedy', 'Screwball comedy', 'Comedy']",1990,4
997206,Hello Brother,1999,['India'],"['Comedy', 'Bollywood', 'World cinema']",1990,9
7210380,Betty Boop for President,1932,['United States of America'],"['Comedy', 'Satire']",1930,2
25061879,Golden Needles,1974,"['Hong Kong', 'United States of America']","['Action', 'Action/Adventure', 'Thriller', 'Adventure', 'Chinese Movies', 'Martial Arts Film']",1970,4
10144863,Little Chenier,2006,['United States of America'],"['Crime Fiction', 'Indie', 'Drama']",2000,6
8181832,A Guide for the Married Man,1967,['United States of America'],"['Comedy', 'Romance Film', 'Romantic comedy', 'Domestic Comedy', 'Sex comedy']",1960,7
1099178,The Muppets Take Manhattan,1984,"['United Kingdom', 'United States of America']","['Musical', 'LGBT', 'Animation', 'Comedy', ""Children's/Family"", 'Adventure', 'Family Film']",1980,4
18496202,Marshal Tito's Spirit,2000,['Croatia'],['Comedy'],2000,0
9594415,The Cat's-Paw,1934,['United States of America'],"['Black-and-white', 'Satire', 'Comedy']",1930,4
1773524,Charulata,1964,['India'],"['Period piece', 'Art film', 'Romantic drama', 'Bengali Cinema', 'World cinema', 'Romance Film', 'Drama']",1960,4
12894538,Light it Up,1999,['United States of America'],"['Crime Fiction', 'Coming of age', 'Teen', 'Melodrama', 'Crime Thriller', 'Drama']",1990,9
2171853,The Passenger,1975,"['Spain', 'France', 'Italy', 'United States of America']","['Psychological thriller', 'Thriller', 'World cinema', 'Drama']",1970,5
2682566,The Heart of Men,2003,['France'],"['Romance Film', 'Comedy']",2000,3
13621726,The Spiral Staircase,2000,"['Canada', 'United States of America']","['Mystery', 'Thriller', 'Family Film']",2000,0
6752142,Good Morning Miss Dove,1955,['United States of America'],['Drama'],1950,5
1345876,The Savage Innocents,1960,"['United Kingdom', 'France', 'Italy']","['Action', 'Film adaptation', 'Crime Fiction', 'World cinema', 'Adventure', 'Drama']",1960,0
29619112,Annayya,1993,[],['Drama'],1990,3
10251251,Recaptured Love,1930,['United States of America'],"['Black-and-white', 'Comedy', 'Romance Film', 'Drama']",1930,0
17820671,Tarzan's Deadly Silence,1970,['United States of America'],"['Adventure', 'Jungle Film']",1970,0
3455547,Portrait of Hell,1969,['Japan'],"['Fantasy Adventure', 'Japanese Movies', 'World cinema', 'Drama']",1960,9
8630242,Stamp Day for Superman,1954,['United States of America'],"['Action', 'Superhero', 'Short Film', 'Superhero movie', ""Children's/Family""]",1950,4
22758400,Fearless Tiger,1991,['Canada'],"['Action', 'Drama', 'Thriller', 'Martial Arts Film']",1990,1
13365023,Meu Tio Matou Um Cara,2004,['Brazil'],"['Crime Fiction', 'Mystery', 'Comedy', 'Adventure']",2000,4
2408918,Judge Dredd,1995,['United States of America'],"['Action', 'Crime Fiction', 'Superhero', 'Action/Adventure', 'Thriller', 'Superhero movie', 'Science Fiction']",1990,5
17188553,Missing Without Leave,1964,"['France', 'Italy']","['Film noir', 'Crime Drama', 'Drama']",1960,4
12908387,Sunset at Chaophraya,1995,['Thailand'],"['War film', 'Drama']",1990,5
18234023,New Adventures of a Yankee in King Arthur's Court,1988,['Soviet Union'],"['Adventure', 'Fantasy']",1980,8
2191717,Stuck in the Suburbs,2004,['United States of America'],"['Musical', 'Comedy', 'Teen', ""Children's"", 'Drama']",2000,4
15907225,Serious Moonlight,2009,['United States of America'],"['Indie', 'Comedy', 'Black comedy', 'Romantic comedy', 'Romance Film', 'Domestic Comedy']",2000,9
5818778,What Gets Me Hot!,1984,['United States of America'],['Pornographic movie'],1980,4
181471,Lady Jane,1986,"['United Kingdom', 'England']","['Period piece', 'Romantic drama', 'Biographical film', 'Political drama', 'Romance Film', 'Costume drama', 'Drama']",1980,6
7129779,Polly,1989,['United States of America'],"['Musical', 'Musical comedy', 'Television movie', ""Children's/Family"", 'Family Film']",1980,9
15531185,Penguin Pool Murder,1932,['United States of America'],"['Black-and-white', 'Mystery', 'Comedy']",1930,2
3752065,The Three Burials of Melquiades Estrada,2005,"['United States of America', 'France']","['Crime Fiction', 'Western', 'Action/Adventure', 'Drama']",2000,5
2580873,Belle Époque,1992,"['Portugal', 'France', 'Spain']","['Romantic drama', 'Comedy', 'World cinema', 'Romance Film', 'Romantic comedy', 'Drama']",1990,2
3505437,Albino Alligator,1997,"['United States of America', 'France']","['Suspense', 'Drama', 'Crime Fiction', 'Indie', 'Thriller', 'Crime Drama', 'Crime Thriller']",1990,7
3628560,Catch-22,1970,['United States of America'],"['Surrealism', 'Film adaptation', 'Satire', 'Comedy', 'Black comedy', 'Drama', 'Anti-war', 'Period piece', 'War film', 'Ensemble Film']",1970,0
23620486,Under The Mountain,2009,['New Zealand'],"['Film adaptation', 'World cinema', 'Adventure', 'Drama', 'Mythological Fantasy', 'Horror', 'Science Fiction', 'Family Film', 'Fantasy']",2000,9
5858224,Arjun,2004,['India'],"['Action', 'Tollywood']",2000,4
1844737,The Roots of Heaven,1958,['United States of America'],"['Melodrama', 'Adventure', 'Drama']",1950,8
5375472,Christopher Columbus: The Discovery,1992,"['United Kingdom', 'Spain', 'United States of America']","['History', 'Biography', 'Action/Adventure', 'Historical fiction', 'Historical Epic', 'Adventure', 'Drama']",1990,2
3266971,Silver Bells,2005,['United States of America'],"['Holiday Film', 'Family Drama']",2000,5
2208902,WiseGirls,2002,"['United Kingdom', 'United States of America', 'Canada']","['Action', 'Crime Fiction', 'Gangster Film', 'Action/Adventure', 'Indie', 'Comedy', 'Thriller', 'Buddy film', 'Drama', 'Comedy-drama']",2000,2
32286723,The Bamboo Blonde,1946,['United States of America'],"['Musical', 'Comedy', 'Romance Film', 'War film']",1940,6
25616821,Niagara Falls,1941,['United States of America'],"['Short Film', 'Romantic comedy']",1940,1
34333015,Cleveland Smith: Bounty Hunter,1982,['United States of America'],"['Short Film', 'Comedy film']",1980,2
1443743,The Salton Sea,2002,['United States of America'],"['Psychological thriller', 'Neo-noir', 'Crime Fiction', 'Mystery', 'Thriller', 'Crime Thriller', 'Drama']",2000,2
6446053,Dr. No,1962,['United Kingdom'],"['Action', 'Action/Adventure', 'Thriller', 'Adventure', 'Glamorized Spy Film']",1960,2
10597194,Five Element Ninjas,1982,['Hong Kong'],"['Action', 'Action/Adventure', 'World cinema', 'Chinese Movies', 'Martial Arts Film']",1980,2
8557069,Her Majesty,2005,"['New Zealand', 'Australia']","['Drama', 'Coming of age', 'Indie', 'Family Drama', 'World cinema', 'Family Film']",2000,5
5867902,Mercury Man,2006,['Thailand'],"['Action', 'Action Thrillers', 'Action/Adventure', 'Thriller', 'World cinema', 'Superhero movie', 'Martial Arts Film']",2000,6
680361,Dirty Dancing,1987,['United States of America'],"['Musical', 'Musical Drama', 'Indie', 'Romantic drama', 'Teen', 'Romance Film', 'Drama', 'Period piece', 'Coming of age', 'Dance']",1980,7
36548689,Kanhaiya,1959,['India'],"['Romantic drama', 'Family Film']",1950,9
2087781,Silverado,1985,['United States of America'],"['Action', 'Revisionist Western', 'Action/Adventure', 'Western', 'Comedy', 'Ensemble Film']",1980,5
23620074,Marine Raiders,1944,['United States of America'],"['War film', 'Black-and-white']",1940,4
7285447,Between Us,2004,['United Kingdom'],['Short Film'],2000,4
31312249,Daruchini Dip,2007,['Bangladesh'],['Romance Film'],2000,7
1376533,The Outlaw,1943,"['United Kingdom', 'United States of America']","['Action', 'Action/Adventure', 'Western', 'Biopic [feature]']",1940,3
6181327,Blood Rush,1983,['Italy'],"['Action', 'Science Fiction', 'Adventure']",1980,3
24162323,The Silver Horde,1930,['United States of America'],"['Action', 'Film adaptation', 'Action/Adventure', 'Western', 'Romance Film', 'Drama']",1930,0
2217387,The Yakuza,1975,"['Japan', 'United States of America']","['Crime Fiction', 'Gangster Film', 'Japanese Movies', 'Mystery', 'Thriller', 'Crime Thriller']",1970,5
614477,The Crimson Ghost,1946,['United States of America'],"['Action', 'Black-and-white', 'Crime Fiction', 'Adventure']",1940,6
4082993,Horror Vision,2001,['United States of America'],"['Monster movie', 'Slasher', 'Thriller', 'Horror', 'B-movie', 'Sci-Fi Horror']",2000,1
5851860,Gemini,1999,['Japan'],"['Psychological thriller', 'Japanese Movies', 'World cinema', 'Horror', 'Drama', 'Fantasy']",1990,9
8102527,Fighting Devil Dogs,1938,['United States of America'],"['Action', 'Black-and-white', 'Adventure']",1930,8
1686352,Black Cloud,2004,['United States of America'],"['Boxing', 'Coming of age', 'Indie', 'Sports', 'Drama']",2000,4
2046787,Haunted Honeymoon,1986,['United States of America'],"['Screwball comedy', 'Parody', 'Comedy', 'Horror']",1980,6
34164437,Paappi Devataa,1995,['India'],"['Action', 'Drama']",1990,5
3654057,Fat Girl,2001,"['France', 'Italy']","['Coming of age', 'Drama']",2000,1
206818,Seven,1995,['United States of America'],"['Psychological thriller', 'Crime Fiction', 'Mystery', 'Indie', 'Thriller', 'Crime Thriller']",1990,5
22810673,Fort Utah,1967,['United States of America'],"['Action', 'Western', 'Action/Adventure']",1960,7
32216249,Double Agent,2003,['South Korea'],"['Action', 'Drama', 'Crime Fiction', 'Thriller']",2000,3
29508267,Too Outrageous!,1987,['Canada'],"['Drama', 'Comedy film']",1980,7
8603914,Flickering Lights,2000,"['Sweden', 'Denmark']","['Action', 'Crime Fiction', 'Comedy', 'Crime Comedy', 'World cinema', 'Crime Thriller', 'Drama']",2000,0
15643111,Shut Up and Kiss Me,2005,['United States of America'],"['Romance Film', 'Romantic comedy', 'Comedy']",2000,5
16053851,Night People,1954,['United States of America'],['Short Film'],1950,4
21889241,American Reel,1999,['United States of America'],"['Comedy-drama', 'Buddy film', 'Drama']",1990,9
2853280,Waves,2000,['India'],"['Musical', 'Romantic drama', 'World cinema', 'Tamil cinema', 'Romance Film', 'Drama']",2000,0
12583555,A Perfect Match,2007,['Belgium'],"['Romance Film', 'Comedy', 'Drama']",2000,7
10542198,A Man Called Horse,1970,['United States of America'],"['Action/Adventure', 'Western', 'Adventure', 'Drama']",1970,0
4419761,Bad Dreams,1988,['United States of America'],"['Psychological thriller', 'Slasher', 'Horror']",1980,8
2091700,The Kiss of the Vampire,1963,['United Kingdom'],['Horror'],1960,3
28071647,Sorry Baby,1999,['China'],['Chinese Movies'],1990,9
246355,Manos: The Hands of Fate,1966,['United States of America'],['Horror'],1960,6
24235116,"A Reason to Live, a Reason to Die",1972,['Italy'],"['Action', 'Western']",1970,2
983560,Machuca,2004,"['Chile', 'Spain', 'United Kingdom', 'France']","['Period piece', 'Coming of age', 'Biographical film', 'World cinema', 'Political drama', 'Drama']",2000,4
4180523,Kaaka Kaaka,2003,['India'],"['Action/Adventure', 'Drama', 'World cinema']",2000,3
1112640,Céline et Julie vont En Bateau,1974,['France'],"['Comedy', 'Drama', 'Fantasy']",1970,4
11829180,Unsung Heroes,1978,[],"['Action', 'Spy']",1970,8
13421923,Home Delivery: Aapko... Ghar Tak,2005,['India'],"['Musical', 'Romantic drama', 'Comedy', 'World cinema', 'Romance Film', 'Romantic comedy', 'Drama']",2000,5
25011142,Bloodbrothers,1978,['United States of America'],['Drama'],1970,8
1731114,Smokey and the Bandit Part 3,1983,['United States of America'],"['Action', 'Crime Fiction', 'Action/Adventure', 'Comedy', 'Adventure']",1980,3
18392617,Full Eclipse,1993,['United States of America'],"['Creature Film', 'Action', 'Action/Adventure', 'Comedy Thriller', 'Thriller', 'Horror']",1990,3
22165686,The Unidentified,2008,['United States of America'],"['Drama', 'Indie', 'Romantic drama', 'Comedy', 'Romance Film', 'Romantic comedy']",2000,8
871080,Two Brothers,2004,"['United Kingdom', 'France', 'Thailand']","['Adventure', ""Children's"", 'Drama', 'Family Film']",2000,4
19137519,Be Forever Yamato,1980,['Japan'],"['Action', 'Animation', 'Japanese Movies', 'Adventure', 'Anime', 'Science Fiction']",1980,0
473086,King Kong,2005,"['Germany', 'United States of America', 'New Zealand']","['Action', 'Action/Adventure', 'Thriller', 'Remake', 'World cinema', 'Romance Film', 'Adventure', 'Drama', 'Monster movie']",2000,5
2917039,Slaughterhouse-Five,1972,['United States of America'],"['Film adaptation', 'Satire', 'Comedy', 'Drama', 'Anti-war', 'Time travel', 'Anti-war film', 'Comedy-drama', 'War film', 'Science Fiction']",1970,2
26137538,Get-Rich-Quick Wallingford,1921,['United States of America'],['Silent film'],1920,1
9457255,Do You Like Hitchcock?,2005,"['Spain', 'Italy']","['Giallo', 'Detective fiction', 'Mystery', 'Thriller', 'World cinema', 'Crime Thriller', 'Detective', 'Horror', 'Television movie']",2000,5
35681617,Vikram,1986,['India'],"['Action', 'Crime Fiction', 'Drama']",1980,6
909006,1900,1976,"['France', 'West Germany', 'Italy']","['Period piece', 'Family Drama', 'Epic', 'Political drama', 'Drama']",1970,6
19744057,Invités Surprises,2008,[],['Comedy'],2000,8
9129523,Speed,2007,['India'],"['Action', 'Drama', 'Thriller', 'Romance Film']",2000,7
725817,The Jungle Book 2,2003,['United States of America'],"['Music', 'Animation', 'Animated Musical', 'Family-Oriented Adventure', ""Children's/Family"", ""Children's"", 'Adventure', 'Family Film']",2000,3
5216707,Seduced and Abandoned,1964,"['France', 'Italy']","['Black-and-white', 'Comedy', 'World cinema', 'Drama']",1960,4
6503761,Boyfriends,1996,['United Kingdom'],"['LGBT', 'Indie', 'Romance Film', 'Drama']",1990,6
22470177,100 Mile Rule,2002,['United States of America'],['Comedy film'],2000,2
18986931,44 Inch Chest,2009,['United Kingdom'],"['Crime Fiction', 'Gangster Film', 'Thriller', 'Black comedy', 'Crime Thriller', 'Drama', 'Crime Drama', 'Comedy-drama']",2000,9
9122309,No Man of Her Own,1932,['United States of America'],"['Black-and-white', 'Comedy', 'Romance Film', 'Romantic comedy']",1930,2
11663591,The Contractor,2007,"['United Kingdom', 'Bulgaria', 'United States of America']","['Action', 'Action/Adventure', 'Thriller']",2000,7
15439130,Perumal,2009,['India'],"['Action', 'Drama']",2000,9
22132828,So Big,1953,['United States of America'],"['Black-and-white', 'Drama']",1950,3
27161161,Megham,1999,['India'],"['Musical', 'Comedy']",1990,9
19246346,Jor,2008,['India'],"['Action', 'Romance Film', 'Drama']",2000,8
29151231,Chaithanya,1991,['India'],"['Romance Film', 'Crime Fiction', 'Drama']",1990,1
9034874,Insaaf:The Final Justice,1997,['India'],['Drama'],1990,7
3869329,Help!,1965,['United Kingdom'],"['Adventure Comedy', 'Musical', 'Screwball comedy', 'Satire', 'Comedy', 'Adventure', 'Absurdism', 'Jukebox musical']",1960,5
26008427,The Grasshopper,1971,['United States of America'],"['Coming of age', 'Melodrama', 'Drama']",1970,1
9464777,The Method,2005,"['Argentina', 'Spain', 'Italy']","['Mystery', 'Indie', 'Thriller', 'World cinema', 'Drama']",2000,5
1405054,The R.M.,2003,['United States of America'],"['Crime Fiction', 'Comedy', 'Religious Film', 'Family Film']",2000,3
1436551,Oxford Blues,1984,[],['Drama'],1980,4
21141408,Devadoothan,2000,['India'],"['Musical', 'Drama', 'Horror']",2000,0
18241669,Simpatico,1999,"['United Kingdom', 'France', 'United States of America']","['Drama', 'Crime Fiction', 'Indie', 'Comedy', 'World cinema']",1990,9
34291403,The Llano Kid,1939,['United States of America'],['Western'],1930,9
12064353,Tata Birla Madhyalo Laila,2006,['India'],"['Comedy-drama', 'World cinema']",2000,6
10668224,The Mad Magician,1954,['United States of America'],"['Thriller', 'Horror']",1950,4
2983714,Popstar,2005,['United States of America'],"['Comedy', 'Teen', 'Romance Film', 'Romantic comedy', 'Family Film']",2000,5
4600432,Young and Dangerous 4,1997,['Hong Kong'],"['Action', 'Gangster Film', 'Chinese Movies', 'Martial Arts Film']",1990,7
1007009,The Mighty Kong,1998,['United States of America'],"['Musical', 'Animation', 'Adventure', 'Family Film', 'Fantasy']",1990,8
5880273,Heavenly Puss,1949,['United States of America'],['Comedy'],1940,9
844078,Smokey and the Bandit,1977,['United States of America'],"['Action', 'Crime Fiction', 'Action/Adventure', 'Comedy', 'Romance Film', 'Adventure', 'Chase Movie', 'Action Comedy', 'Road movie']",1970,7
14899728,Nenu,2003,['India'],['World cinema'],2000,3
28350035,Mangammagari Manavadu,1984,['India'],"['Action', 'Drama']",1980,4
24739881,Ruckus,1981,['United States of America'],"['Drama', 'Adventure', 'Thriller']",1980,1
24778931,Mancora,2008,"['Spain', 'Peru']","['Romantic drama', 'World cinema', 'Romance Film', 'Drama']",2000,8
997939,Kindergarten Cop,1990,['United States of America'],"['Action', 'Indie', 'Action/Adventure', 'Comedy Thriller', 'Thriller', 'Comedy', 'Family Film']",1990,0
29450146,Mickey's Minstrels,1934,['United States of America'],['Short Film'],1930,4
3782947,Pound Puppies and the Legend of Big Paw,1988,['United States of America'],"['Musical', 'Animation', 'Comedy', ""Children's"", 'Family Film']",1980,8
19843601,Dragon Hunters,2008,"['Australia', 'France', 'Italy', 'Spain', 'Luxembourg', 'Belgium', 'Argentina', 'United Kingdom', 'Germany', 'United States of America']","['Animation', 'Adventure', 'Family Film', 'Fantasy']",2000,8
317647,Tomorrow Never Dies,1997,"['United Kingdom', 'United States of America']","['Action', 'Crime Fiction', 'Action Thrillers', 'Action/Adventure', 'Thriller', 'Glamorized Spy Film']",1990,7
3683909,Inside The Forbidden City,1965,['Hong Kong'],"['Musical', 'Drama', 'Chinese Movies']",1960,5
167924,Like Mike,2002,['United States of America'],"['Comedy', ""Children's/Family"", 'Sports', 'Fantasy Comedy', 'Family Film', 'Fantasy']",2000,2
2974485,Guns at Batasi,1964,['United Kingdom'],"['Action/Adventure', 'Adventure', 'War film', 'Drama']",1960,4
28066621,The Thousand Plane Raid,1969,['United States of America'],"['Action', 'Docudrama', 'War film', 'Adventure', 'Drama']",1960,9
18769096,Beneath Still Waters,2005,"['United Kingdom', 'Spain']","['Zombie Film', 'Indie', 'Horror']",2000,5
6430372,For Me and My Gal,1942,['United States of America'],"['Musical', 'Black-and-white', 'Romantic drama', 'Musical Drama', 'Romance Film', 'Drama']",1940,2
32809361,Johnny One-Eye,1950,['United States of America'],"['Crime Fiction', 'Gangster Film', 'Thriller', 'Crime Drama', 'Crime Thriller', 'Drama']",1950,0
24706774,Hollywood Dreams,2006,[],"['Indie', 'Parody', 'Comedy', 'Romance Film']",2000,6
21423308,Beck - Levande Begravd,2009,['Sweden'],"['Mystery', 'Crime Fiction']",2000,9
23992707,Nothing Personal,2009,"['Ireland', 'Netherlands']","['Romantic drama', 'Indie', 'Romance Film', 'Drama']",2000,9
33159402,To Whom It May Concern: Ka Shen's Journey,2009,[],"['Biographical film', 'Drama', 'Documentary']",2000,9
1727946,Beauty Shop,2005,['United States of America'],['Comedy'],2000,5
19664801,Bonnie Prince Charlie,1948,['United Kingdom'],['War film'],1940,8
3286039,The Phantom Empire,1935,['United States of America'],"['Action', 'Black-and-white', 'Western', 'Movie serial', 'Adventure', 'Singing cowboy']",1930,5
14246985,Three Missing Links,1938,['United States of America'],"['Short Film', 'Black-and-white', 'Comedy']",1930,8
985064,Viva Las Vegas,1964,['United States of America'],"['Musical', 'Romance Film']",1960,4
20987461,A Bloody Aria,2006,['South Korea'],"['Thriller', 'World cinema', 'Crime Thriller', 'Martial Arts Film']",2000,6
6745617,Futurama: Bender's Big Score,2007,['United States of America'],"['Animation', 'Science Fiction', 'Comedy']",2000,7
10014541,Hysteria - The Def Leppard Story,2001,['United States of America'],"['Musical', 'Biography', 'Television movie', 'Drama']",2000,1
12569581,Fire,2002,['Pakistan'],['Action'],2000,2
31908,Until the End of the World,1991,"['France', 'Germany', 'Australia']","['Existentialism', 'Adventure', 'Road movie', 'Science Fiction', 'Drama']",1990,1
11774920,Kissing Cousins,2008,['United States of America'],"['Indie', 'Comedy', 'Romance Film', 'Romantic comedy']",2000,8
967721,Summer School,1987,['United States of America'],"['Cult', 'Comedy', 'Teen']",1980,7
25175199,Red Heat,1985,"['Austria', 'Germany', 'West Germany', 'United States of America']","['Thriller', 'World cinema', 'Erotic thriller', 'Crime Thriller']",1980,5
5016250,Watchmen,2009,['United States of America'],"['Action', 'Film adaptation', 'Crime Fiction', 'Superhero', 'Mystery', 'Action/Adventure', 'Thriller', 'Drama', 'Superhero movie', 'Science Fiction']",2000,9
2141418,Mysterious Skin,2004,"['Netherlands', 'United States of America']","['Gay Themed', 'Gay', 'Coming of age', 'Gay Interest', 'Drama']",2000,4
451062,The Dead Zone,1983,['United States of America'],"['Psychological thriller', 'Indie', 'Thriller', 'Crime Thriller', 'Horror', 'Supernatural', 'Science Fiction', 'Political thriller']",1980,3
19862344,The Other Lover,1985,['United States of America'],['Drama'],1980,5
29271529,3 Stories About Evil,2008,['United States of America'],['Short Film'],2000,8
9219835,College,1927,['United States of America'],"['Romantic drama', 'Indie', 'Comedy', 'Romance Film', 'Slapstick', 'Drama', 'Silent film', 'Romantic comedy', 'Sports']",1920,7
2201463,The Sorcerers,1967,['United Kingdom'],"['Psychological thriller', 'Indie', 'Horror', 'Science Fiction']",1960,7
76377,The Tall T,1957,['United States of America'],"['Action', 'B-Western', 'Western', 'Action/Adventure']",1950,7
5512801,It Runs in the Family,2003,['United States of America'],"['Family Drama', 'Comedy', 'Comedy-drama', 'Drama', 'Family Film']",2000,3
17119784,Invincible,2001,"['Canada', 'United States of America']","['Martial Arts Film', 'Fantasy']",2000,1
24838369,What Did the Lady Forget?,1990,['Japan'],"['Japanese Movies', 'Comedy-drama']",1990,0
12929755,Rang,1993,['India'],['Musical'],1990,3
8343962,29 Palms,2003,"['France', 'Germany', 'United States of America']","['Thriller', 'World cinema', 'Erotic thriller', 'Crime Thriller', 'Drama']",2000,3
1330220,RoboCop 2,1990,['United States of America'],"['Action', 'Crime Fiction', 'Action/Adventure', 'Thriller', 'Superhero movie', 'Stop motion', 'Science Fiction']",1990,0
26010232,Tora-san's Forbidden Love,1984,['Japan'],['Japanese Movies'],1980,4
14882944,Brothers,2009,['United States of America'],"['Psychological thriller', 'War film', 'Drama']",2000,9
15670779,The House of Mirth,2000,['United Kingdom'],"['Period piece', 'Film adaptation', 'Black-and-white', 'Romantic drama', 'Romance Film', 'Drama']",2000,0
32600481,The 49th Man,1953,['United States of America'],"['Action', 'Thriller', 'Drama']",1950,3
10387685,The Egg and I,1947,['United States of America'],['Black-and-white'],1940,7
4541896,Next Stop Wonderland,1998,['United States of America'],"['Drama', 'Indie', 'Romantic drama', 'Comedy', 'Romance Film', 'Romantic comedy', 'Comedy-drama']",1990,8
73170,Aladdin,1992,['United States of America'],"['Music', 'Musical', 'Animation', 'Comedy', 'Romance Film', ""Children's"", 'Costume drama', 'Adventure', 'Family Film', 'Fantasy']",1990,2
525292,Hidalgo,2004,['United States of America'],"['Period piece', 'Costume Adventure', 'Action/Adventure', 'Western', 'Adventure', 'Drama']",2000,4
9399204,Jack the Giant Killer,1962,['United States of America'],"['Stop motion', 'Adventure', 'Drama', 'Family Film', 'Fantasy']",1960,2
9391797,Double Exposure,1944,['United States of America'],"['Black-and-white', 'Crime Fiction', 'Comedy']",1940,4
24155032,The Girl Who Kicked the Hornets' Nest,2009,"['Sweden', 'Germany', 'Denmark']","['Crime Fiction', 'Thriller', 'World cinema', 'Drama']",2000,9
6029546,The Spirit,2008,['United States of America'],"['Action', 'Crime Fiction', 'Action/Adventure', 'Satire', 'Thriller', 'Comedy', 'Detective', 'Superhero movie', 'Fantasy']",2000,8
1686611,Yogen,2004,['Japan'],"['Psychological thriller', 'Japanese Movies', 'Horror', 'World cinema', 'Supernatural']",2000,4
50793,Star Wars Episode I: The Phantom Menace,1999,['United States of America'],"['Action', 'Adventure', 'Science Fiction', 'Family Film', 'Fantasy']",1990,9
23624423,The Mirror,1997,['Iran'],"['Drama', 'Art film']",1990,7
1546168,Heaven & Earth,1993,"['France', 'United States of America']","['Period piece', 'Action', 'Marriage Drama', 'Biographical film', 'Docudrama', 'War film', 'Drama']",1990,3
23767889,No One Would Tell,1996,['United States of America'],"['Crime Fiction', 'Thriller', 'Teen', 'Television movie', 'Drama']",1990,6
9554269,Dark Matter,2007,['United States of America'],['Drama'],2000,7
7849254,Underfunded,2006,"['Canada', 'United States of America']","['Television movie', 'Comedy-drama']",2000,6
24577926,The Boy Friend,1926,[],['Silent film'],1920,6
23777979,Firefighter,1986,['United States of America'],['Biography'],1980,6
961796,House of Wax,1953,['United States of America'],['Horror'],1950,3
11876523,Extreme Movie,2008,['United States of America'],"['Parody', 'Comedy', 'Teen', 'Sex comedy']",2000,8
9364830,Save the Last Dance 2,2006,['United States of America'],"['Romantic drama', 'Teen', 'Romance Film', 'Drama']",2000,6
30232393,Charlie Chan on Broadway,1937,['United States of America'],"['Film adaptation', 'Crime Fiction', 'Mystery', 'Comedy', 'Thriller', 'Crime Thriller', 'Drama']",1930,7
27514945,Temptation: Eating Me,2007,['Japan'],['Japanese Movies'],2000,7
25566018,The Face on the Milk Carton,1995,[],['Drama'],1990,5
6647358,Playing God,1997,['United States of America'],"['Psychological thriller', 'Suspense', 'Neo-noir', 'Crime Fiction', 'Thriller', 'Crime Thriller', 'Drama']",1990,7
9808649,Repo! the Genetic Opera,2008,['United States of America'],"['Musical', 'Satire', 'Comedy', 'Horror', 'Science Fiction', 'Cult']",2000,8
34977771,Chinna Thambi Periya Thambi,1987,['India'],"['Drama', 'Comedy film']",1980,7
2570318,Walk Don't Run,1966,['United States of America'],"['Romance Film', 'Romantic comedy', 'Comedy']",1960,6
3146380,Hope Floats,1998,['United States of America'],"['Romantic drama', 'Romance Film', 'Domestic Comedy', 'Comedy-drama', 'Drama']",1990,8
8080890,Habitat,1997,"['Canada', 'Netherlands']","['Indie', 'Science Fiction', 'Horror']",1990,7
9489391,The Prowler,1981,['United States of America'],"['Cult', 'Slasher', 'Horror']",1980,1
18413278,Ghost Voyage,2008,['United States of America'],"['Television movie', 'Horror']",2000,8
1809458,The Reflecting Skin,1990,"['Canada', 'United Kingdom', 'England', 'United States of America']","['Thriller', 'Horror', 'Film noir', 'Drama']",1990,0
20066677,The Secret of the Iron Door,1970,['Soviet Union'],"['Science Fiction', 'Adventure', 'Family Film']",1970,0
4449647,Stag Night,2009,['United States of America'],"['Action', 'Crime Fiction', 'Action Thrillers', 'Action/Adventure', 'Thriller', 'Crime Thriller', 'Suspense', 'Slasher', 'Horror']",2000,9
686022,Wolf,1994,['United States of America'],"['Supernatural', 'Thriller', 'Horror']",1990,4
9127971,Port of Call,1948,['Sweden'],"['Black-and-white', 'Romantic drama', 'World cinema', 'Romance Film', 'Drama']",1940,8
143259,Santa Claus Conquers the Martians,1964,['United States of America'],"['Indie', 'Family-Oriented Adventure', 'Holiday Film', 'Christmas movie', 'Adventure', 'Alien Film', 'Science Fiction', 'Family Film']",1960,4
433414,Tremors,1990,['United States of America'],"['Action', 'Monster', 'Action/Adventure', 'Comedy', 'Horror Comedy', 'Adventure', 'Creature Film', 'Horror', 'Science Fiction', 'Cult']",1990,0
27947388,The Mysterious Mr. Valentine,1946,['United States of America'],"['Crime Fiction', 'Mystery', 'Film noir', 'Drama']",1940,6
737027,Shock to the System,2006,"['Canada', 'United States of America']","['Film adaptation', 'Crime Fiction', 'LGBT', 'Mystery', 'Thriller', 'Crime Thriller', 'Drama', 'Gay Themed', 'Gay', 'Gay Interest']",2000,6
10723393,Musafir,1957,['India'],['Drama'],1950,7
1710667,Twin Town,1997,['United Kingdom'],"['Black comedy', 'Comedy-drama', 'Comedy']",1990,7
31133228,Keli,1991,[],"['Romance Film', 'Crime Fiction', 'Drama']",1990,1
13414244,The Radio Pirates,2007,['Norway'],"['Comedy', 'Family Film']",2000,7
32578669,Ek Baar Phir,1980,['India'],"['Musical', 'Romantic drama', 'Bollywood', 'World cinema', 'Romance Film', 'Drama']",1980,0
5589362,How I Got Into College,1989,['United States of America'],"['Comedy', 'Satire', 'Teen', 'Romance Film', 'Romantic comedy']",1980,9
21165341,The 9/11 Commission Report,2006,['United States of America'],"['Psychological thriller', 'Drama', 'Indie', 'Thriller', 'Docudrama']",2000,6
18885034,Pool of London,1951,['United Kingdom'],"['Crime Drama', 'Crime Fiction', 'Drama']",1950,1
3607618,My Little Eye,2004,"['Canada', 'United Kingdom', 'France', 'United States of America']","['Psychological thriller', 'Slasher', 'Horror']",2000,4
25818173,Drums of Love,1928,['United States of America'],"['Romantic drama', 'Silent film']",1920,8
31988272,Love Dot Com,2009,[],"['Action', 'Musical', 'Comedy film']",2000,9
18896556,Nobody Runs Forever,1968,"['United Kingdom', 'United States of America']","['Psychological thriller', 'Spy', 'Thriller', 'Detective', 'Political thriller']",1960,8
4139874,DC 9/11: Time of Crisis,2003,"['Canada', 'United States of America']","['History', 'Docudrama', 'Political drama', 'Drama']",2000,3
15021502,Art of Fighting,2006,['South Korea'],"['Drama', 'Comedy']",2000,6
1172977,Force 10 from Navarone,1978,['United Kingdom'],"['Action', 'Drama', 'Action/Adventure', 'Adventure', 'War film']",1970,8
2880075,Inspector Clouseau,1968,"['United Kingdom', 'United States of America']","['Crime Fiction', 'Mystery', 'Comedy', 'Slapstick']",1960,8
30323221,Charlie Chan in the Secret Service,1944,['United States of America'],"['Mystery', 'Crime Thriller', 'Thriller']",1940,4
6672250,Sparrows Can't Sing,1963,['United Kingdom'],"['Melodrama', 'Comedy-drama', 'Comedy']",1960,3
5882475,Minnie and Moskowitz,1971,['United States of America'],"['Drama', 'Indie', 'Romantic drama', 'Comedy', 'Romance Film', 'Comedy-drama']",1970,1
24860307,The Brain,1988,"['Canada', 'United States of America']","['Horror', 'Science Fiction']",1980,8
3432108,Eye of the Tiger,1986,['United States of America'],"['Action', 'Drama', 'Crime Fiction', 'Biker Film', 'Indie', 'Action/Adventure']",1980,6
6517453,Expiration Date,2006,['United States of America'],"['Romance Film', 'Comedy']",2000,6
2091800,Dracula: Prince of Darkness,1966,['United Kingdom'],"['Costume Horror', 'Horror']",1960,6
5860476,The Night Listener,2006,['United States of America'],"['Psychological thriller', 'Film adaptation', 'LGBT', 'Crime Fiction', 'Mystery', 'Thriller', 'Drama']",2000,6
11655972,Kamen Rider The Next,2007,['Japan'],['Japanese Movies'],2000,7
33766327,Every Bastard a King,1968,"['Israel', 'Denmark']",['Drama'],1960,8
225554,Autumn Sonata,1978,"['Sweden', 'France', 'Germany', 'West Germany']","['Musical', 'Art film', 'Family Drama', 'World cinema', 'Drama']",1970,8
7252487,A Delicate Balance,1973,"['United Kingdom', 'United States of America', 'Canada']","['Indie', 'Marriage Drama', 'Drama']",1970,3
1690432,Jeepers Creepers,2001,"['Germany', 'United States of America']","['Monster movie', 'Mystery', 'Teen', 'Horror', 'Road-Horror', 'Supernatural', 'Cult']",2000,1
2175294,A Tiger Walks,1964,['United States of America'],"['Animal Picture', 'Drama', 'Family Film']",1960,4
22799606,Don't Look Back,2009,['France'],"['Drama', 'Thriller', 'World cinema']",2000,9
28947608,Hibernatus,1969,['France'],['Comedy'],1960,9
17565431,The Land Has Eyes,2004,[],"['Coming of age', 'Drama']",2000,4
28285223,Perils of the Sentimental Swordsman,1982,['Hong Kong'],"['Wuxia', 'Chinese Movies']",1980,2
28211412,Penny Paradise,1938,['United Kingdom'],['Comedy film'],1930,8
6866061,Keisarin salaisuus,2006,['Finland'],"['Animation', 'Comedy', ""Children's"", 'Family Film', 'Computer Animation']",2000,6
9872447,Buenos Aires 100 Kilómetros,2004,"['Argentina', 'Spain', 'France']","['Drama', 'Coming of age', 'Indie', 'World cinema']",2000,4
27466117,Sundance and the Kid,1969,"['Spain', 'Italy']",['Spaghetti Western'],1960,9
14298077,Dirty Dingus Magee,1970,['United States of America'],"['Comedy Western', 'Western', 'Comedy']",1970,0
9532999,Wasabi Tuna,2003,['United States of America'],"['Action', 'Indie', 'Comedy', 'Comedy of Errors']",2000,3
18655054,Summer Heat,2006,['Philippines'],"['Filipino Movies', 'Drama', 'World cinema']",2000,6
4213160,$,1971,['United States of America'],"['Action', 'Heist', 'Crime Fiction', 'Action/Adventure', 'Comedy', 'Thriller']",1970,1
21847912,Mr. North,1988,['United States of America'],"['Comedy', 'Comedy-drama', 'Fantasy Comedy', 'Drama', 'Fantasy']",1980,8
14536033,Gamer,2009,['United States of America'],"['Action', 'Science Fiction', 'Thriller']",2000,9
9652328,As Young as You Feel,1951,['United States of America'],"['Black-and-white', 'Parody', 'Satire', 'Comedy', 'Workplace Comedy']",1950,1
4922991,The Harvest,1993,['United States of America'],"['Psychological thriller', 'Crime Thriller', 'Thriller']",1990,3
7591721,Igor,2008,"['United States of America', 'France']","['Computer Animation', 'Animation', 'Comedy', 'Black comedy', 'Adventure', 'Family Film', 'Fantasy']",2000,8
5492073,Deadly Companion,1980,['Canada'],"['Mystery', 'Thriller']",1980,0
1100688,Carnival of Souls,1962,['United States of America'],"['Indie', 'Comedy', 'Thriller', 'Drama', 'Parody', 'Horror', 'Supernatural', 'Cult']",1960,2
13911153,Remember My Name,1978,['United States of America'],"['Psychological thriller', 'Drama', 'Thriller']",1970,8
5781218,Damnation Alley,1977,['United States of America'],"['Action', 'Dystopia', 'Apocalyptic and post-apocalyptic fiction', 'Road movie', 'Doomsday film', 'Disaster', 'Science Fiction']",1970,7
23753810,Paris Frills,1945,['France'],"['Romance Film', 'Drama']",1940,5
8055027,Snow White: A Tale Of Terror,1997,['United States of America'],"['Fairy tale', 'Indie', 'Gothic Film', 'Thriller', 'Horror', 'Fantasy']",1990,7
17139347,Spy Chasers,1955,['United States of America'],"['Action', 'Spy', 'Black-and-white', 'Comedy', 'Adventure']",1950,5
12993849,The Loss of a Teardrop Diamond,2009,"['United Kingdom', 'United States of America']","['Period piece', 'Romantic drama', 'Romance Film', 'Drama']",2000,9
1607540,Moon Child,2003,['Japan'],"['Action', 'Japanese Movies', 'Action/Adventure', 'Thriller', 'Horror', 'World cinema', 'Science Fiction']",2000,3
12840836,Hinugot sa Langit,1985,['Philippines'],"['Filipino Movies', 'Christian film', 'Drama']",1980,5
21427848,Gaby: A True Story,1987,"['Mexico', 'United States of America']","['Biography', 'Drama']",1980,7
4586623,Queen of Blood,1966,['United States of America'],"['Horror', 'Science Fiction']",1960,6
9713368,What Ever Happened to Aunt Alice?,1969,['United States of America'],"['Psychological thriller', 'Crime Fiction', 'Mystery', 'Thriller', 'Black comedy', 'Crime Thriller', 'Drama', 'Psycho-biddy', 'Horror']",1960,9
4367482,Sextette,1978,['United States of America'],"['Musical', 'Comedy', 'Cult', 'Comedy of Errors']",1970,8
24542123,Banzai Runner,1987,['United States of America'],"['Action', 'Auto racing', 'Indie', 'Action/Adventure', 'Thriller', 'Sports']",1980,7
8250603,Nong Teng Nakleng-pukaotong,2006,['Thailand'],['Comedy'],2000,6
8288529,Vishwatma,1992,['India'],"['Action', 'Comedy', 'Thriller']",1990,2
20796085,Our Mother's House,1967,['United Kingdom'],"['Drama', 'Family Drama', 'Thriller']",1960,7
14815506,Zeder,1983,['Italy'],"['Thriller', 'Horror', 'Zombie Film', 'Supernatural']",1980,3
358263,The Player,1992,['United States of America'],"['Crime Fiction', 'Comedy', 'Black comedy', 'Drama']",1990,2
779790,El Patrullero,1991,"['Mexico', 'Japan', 'United States of America']","['Crime Fiction', 'Japanese Movies', 'World cinema', 'Drama']",1990,1
32161398,Varusham Padhinaaru,1989,['India'],['Drama'],1980,9
7581816,Hum Kisise Kum Nahi,2002,['India'],"['Musical', 'Comedy', 'Bollywood', 'World cinema']",2000,2
7238599,Rich And Famous,1981,['United States of America'],['Drama'],1980,1
12271243,Bubble Fiction: Boom or Bust,2007,['Japan'],"['Science Fiction', 'Comedy']",2000,7
1008396,A Fistful of Dynamite,1971,['Italy'],"['Action', 'Western', 'Action/Adventure', 'World cinema', 'Spaghetti Western', 'War film', 'Adventure']",1970,1
180993,"Now, Voyager",1942,['United States of America'],"['Film adaptation', 'Black-and-white', 'Romantic drama', 'Romance Film', 'Melodrama', 'Drama']",1940,2
4690238,Last Quarter,2004,['Japan'],"['Japanese Movies', 'Romantic drama', 'World cinema', 'Romance Film', 'Drama']",2000,4
20163502,Hariharnagar-2,2009,['India'],['Comedy'],2000,9
25858024,Stage-Struck Tora-san,1978,['Japan'],['Japanese Movies'],1970,8
2097287,Psycho II,1983,['United States of America'],"['Psychological thriller', 'Crime Fiction', 'Mystery', 'Thriller', 'Crime Thriller', 'Suspense', 'Slasher', 'Horror']",1980,3
30923442,The Key to Reserva,2007,['Spain'],['Short Film'],2000,7
30092412,Blueberry Hill,1988,['United States of America'],"['Period piece', 'Drama']",1980,8
9362663,Sixty Million Dollar Man,1995,['Hong Kong'],"['Comedy', 'Media Satire', 'Chinese Movies', 'Science Fiction', 'Fantasy']",1990,5
22121117,The Last International Playboy,2008,['United States of America'],"['Romantic drama', 'Indie', 'Romance Film', 'Drama']",2000,8
441315,True Romance,1993,['United States of America'],"['Action', 'Crime Fiction', 'Indie', 'Action/Adventure', 'Thriller', 'Romance Film', 'Crime Thriller', 'Drama']",1990,3
8206306,Dead Ringer,1964,['United States of America'],"['Psychological thriller', 'Black-and-white', 'Psycho-biddy', 'Thriller', 'Crime Thriller']",1960,4
4605171,Camp Nowhere,1994,['United States of America'],"[""Children's"", 'Comedy', 'Family Film']",1990,4
24160887,Welcome Home,1989,"['United Kingdom', 'United States of America']",['Drama'],1980,9
17719953,Scam,2006,['United States of America'],"['Crime Fiction', 'Gangster Film', 'Thriller', 'Erotic thriller', 'Drama']",2000,6
5714284,The Four Feathers,1939,"['United Kingdom', 'England']","['Action', 'Film adaptation', 'Action/Adventure', 'Romance Film', 'War film', 'Adventure', 'Drama']",1930,9
36033931,Kamaraj,2003,['India'],['Biographical film'],2000,3
1964205,The Blue Lagoon,1949,['United Kingdom'],"['Coming of age', 'Romance Film', 'Adventure', 'Drama']",1940,9
26810153,Sunil Vayassu 20,1986,['India'],"['Drama', 'Crime Fiction']",1980,6
12156128,Demented Death Farm Massacre,1971,['United States of America'],"['Indie', 'Slasher', 'Horror']",1970,1
3578336,Bubble,2006,['United States of America'],"['Crime Fiction', 'Mystery', 'Indie', 'Thriller', 'Crime Thriller', 'Americana', 'Drama', 'Tragedy']",2000,6
14330111,A Place in the World,1992,"['Argentina', 'Spain', 'Uruguay']","['Indie', 'Action/Adventure', 'Western', 'World cinema', 'Drama']",1990,2
5336170,What Planet Are You From?,2000,['United States of America'],"['Comedy', 'Comedy film', 'Romance Film', 'Romantic comedy', 'Alien Film', 'Science Fiction', 'Sex comedy']",2000,0
9100609,Bite Me - Chameleon,2004,['United States of America'],"['B-movie', 'Comedy', 'Horror']",2000,4
10116734,Strawberry Shortcake: Pets on Parade,1982,"['Japan', 'United States of America']","['Animation', 'Comedy', ""Children's/Family"", ""Children's"", ""Children's Entertainment"", 'Japanese Movies', 'Short Film', 'Family Film']",1980,2
1386250,Surf Ninjas,1993,['United States of America'],"['Action', 'Action Comedy', 'Action/Adventure', 'Comedy', ""Children's/Family"", 'Martial Arts Film', 'Family Film']",1990,3
8644405,Road House 2: Last Call,2006,['United States of America'],"['Action', 'Action/Adventure', 'Thriller']",2000,6
2736433,Jungle Emperor Leo,1997,['Japan'],"['Animation', 'Japanese Movies', 'Animal Picture', 'Anime', ""Children's/Family"", ""Children's"", 'Family Film']",1990,7
27632526,Nesimi,1973,['Azerbaijan'],['Drama'],1970,3
20053452,Baby and I,2008,['South Korea'],"['Adventure Comedy', 'Comedy', 'Teen']",2000,8
14719555,"Stop, Look and Laugh",1960,['United States of America'],"['Black-and-white', 'Slapstick', 'Comedy']",1960,0
22628915,There's No Time for Love,1964,['India'],['Comedy'],1960,4
8656096,Yangtse Incident,1957,['United Kingdom'],"['Black-and-white', 'War film', 'Drama']",1950,7
14289904,Flash,2007,['India'],"['Drama', 'Mystery', 'Thriller']",2000,7
7999803,Jigsaw,1949,['United States of America'],"['Crime Fiction', 'Mystery', 'Thriller', 'Film noir', 'Drama']",1940,9
9613761,Taps,2006,['United States of America'],"['Short Film', 'Drama']",2000,6
18683970,The River Why,2009,['United States of America'],"['Coming of age', 'Indie', 'Drama']",2000,9
1152328,Battle Beyond the Stars,1980,['United States of America'],"['Indie', 'Parody', 'Adventure', 'Space western', 'Science Fiction']",1980,0
9911722,La Bestia debe morir,1952,['Argentina'],['Black-and-white'],1950,2
23409028,Shall We Kiss?,2007,['France'],"['Romantic drama', 'Comedy', 'World cinema', 'Romance Film', 'Romantic comedy', 'Drama']",2000,7
22965162,Shyness Machine Girl,2009,"['Japan', 'United States of America']","['Action', 'Japanese Movies', 'Short Film', 'Thriller', 'Horror', 'Science Fiction']",2000,9
3592476,Track of the Cat,1954,['United States of America'],"['Film adaptation', 'Action/Adventure', 'Western', 'Adventure', 'Drama']",1950,4
32774866,Hollywood Capers,1935,[],"['Animation', 'Short Film', 'Family Film']",1930,5
17311482,Perpetual Motion,2005,['China'],"['Chinese Movies', 'Drama']",2000,5
90156,Vibes,1988,['United States of America'],"['Mystery', 'Action/Adventure', 'Comedy', 'Adventure', 'Fantasy']",1980,8
8247295,Peter-No-Tail in America,1985,['Sweden'],['Animation'],1980,5
30782658,Blonde Fever,1944,['United States of America'],"['Drama', 'Comedy film']",1940,4
14138235,Panduranga,2008,['India'],[],2000,8
27856783,Vara Vikrayam,1939,['India'],['Drama'],1930,9
11081144,12 Angry Men,1997,['United States of America'],['Drama'],1990,7
23409969,Chor Police,1983,['India'],"['Action/Adventure', 'Drama', 'World cinema']",1980,3
7682778,Fred Claus,2007,['United States of America'],"['Comedy', 'Black comedy', 'Holiday Film', 'Christmas movie', 'Fantasy Comedy']",2000,7
3116944,Trapped,2002,"['Germany', 'United States of America']","['Action', 'Psychological thriller', 'Suspense', 'Action/Adventure', 'Thriller', 'Crime Thriller']",2000,2
1589300,Very Bad Things,1998,['United States of America'],"['Crime Fiction', 'Comedy', 'Thriller', 'Black comedy']",1990,8
31155849,Kadalpalam,1969,[],['Drama'],1960,9
18243264,Conduct Zero,2002,['South Korea'],"['Romantic drama', 'Comedy film', 'World cinema', 'Romance Film', 'Romantic comedy', 'Drama']",2000,2
24245794,White Cannibal Queen,1980,"['France', 'Spain', 'Italy']","['Cult', 'Slasher', 'Horror']",1980,0
26368124,Dr. Popaul,1972,"['France', 'Italy']",['Black comedy'],1970,2
5327576,Warning from Space,1956,['Japan'],"['Japanese Movies', 'World cinema', 'Alien Film', 'Science Fiction']",1950,6
9671700,Cacería,2002,['Argentina'],"['Action', 'Thriller']",2000,2
6882568,Boytown,2006,['Australia'],['Comedy'],2000,6
21743943,The Ape Woman,1964,"['France', 'Italy']","['Black-and-white', 'Drama']",1960,4
9691015,Aanandham,2002,['India'],"['Musical', 'Bollywood', 'World cinema', 'Drama']",2000,2
168483,My Favorite Year,1982,"['United Kingdom', 'United States of America']","['Comedy', 'World cinema']",1980,2
27902760,There Auto Be a Law,1953,['United States of America'],"['History', 'Animation', 'Short Film', 'Comedy']",1950,3
13364985,Superhero!,2008,['United States of America'],"['Parody', 'Action/Adventure', 'Comedy', 'Thriller', 'Superhero movie', 'Science Fiction', 'Fantasy']",2000,8
28010622,Lady Killer,1995,['United States of America'],"['Action', 'Psychological thriller', 'Suspense', 'Action/Adventure', 'Thriller']",1990,5
5876575,K2,1992,['United Kingdom'],"['Film adaptation', 'Action/Adventure', 'Adventure', 'Sports', 'Drama']",1990,2
2247689,The Devil and Daniel Mouse,1978,['Canada'],['Short Film'],1970,8
14270026,Xxxholic: The Movie: A Midsummer Night's Dream,2005,['Japan'],"['Animation', 'Thriller', 'World cinema', 'Drama', 'Japanese Movies', 'Comedy film', 'Anime', 'Supernatural', 'Fantasy']",2000,5
1199638,Melvin and Howard,1980,['United States of America'],"['Comedy', 'Black comedy', 'Comedy-drama', 'Americana', 'Drama', 'Cult']",1980,0
1936491,The Iron Petticoat,1956,['United Kingdom'],"['Romance Film', 'Romantic comedy', 'Comedy']",1950,6
3027915,The Sponge Who Could Fly,2003,['United States of America'],['Short Film'],2000,3
14727790,Triangle,2007,"['China', 'Hong Kong']","['Thriller', 'Chinese Movies', 'World cinema']",2000,7
3501043,Hollow Triumph,1948,['United States of America'],"['Film noir', 'Black-and-white']",1940,8
4104442,Taylor's Wall,2001,['United States of America'],"['Television movie', 'Short Film', 'Drama']",2000,1
4877390,Nandha,2001,['India'],"['Romantic drama', 'World cinema', 'Romance Film', 'Drama']",2000,1
33799734,Kath Putli,1957,['India'],"['Musical', 'Romantic drama', 'Bollywood', 'World cinema', 'Romance Film', 'Drama']",1950,7
6184001,Partners,1982,['United States of America'],"['Action', 'LGBT', 'Action/Adventure', 'Buddy film', 'Comedy']",1980,2
8359558,Retribution,1999,['Japan'],"['Action', 'Psychological thriller', 'Crime Fiction', 'Gangster Film', 'Action/Adventure', 'Thriller', 'World cinema', 'Crime Thriller', 'Japanese Movies', 'Horror', 'Supernatural']",1990,9
4859540,Lord of the Beans,2005,[],"['Musical', 'Animation', 'Short Film', 'Comedy', ""Children's""]",2000,5
7094678,Stopping the Show,1932,['United States of America'],"['Musical', 'Animation', 'Short Film']",1930,2
16352214,Duplicity,2009,"['Germany', 'United States of America']","['Spy', 'Suspense', 'Heist', 'Thriller', 'Black comedy', 'Romantic comedy', 'Crime Thriller']",2000,9
23832214,Only Clouds Move the Stars,1998,['Norway'],"['Drama', 'Family Film']",1990,8
2023704,The Bone Collector,1999,['United States of America'],"['Action', 'Psychological thriller', 'Crime Fiction', 'Mystery', 'Action/Adventure', 'Thriller', 'Crime Thriller', 'Drama']",1990,9
3088906,The Kid & I,2005,['United States of America'],"['Action', 'Buddy film', 'Comedy', 'Family Film']",2000,5
10792112,Thudikkum Karangal,1983,['India'],"['Action', 'Bollywood', 'World cinema']",1980,3
1543888,"Yours, Mine and Ours",1968,['United States of America'],"['Comedy', 'Drama', 'Family Film']",1960,8
2884125,Love Object,2003,['United States of America'],"['Psychological thriller', 'Slasher', 'Horror']",2000,3
24537445,May Madham,1994,['India'],['Musical'],1990,4
1769134,Attack Force Z,1982,"['New Zealand', 'Australia']","['Action', 'Combat Films', 'Action/Adventure', 'World cinema', 'War film', 'Drama']",1980,2
24478946,The Devil's Circus,1926,[],['Silent film'],1920,6
17390473,Blue Island,1982,['Italy'],['Adventure'],1980,2
9385381,Sorority House Massacre 2,1990,['United States of America'],"['Slasher', 'Teen', 'Horror', 'B-movie']",1990,0
1623233,Number Seventeen,1932,"['United Kingdom', 'England']","['Suspense', 'Black-and-white', 'Crime Fiction', 'Mystery', 'Thriller', 'Drama']",1930,2
19216464,The Ballad of Josie,1967,['United States of America'],"['Comedy Western', 'Western', 'Comedy', 'Feminist Film']",1960,7
16949657,The Return,1980,['United States of America'],"['Science Fiction', 'Thriller']",1980,0
19337214,"Corrina, Corrina",1994,['United States of America'],"['Period piece', 'Romantic drama', 'Family Drama', 'Romance Film', 'Comedy-drama', 'Drama', 'Family Film']",1990,4
3548254,Snowboard Academy,1996,"['Canada', 'United States of America']","['Sports', 'Slapstick', 'Comedy']",1990,6
15092167,Charlie Chan at the Opera,1936,['United States of America'],"['Detective fiction', 'Black-and-white', 'Mystery', 'Thriller', 'Detective', 'Crime Thriller', 'Drama']",1930,6
28301310,So Little Time,1952,['United Kingdom'],"['Romance Film', 'War film', 'Drama']",1950,2
22151344,Ben 10: Alien Swarm,2009,['United States of America'],"['Adventure', ""Children's/Family"", 'Sci-Fi Adventure', 'Alien Film', 'Science Fiction', 'Family Film']",2000,9
3565252,Peacock,2004,['China'],"['Chinese Movies', 'Drama']",2000,4
3551668,Lola,1970,"['United Kingdom', 'Italy']","['Romantic drama', 'Comedy', 'Romance Film', 'Drama']",1970,0
25564963,The Fourth King,2006,"['Sweden', 'Germany', 'Switzerland']","['Short Film', 'Animation']",2000,6
12815847,Day One,1989,['United States of America'],"['Docudrama', 'Drama']",1980,9
4966576,Ratchagan,1997,['India'],['Action'],1990,7
6321630,Only the Lonely,1991,['United States of America'],"['Romantic drama', 'Comedy', 'Romance Film', 'Romantic comedy', 'Domestic Comedy', 'Comedy-drama', 'Drama']",1990,1
1267998,East is East,1999,['United Kingdom'],"['LGBT', 'Indie', 'Comedy', 'Drama']",1990,9
1693128,The Grotesque,1995,['United Kingdom'],"['Film adaptation', 'LGBT', 'Comedy', 'Crime Comedy', 'Black comedy', 'Drama']",1990,5
3850268,All About Lily Chou-Chou,2001,['Japan'],"['Musical', 'Crime Fiction', 'Art film', 'Thriller', 'World cinema', 'Drama', 'Japanese Movies', 'Coming of age']",2000,1
23112521,And Your Love Too,1962,['German Democratic Republic'],"['War film', 'Drama']",1960,2
35095629,Manzil,1960,['India'],"['Romance Film', 'Drama', 'Comedy film']",1960,0
9167607,Sira` Fi al-Wadi,1954,['Egypt'],"['Romance Film', 'Drama']",1950,4
62693,The Long Voyage Home,1940,['United States of America'],"['Action', 'Film adaptation', 'Black-and-white', 'Action/Adventure', 'War film', 'Drama']",1940,0
15440115,Our Gang Follies of 1938,1937,['United States of America'],"['Musical', 'Black-and-white', 'Short Film', 'Comedy', ""Children's/Family"", 'Family Film']",1930,7
28387210,The Masked Gang: Cyprus,2008,[],['Comedy film'],2000,8
9043017,Padaharella Vayasu,1978,['India'],['Drama'],1970,8
17444150,Go,2007,['India'],"['Musical', 'Comedy', 'Bollywood', 'World cinema']",2000,7
29260374,Charithram,1989,[],['Thriller'],1980,9
15497901,The Baader Meinhof Complex,2008,"['France', 'Germany', 'Czech Republic']","['Period piece', 'Thriller', 'World cinema', 'Drama', 'Political thriller']",2000,8
155790,An Extremely Goofy Movie,2000,"['United States of America', 'Australia']","['Animation', 'Coming of age', 'Animated Musical', 'Comedy', ""Children's/Family""]",2000,0
8851830,Blood Alley,1955,['United States of America'],"['Action', 'Escape Film', 'Action Thrillers', 'Action/Adventure', 'Thriller', 'War film', 'Adventure']",1950,5
3819605,Kill Zone: Sha Po Lang,2005,"['China', 'Hong Kong']","['Action', 'Crime Fiction', 'Action/Adventure', 'Thriller', 'World cinema', 'Chinese Movies', 'Martial Arts Film', 'Drama']",2000,5
20389766,Crush and Blush,2008,['South Korea'],"['Comedy', 'Drama', 'World cinema']",2000,8
26655390,Murder at Monte Carlo,1935,['United Kingdom'],"['Drama', 'Crime Fiction']",1930,5
25829151,Hollow Point,1996,"['Canada', 'United States of America']","['Action', 'Action/Adventure', 'Comedy', 'Thriller', 'Crime Thriller']",1990,6
6982919,Elmer Gantry,1960,['United States of America'],['Drama'],1960,0
6126268,Twas the Night,2001,['United States of America'],"['Music', 'Holiday Film', 'Christmas movie', ""Children's Entertainment""]",2000,1
8514531,The Substitute,1996,['United States of America'],"['Action', 'Crime Fiction', 'Mystery', 'Action/Adventure', 'Thriller', 'Drama']",1990,6
8035875,Pro-Life,2007,['United States of America'],"['Teen', 'Horror', 'Television movie', 'Cult']",2000,7
8387011,As You Desire Me,1932,['United States of America'],"['Black-and-white', 'Melodrama', 'Pre-Code', 'Drama']",1930,2
5444993,Black Christmas,2006,"['Canada', 'United States of America']","['Slasher', 'Thriller', 'Horror', 'Teen']",2000,6
2579441,What's Up with Love?,2002,['Indonesia'],"['Romance Film', 'Drama']",2000,2
17286656,The Case of the Curious Bride,1935,['United States of America'],"['Black-and-white', 'Detective fiction', 'Crime Fiction', 'Mystery', 'Comedy', 'Detective']",1930,5
30050508,Cloud 9,2006,['United States of America'],"['Sports', 'Comedy', 'Pornographic movie']",2000,6
1686720,The Twilight Samurai,2002,['Japan'],"['Action', 'Samurai cinema', 'Romantic drama', 'Action/Adventure', 'World cinema', 'Martial Arts Film', 'Drama', 'Japanese Movies']",2000,2
4899791,Carrie,1976,['United States of America'],"['Drama', 'Horror']",1970,6
2255336,The Unfaithful,1947,['United States of America'],"['Film noir', 'Drama']",1940,7
1346469,El Dorado,1966,['United States of America'],"['Action', 'Western', 'Adventure']",1960,6
3780957,Under Wraps,1997,['United States of America'],"['Comedy', 'Family Film', 'Adventure']",1990,7
31848416,Pelleedu pillalu,1982,[],"['Drama', 'Comedy film']",1980,2
3644374,Le Million,1931,['France'],"['Musical', 'Black-and-white', 'Chase Movie', 'Comedy', 'World cinema', 'Musical comedy']",1930,1
32541928,Dead Hooker in a Trunk,2009,[],"['Action', 'Mystery', 'Thriller', 'Horror']",2000,9
7467873,Sunglass,2007,['India'],['Art film'],2000,7
4355887,Ice Castles,1978,['United States of America'],"['Romantic drama', 'Romance Film', 'Sports', 'Drama']",1970,8
412475,Distant Drums,1951,['United States of America'],"['Action', 'Action/Adventure', 'Western', 'Romance Film', 'Historical fiction']",1950,1
26250274,Tripping Forward,2009,['United States of America'],"['Indie', 'Comedy', 'Sex comedy']",2000,9
75265,Nothing But a Man,1964,['United States of America'],"['Melodrama', 'Indie', 'Drama']",1960,4
25081936,Me & Isaac Newton,1999,['United States of America'],"['Biography', 'Documentary']",1990,9
29353909,Jhoothi Shaan,1991,['India'],"['Romantic drama', 'World cinema', 'Romance Film', 'Drama']",1990,1
17532991,Blue Tiger,1994,"['Japan', 'United States of America']","['Action', 'Japanese Movies', 'Action/Adventure', 'Thriller', 'World cinema', 'Erotic thriller', 'Crime Thriller']",1990,4
8259130,What's Good for the Goose,1969,['United Kingdom'],"['Comedy', 'Comedy of manners', 'Slapstick', 'Sex comedy']",1960,9
26669413,Saviour of the Soul II,1992,['Hong Kong'],"['Fantasy Adventure', 'Action', 'Fantasy Comedy', 'World cinema', 'Romance Film', 'Chinese Movies', 'Adventure', 'Science Fiction', 'Fantasy']",1990,2
9024466,The Parent Trap III,1989,['United States of America'],"['Comedy', 'Family Film']",1980,9
923759,Rounders,1998,['United States of America'],"['Crime Fiction', 'Gangster Film', 'Indie', 'Buddy film', 'Drama']",1990,8
1370104,Shiza,2004,"['Russia', 'France', 'Germany']","['Crime Fiction', 'Thriller', 'World cinema', 'Romance Film', 'Drama']",2000,4
22954762,I Killed My Mother,2009,['Canada'],"['LGBT', 'Drama', 'Coming of age', 'Biography', 'Indie', 'Family Drama']",2000,9
8675614,Leprechaun 2,1994,['United States of America'],"['Creature Film', 'Monster movie', 'Slasher', 'Horror', 'Supernatural', 'Cult']",1990,4
2574924,Miami Vice,2006,"['Germany', 'United States of America']","['Action', 'Crime Fiction', 'Action Thrillers', 'Action/Adventure', 'Thriller', 'Crime Thriller', 'Drama']",2000,6
3766451,Piranha II: The Spawning,1981,['Italy'],"['Natural horror films', 'Cult', 'Horror']",1980,1
3213322,The Friends of Eddie Coyle,1973,['United States of America'],"['Crime Fiction', 'Thriller', 'Crime Drama', 'Crime Thriller']",1970,3
7999304,Duel of Fists,1971,['Hong Kong'],"['Action', 'Gangster Film', 'Chinese Movies', 'Martial Arts Film']",1970,1
4198361,Chaos,2005,"['United Kingdom', 'United States of America', 'Canada']","['Action', 'Heist', 'Crime Fiction', 'Action/Adventure', 'Thriller', 'Drama']",2000,5
27195082,Force: Five,1981,['United States of America'],"['Action', 'Drama', 'Adventure']",1980,1
9909983,Anarkali,1953,['India'],"['Romantic drama', 'World cinema', 'Romance Film', 'Epic', 'Drama']",1950,3
14551645,The Grey Hounded Hare,1949,['United States of America'],"['Animation', 'Short Film', 'Comedy', 'Family Film']",1940,9
34992096,Lover Come Back,1946,['United States of America'],['Comedy'],1940,6
4614452,Texas Rangers,2001,['United States of America'],"['Western', 'Action/Adventure', 'Drama']",2000,1
24158497,Slow Dancing in the Big City,1979,['United States of America'],"['Dance', 'Melodrama', 'Drama']",1970,9
13048987,Raat Aur Din,1967,['India'],"['Thriller', 'Mystery', 'Bollywood']",1960,7
5250079,Farz,1967,['India'],"['Action/Adventure', 'World cinema']",1960,7
6028988,Talaaq,1958,['India'],"['Musical', 'Drama', 'World cinema']",1950,8
5339358,The Rich Man's Wife,1996,['United States of America'],"['Suspense', 'Crime Fiction', 'Thriller', 'Crime Thriller']",1990,6
24479047,Zander the Great,1925,[],"['Silent film', 'Western']",1920,5
3504445,Spermula,1976,['France'],"['Softcore Porn', 'Horror', 'Science Fiction', 'Adult']",1970,6
7273637,Cry of the Werewolf,1944,['United States of America'],"['Creature Film', 'Horror']",1940,4
10028410,Red Dust,2004,"['United Kingdom', 'South Africa']","['Drama', 'Political drama']",2000,4
8788084,On the Wrong Trek,1936,['United States of America'],"['Short Film', 'Comedy']",1930,6
18865836,Pot o' Gold,1941,['United States of America'],"['Musical', 'Black-and-white', 'Comedy', 'Musical comedy']",1940,1
31470462,Pokkuveyil,1981,[],"['Drama', 'Family Film']",1980,1
20543986,Abar Aranye,2003,['India'],['Drama'],2000,3
7276177,El Hombre que Vino de Ummo,1970,"['Spain', 'Italy']",['Horror'],1970,0
3541389,Inserts,1974,['United Kingdom'],"['Indie', 'Satire', 'Thriller', 'Romance Film', 'Crime Thriller', 'Drama', 'Period piece', 'Erotic thriller', 'Comedy-drama']",1970,4
1728600,Series 7: The Contenders,2001,['United States of America'],"['Action', 'Action/Adventure', 'Satire', 'Thriller', 'Comedy', 'Media Satire', 'Black comedy', 'Crime Thriller', 'Parody']",2000,1
6043918,Police Academy: Mission to Moscow,1994,"['Russia', 'United States of America']","['Action', 'Action/Adventure', 'Comedy', 'Slapstick']",1990,4
14001162,Father was a Fullback,1949,['United States of America'],"['Comedy', 'Black-and-white']",1940,9
15834753,Final,2001,['United States of America'],"['Drama', 'Science Fiction', 'Thriller']",2000,1
447299,From Dusk Till Dawn,1996,['United States of America'],"['Action', 'Crime Fiction', 'Action/Adventure', 'Comedy', 'Satire', 'Thriller', 'Horror Comedy', 'Crime Thriller', 'Horror', 'Supernatural', 'Cult']",1990,6
11773632,A Little Worm,1995,['United Kingdom'],"['Black-and-white', 'Drama', 'Indie', 'Short Film']",1990,5
14746975,Creeps,1956,['United States of America'],"['Short Film', 'Black-and-white', 'Comedy']",1950,6
18016582,Children of the Dust,1995,['United States of America'],"['Film adaptation', 'Revisionist Western', 'Action/Adventure', 'Western', 'Television movie', 'Drama']",1990,5
9675457,Shakalaka Boom Boom,2007,['India'],"['Musical', 'Romantic drama', 'Bollywood', 'World cinema', 'Romance Film', 'Drama']",2000,7
20827074,The Thirty Nine Steps,2008,['United Kingdom'],['Thriller'],2000,8
2283823,International House,1933,['United States of America'],"['Black-and-white', 'Slapstick', 'Comedy']",1930,3
26612083,Pachakuthira,2006,['India'],['Comedy-drama'],2000,6
15142007,The Merry Widow,1952,['United States of America'],"['Musical', 'Romance Film']",1950,2
22546052,The Show Goes On,1937,['United Kingdom'],"['Musical', 'Biopic [feature]']",1930,7
7987285,Hoofs and Goofs,1957,['United States of America'],"['Short Film', 'Black-and-white', 'Comedy']",1950,7
14109452,Crime Doctor,1943,['United States of America'],"['Black-and-white', 'Crime Fiction', 'Mystery', 'Crime Drama', 'Drama']",1940,3
24133239,"It's a Joke, Son!",1947,['United States of America'],['Comedy film'],1940,7
7987093,Pardon My Backfire,1953,['United States of America'],"['Short Film', 'Black-and-white', 'Comedy']",1950,3
18715613,Test pilota Pirxa,1978,"['Soviet Union', 'Poland']","['Science Fiction', 'Drama']",1970,8
26347633,Thenkasipattanam,2000,['India'],"['Action', 'Comedy']",2000,0
4495195,Sinbad the Sailor,1947,['United States of America'],"['Costume drama', 'Fantasy']",1940,7
275547,Selena,1997,['United States of America'],"['Biography', 'Musical Drama', 'Biographical film', 'Biopic [feature]', 'Drama']",1990,7
5853945,Hollywood steps out,1941,['United States of America'],"['Animation', 'Short Film', 'Family Film']",1940,1
8134379,Aatamin poika,1996,['Finland'],"['Short Film', 'Drama']",1990,6
4253548,Antar Mahal,2005,['India'],['Art film'],2000,5
12517482,Breeders,1986,['United States of America'],"['Thriller', 'Horror', 'B-movie', 'Science Fiction']",1980,6
113226,A Charlie Brown Christmas,1965,['United States of America'],"['Animation', 'Short Film', ""Children's/Family"", 'Christmas movie', 'Drama', 'Family Film']",1960,5
33327349,Victim,1999,['Hong Kong'],"['Action', 'Action/Adventure', 'Thriller', 'World cinema', 'Chinese Movies']",1990,9
19842633,The Avenger,1960,['Germany'],"['Black-and-white', 'Crime Fiction']",1960,0
13299192,Drop Dead Sexy,2006,['United States of America'],"['Indie', 'Comedy', 'Crime Comedy', 'Black comedy']",2000,6
19684895,Men In Fright,1938,['United States of America'],"['Black-and-white', 'Short Film', 'Comedy', 'Family Film']",1930,8
4567908,Phool Aur Patthar,1966,['India'],"['Romantic drama', 'Bollywood', 'World cinema', 'Romance Film', 'Drama']",1960,6
20822903,Journey's End,1930,"['United Kingdom', 'United States of America']","['War film', 'Drama']",1930,0
1190594,Hide and Seek,2005,"['Germany', 'United States of America']","['Psychological thriller', 'Mystery', 'Thriller', 'Crime Thriller', 'Suspense', 'Short Film', 'Horror', 'Supernatural']",2000,5
6243766,Superman,1948,['United States of America'],"['Action', 'Black-and-white', 'Superhero movie', 'Adventure']",1940,8
18540323,The Golden Blade,1953,['United States of America'],"['Action', 'Swashbuckler films', 'Adventure']",1950,3
26611951,Makalkku,2005,['India'],['Drama'],2000,5
3550987,In Like Flint,1967,['United States of America'],"['Action', 'Spy', 'Action Comedy', 'Parody', 'Action/Adventure', 'Comedy', 'Glamorized Spy Film']",1960,7
28925794,Three Men Army,1995,['India'],"['Romance Film', 'Comedy film']",1990,5
30939209,Quiet Please: Murder,1942,['United States of America'],"['Drama', 'Crime Fiction', 'Thriller']",1940,2
2636682,Disclosure,1994,['United States of America'],"['Suspense', 'Film adaptation', 'Courtroom Drama', 'Mystery', 'Thriller', 'Erotic thriller', 'Drama']",1990,4
8656846,Love and Pain and the Whole Damn Thing,1973,['United States of America'],"['Romance Film', 'Romantic drama', 'Drama']",1970,3
2602021,How Stella Got Her Groove Back,1998,['United States of America'],"['Romantic drama', 'Comedy', 'Romance Film', 'Romantic comedy', 'Comedy-drama', 'Drama']",1990,8
20689529,Candy Rain,2008,['Taiwan'],"['Gay Themed', 'Gay', 'Gay Interest', 'Comedy-drama']",2000,8
26442595,Voodoo Man,1944,['United States of America'],"['Parody', 'Comedy']",1940,4
11047814,Kalicharan,1976,['India'],"['Drama', 'World cinema']",1970,6
35588348,Ibunda,1986,['Indonesia'],['Drama'],1980,6
3336298,The Making of Star Wars,1977,['United States of America'],['Documentary'],1970,7
14025276,Come Come Come Upward,1989,['South Korea'],['Drama'],1980,9
5410228,Intentions of Murder,1964,['Japan'],['Drama'],1960,4
11526346,Wise Guys,1986,['United States of America'],"['Action', 'Crime Fiction', 'Action/Adventure', 'Buddy film', 'Comedy', 'Black comedy']",1980,6
1715093,Big B,2007,['India'],"['Action', 'Drama', 'Crime Fiction', 'Thriller']",2000,7
1638112,Ace in the Hole,1951,['United States of America'],"['Film noir', 'Black-and-white', 'Drama']",1950,1
2020117,Wild Geese,1978,['United Kingdom'],"['Action', 'Action/Adventure', 'Thriller', 'War film']",1970,8
13580138,Propaganda,1999,['Turkey'],"['Surrealism', 'Political satire', 'Comedy', 'Black comedy']",1990,9
32869134,The Last Frontier,1955,['United States of America'],"['Action', 'History', 'Action/Adventure', 'Western']",1950,5
18578563,Me Myself I,1999,"['France', 'Australia']","['Romantic fantasy', 'Time travel', 'Comedy', 'Romantic comedy', 'Comedy-drama', 'Fantasy Comedy', 'Fantasy']",1990,9
17016349,Bloodmoon,1997,['United States of America'],"['Action', 'Action/Adventure', 'Thriller', 'Martial Arts Film']",1990,7
1471253,McLintock!,1963,['United States of America'],"['Comedy Western', 'Action/Adventure', 'Western', 'Comedy', 'Romance Film', 'Romantic comedy']",1960,3
11613399,Down Beat Bear,1956,[],"['Animation', 'Short Film', 'Family Film']",1950,6
3624815,The Long Goodbye,1973,['United States of America'],"['Crime Fiction', 'Mystery', 'Satire', 'Thriller', 'Film noir', 'Crime Thriller', 'Drama', 'New Hollywood']",1970,3
1658116,Nothing in Common,1986,['United States of America'],"['Workplace Comedy', 'Comedy', 'Romance Film', 'Romantic comedy', 'Domestic Comedy', 'Comedy-drama', 'Drama']",1980,6
35005403,Iso lo,1994,"['France', 'Senegal']",['Documentary'],1990,4
35283354,Kaneez,1949,['India'],[],1940,9
32996540,Zebra in the Kitchen,1965,['United States of America'],"['Comedy', 'Childhood Drama', 'Animal Picture', ""Children's/Family"", 'Drama', 'Family Film']",1960,5
4569398,Phir Milenge,2004,['India'],"['Romantic drama', 'Bollywood', 'World cinema', 'Romance Film', 'Melodrama', 'Drama']",2000,4
28756111,Spare the Rod,1961,['United Kingdom'],['Drama'],1960,1
12649366,The Chocolate War,1988,['United States of America'],"['Film adaptation', 'Drama', 'Teen']",1980,8
4783144,Suburban Girl,2007,['United States of America'],"['Indie', 'Comedy', 'Romance Film', 'Romantic comedy']",2000,7
33192024,The Snow Queen's Revenge,1996,['United Kingdom'],['Animation'],1990,6
2810604,Gold Diggers of 1933,1933,['United States of America'],"['Musical', 'Black-and-white', 'Musical comedy', 'Pre-Code', 'Comedy of Errors']",1930,3
12091274,Puccini for Beginners,2007,['United States of America'],"['LGBT', 'Screwball comedy', 'Indie', 'Comedy', 'Romance Film', 'Gay Themed', 'Gay', 'Gay Interest', 'Romantic comedy']",2000,7
849321,Suburban Commando,1991,['United States of America'],"['Adventure Comedy', 'Comedy', 'Adventure', 'Family Film', 'Alien Film', 'Science Fiction']",1990,1
13417367,San Ferry Ann,1966,['United Kingdom'],['Comedy'],1960,6
1274418,Cheech & Chong's Up in Smoke,1978,['United States of America'],"['Musical', 'Stoner film', 'Comedy', 'Slapstick', 'Cult']",1970,8
21837079,El Esqueleto de la señora Morales,1960,['Mexico'],"['Marriage Drama', 'Comedy', 'World cinema', 'Crime Drama', 'Black comedy', 'Drama']",1960,0
24709707,Staunton Hill,2009,['United States of America'],"['Slasher', 'Horror']",2000,9
11265801,Benji,1974,['United States of America'],"['Mystery', 'Romance Film', 'Family-Oriented Adventure', ""Children's/Family"", ""Children's"", 'Adventure', 'Drama', 'Animal Picture', 'Family Film']",1970,4
28722138,Possessed by the Night,1994,['United States of America'],"['Action', 'Thriller', 'Horror']",1990,4
17325678,The Mystic,1925,['United States of America'],"['Silent film', 'Black-and-white', 'Drama']",1920,5
20637977,Heaven's Burning,1998,"['New Zealand', 'Australia']","['Action', 'Suspense', 'Crime Fiction', 'Action/Adventure', 'Thriller', 'World cinema', 'Crime Thriller']",1990,8
9968318,Rambling Rose,1991,['United States of America'],"['Period piece', 'Drama']",1990,1
448331,Class Action,1991,['United States of America'],"['Courtroom Drama', 'Drama']",1990,1
26147476,Splendor,1999,"['United Kingdom', 'United States of America']",['Comedy'],1990,9
21606161,The Man Between,1953,['United Kingdom'],"['Spy', 'Drama', 'Thriller']",1950,3
14734695,Fifi Blows Her Top,1958,['United States of America'],"['Short Film', 'Black-and-white', 'Comedy']",1950,8
28353730,Dear Mr. Prohack,1949,['United Kingdom'],"['Romance Film', 'Comedy']",1940,9
11838795,Jacob Two Two Meets The Hooded Fang,1978,"['Canada', 'United States of America']","['Adventure', 'Family Film', 'Fantasy']",1970,8
15420578,Water Lady,1979,['South Korea'],['Drama'],1970,9
23092410,Vallal,1997,['India'],"['Comedy', 'Family Film', 'Tamil cinema']",1990,7
10422347,Mirror,2007,['Malaysia'],['Horror'],2000,7
10072700,Run for the Sun,1956,['United States of America'],"['Action', 'Film adaptation', 'Crime Fiction', 'Action/Adventure', 'Thriller', 'Escape Film', 'Adventure', 'Drama', 'Chase Movie']",1950,6
28789973,The Tuttles of Tahiti,1942,['United States of America'],['Comedy'],1940,2
6043815,Police Academy 6: City Under Siege,1989,['United States of America'],"['Action', 'Action/Adventure', 'Comedy', 'Slapstick']",1980,9
8967683,Max Headroom: 20 Minutes into the Future,1985,['United Kingdom'],"['Science Fiction', 'Drama']",1980,5
24336588,Rope Cosmetology,1978,['Japan'],"['Erotica', 'Japanese Movies', 'Pornographic movie']",1970,8
14734295,Rumpus in the Harem,1956,['United States of America'],"['Short Film', 'Black-and-white', 'Comedy']",1950,6
14434425,Ex-Lady,1933,['United States of America'],"['Black-and-white', 'Romance Film', 'Romantic comedy', 'Pre-Code', 'Sex comedy']",1930,3
8023659,Unaccompanied Minors,2006,['United States of America'],"['Christmas movie', 'Comedy', 'Teen', 'Holiday Film', 'Adventure', 'Family Film']",2000,6
1861161,Eye of the Beholder,2000,"['Canada', 'Australia', 'United Kingdom', 'United States of America']","['Psychological thriller', 'Crime Fiction', 'Mystery', 'Thriller', 'Drama']",2000,0
17324736,An Awfully Big Adventure,1995,['United Kingdom'],"['Period piece', 'Film adaptation', 'Romantic drama', 'Comedy', 'Romance Film', 'Drama']",1990,5
21038494,Thedi Vandha Mappillai,1970,['India'],"['Musical', 'Bollywood', 'World cinema', 'Drama']",1970,0
15564747,Love and Other Dilemmas,2006,['Canada'],['Comedy'],2000,6
9056809,Indrajeet,1991,['India'],['World cinema'],1990,1
26716550,Valet Girls,1987,['United States of America'],['Comedy'],1980,7
4149931,"Careful, He Might Hear You",1983,['Australia'],"['Childhood Drama', 'World cinema', 'Adventure', 'Drama', 'Family Film']",1980,3
19262729,Bear Island,1979,['United Kingdom'],"['Adventure', 'Thriller']",1970,9
454818,The Abominable Dr. Phibes,1971,['United Kingdom'],"['Costume Horror', 'Master Criminal Films', 'Horror']",1970,1
14583360,Westward the Women,1951,['United States of America'],['Western'],1950,1
9402549,"Kidnapping, Caucasian Style",1966,"['Russia', 'Soviet Union']","['Comedy', 'World cinema']",1960,6
32905753,Westward Whoa,1936,[],"['Animation', 'Short Film', 'Western', 'Comedy film', 'Family Film']",1930,6
95953,Office Space,1999,['United States of America'],"['Crime Fiction', 'Comedy', 'Black comedy', 'Workplace Comedy']",1990,9
576049,Affair in Trinidad,1952,['United States of America'],"['Spy', 'Mystery', 'Thriller', 'Film noir', 'Crime Thriller', 'Glamorized Spy Film', 'Drama']",1950,2
12357969,Silambattam,2008,['India'],"['Action', 'Family Film']",2000,8
8466575,Crime School,1938,['United States of America'],"['Black-and-white', 'Crime Fiction']",1930,8
183768,The Farmer's Daughter,1947,['United States of America'],"['Political cinema', 'Black-and-white', 'Parody', 'Comedy', 'Romance Film', 'Romantic comedy']",1940,7
3448942,George of the Jungle 2,2003,"['United States of America', 'Australia']","['Parody', 'Slapstick', 'Comedy', 'Jungle Film', 'Family Film']",2000,3
4808174,Three for the Road,1987,['United States of America'],"['Indie', 'Comedy', 'Drama']",1980,7
1059688,Good Morning,1959,['Japan'],"['Japanese Movies', 'Comedy', 'World cinema', 'Drama']",1950,9
19011235,5 Steps to Danger,1957,['United States of America'],"['Action', 'Spy', 'Thriller']",1950,7
5894829,Edmond,2005,"['United Kingdom', 'France', 'United States of America']","['Psychological thriller', 'Crime Fiction', 'Indie', 'Thriller', 'Drama']",2000,5
2129381,Suspect,1987,['United States of America'],"['Suspense', 'Crime Fiction', 'Mystery', 'Thriller', 'Drama', 'Courtroom Drama']",1980,7
2228850,Saints and Soldiers,2003,['United States of America'],"['Period piece', 'Action', 'Drama', 'Indie', 'War film', 'Escape Film']",2000,3
24724201,Thursday's Child,1983,['United States of America'],"['Film adaptation', 'Television movie', 'Drama']",1980,3
11320484,Aaj Ka Laawaris,2006,['India'],['Action'],2000,6
5590209,Sword of Sherwood Forest,1960,['United Kingdom'],"['Action', 'Action/Adventure', 'Historical fiction', 'Costume drama', 'Adventure', 'Swashbuckler films']",1960,0
1357330,Love Field,1992,['United States of America'],"['Period piece', 'Drama', 'Indie', 'Chase Movie', 'Romantic drama', 'Romance Film', 'Road movie']",1990,2
24269214,Monster Mash,1995,['United States of America'],"['Musical', 'Comedy film', 'Horror']",1990,5
5123115,Tale of Tales,1979,"['Russia', 'Soviet Union', 'United States of America']","['Animation', 'Short Film', 'Stop motion']",1970,9
3509741,Count Dracula,1970,['Spain'],['Horror'],1970,0
31321940,The Navy vs. the Night Monsters,1966,[],"['Horror', 'Science Fiction']",1960,6
29094903,Orukkam,1990,[],"['Action', 'Thriller', 'Drama']",1990,0
30244111,Kannupada Poguthaiya,1999,[],[],1990,9
6748447,Little John,2001,['India'],"['Musical', 'Family Drama', 'World cinema', 'Romance Film', 'Drama', 'Fantasy']",2000,1
14877669,That Night in Rio,1941,['United States of America'],"['Musical', 'Comedy', 'Musical comedy', 'Romance Film', 'Romantic comedy']",1940,1
2535397,Left Behind: World at War,2005,"['Canada', 'United States of America']","['Film adaptation', 'Thriller', 'Christian film', 'Drama', 'Political thriller']",2000,5
19746162,Confesión a Laura,1990,"['Colombia', 'Spain', 'Cuba']",['Drama'],1990,0
214312,A Man and a Woman,1966,['France'],"['Romantic drama', 'World cinema', 'Romance Film', 'Drama']",1960,6
21597854,KAMI the Movie,2008,['Malaysia'],['Drama'],2000,8
10134094,Invasion from Inner Earth,1974,['United States of America'],"['Horror', 'Science Fiction']",1970,4
255198,Notorious,1946,['United States of America'],"['Spy', 'Black-and-white', 'Thriller', 'Film noir', 'Romance Film', 'Drama', 'Suspense', 'Political thriller']",1940,6
18755554,The Big I Am,2009,['United Kingdom'],"['Action', 'Crime Fiction', 'Gangster Film', 'Action/Adventure', 'Thriller']",2000,9
30318497,Sarvakalashala,1987,[],"['Romance Film', 'Comedy', 'Drama']",1980,7
17575809,Kadhal Azhivathillai,2002,['India'],"['Romantic drama', 'World cinema', 'Romance Film', 'Drama']",2000,2
4409408,The House of Sand,2006,['Brazil'],"['Art film', 'Drama', 'World cinema']",2000,6
673599,Men in Black II,2002,['United States of America'],"['Action', 'Action/Adventure', 'Buddy film', 'Comedy', 'Alien Film', 'Science Fiction']",2000,2
1226871,"No Retreat, No Surrender",1986,"['Hong Kong', 'United States of America']","['Action', 'Chinese Movies', 'Martial Arts Film']",1980,6
1185745,Dodesukaden,1970,['Japan'],"['Art film', 'Japanese Movies', 'World cinema', 'Drama']",1970,0
2012056,"Rome, Open City",1945,"['Kingdom of Italy', 'Italy']","['War film', 'Drama']",1940,5
27862110,Poochudava,1997,[],['Romance Film'],1990,7
20947864,You and Your Stupid Mate,2005,"['New Zealand', 'Australia']","['Indie', 'Buddy film', 'Comedy film', 'World cinema']",2000,5
11699620,Frenchie,1950,['United States of America'],"['Action', 'Hybrid Western', 'Western', 'Romance Film']",1950,0
1766514,When in Rome,2002,['United States of America'],"['Comedy', 'Teen', 'Romance Film', 'Adventure', 'Drama', 'Coming of age', 'Romantic comedy', 'Family Film']",2000,2
8310511,Ibu Mertuaku,1962,"['Singapore', 'Malaysia']","['Musical', 'Black-and-white', 'Drama', 'Tragedy']",1960,2
3612689,World for Ransom,1954,['United States of America'],"['Action', 'Spy', 'Black-and-white', 'Crime Fiction', 'Action Thrillers', 'Action/Adventure', 'Thriller', 'Film noir', 'Crime Thriller', 'Drama']",1950,4
26010183,Marriage Counselor Tora-san,1984,['Japan'],['Japanese Movies'],1980,4
31156636,Meghamalhar,2002,[],"['Musical', 'Romance Film']",2000,2
6583033,Bobby,2002,['India'],['Romance Film'],2000,2
21163352,Master Harold...and the Boys,2009,[],"['Film adaptation', 'Drama', 'World cinema']",2000,9
16585327,Straight,2009,['India'],"['Musical', 'Comedy', 'Bollywood', 'World cinema', 'Sex comedy']",2000,9
471352,Ghost Dog: The Way of the Samurai,1999,"['Japan', 'France', 'Germany', 'United States of America']","['Action', 'Crime Fiction', 'Gangster Film', 'Action/Adventure', 'Comedy', 'Martial Arts Film', 'Drama', 'Japanese Movies', 'Parody', 'Crime Drama']",1990,9
26262030,Tana,1958,['Albania'],['Drama'],1950,8
17925680,Straight on Till Morning,1972,['United Kingdom'],"['Suspense', 'Mystery', 'Thriller', 'Horror']",1970,2
9161616,Way for a Sailor,1930,['United States of America'],"['Action', 'Black-and-white', 'Drama', 'Romance Film']",1930,0
7102059,Danny Roane: First Time Director,2006,['United States of America'],"['Mockumentary', 'Parody', 'Comedy']",2000,6
25927269,Calendar,2009,['India'],"['Romance Film', 'Drama']",2000,9
6999811,Finding North,1998,['United States of America'],"['LGBT', 'Indie', 'Comedy', 'Drama', 'Gay Themed', 'Gay', 'Road movie', 'Gay Interest', 'Romantic comedy', 'Comedy-drama']",1990,8
464128,Bad News Bears,1976,['United States of America'],"['Coming of age', 'Comedy', 'Baseball', 'Sports', 'Family Film']",1970,6
13784031,Pudhiya Mugam,1993,['India'],['Thriller'],1990,3
6012695,Devar,1966,['India'],"['Romance Film', 'Crime Fiction', 'Drama']",1960,6
8281847,The Last Valley,1971,"['United Kingdom', 'United States of America']","['Costume Adventure', 'Drama', 'Indie', 'Action/Adventure', 'Adventure', 'War film']",1970,1
32808169,Into the Straight,1949,[],['Drama'],1940,9
2344342,Crime Wave,1954,['United States of America'],"['Film noir', 'Crime Fiction', 'Drama']",1950,4
1845248,The Crossing,2000,['United States of America'],"['Period piece', 'History', 'Biography', 'Costume drama', 'Television movie', 'War film', 'Drama']",2000,0
1010466,Dark Blue World,2001,"['United Kingdom', 'Germany', 'Czech Republic', 'Italy']","['Action', 'Drama', 'Buddy film', 'World cinema', 'War film']",2000,1
2672672,Audrey Rose,1977,['United States of America'],"['Psychological thriller', 'Film adaptation', 'Family Drama', 'Thriller', 'Horror', 'Supernatural', 'Drama']",1970,7
14224022,City for Conquest,1940,['United States of America'],"['Black-and-white', 'Film noir', 'Melodrama', 'Drama']",1940,0
26876859,Aayirathil Oruvan,2009,['India'],['Drama'],2000,9
13272614,Salsa,1988,['United States of America'],"['Romance Film', 'Romantic drama', 'Drama']",1980,8
14411595,Crossing Over,2009,['United States of America'],['Drama'],2000,9
24579000,Strictly Sexual,2008,['United States of America'],"['Drama', 'Indie', 'Romantic drama', 'Comedy', 'Romance Film', 'Romantic comedy']",2000,8
26940384,Il Bacio di Tosca,1984,['Italy'],"['Documentary', 'World cinema']",1980,4
6307392,Thanks A Million,1935,['United States of America'],"['Musical', 'Black-and-white', 'Political satire', 'Satire', 'Comedy']",1930,5
3267547,A House Is Not a Home,1964,['United States of America'],"['Black-and-white', 'Drama', 'Indie', 'Biopic [feature]', 'Romance Film', 'Docudrama']",1960,4
8153627,Cotton Comes to Harlem,1970,['United States of America'],"['Action', 'Blaxploitation', 'Crime Fiction', 'Action/Adventure', 'Buddy film', 'Thriller', 'Comedy', 'Action Comedy', 'Comedy Thriller']",1970,0
2685420,Kaviratna Kalidasa,1983,['India'],"['Musical', 'Bollywood', 'World cinema', 'Romance Film']",1980,3
10419077,Raampur Ka Lakshman,1972,['India'],"['Drama', 'World cinema']",1970,2
14241872,Dragonball Evolution,2009,"['United Kingdom', 'Hong Kong', 'United States of America']","['Action', 'Action/Adventure', 'Chinese Movies', 'Martial Arts Film', 'Adventure', 'Superhero movie', 'Doomsday film', 'Science Fiction', 'Fantasy']",2000,9
3344455,Anne of Green Gables,1934,['United States of America'],"['Black-and-white', 'Comedy', 'Drama', 'Family Film']",1930,4
18893263,Drake's Venture,1980,['United Kingdom'],['Historical drama'],1980,0
3818389,Peter Pan,1924,['United States of America'],"['Silent film', 'Black-and-white', 'Fantasy']",1920,4
171628,I Am Sam,2001,['United States of America'],"['Melodrama', 'Drama', 'Courtroom Drama']",2000,1
26164214,The Girl in Black Stockings,1957,['United States of America'],"['Crime Fiction', 'Mystery', 'Thriller', 'Film noir', 'Drama']",1950,7
2098803,Songcatcher,2000,['United States of America'],"['Music', 'Musical', 'Period piece', 'Indie', 'Drama']",2000,0
14428799,Scarlet Sails,1961,"['Russia', 'Soviet Union']","['Romantic fantasy', 'World cinema', 'Romance Film', 'Fantasy']",1960,1
24354731,Freeway,1988,['United States of America'],"['Suspense', 'Indie', 'Thriller']",1980,8
31427846,Kudumbapuranam,1988,[],"['Family Film', 'Drama', 'Comedy film']",1980,8
19659317,The Blue Beads from Greece,1967,['Greece'],"['Musical', 'Comedy film']",1960,7
5752544,I Now Pronounce You Chuck and Larry,2007,['United States of America'],"['LGBT', 'Screwball comedy', 'Buddy film', 'Comedy', 'Romantic comedy', 'Sex comedy']",2000,7
32621558,What a Woman!,1943,['United States of America'],"['Comedy', 'Comedy film', 'Romance Film', 'Romantic comedy']",1940,3
213472,Aliens,1986,"['United Kingdom', 'United States of America']","['Action', 'Action/Adventure', 'Thriller', 'Sci-Fi Horror', 'Adventure', 'Creature Film', 'Horror', 'Stop motion', 'Science Fiction']",1980,6
25811332,The Mind Benders,1963,['United Kingdom'],"['Science Fiction', 'Thriller']",1960,3
3762449,*batteries not included,1987,['United States of America'],"['Comedy', 'Comedy-drama', 'Science Fiction', 'Drama', 'Family Film', 'Fantasy']",1980,7
3446656,Mikey and Nicky,1975,['United States of America'],"['Crime Fiction', 'Gangster Film', 'Indie', 'Crime Drama', 'Drama']",1970,5
24153140,Tiger in the Smoke,1956,['United Kingdom'],"['Drama', 'Crime Fiction', 'Thriller']",1950,6
9893064,Savage Streets,1984,['United States of America'],"['Action', 'Crime Fiction', 'Action Thrillers', 'Indie', 'Action/Adventure', 'Thriller']",1980,4
24669284,The Boogens,1981,['United States of America'],['Horror'],1980,1
7405036,The Return of the Soldier,1982,['United Kingdom'],"['Film adaptation', 'Romantic drama', 'Romance Film', 'Drama']",1980,2
2659131,L'Alpagueur,1976,['France'],"['Thriller', 'Crime Thriller']",1970,6
27424347,Old Bill and Son,1941,['United Kingdom'],['Comedy'],1940,1
3369664,Helen of Troy,2003,['United States of America'],"['Action', 'History', 'Romance Film', 'Television movie', 'War film', 'Adventure']",2000,3
571311,An Angel at My Table,1990,"['Australia', 'United Kingdom', 'New Zealand', 'United States of America']","['Biography', 'Biopic [feature]', 'World cinema', 'Drama', 'Feminist Film']",1990,0
27488403,Ennum Nanmakal,1991,['India'],"['Drama', 'Comedy film']",1990,1
24868783,Yauwan,1973,['India'],['World cinema'],1970,3
5612615,The Family Way,1966,['United Kingdom'],"['Romantic comedy', 'Screwball comedy', 'Comedy']",1960,6
28920951,The D.I.,1957,['United States of America'],['Drama'],1950,7
33298020,"Skaz pro to, kak tsar Pyotr arapa zhenil",1976,['Soviet Union'],"['Musical', 'Romance Film']",1970,6
29636228,Tub Girls,1967,['United States of America'],['Romance Film'],1960,7
24361001,Oryu's Passion: Bondage Skin,1975,['Japan'],"['Erotica', 'Japanese Movies', 'Pornographic movie']",1970,5
3226774,The Grudge 2,2006,"['Japan', 'United States of America']","['Japanese Movies', 'Supernatural', 'Horror']",2000,6
14037329,Fireproof,2008,['United States of America'],"['Drama', 'Indie', 'Romantic drama', 'Marriage Drama', 'Romance Film', 'Christian film']",2000,8
11327665,The Net 2.0,2006,['United States of America'],"['Action', 'Psychological thriller', 'Suspense', 'Drama', 'Thriller']",2000,6
6555711,Carry On Matron,1972,['United Kingdom'],"['Parody', 'Slapstick', 'Comedy']",1970,2
2002320,Halloween 5: The Revenge of Michael Myers,1989,['United States of America'],"['Indie', 'Slasher', 'Teen', 'Horror', 'Cult']",1980,9
8291511,Lost,1956,['United Kingdom'],"['Crime Fiction', 'Mystery', 'Thriller', 'Detective']",1950,6
2726483,Possessed,2000,['United States of America'],"['Thriller', 'Horror', 'Television movie', 'Drama']",2000,0
1147064,The Fairly OddParents in: Channel Chasers,2004,['United States of America'],"['Parody', 'Animation']",2000,4
1358544,Obsession,1976,['United States of America'],"['Psychological thriller', 'Suspense', 'Mystery', 'Thriller', 'Crime Thriller', 'Drama']",1970,6
3867110,How They Get There,1997,['United States of America'],['Short Film'],1990,7
9622333,Elvis and Anabelle,2007,['United States of America'],"['Romantic drama', 'Indie', 'Romance Film', 'Drama']",2000,7
10603823,The First Power,1990,['United States of America'],"['Psychological thriller', 'Mystery', 'Slasher', 'Thriller', 'Horror', 'Crime Thriller', 'Supernatural']",1990,0
6035884,In Tranzit,2008,"['Russia', 'United Kingdom']","['Period piece', 'Drama', 'World cinema']",2000,8
25847410,Tora-san's Love Call,1971,['Japan'],['Japanese Movies'],1970,1
195388,Y tu mamá también,2001,['Mexico'],"['Romantic drama', 'Comedy', 'World cinema', 'Romance Film', 'Drama', 'Coming of age', 'Comedy-drama', 'Road movie', 'Sex comedy']",2000,1
4489906,Mumford,1999,['United States of America'],"['Screwball comedy', 'Romantic drama', 'Comedy', 'Romance Film', 'Drama', 'Romantic comedy', 'Comedy-drama', 'Ensemble Film']",1990,9
7616900,Starik Khottabych,1956,"['Russia', 'Soviet Union']","[""Children's Fantasy"", 'World cinema', ""Children's/Family"", 'Family Film', 'Fantasy']",1950,6
93760,Showgirls,1995,"['France', 'United States of America']","['Erotic Drama', 'Sexploitation', 'Drama']",1990,5
4303794,Dedication,2006,['United States of America'],"['Drama', 'Indie', 'Comedy', 'Black comedy', 'Romantic comedy', 'Comedy-drama', 'Romance Film']",2000,6
2918727,Miami Blues,1990,['United States of America'],"['Action', 'Film adaptation', 'Crime Fiction', 'Thriller', 'Crime Drama', 'Crime Thriller', 'Drama']",1990,0
23830211,Requiem for a Dream,2000,['United States of America'],"['Drama', 'Indie', 'Addiction Drama', 'Tragedy']",2000,0
2417417,Wet Gold,1984,['United States of America'],"['Action/Adventure', 'Adventure', 'Drama']",1980,4
30873754,Rider On The Rain,1969,"['France', 'Italy']","['Psychological thriller', 'Crime Fiction', 'Mystery', 'Thriller', 'World cinema', 'Crime Thriller', 'Drama']",1960,9
25756229,The Siege of Pinchgut,1959,['United Kingdom'],"['Action', 'Drama', 'Crime Fiction', 'Thriller', 'Romance Film']",1950,9
27561302,The Return of the Man from U.N.C.L.E,1983,['United States of America'],"['Action', 'Crime Fiction', 'Thriller']",1980,3
23420246,Revelation,1924,['United States of America'],"['Silent film', 'Black-and-white', 'Drama']",1920,4
26488597,Hysterical,1983,['United States of America'],"['Indie', 'Comedy', 'Parody']",1980,3
2952434,The Chaos Factor,2000,['United States of America'],"['Crime Fiction', 'Thriller', 'Political drama', 'Drama']",2000,0
3790446,"Yesterday, Today, and Tomorrow",1963,"['France', 'Italy']","['Crime Fiction', 'Romantic drama', 'Comedy', 'World cinema', 'Romance Film', 'Drama', 'Romantic comedy', 'Sex comedy']",1960,3
5606790,Nothing But Trouble,1944,['United States of America'],"['Comedy', 'Black-and-white']",1940,4
13345732,The Richest Girl in the World,1934,['United States of America'],"['Romantic comedy', 'Black-and-white']",1930,4
13378027,Trombone Trouble,1944,['United States of America'],"['Animation', 'Short Film', 'Comedy', 'Family Film', 'Fantasy']",1940,4
25783738,Organ,1996,['Japan'],"['Japanese Movies', 'Horror']",1990,6
27689047,Private Eyes,1953,['United States of America'],"['Action', 'Crime Fiction', 'Comedy', 'Adventure']",1950,3
5489530,A Real Young Girl,2000,['France'],"['Romantic drama', 'World cinema', 'Romance Film', 'Drama']",2000,0
36098000,Madly Bangalee,2009,['India'],"['Musical', 'Drama']",2000,9
23233139,A Blood Pledge,2009,['South Korea'],"['World cinema', 'Drama', 'Horror']",2000,9
4230724,Frostbiter: Wrath of the Wendigo,1996,['United States of America'],['Horror'],1990,6
9541484,Crimes of Passion,1984,['United States of America'],"['Suspense', 'Drama', 'Indie', 'Thriller', 'Erotic thriller', 'Romance Film']",1980,4
11217842,Thodisi Bewafaii,1980,['India'],"['Drama', 'Bollywood', 'World cinema']",1980,0
1741449,The Young Master,1980,['Hong Kong'],"['Action', 'Martial Arts Film', 'Action Comedy', 'Action/Adventure', 'Comedy', 'World cinema', 'Chinese Movies']",1980,0
1381470,The Pure Hell of St Trinian's,1960,['United Kingdom'],"['Comedy', 'Black-and-white']",1960,0
4317405,"Truth or Consequences, N.M.",1997,['United States of America'],"['Action', 'Psychological thriller', 'Crime Fiction', 'Thriller', 'Crime Thriller', 'Drama']",1990,7
913165,Berkeley Square,1933,['United States of America'],"['Romance Film', 'Black-and-white', 'Fantasy']",1930,3
5638171,Camp Blood,1999,['United States of America'],"['Indie', 'Slasher', 'Horror Comedy', 'Horror', 'B-movie']",1990,9
1029774,Catlow,1971,['United States of America'],"['Film adaptation', 'Comedy Western', 'Action/Adventure', 'Western']",1970,1
12834270,The Pleasure of His Company,1961,['United States of America'],"['Film adaptation', 'Comedy', 'Romance Film', 'Romantic comedy', 'Domestic Comedy', 'Drama']",1960,1
9685347,Zero to Sixty,1978,['United States of America'],"['Action', 'Action/Adventure', 'Comedy']",1970,8
11558326,What Just Happened?,2008,['United States of America'],"['Action', 'Drama', 'Indie', 'Satire', 'Thriller', 'Comedy', 'Comedy-drama']",2000,8
9628464,Second Best,1994,"['United Kingdom', 'United States of America']",['Drama'],1990,4
14656940,Shadow on the Wall,1950,['United States of America'],"['Psychological thriller', 'Black-and-white', 'Mystery', 'Film noir']",1950,0
7766450,Flywheel,2003,['United States of America'],"['Drama', 'Indie', 'Family Drama', 'Inspirational Drama', 'Christian film', 'Family Film']",2000,3
8272738,Santa Claus Is Comin' to Town,1970,"['Japan', 'United States of America']","['Musical', 'Animation', 'Stop motion', ""Children's"", 'Family Film', 'Fantasy']",1970,0
21064505,Take Out,2004,['United States of America'],"['Indie', 'Drama']",2000,4
36284183,Danger,2005,['India'],['Thriller'],2000,5
525113,Tombstone,1993,['United States of America'],"['Action', 'Crime Fiction', 'Action/Adventure', 'Romance Film', 'Costume drama', 'Drama', 'History', 'Western']",1990,3
8427501,Whistle Down the Wind,1961,['United Kingdom'],"['Film adaptation', ""Children's"", 'Drama', 'Family Film']",1960,1
2298243,All Over Me,1997,['United States of America'],"['LGBT', 'Crime Fiction', 'Indie', 'Romantic drama', 'Teen', 'Romance Film', 'Drama', 'Gay Themed', 'Gay', 'Coming of age', 'Gay Interest']",1990,7
9912911,Your Vice Is a Locked Room and Only I Have the Key,1972,['Italy'],"['Giallo', 'Crime Fiction', 'Slasher', 'Horror', 'World cinema']",1970,2
24751153,The Lost Man,1969,['United States of America'],"['Drama', 'Crime Fiction']",1960,9
25924200,"CID Unnikrishnan B.A., B.Ed.",1994,['India'],"['Mystery', 'Comedy film']",1990,4
13553852,Flash Point,2008,['Hong Kong'],"['Action', 'Crime Fiction', 'Action/Adventure', 'Thriller', 'World cinema', 'Crime Thriller', 'Chinese Movies', 'Martial Arts Film']",2000,8
1208102,The Testaments: Of One Fold and One Shepherd,2000,['United States of America'],['Religious Film'],2000,0
5561794,The Driver,1978,"['United Kingdom', 'United States of America']","['Action', 'Crime Fiction', 'Action/Adventure', 'Existentialism', 'Thriller', 'Crime Thriller']",1970,8
4908353,All the Pretty Horses,2000,['United States of America'],"['Film adaptation', 'Romantic drama', 'Action/Adventure', 'Romance Film', 'Adventure', 'Drama', 'Period piece', 'Coming of age', 'Western']",2000,0
5844700,A view from the Eiffel tower,2005,['Serbia and Montenegro'],['Drama'],2000,5
14910791,Kasam Paida Karne Wale Ki,1984,['India'],"['Romantic drama', 'Action/Adventure', 'World cinema', 'Romance Film', 'Drama']",1980,4
1752246,Live Free or Die Hard,2007,"['United Kingdom', 'United States of America']","['Action', 'Crime Fiction', 'Action Thrillers', 'Thriller']",2000,7
20904045,Chala Murari Hero Banne,1977,['India'],"['Comedy', 'Bollywood', 'World cinema']",1970,7
12259086,Beyond Silence,1996,['Germany'],"['Drama', 'World cinema']",1990,6
30164669,Beti No.1,2000,['India'],['Comedy film'],2000,0
2165760,The Far Country,1955,['United States of America'],"['Action/Adventure', 'Western']",1950,5
5516533,Captain Kronos - Vampire Hunter,1974,['United Kingdom'],"['Action/Adventure', 'Adventure', 'Horror']",1970,4
1389387,Inside Moves,1980,['United States of America'],"['Film adaptation', 'Tragicomedy', 'Sports', 'Drama']",1980,0
11760799,Blindness,2008,"['Brazil', 'United States of America', 'Canada', 'Japan', 'Uruguay']","['Psychological thriller', 'Japanese Movies', 'Thriller', 'Drama']",2000,8
1414872,Zhou Yu's Train,2002,['China'],"['Romantic drama', 'World cinema', 'Romance Film', 'Chinese Movies', 'Drama']",2000,2
15852561,Foolish Wives,1922,['United States of America'],"['Silent film', 'Black-and-white', 'Drama']",1920,2
473964,Justice,2002,['Japan'],['Japanese Movies'],2000,2
14619627,Tarzan's Magic Fountain,1949,['United States of America'],"['Black-and-white', 'Adventure', 'Jungle Film']",1940,9
15798140,Angels Fall,2007,['United States of America'],"['Film adaptation', 'Mystery', 'Thriller', 'Romance Film', 'Television movie', 'Crime Thriller', 'Drama']",2000,7
9088040,Dark Prince: The True Story of Dracula,2000,['United States of America'],"['Biographical film', 'Thriller', 'Horror']",2000,0
20937202,Noël Noël,2003,['Canada'],"['Animation', 'Short Film', 'Family Film']",2000,3
20291261,The Coffin,2008,"['South Korea', 'United States of America', 'Singapore', 'Thailand']","['Thriller', 'Horror']",2000,8
28953446,Ayer me echaron del pueblo,1982,['Colombia'],['Drama'],1980,2
23632489,Puppet Master: Axis of Evil,2009,['United States of America'],"['Horror', 'B-movie', 'Supernatural', 'Cult']",2000,9
3242749,"Faraway, So Close!",1993,['Germany'],"['Heaven-Can-Wait Fantasies', 'World cinema', 'Drama', 'Fantasy']",1990,3
6043780,Police Academy,1984,['United States of America'],"['Comedy', 'Crime Fiction']",1980,4
8637627,Full Metal Yakuza,1997,['Japan'],"['Action', 'Japanese Movies', 'Action/Adventure', 'World cinema', 'Horror', 'Science Fiction']",1990,7
9698112,Aanch,2003,['India'],"['Musical', 'Romantic drama', 'Bollywood', 'World cinema', 'Romance Film', 'Drama']",2000,3
20683469,Maskerade,1934,['Austria'],"['Musical', 'Black-and-white', 'Comedy', 'Melodrama']",1930,4
13611982,Dangerous Dan McFoo,1939,[],"['Animation', 'Short Film', 'Comedy', 'Family Film']",1930,9
24108514,Moving Target,2007,['United Kingdom'],"['Thriller', 'Drama']",2000,7
32977687,Hopalong Cassidy Returns,1936,['United States of America'],['Western'],1930,6
3331330,Evenfall,2005,['United States of America'],"['Action', 'Short Film', 'Adventure']",2000,5
20775950,The Mark of an Angel,2008,['France'],"['Drama', 'Thriller', 'World cinema']",2000,8
3222550,Burn!,1969,['Italy'],"['War film', 'Drama', 'Political drama']",1960,9
18290593,Büyü,2004,['Turkey'],['Horror'],2000,4
5831848,Wristcutters: A Love Story,2006,"['United Kingdom', 'United States of America']","['Indie', 'Comedy', 'Black comedy', 'Romance Film', 'Drama', 'Heaven-Can-Wait Fantasies', 'Romantic comedy', 'Fantasy']",2000,6
876728,The Muppet Movie,1979,"['United Kingdom', 'United States of America']","['Music', 'Musical', 'Comedy', 'Musical comedy', 'Family-Oriented Adventure', ""Children's/Family"", ""Children's"", 'Adventure', 'Drama', 'Road movie', 'Family Film']",1970,9
5527808,The Joy Luck Club,1993,['United States of America'],"['Film adaptation', 'Family Drama', 'Drama', 'Ensemble Film']",1990,3
28097123,Vision - From the Life of Hildegard von Bingen,2009,['Germany'],"['Period piece', 'Art film', 'World cinema', 'Drama']",2000,9
5008870,Madhumati,1958,['India'],"['Musical', 'Romantic fantasy', 'Mystery', 'Bollywood', 'World cinema', 'Drama', 'Fantasy']",1950,8
4599747,Intermezzo,1939,['United States of America'],"['Black-and-white', 'Romantic drama', 'Romance Film', 'Drama']",1930,9
187100,"Come Back, Little Sheba",1952,['United States of America'],"['Romance Film', 'Romantic drama', 'Drama']",1950,2
1437474,Anjali,1990,['India'],"['Musical', 'Family Drama', 'Tamil cinema']",1990,0
27622196,Fires Within,1991,['United States of America'],"['Romantic drama', 'Indie', 'Romance Film', 'Political drama', 'Drama']",1990,1
23423159,Married Flirts,1924,['United States of America'],"['Black-and-white', 'Silent film', 'Romance Film', 'Drama']",1920,4
1588930,The Blue Angel,1930,"['Weimar Republic', 'Germany']","['Musical', 'Black-and-white', 'Pre-Code', 'Drama']",1930,0
6000549,The Razor's Edge,1946,['United States of America'],"['Period piece', 'Film adaptation', 'Romantic drama', 'Romance Film', 'Drama']",1940,6
18613085,Anjuman,1970,['Pakistan'],['Drama'],1970,0
9112296,Shaadi Karke Phas Gaya Yaar,2006,['India'],['Romance Film'],2000,6
26749354,The Girls of Huntington House,1973,['United States of America'],"['Melodrama', 'Drama']",1970,3
26614442,Black Dalia,2009,['India'],"['Action', 'Drama']",2000,9
12613879,Locura de amor,1948,['Spain'],"['Black-and-white', 'Biographical film', 'Historical fiction', 'Melodrama', 'Drama']",1940,8
33515860,You My Rose Mellow,1998,[],"['Romance Film', 'Drama']",1990,8
35790657,Sugamana Sumaigal,1992,['India'],['Drama'],1990,2
817057,Outland,1981,['United Kingdom'],"['Crime Fiction', 'Western', 'Hybrid Western', 'Thriller', 'Adventure', 'Space western', 'Science Fiction']",1980,1
3858746,Madagascar: Escape 2 Africa,2008,['United States of America'],"['Action', 'Computer Animation', 'Animation', 'Comedy', ""Children's/Family"", 'Adventure', 'Family Film']",2000,8
8356812,Lankeshwarudu,1989,['India'],"['Action', 'Drama', 'Family Film']",1980,9
11958275,Mob Sister,2008,['Hong Kong'],['Chinese Movies'],2000,8
5608558,Another Fine Mess,1930,['United States of America'],"['Black-and-white', 'Short Film', 'Comedy', 'Remake', 'Slapstick']",1930,0
44501,Cast Away,2000,['United States of America'],"['Airplanes and airports', 'Action/Adventure', 'Adventure', 'Drama']",2000,0
369508,Gandhi,1982,"['United Kingdom', 'India']","['British Empire Film', 'Biographical film', 'Drama', 'History', 'Biopic [feature]', 'Historical Epic', 'Historical fiction', 'Epic']",1980,2
3418109,Dream a Little Dream,1989,['United States of America'],"['Comedy', 'Teen', 'Romance Film', 'Romantic comedy', 'Fantasy Comedy', 'Fantasy']",1980,9
12246739,The International,2009,"['United Kingdom', 'Germany', 'United States of America']","['Action', 'Psychological thriller', 'Mystery', 'Thriller', 'Crime Thriller', 'Political thriller']",2000,9
15239845,Never Ever,1996,"['United Kingdom', 'United States of America']",['Drama'],1990,6
3394318,Death Before Dishonor,1987,['United States of America'],"['Action', 'Drama', 'Indie', 'Action/Adventure', 'Thriller', 'War film']",1980,7
1124048,Taxi 2,2000,['France'],"['Action', 'Crime Fiction', 'Action Thrillers', 'Action/Adventure', 'Comedy', 'Thriller', 'Buddy film', 'World cinema', 'Parkour in popular culture', 'Crime Thriller', 'Chase Movie']",2000,0
4764375,Shark Attack films,1999,['United States of America'],"['Horror', 'Natural horror films']",1990,9
27065959,Vindhyarani,1948,['India'],"['Musical', 'Drama']",1940,8
1380847,Wrong Turn,2003,"['Germany', 'United States of America']","['Slasher', 'Thriller', 'Horror', 'Teen', 'Road-Horror']",2000,3
17428180,Pretty Smart,1987,['United States of America'],"['Indie', 'Coming of age', 'Comedy', 'Comedy-drama', 'Drama']",1980,7
11946021,Double Dribble,1946,['United States of America'],"['Animation', 'Short Film', 'Comedy']",1940,6
872342,Praying with Anger,1992,['United States of America'],"['Family Drama', 'Drama']",1990,2
23447923,Sachché Ká Bol-Bálá,1989,['India'],"['Musical', 'Bollywood', 'World cinema', 'Drama']",1980,9
13038083,Gee Whiz-z-z-z-z-z-z,1956,['United States of America'],"['Animation', 'Short Film', 'Family Film']",1950,6
18664228,Laid to Rest,2009,['United States of America'],"['Slasher', 'Horror']",2000,9
8990197,The Undefeated,1969,['United States of America'],"['Action', 'Action/Adventure', 'Western', 'War film', 'Adventure', 'Drama']",1960,9
15187211,Outrage!,1993,['Spain'],"['Drama', 'World cinema']",1990,3
922084,Legend,1985,"['United Kingdom', 'United States of America']","['Fantasy Adventure', 'Fantasy Drama', 'Action/Adventure', 'Romance Film', 'Costume drama', 'Adventure', 'Sword and sorcery films', 'Science Fiction', 'Fantasy']",1980,5
31139958,Sandhyakku Virinja Poovu,1983,[],['Drama'],1980,3
67423,Under Siege 2: Dark Territory,1995,['United States of America'],"['Action', 'Action Thrillers', 'Action/Adventure', 'Thriller', 'Martial Arts Film', 'Drama']",1990,5
2813558,They,2002,['United States of America'],"['Suspense', 'Psychological thriller', 'Thriller', 'Horror', 'Crime Thriller', 'Supernatural']",2000,2
7498130,The Long and Short of It,2003,"['New Zealand', 'United States of America']","['Short Film', 'Drama', 'Comedy film']",2000,3
3145948,The Gunfighter,1950,['United States of America'],['Western'],1950,0
805037,The Crush,1993,['United States of America'],"['Psychological thriller', 'Suspense', 'Thriller', 'Erotic thriller', 'Drama']",1990,3
386124,Barbershop,2002,['United States of America'],"['Workplace Comedy', 'Comedy', 'Ensemble Film']",2000,2
13343441,Gli Anni ruggenti,1962,['Italy'],"['Comedy', 'Black-and-white']",1960,2
8421267,The Crimson Palm,1964,['Hong Kong'],['Chinese Movies'],1960,4
2018117,Frankenfish,2004,['United States of America'],"['Action', 'Monster', 'Horror', 'Science Fiction', 'Natural horror films']",2000,4
12296652,Most High,2006,['United States of America'],"['Indie', 'Addiction Drama', 'Drama']",2000,6
6052706,Hounded,2001,['United States of America'],"['Comedy', 'Drama', 'Family Film']",2000,1
9857969,Cita en las estrellas,1949,['Argentina'],"['Romantic comedy', 'Black-and-white']",1940,9
18849328,Koondukkili,1954,['India'],[],1950,4
6804473,Way...Way Out,1966,['United States of America'],['Comedy'],1960,6
81100,Rio Bravo,1959,['United States of America'],"['Western', 'Buddy film', 'Romance Film', 'Drama']",1950,9
6277939,Cello,2005,['South Korea'],"['World cinema', 'Horror']",2000,5
21041655,Aalayamani,1962,['India'],['Drama'],1960,2
12202956,A Friend to Die For,1994,['United States of America'],"['Crime Fiction', 'Television movie', 'Drama', 'Courtroom Drama']",1990,4
224220,Space Is the Place,1974,['United States of America'],"['Musical', 'Science Fiction']",1970,4
3899153,The Steamroller and the Violin,1960,"['Russia', 'Soviet Union']","['Short Film', 'Drama', 'World cinema']",1960,0
30863163,"I Do, They Don't",2005,['United States of America'],['Family Film'],2000,5
10311825,Good Guys Wear Black,1978,['United States of America'],"['Action', 'Action Thrillers', 'Action/Adventure', 'Thriller', 'Martial Arts Film']",1970,8
20795591,Idi Katha Kaadu,1979,['India'],"['Drama', 'Family Film']",1970,9
30181744,The Flight Before Christmas,2008,"['Denmark', 'Finland', 'Germany', 'Ireland']","['Animation', ""Children's/Family"", 'Holiday Film', 'Adventure', 'Family Film']",2000,8
5898233,Yun Hota To Kya Hota,2006,['India'],"['Drama', 'World cinema']",2000,6
22227380,The Black Marble,1980,['United States of America'],"['Crime Fiction', 'Indie', 'Comedy film', 'Romance Film', 'Drama']",1980,0
13937823,Mumbai Salsa,2007,['India'],"['Musical', 'Romantic drama', 'Comedy', 'Bollywood', 'World cinema', 'Romance Film', 'Drama', 'Romantic comedy', 'Comedy-drama', 'Ensemble Film']",2000,7
17803422,Flower in the Pocket,2007,['Malaysia'],['Comedy'],2000,7
14314426,Sam Jackson's Secret Video Diary,2005,['England'],['Drama'],2000,5
10394520,No Time for Love,1943,['United States of America'],"['Black-and-white', 'Comedy', 'Romance Film', 'Romantic comedy']",1940,3
10624481,Chanthupottu,2005,['India'],"['Romance Film', 'Comedy', 'Drama']",2000,5
24964277,The Wild Party,1929,['United States of America'],"['Drama', 'Comedy']",1920,9
11744082,The Savages,2007,['United States of America'],"['Drama', 'Indie', 'Short Film', 'Comedy', 'Comedy-drama', 'Political drama']",2000,7
15033915,Sugar,2008,['United States of America'],"['Drama', 'Indie', 'World cinema', 'Sports']",2000,8
9877212,Tarzan the Tiger,1929,['United States of America'],"['Action', 'Black-and-white', 'Drama', 'Indie', 'Action/Adventure', 'Adventure', 'Silent film']",1920,9
4122339,Abandon,2002,"['United States of America', 'Australia']","['Psychological thriller', 'Suspense', 'Mystery', 'Thriller', 'Drama']",2000,2
24869271,Destiny,1977,[],"['Romance Film', 'Drama']",1970,7
6172892,Evil Brain from Outer Space,1964,['Japan'],"['Superhero movie', 'Japanese Movies']",1960,4
26654072,Rahasya Police,2009,['India'],"['Drama', 'Mystery', 'Thriller']",2000,9
16100989,Everybody Does It,1949,['United States of America'],"['Black-and-white', 'Satire', 'Comedy', 'Remake']",1940,9
2008660,Wicked City,1987,['Japan'],"['Animation', 'Japanese Movies', 'Horror', 'Anime', 'Science Fiction']",1980,7
2245072,Rock & Rule,1983,['Canada'],"['Musical', 'Animation', 'Science Fiction']",1980,3
4503816,Blue Steel,1990,['United States of America'],"['Action', 'Psychological thriller', 'Suspense', 'Action/Adventure', 'Thriller', 'Crime Thriller']",1990,0
19231927,The Clique,2008,['United States of America'],"['Film adaptation', 'Comedy', 'Teen', 'Drama']",2000,8
15614260,The Ghosts of Girlfriends Past,2009,['United States of America'],"['Comedy', 'Romance Film', 'Romantic comedy', 'Fantasy']",2000,9
13087370,The Client,1994,['United States of America'],"['Film adaptation', 'Crime Fiction', 'Mystery', 'Thriller', 'Crime Thriller', 'Drama', 'Courtroom Drama', 'Suspense']",1990,4
8055976,Miami Rhapsody,1995,['United States of America'],"['Comedy', 'Comedy of manners', 'Romance Film', 'Romantic comedy']",1990,5
8493002,Spellbinder,1988,['United States of America'],"['Suspense', 'Mystery', 'Indie', 'Thriller', 'Horror', 'Supernatural']",1980,8
24196090,The World of Geisha,1973,['Japan'],"['Erotic Drama', 'Romantic drama', 'World cinema', 'Romance Film', 'Drama', 'Period piece', 'Japanese Movies', 'Pornographic movie', 'Erotica']",1970,3
930894,Lovin' Molly,1974,['United States of America'],"['Romance Film', 'Romantic drama', 'Drama']",1970,4
2535395,Beyond the Rainbow,1922,['United States of America'],"['Black-and-white', 'Drama', 'Indie', 'Silent film']",1920,2
22645080,Jesus is a Palestinian,1999,['Netherlands'],['Comedy'],1990,9
2071080,Cannonball,1976,"['Hong Kong', 'United States of America']","['Action', 'Crime Fiction', 'Action/Adventure', 'Comedy', 'Thriller', 'Auto racing', 'Chinese Movies', 'Drama', 'Sports']",1970,6
1962192,Poetic Justice,1993,['United States of America'],"['Romantic drama', 'Romance Film', 'Road movie', 'Drama']",1990,3
12782772,Silk Stockings,1957,['United States of America'],"['Musical', 'Romance Film', 'Comedy']",1950,7
6025381,Anamika,1973,['India'],"['Romantic drama', 'World cinema', 'Romance Film', 'Drama']",1970,3
10539303,Heidi,1937,['United States of America'],"['Black-and-white', 'Family Drama', 'Drama', 'Family Film']",1930,7
8995246,The Stupid Cupid,1944,['United States of America'],"['Animation', 'Short Film', 'Comedy film', 'Family Film']",1940,4
7014201,Ernest Goes to School,1994,['United States of America'],"['Slapstick', 'Comedy', 'Family Film']",1990,4
7153837,Puppet Master 4,1993,['United States of America'],['Horror'],1990,3
6458885,Conspirators of Pleasure,1996,"['Switzerland', 'United Kingdom', 'England', 'Czech Republic']","['Surrealism', 'Animation', 'Comedy', 'Avant-garde', 'Black comedy', 'Experimental film', 'Stop motion', 'Sex comedy']",1990,6
14865130,Private Fears in Public Places,2006,"['France', 'Italy']","['Romantic drama', 'World cinema', 'Romance Film', 'Drama']",2000,6
21777123,Mass Appeal,1984,['United States of America'],"['Comedy-drama', 'Comedy', 'Drama']",1980,4
27098,Star Trek II: The Wrath of Khan,1982,['United States of America'],"['Action', 'Thriller', 'Adventure', 'Science Fiction', 'Family Film']",1980,2
3754545,Wedding Campaign,2005,['South Korea'],"['Drama', 'Comedy']",2000,5
668614,Cats Don't Dance,1997,['United States of America'],"['Music', 'Musical', 'Animation', 'Animated Musical', 'Comedy', ""Children's/Family"", ""Children's"", 'Family Film', 'Fantasy']",1990,7
18269587,Bad Day on the Block,1997,['United States of America'],"['Action', 'Psychological thriller', 'Crime Fiction', 'Action/Adventure', 'Thriller', 'Crime Thriller', 'Drama']",1990,7
32874167,The Highest Honor,1983,[],"['War film', 'Drama']",1980,3
32789431,The Color of Lies,1999,['France'],"['Crime Fiction', 'Mystery', 'Crime Drama', 'Drama']",1990,9
6094307,The 5th Monkey,1990,['United States of America'],"['Romantic comedy', 'Adventure', 'Drama']",1990,0
10931728,Carnival in Costa Rica,1947,['United States of America'],['Musical'],1940,7
26445863,A Touch of Love,1969,['United Kingdom'],['Drama'],1960,9
23240836,Raffles,1925,['United States of America'],"['Black-and-white', 'Crime Fiction', 'Silent film', 'Romance Film', 'Adventure']",1920,5
2869016,Task Force,1949,['United States of America'],['Black-and-white'],1940,9
2229575,Carbine Williams,1952,['United States of America'],"['Prison', 'Biographical film', 'Biopic [feature]', 'Drama']",1950,2
2349353,Yahaan,2004,['India'],"['Romantic drama', 'World cinema', 'Romance Film', 'Drama']",2000,4
14543900,Raju Chacha,2000,['India'],"['Drama', 'Comedy']",2000,0
18002657,Rajavinte Makan,1986,['India'],"['Action', 'Drama', 'Crime Fiction', 'Thriller']",1980,6
2411131,Men at Work,1990,['United States of America'],"['Action', 'Action/Adventure', 'Comedy', 'Thriller']",1990,0
12293793,The Party Never Stops: Diary of a Binge Drinker,2007,"['Canada', 'United States of America']",['Drama'],2000,7
12003,Godzilla vs. Mothra,1992,['Japan'],"['Japanese Movies', 'Monster', 'Science Fiction', 'Fantasy']",1990,2
35281429,Kavalukku Kettikaran,1990,['India'],[],1990,0
9104365,Our Vines Have Tender Grapes,1945,['United States of America'],"['Family Drama', 'Drama', 'Family Film']",1940,5
2305752,The Players Club,1998,['United States of America'],"['Comedy-drama', 'Comedy', 'Drama']",1990,8
1599864,The Upside of Anger,2005,"['United Kingdom', 'Germany', 'United States of America']","['Family Drama', 'Romantic drama', 'Comedy', 'Romance Film', 'Romantic comedy', 'Comedy-drama', 'Drama']",2000,5
19015856,Purani Haveli,1989,['India'],"['Musical', 'Mystery', 'Comedy', 'Thriller', 'Bollywood', 'World cinema', 'Drama', 'Horror']",1980,9
21788853,Lila,1968,['United States of America'],"['Sexploitation', 'Slasher', 'Teen', 'Horror', 'B-movie']",1960,8
3692685,Hammers Over the Anvil,1993,['Australia'],"['Film adaptation', 'Indie', 'Biographical film', 'World cinema', 'Romance Film', 'Drama', 'Period piece', 'Coming of age']",1990,3
14881515,Legend of Seven Monks,2006,['Japan'],"['Japanese Movies', 'Action/Adventure', 'World cinema', 'Martial Arts Film']",2000,6
13466352,The Juggler,1953,['United States of America'],['Drama'],1950,3
602789,The Nanny,1965,['United Kingdom'],"['Psychological thriller', 'Black-and-white', 'Psycho-biddy', 'Thriller', 'Horror', 'Drama']",1960,5
5060456,Dahmer,2002,['United States of America'],"['Crime Fiction', 'LGBT', 'Mystery', 'Biography', 'Indie', 'Biographical film', 'Thriller', 'Drama', 'Slasher', 'Biopic [feature]', 'Horror', 'Cult']",2000,2
27853742,Fists of Bruce Lee,1978,"['Hong Kong', 'Taiwan']","['Action', 'Action/Adventure', 'World cinema', 'Chinese Movies', 'Martial Arts Film', 'Drama']",1970,8
3030276,The Spook Who Sat By The Door,1973,['United States of America'],"['Action', 'Spy', 'Blaxploitation', 'Film adaptation', 'Crime Fiction', 'Action/Adventure', 'Thriller', 'Drama', 'Political drama']",1970,3
13889076,"Jeanne Dielman 23, quai du Commerce, 1080 Bruxelles",1975,"['France', 'Belgium']","['Art film', 'Drama', 'World cinema']",1970,5
5209597,The Terminal Man,1974,['United States of America'],"['Science Fiction', 'Thriller', 'Horror', 'Sci-Fi Horror']",1970,4
5276483,Le Beau Mariage,1982,['France'],"['Romance Film', 'Comedy', 'Drama']",1980,2
21579836,Yanda Kartavya Aahe,2006,['India'],"['Musical', 'Bollywood', 'World cinema']",2000,6
16366225,"I, the Other",2006,['Italy'],['Drama'],2000,6
35104864,Missing You...,2008,['Singapore'],"['Romance Film', 'Drama']",2000,8
22142761,Physical Evidence,1989,['United States of America'],"['Crime Fiction', 'Thriller', 'Drama', 'Courtroom Drama']",1980,9
12767936,Zwei Menschen,1930,['Germany'],['Drama'],1930,0
9013587,Sukiyaki Western: Django,2007,['Japan'],"['Action', 'Japanese Movies', 'Action/Adventure', 'Western', 'Thriller', 'Comedy', 'World cinema']",2000,7
15762321,Seven Pounds,2008,['United States of America'],"['Romance Film', 'Romantic drama', 'Drama']",2000,8
2563741,All Night Long,1961,['United Kingdom'],"['Black-and-white', 'Drama']",1960,1
28469376,The Edifying and Joyous Story of Colinot,1973,['France'],['Comedy film'],1970,3
14186757,That Forsyte Woman,1949,['United States of America'],"['Romantic drama', 'Marriage Drama', 'Romance Film', 'Drama']",1940,9
16907195,The Italian Job,1969,['United Kingdom'],"['Action', 'Heist', 'Crime Fiction', 'Action/Adventure', 'Comedy', 'Thriller', 'Crime Thriller']",1960,9
29450013,Mickey's Explorers,1930,['United States of America'],['Short Film'],1930,0
7055037,Fukkatsu no hi,1980,['Japan'],"['Doomsday film', 'Japanese Movies', 'Action/Adventure', 'World cinema', 'Disaster', 'Science Fiction']",1980,0
28226296,Empty Cradle,1993,['United States of America'],['Drama'],1990,3
404122,Pirates of Silicon Valley,1999,['United States of America'],"['Film adaptation', 'Biography', 'Biopic [feature]', 'Docudrama', 'Television movie', 'Drama']",1990,9
5111225,Shining Victory,1941,['United States of America'],"['Black-and-white', 'Romance Film', 'Melodrama', 'Drama']",1940,1
18050595,We Live Again,1934,['United States of America'],['Drama'],1930,4
11141646,Vetri Vizha,1985,['India'],"['Action', 'Drama']",1980,5
11467786,Return of Sabata,1972,['Italy'],"['Action', 'Action/Adventure', 'Western', 'World cinema', 'Spaghetti Western']",1970,2
25011242,Diamond Horseshoe,1945,['United States of America'],"['Musical', 'Musical comedy']",1940,5
3686795,Supertwink,2006,['United States of America'],"['Indie', 'Short Film']",2000,6
5936011,Mogudu Pellam O Dongodu,2005,['India'],"['Romantic drama', 'Comedy', 'World cinema', 'Romance Film', 'Romantic comedy', 'Drama']",2000,5
9220529,The Great Moment,1921,['United States of America'],"['Black-and-white', 'Drama', 'Indie', 'Silent film']",1920,1
23779787,The Long Shot,2004,['United States of America'],"['Television movie', 'Sports', 'Drama']",2000,4
25847709,Tora-san's Dear Old Home,1972,['Japan'],['Japanese Movies'],1970,2
1604763,The Ballad of Jack and Rose,2005,['United States of America'],"['Indie', 'Drama']",2000,5
8408239,Man Hunt,1984,['Italy'],"['Action', 'Drama', 'Action/Adventure', 'Western', 'World cinema']",1980,4
3595559,Real Fiction,2000,['South Korea'],"['Crime Fiction', 'Thriller', 'World cinema', 'Crime Thriller', 'Drama']",2000,0
32508075,Virgin Island,1958,['United Kingdom'],"['Adventure', 'Drama']",1950,8
2145582,A Stolen Life,1946,['United States of America'],"['Crime Drama', 'Drama']",1940,6
33447219,Dana Paani,1989,['India'],"['Action', 'Crime Fiction', 'Drama']",1980,9
1365691,"Captain Newman, M.D.",1963,['United States of America'],"['Comedy', 'Comedy-drama', 'War film', 'Drama']",1960,3
32809321,The Mississippi Gambler,1953,['United States of America'],"['Action', 'Romance Film', 'Adventure']",1950,3
23777614,Three Colors: Red,1994,"['France', 'Poland', 'Switzerland']","['Romantic drama', 'World cinema', 'Romance Film', 'Drama']",1990,4
4710606,Smooth Talk,1985,"['United Kingdom', 'United States of America']","['Drama', 'Crime Fiction', 'Coming of age', 'Romantic drama', 'Indie', 'Romance Film']",1980,5
7211042,Betty Boop's Ker-Choo,1933,['United States of America'],"['Animation', 'Short Film', 'Comedy', 'Family Film']",1930,3
15395979,"Bianco, rosso e Verdone",1981,['Italy'],['Comedy'],1980,1
18699640,The Halliday Brand,1957,['United States of America'],"['Black-and-white', 'Western', 'Drama']",1950,7
950274,Hey Arnold!: The Movie,2002,['United States of America'],"[""Children's"", 'Animation']",2000,2
13814145,The Amati Girls,2001,['United States of America'],"['Family Drama', 'Drama']",2000,1
4398217,Frederic Remington: The Truth of Other Days,1991,['United States of America'],['Documentary'],1990,1
4521534,Roja,1992,['India'],"['Crime Fiction', 'Thriller', 'Bollywood', 'World cinema', 'Romance Film', 'Adventure', 'Drama']",1990,2
10344059,Paradise Murdered,2007,['South Korea'],"['Mystery', 'Thriller']",2000,7
15205423,Romance of Their Own,2004,['South Korea'],"['Action', 'Romance Film', 'Drama']",2000,4
5859582,Killer Tomatoes Strike Back,1990,['United States of America'],"['Parody', 'Comedy', 'Horror Comedy', 'Horror', 'B-movie', 'Science Fiction']",1990,0
7329519,West Bank Story,2005,['United States of America'],"['Musical', 'Indie', 'Parody', 'Short Film', 'Satire', 'Musical comedy', 'Comedy']",2000,5
979825,Babette's Feast,1987,['Denmark'],"['Music', 'Period piece', 'Family Drama', 'World cinema', 'Romance Film', 'Christian film', 'Drama']",1980,7
18726173,Silver Bears,1978,"['United Kingdom', 'United States of America']","['Comedy', 'Crime Comedy', 'Ensemble Film']",1970,8
2010907,Blood and Black Lace,1964,"['Monaco', 'France', 'West Germany', 'Italy']","['Psychological thriller', 'Giallo', 'Slasher', 'Thriller', 'Horror', 'World cinema']",1960,4
32608557,Buster's Bedroom,1990,"['Canada', 'Germany']",['Comedy film'],1990,0
9117823,Up in Flames,1973,['United States of America'],['Pornographic movie'],1970,3
20786,Mulholland Drive,2001,"['France', 'United States of America']","['Surrealism', 'Psychological thriller', 'Neo-noir', 'LGBT', 'Crime Fiction', 'Mystery', 'Indie', 'Thriller', 'Crime Thriller', 'Drama', 'Erotic thriller']",2000,1
7003785,Cadillac Man,1990,['United States of America'],"['Crime Fiction', 'Comedy', 'Crime Comedy', 'Comedy of manners', 'Black comedy', 'Comedy-drama', 'Drama']",1990,0
1987419,Poochakkoru Mookkuthi,1984,['India'],['Screwball comedy'],1980,4
12360053,Mammo,1994,['India'],"['Drama', 'Art film']",1990,4
5388037,Scenes Of The Crime,2001,"['Germany', 'United States of America']","['Crime Fiction', 'Thriller', 'Crime Thriller', 'Drama']",2000,1
8678850,La Casa 5,1990,['Italy'],['Horror'],1990,0
27365029,Face of a Fugitive,1959,['United States of America'],['Western'],1950,9
1144915,Delgo,2007,['United States of America'],"[""Children's Fantasy"", 'Animation', 'Indie', 'Fantasy', 'Adventure', 'Family Film', 'Computer Animation']",2000,7
3484353,Stephen Tobolowsky's Birthday Party,2005,['United States of America'],"['Film & Television History', 'Indie', 'Biography', 'Documentary', 'Film']",2000,5
4563943,Bartok the Magnificent,1999,['United States of America'],"['Music', 'Animation', 'Animated Musical', 'Buddy film', ""Children's/Family"", ""Children's"", 'Adventure', ""Children's Fantasy"", 'Family Film', 'Fantasy']",1990,9
23563063,Rosa Luxemburg,1986,['Germany'],"['Drama', 'Political drama', 'Biopic [feature]']",1980,6
21132938,The Square,2008,"['New Zealand', 'Australia', 'United States of America']","['Indie', 'Thriller', 'World cinema', 'Crime Thriller', 'Drama']",2000,8
13291318,Bujjigadu,2008,['India'],[],2000,8
4535667,Tarzan Goes to India,1962,"['United Kingdom', 'Switzerland', 'United States of America']","['Action', 'Adventure', 'Jungle Film']",1960,2
12755419,Self Medicated,2007,['United States of America'],"['Indie', 'Drama']",2000,7
2542052,Rings,2005,['United States of America'],"['Short Film', 'Horror']",2000,5
29243700,Dad and Dave: On Our Selection,1995,['Australia'],['Comedy'],1990,5
5538370,The Sinister Urge,1961,['United States of America'],"['Psychological thriller', 'Black-and-white', 'Crime Fiction', 'Horror', 'Crime Drama', 'Drama']",1960,1
25786322,Play Girl,1941,['United States of America'],['Romantic comedy'],1940,1
5578994,The Package,1989,['United States of America'],"['Action', 'Action/Adventure', 'Thriller', 'Drama', 'Period piece', 'Suspense', 'Political drama', 'Political thriller']",1980,9
25845043,It's Tough Being a Man,1969,['Japan'],['Japanese Movies'],1960,9
20695179,Barefoot Ki-bong,2006,['South Korea'],"['Comedy', 'Comedy film', 'Drama', 'Family Film']",2000,6
9113966,Buscando a Mónica,1962,"['Argentina', 'Spain']","['Musical', 'Drama']",1960,2
29647426,Love Bites,1993,['United States of America'],"['Romance Film', 'Romantic comedy', 'Comedy']",1990,3
35762859,Pop Class,2009,['Philippines'],['Drama'],2000,9
4589205,Andromedia,1998,['Japan'],"['Japanese Movies', 'Action/Adventure', 'Science Fiction', 'World cinema']",1990,8
80499,The Yearling,1946,['United States of America'],"['Coming of age', 'Family Drama', 'Drama', 'Family Film']",1940,6
33486701,Intimate Strangers,1977,['United States of America'],"['Romantic drama', 'Romance Film', 'Television movie', 'Drama']",1970,7
24520513,Trancers 4: Jack of Swords,1994,['United States of America'],['Time travel'],1990,4
9900396,Executioners,1993,['Hong Kong'],"['Action', 'Action/Adventure', 'World cinema', 'Superhero movie', 'Chinese Movies', 'Martial Arts Film']",1990,3
1941591,Gorky Park,1983,['United States of America'],"['Detective fiction', 'Crime Fiction', 'Mystery', 'Thriller', 'Crime Thriller', 'Drama', 'Detective', 'Political drama', 'Political thriller']",1980,3
4869325,The Sheriff and the Satellite Kid,1979,['Italy'],"['Action/Adventure', 'Western', 'Comedy', 'World cinema', 'Hybrid Western', 'Adventure', 'Science Fiction']",1970,9
29127721,Kalyana Sougandhikam,1996,[],"['Romance Film', 'Drama', 'Comedy film']",1990,6
2713808,The Unholy Wife,1957,['United States of America'],"['Crime Fiction', 'Thriller', 'Film noir', 'Drama']",1950,7
10709972,Kill Buljo,2007,['Norway'],"['Action', 'Martial Arts Film', 'Parody', 'Action Comedy', 'Action/Adventure', 'Comedy', 'World cinema']",2000,7
5498919,The Second Jungle Book: Mowgli & Baloo,1997,[],"['Adventure', 'Family Film']",1990,7
6858830,Captivity,2007,"['Russia', 'United States of America']","['Psychological thriller', 'Indie', 'Slasher', 'Thriller', 'Horror']",2000,7
2384827,Blood and Bones,2004,['Japan'],"['Period piece', 'Japanese Movies', 'Family Drama', 'World cinema', 'Crime Drama', 'Drama']",2000,4
9422795,Parrish,1961,['United States of America'],"['Romantic drama', 'Family Drama', 'Romance Film', 'Drama']",1960,1
2293612,The Tingler,1959,['United States of America'],"['Creature Film', 'Thriller', 'Horror']",1950,9
4913527,The Hills Have Eyes 2,2007,['United States of America'],"['Slasher', 'Thriller', 'Horror']",2000,7
11544253,Section spéciale,1975,"['France', 'Germany', 'Italy']","['Thriller', 'World cinema', 'Political drama', 'Drama']",1970,5
5664103,Recess Christmas: Miracle on Third Street,2001,['United States of America'],"['Family Film', 'Animation']",2000,1
2646805,Arabian Nights,2000,['United States of America'],"['Adventure', 'Family Film', 'Fantasy']",2000,0
18724476,The Reading Room,2005,['United States of America'],"['Melodrama', 'Television movie', 'Drama']",2000,5
74966,Morocco,1930,['United States of America'],"['Romance Film', 'LGBT', 'Drama']",1930,0
8432450,The Mist,2007,['United States of America'],"['Suspense', 'Film adaptation', 'Thriller', 'Horror', 'Science Fiction']",2000,7
18940234,The Yellow Balloon,1953,['United Kingdom'],"['Crime Fiction', 'Thriller', 'Crime Thriller', 'Adventure']",1950,3
71975,Hellraiser,1987,['United Kingdom'],"['Monster movie', 'Slasher', 'Thriller', 'Horror', 'Supernatural', 'Cult']",1980,7
27908690,High Society,1955,['United States of America'],['Comedy film'],1950,5
15416641,Megha,1996,['India'],['Romance Film'],1990,6
1620539,Money Talks,1997,['United States of America'],"['Action', 'Heist', 'Action/Adventure', 'Buddy film', 'Comedy']",1990,7
4278011,Brotherhood of Blood,2007,"['Germany', 'United States of America']","['Creature Film', 'Cult', 'Horror']",2000,7
76631,Will Success Spoil Rock Hunter?,1957,['United States of America'],"['Workplace Comedy', 'Parody', 'Comedy', 'Media Satire', 'Romantic comedy', 'Romance Film']",1950,7
701775,Fluke,1995,['United States of America'],"[""Children's Fantasy"", 'Family Drama', 'Fantasy', 'Animal Picture', ""Children's/Family"", 'Drama', 'Family Film']",1990,5
1011468,We Were Soldiers,2002,"['Germany', 'United States of America']","['Action', 'Combat Films', 'History', 'Action/Adventure', 'War film', 'Drama']",2000,2
1184652,The War Lover,1962,"['United Kingdom', 'United States of America']","['Film adaptation', 'Romantic drama', 'Romance Film', 'War film', 'Drama']",1960,2
4003719,Toys in the Attic,1963,['United States of America'],"['Melodrama', 'Drama']",1960,3
23315198,Drishti,1991,['India'],"['Art film', 'World cinema']",1990,1
1563060,Pump Up the Volume,1990,"['Canada', 'United States of America']","['Coming of age', 'Comedy', 'Teen', 'Comedy-drama', 'Drama']",1990,0
4762435,Orchestra Wives,1942,['United States of America'],"['Musical', 'Backstage Musical', 'Romantic drama', 'Musical Drama', 'Romance Film', 'Drama']",1940,2
25516824,Rosa Blanca,1961,[],"['Thriller', 'Drama']",1960,1
21945570,Tokyo Sonata,2008,['Japan'],"['Japanese Movies', 'Family Drama', 'World cinema', 'Drama']",2000,8
13024213,Fire Down Below,1957,"['United Kingdom', 'United States of America']","['Action', 'Drama', 'Action/Adventure', 'Adventure', 'Romance Film']",1950,7
6473343,One Hot Summer Night,1998,['United States of America'],"['Drama', 'Crime Fiction']",1990,8
8267711,Perils of Nyoka,1942,['United States of America'],"['Action', 'Black-and-white', 'Movie serial', 'Adventure']",1940,2
18717177,Shrek,2001,"['Canada', 'United States of America']","['Animation', 'Comedy', ""Children's/Family"", 'Costume drama', 'Adventure', 'Computer Animation', 'Fairy tale', ""Children's Fantasy"", 'Parody', 'Fantasy Comedy', 'Family Film', 'Fantasy']",2000,1
26161289,Rechukka,1954,['India'],['Drama'],1950,4
32655855,The Silence of Dean Maitland,1934,[],['Drama'],1930,4
14320073,That Certain Woman,1937,['United States of America'],"['Black-and-white', 'Romantic drama', 'Romance Film', 'Melodrama', 'Drama']",1930,7
15294037,Naked Blood,1996,['Japan'],"['Japanese Movies', 'World cinema', 'Horror']",1990,6
9381735,Kanda Naal Mudhal,2005,['India'],"['Romance Film', 'Romantic comedy', 'Comedy']",2000,5
18848055,Die Feuerzangenbowle,1944,['Germany'],['Black-and-white'],1940,4
12138831,Grizzly Park,2008,['United States of America'],"['Natural horror films', 'Slasher', 'Horror']",2000,8
28740295,Rowing with the Wind,1988,['Spain'],"['Mystery', 'Romantic drama', 'Thriller', 'World cinema', 'Romance Film', 'Drama', 'Period piece', 'Biopic [feature]', 'Supernatural']",1980,8
1688219,Hangar 18,1980,['United States of America'],"['Mystery', 'Thriller', 'Science Fiction', 'Drama']",1980,0
858575,Harry Potter and the Half-Blood Prince,2009,"['United Kingdom', 'United States of America']","['Action', 'Fantasy Adventure', 'Mystery', 'Romance Film', ""Children's/Family"", 'Adventure', ""Children's Fantasy"", 'Family Film', 'Fantasy']",2000,9
12134356,Garfield Gets Real,2007,['United States of America'],"[""Children's/Family"", 'Family Film', 'Computer Animation']",2000,7
1651639,Siberiade,1979,"['Russia', 'Soviet Union']","['Art film', 'World cinema', 'War film', 'Drama']",1970,9
993024,The Return,2003,['Russia'],"['Drama', 'World cinema']",2000,3
75268,The Ox-Bow Incident,1943,['United States of America'],"['Action', 'Film adaptation', 'Black-and-white', 'Action/Adventure', 'Western', 'Drama']",1940,3
2321878,Violent Shit,1987,['Germany'],['Horror'],1980,7
3246234,Big Jim McLain,1952,['United States of America'],"['Action', 'Spy', 'Action/Adventure', 'Thriller', 'Drama', 'Political thriller']",1950,2
10801336,Home from the Hill,1960,['United States of America'],"['Romance Film', 'Family Drama', 'Drama']",1960,0
14144221,Girlfriends,1978,['United States of America'],"['Comedy-drama', 'Indie', 'Drama']",1970,8
20931537,The House Behind the Cedars,1927,['United States of America'],"['Silent film', 'Drama']",1920,7
58865,Wall Street,1987,['United States of America'],"['Drama', 'Crime Fiction']",1980,7
10614972,Hum Dono,1961,['India'],"['Romantic drama', 'Bollywood', 'World cinema', 'Romance Film', 'War film', 'Drama']",1960,1
8819339,Robinson Crusoe,1954,"['Mexico', 'United States of America']","['Film adaptation', 'Action/Adventure', 'World cinema', 'Adventure', 'Drama']",1950,4
5457037,Betrayed,1988,"['Japan', 'United States of America']","['Suspense', 'Crime Fiction', 'Japanese Movies', 'Thriller', 'Crime Thriller', 'Drama', 'Political thriller']",1980,8
5208783,Dhool,2003,['India'],"['Action', 'Musical', 'World cinema', 'Tamil cinema', 'Drama', 'Family Film']",2000,3
10932345,Broken Oath,1977,['Hong Kong'],"['Chinese Movies', 'Martial Arts Film']",1970,7
12171288,White Cargo,1942,['United States of America'],"['Black-and-white', 'Drama']",1940,2
23767847,Cheburashka Goes to School,1983,['Soviet Union'],"['Short Film', 'Animation']",1980,3
14556686,Musty Musketeers,1954,['United States of America'],"['Short Film', 'Black-and-white', 'Comedy']",1950,4
8009696,"Fort Apache, The Bronx",1981,['United States of America'],"['Action', 'Drama', 'Crime Fiction', 'Docudrama']",1980,1
15823843,Fleisch,1979,['Germany'],"['Thriller', 'Horror']",1970,9
822146,The Wicked Lady,1945,['United Kingdom'],"['Swashbuckler films', 'Black-and-white']",1940,5
25207368,Kaidan,2007,['Japan'],"['Psychological thriller', 'Japanese Movies', 'Thriller', 'World cinema', 'Horror', 'Supernatural']",2000,7
28992417,The Girl from Rio,1969,"['Spain', 'West Germany', 'United States of America']","['Action', 'LGBT', 'Action/Adventure', 'Thriller', 'Adventure', 'Science Fiction']",1960,9
3654163,La commare secca,1962,['Italy'],"['Black-and-white', 'Crime Fiction', 'Art film', 'Mystery', 'Thriller', 'World cinema', 'Crime Thriller', 'Drama', 'Crime Drama']",1960,2
1396988,Jezebel,1938,['United States of America'],"['Romance Film', 'Black-and-white', 'Drama']",1930,8
3961314,Khamosh Pani,2004,"['India', 'France', 'Pakistan', 'Germany']","['Family Drama', 'World cinema', 'Political drama', 'Drama']",2000,4
24577034,The Fire Brigade,1926,[],['Silent film'],1920,6
2018791,The Girl Can't Help It,1956,['United States of America'],"['Musical', 'Crime Fiction', 'Comedy', 'Crime Comedy']",1950,6
5476641,X-Paroni,1964,['Finland'],['Comedy'],1960,4
15033706,Phoebe in Wonderland,2009,['United States of America'],"['Drama', 'Indie', 'Childhood Drama', 'Fantasy']",2000,9
7167797,"Synecdoche, New York",2008,['United States of America'],"['Drama', 'Indie', 'Comedy', 'Comedy-drama']",2000,8
9432295,Den ofrivillige golfaren,1991,['Sweden'],['Comedy'],1990,1
11384089,Major Movie Star,2008,['United States of America'],"['Action', 'Action/Adventure', 'Comedy']",2000,8
18328543,Ten Dead Men,2008,['United Kingdom'],"['Action', 'Crime Fiction', 'Indie', 'Action/Adventure', 'Thriller', 'Crime Thriller', 'Martial Arts Film']",2000,8
11693369,The Story of Esther Costello,1957,"['United Kingdom', 'United States of America']","['Black-and-white', 'Melodrama', 'Drama']",1950,7
17634336,The Haunting of Molly Hartley,2008,['United States of America'],"['Psychological thriller', 'Thriller', 'Horror', 'Teen', 'Drama']",2000,8
18822660,Art of the Devil 3,2008,['Thailand'],"['Horror', 'Supernatural', 'World cinema']",2000,8
8432968,"Why Me, Sweetie?!",2003,['Hong Kong'],"['Romantic drama', 'Comedy', 'World cinema', 'Romance Film', 'Romantic comedy', 'Chinese Movies', 'Drama']",2000,3
33424996,Unforgettable Life,1988,[],['Drama'],1980,8
5330837,Trojan Warrior,2002,['Australia'],"['Action', 'Crime Fiction', 'Action/Adventure', 'Comedy', 'Martial Arts Film']",2000,2
12545744,Darkman II: The Return of Durant,1995,['United States of America'],"['Action', 'Crime Fiction', 'Action/Adventure', 'Thriller', 'Superhero movie', 'Science Fiction']",1990,5
12013299,Miracle on 1st Street,2007,['South Korea'],"['Gangster Film', 'Comedy', 'Crime Comedy', 'Comedy-drama', 'Drama']",2000,7
24929092,Boogie,2009,['Argentina'],"['Action', 'Crime Fiction', 'Animation']",2000,9
10354167,The Terror Within,1989,['United States of America'],"['Action/Adventure', 'Disaster', 'Sci-Fi Horror', 'Creature Film', 'Monster movie', 'Horror', 'B-movie', 'Science Fiction']",1980,9
20525737,Garfield's Pet Force,2009,['United States of America'],"['Animation', 'Comedy', ""Children's/Family"", 'Family Film', 'Computer Animation']",2000,9
4541150,Dead & Breakfast,2004,['United States of America'],"['Creature Film', 'Comedy', 'Horror Comedy', 'Horror', 'Black comedy', 'Zombie Film']",2000,4
16898172,Walking Tall: Final Chapter,1977,['United States of America'],"['Action', 'Crime Fiction', 'Action/Adventure', 'Thriller', 'Crime Thriller', 'Drama']",1970,7
17454217,Landscape in the Mist,1988,"['France', 'Italy', 'Greece']","['Art film', 'Childhood Drama', 'World cinema', 'Road movie', 'Drama']",1980,8
3267959,Sólo con tu pareja,1991,['Mexico'],"['Romantic drama', 'Comedy', 'World cinema', 'Romance Film', 'Romantic comedy', 'Drama']",1990,1
2608296,All for the Winner,1990,['Hong Kong'],"['Action', 'Action/Adventure', 'Comedy', 'World cinema', 'Chinese Movies', 'Martial Arts Film', 'Parody', 'Crime Comedy']",1990,0
11158178,Fly Me to the Moon,2008,['Belgium'],"['Computer Animation', 'Animation', 'Comedy', 'World cinema', 'Fantasy', 'Adventure', 'Family Film']",2000,8
7432079,The North Avenue Irregulars,1979,['United States of America'],"['Crime Fiction', 'Mystery', 'Comedy', 'Crime Comedy', 'Family Film']",1970,9
21379138,Elvira Madigan,1967,['Sweden'],"['History', 'Romantic drama', 'World cinema', 'Romance Film', 'Drama']",1960,7
17552066,Tarzan and the Great River,1967,"['Switzerland', 'United States of America']","['Adventure', 'Jungle Film']",1960,7
1091175,The Guru,2002,"['United Kingdom', 'France', 'United States of America']","['Music', 'Comedy', 'Romance Film', 'Romantic comedy', 'Fantasy']",2000,2
21439313,Thambikku Indha Ooru,2009,"['India', 'Sri Lanka']",['Drama'],2000,9
5398963,Little Monsters,1989,['United States of America'],"['Indie', 'Comedy', ""Children's/Family"", 'Creature Film', ""Children's Fantasy"", 'Fantasy Comedy', 'Family Film', 'Fantasy']",1980,9
314406,Bring Me the Head of Alfredo Garcia,1974,"['Mexico', 'United States of America']","['Action', 'Crime Fiction', 'Action Thrillers', 'Revisionist Western', 'Action/Adventure', 'Comedy', 'Thriller', 'Black comedy', 'Adventure', 'Drama', 'Road movie']",1970,4
4084601,The Trial,1963,"['France', 'Germany', 'Italy']","['Surrealism', 'Courtroom Drama', 'Film adaptation', 'Black-and-white', 'Drama', 'Indie']",1960,3
5020340,Jewel Thief,1967,['India'],"['Musical', 'Thriller', 'Bollywood', 'World cinema']",1960,7
10536985,Hugo Pool,1997,['United States of America'],"['Indie', 'Comedy', 'Romance Film', 'Drama', 'Romantic comedy', 'Comedy-drama', 'Cult', 'Ensemble Film']",1990,7
5016035,Why Worry?,1923,['United States of America'],"['Adventure Comedy', 'Black-and-white', 'Indie', 'Comedy', 'Silent film', 'Slapstick']",1920,3
30906682,Black Gunn,1972,['United States of America'],"['Action', 'Blaxploitation', 'Drama', 'Crime Fiction', 'Action/Adventure']",1970,2
11120865,Butterfly and Sword,1993,['Hong Kong'],"['Action/Adventure', 'World cinema', 'Wuxia', 'Chinese Movies', 'Martial Arts Film']",1990,3
5137345,Ninja III: The Domination,1984,['United States of America'],"['Action', 'Indie', 'Martial Arts Film']",1980,4
14059068,Rebel High,1987,['Canada'],"['Comedy', 'Satire']",1980,7
21646685,Twisted,1986,['United States of America'],"['Psychological thriller', 'Thriller', 'Horror']",1980,6
214331,Morgan: A Suitable Case for Treatment,1966,['United Kingdom'],"['Political cinema', 'Black-and-white', 'Parody', 'Comedy', 'Drama']",1960,6
37599,Traffic,2001,['United States of America'],"['Crime Fiction', 'Gangster Film', 'Thriller', 'Crime Thriller', 'Political drama', 'Drama']",2000,1
6117263,Kushi,2001,['India'],"['Action', 'Romance Film', 'Drama']",2000,1
92605,12 Angry Men,1957,['United States of America'],['Drama'],1950,7
14000171,House of Fury,2005,['Hong Kong'],"['Action', 'Action/Adventure', 'Comedy', 'World cinema', 'Chinese Movies', 'Martial Arts Film']",2000,5
3822650,Fellini's Casanova,1976,['Italy'],"['Historical drama', 'Biographical film', 'World cinema', 'Romance Film', 'Drama']",1970,6
21237721,Invasion of the Pod People,2007,['United States of America'],"['Indie', 'Thriller', 'Horror', 'B-movie', 'Alien Film', 'Science Fiction']",2000,7
4133698,When a Stranger Calls Back,1993,['United States of America'],"['Crime Fiction', 'Slasher', 'Thriller', 'Horror', 'Melodrama', 'Drama']",1990,3
16704261,Crazy Cruise,1942,['United States of America'],"['Short Film', 'Comedy', 'Family Film']",1940,2
12437827,Case Closed: The Fourteenth Target,1998,['Japan'],"['Action', 'Animation', 'Japanese Movies', 'Anime']",1990,8
10538836,Forest of the damned,2005,['United Kingdom'],"['Horror', 'Zombie Film']",2000,5
3781791,Johnny O'Clock,1947,['United States of America'],"['Black-and-white', 'Crime Fiction', 'Thriller', 'Film noir', 'Crime Thriller', 'Drama']",1940,7
12032423,In the Valley of Elah,2007,['United States of America'],"['Crime Fiction', 'Mystery', 'Thriller', 'Crime Thriller', 'War film', 'Drama']",2000,7
15150205,The Pretender,1947,['United States of America'],"['Black-and-white', 'Crime Fiction', 'Thriller', 'Film noir', 'Therimin music', 'Drama']",1940,7
17477023,A Self Made Hero,1996,['France'],"['Drama', 'Comedy']",1990,6
26392265,Ciao,2007,['United States of America'],"['Indie', 'LGBT']",2000,7
2045037,Time Changer,2002,['United States of America'],"['Adventure', 'Christian film', 'Science Fiction', 'Drama', 'Family Film']",2000,2
7749570,Punnami Naagu,1980,['India'],"['Drama', 'Family Film']",1980,0
2120494,"Godzilla, King of the Monsters!",1956,"['Japan', 'United States of America']","['Black-and-white', 'Japanese Movies', 'Monster', 'Disaster', 'Science Fiction']",1950,6
2083293,Bully For Bugs,1953,['United States of America'],"['Animation', 'Short Film', 'Comedy film', 'Family Film']",1950,3
9661361,Pardners,1956,['United States of America'],['Comedy'],1950,6
25381381,Manthiri Kumari,1950,['India'],['World cinema'],1950,0
22156853,Apocalypse III: Tribulation,2000,"['Canada', 'United States of America']","['Action', 'Drama', 'Action/Adventure', 'Science Fiction', 'Thriller']",2000,0
34694618,Du rififi chez les femmes,1959,"['France', 'Italy']","['Drama', 'Crime Fiction']",1950,9
5579722,Bad Company,1931,['United States of America'],"['Pre-Code', 'Drama']",1930,1
8156833,Ruthless,1948,['United States of America'],"['Black-and-white', 'Thriller', 'Film noir', 'Drama']",1940,8
25048337,A Swingin' Summer,1965,['United States of America'],"['Musical', 'Comedy']",1960,5
7036459,Larva,2006,['United States of America'],"['Science Fiction', 'Natural horror films', 'Horror']",2000,6
8279500,The Phantom Rider,1946,['United States of America'],"['Action', 'Black-and-white', 'Western', 'Adventure']",1940,6
413949,Peeping Tom,1960,['United Kingdom'],"['Psychological thriller', 'Suspense', 'Crime Fiction', 'Thriller', 'Horror', 'Cult']",1960,0
11525423,Red Line 7000,1965,['United States of America'],"['Action', 'Drama', 'Auto racing']",1960,5
10628498,White Fang 2: Myth of the White Wolf,1994,['United States of America'],"['Family Drama', 'Animal Picture', 'Family-Oriented Adventure', ""Children's/Family"", 'Adventure', 'Drama', 'Family Film']",1990,4
18856160,Kansas City Bomber,1972,['United States of America'],"['Sports', 'Drama']",1970,2
24157484,Crossing the Line,2002,['United States of America'],"['Family Drama', 'Television movie', 'Family Film', 'Sports', 'Drama']",2000,2
25851654,Tora-san's Lovesick,1974,['Japan'],['Japanese Movies'],1970,4
1108697,Lone Star,1996,['United States of America'],"['Crime Fiction', 'Mystery', 'Indie', 'Thriller', 'Romance Film', 'Crime Thriller', 'Drama', 'Western']",1990,6
22667885,The Family Friend,2006,"['France', 'Italy']","['Black comedy', 'Drama']",2000,6
12250650,Gejje Pooje,1969,['India'],[],1960,9
5699114,The Detonator,2006,['United States of America'],"['Action', 'Action Thrillers', 'Action/Adventure', 'Thriller']",2000,6
8583537,Al Filo de la Ley,1992,['Argentina'],"['Action', 'Musical', 'Crime Fiction', 'Crime Thriller']",1990,2
22342877,Cold Comfort Farm,1995,"['United Kingdom', 'England']","['Period piece', 'Film adaptation', 'Comedy', 'Romance Film', 'Romantic comedy', 'Television movie', 'Drama']",1990,5
717281,Pandora and the Flying Dutchman,1951,['United Kingdom'],"['Period piece', 'Romantic fantasy', 'Mystery', 'Romantic drama', 'Romance Film', 'Drama', 'Fantasy']",1950,1
26049717,Nelavanka,1983,['India'],['Drama'],1980,3
17026195,Down Came a Blackbird,1995,['United States of America'],['Drama'],1990,5
17442515,Chandralekha,1948,['India'],['Epic'],1940,8
13165463,Evangelion: 2.0,2009,['Japan'],"['Action', 'Animation', 'Japanese Movies', 'Anime', 'Science Fiction', 'Drama', 'Fantasy']",2000,9
12794137,Den of Lions,2003,"['Hungary', 'United States of America']","['Action', 'Suspense', 'Action Thrillers', 'Action/Adventure', 'Thriller', 'Crime Thriller']",2000,3
33559533,Dharma Seelan,1993,['India'],"['Musical', 'Bollywood', 'World cinema', 'Drama']",1990,3
16011687,Karma,2009,['India'],"['Psychological thriller', 'Crime Fiction', 'Mystery', 'Romance Film', 'Drama']",2000,9
2306889,Disco Pigs,2001,"['Ireland', 'United Kingdom']","['Coming of age', 'Thriller', 'World cinema', 'Drama']",2000,1
3226241,In the Mix,2005,['United States of America'],"['Action', 'Action/Adventure', 'Comedy', 'Romance Film', 'Romantic comedy', 'Drama']",2000,5
17871789,Martyrs,2008,"['Canada', 'France']","['World cinema', 'Horror']",2000,8
16799338,Mother Lode,1982,['United States of America'],"['Action', 'Suspense', 'Action/Adventure', 'Thriller', 'Adventure']",1980,2
10792067,Tiger,1979,['India'],['Drama'],1970,9
2229439,No Highway in the Sky,1951,['United Kingdom'],"['Disaster', 'Drama']",1950,1
25445712,Thodu Dongalu,1981,[],"['Action', 'Comedy film']",1980,1
7089265,Blackbeard,2006,['United States of America'],"['Action/Adventure', 'Historical fiction', 'War film', 'Adventure', 'Drama', 'Swashbuckler films']",2000,6
4389723,Muscle Beach Party,1964,['United States of America'],"['Musical', 'Comedy', 'Teen', 'Beach Film', 'Beach Party film']",1960,4
10292216,Lake City,2008,['United States of America'],"['Crime Fiction', 'Indie', 'Family Drama', 'Melodrama', 'Drama']",2000,8
26363125,The Champagne Murders,1967,['France'],"['Drama', 'Crime Fiction', 'Thriller']",1960,7
585824,The Getaway,1972,['United States of America'],"['Action', 'Crime Fiction', 'Thriller']",1970,2
29068155,The Big Vacation,1967,"['France', 'Italy']",['Comedy'],1960,7
23758023,Let's Go Navy!,1951,['United States of America'],['Comedy film'],1950,1
1399682,Groove,2000,['United States of America'],"['Drama', 'Indie', 'Musical Drama', 'Romantic drama', 'Dance', 'Romance Film', 'Ensemble Film']",2000,0
3610610,The Lawless Frontier,1934,['United States of America'],"['Action', 'B-Western', 'Black-and-white', 'Action/Adventure', 'Western']",1930,4
1615582,They Might Be Giants,1971,['United States of America'],"['Adventure Comedy', 'Mystery', 'Comedy', 'Thriller', 'Black comedy', 'Romantic comedy', 'Cult']",1970,1
163491,Seven Beauties,1975,['Italy'],"['World cinema', 'Black comedy', 'Comedy-drama', 'Tragicomedy', 'Drama']",1970,5
10999486,Awarapan,2007,"['India', 'Pakistan']","['Action', 'Crime Fiction', 'Romantic drama', 'World cinema', 'Romance Film', 'Drama']",2000,7
145629,Abe Lincoln in Illinois,1940,['United States of America'],"['Black-and-white', 'Biopic [feature]', 'Historical fiction', 'Drama']",1940,0
1660909,Operation Dumbo Drop,1995,['United States of America'],"['Comedy', 'Animal Picture', 'War film', 'Adventure', 'Family Film']",1990,5
31851567,House of Fears,2007,['United States of America'],['Horror'],2000,7
26742350,The Addams Family,1991,['United States of America'],"['Comedy', 'Black comedy', 'Domestic Comedy', 'Family Film', 'Fantasy']",1990,1
153007,"It's the Great Pumpkin, Charlie Brown",1966,['United States of America'],"['Animation', 'Short Film', ""Children's/Family"", 'Drama', 'Family Film']",1960,6
4091681,Club Paradise,1986,['United States of America'],"['Slapstick', 'Comedy']",1980,6
22198915,Inside Out,1975,"['United Kingdom', 'West Germany', 'United States of America']",['Action'],1970,5
26165645,Passage Home,1955,['United Kingdom'],['Drama'],1950,5
2066600,Coffy,1973,['United States of America'],"['Action', 'Blaxploitation', 'Crime Fiction', 'Action/Adventure', 'Thriller', 'Crime Thriller']",1970,3
12933842,Brother John,1971,['United States of America'],['Drama'],1970,1
482882,"The Adventures of Priscilla, Queen of the Desert",1994,"['Germany', 'New Zealand', 'Australia']","['Music', 'Musical', 'LGBT', 'Indie', 'Comedy', 'Buddy film', 'World cinema', 'Drama', 'Gay Themed', 'Gay', 'Gay Interest', 'Comedy-drama', 'Road movie', 'Cult', 'Ensemble Film']",1990,4
19507780,Painted Skin,2008,"['Hong Kong', 'Singapore', 'China']","['Action', 'Drama', 'Thriller', 'Chinese Movies']",2000,8
10380700,Trick 'r Treat,2008,['United States of America'],"['Psychological thriller', 'Slasher', 'Comedy', 'Thriller', 'Horror', 'Zombie Film', 'Ensemble Film']",2000,8
1814329,Stir Crazy,1980,['United States of America'],"['Action', 'Prison', 'Action/Adventure', 'Buddy film', 'Comedy', 'Comedy of Errors', 'Prison film', 'Cult']",1980,0
15637345,Master of the World,1934,['Germany'],['Black-and-white'],1930,4
19155004,A Woman's Vengeance,1948,['United States of America'],"['Black-and-white', 'Crime Fiction', 'Mystery', 'Drama']",1940,8
16793054,Lawyer Man,1933,['United States of America'],"['Black-and-white', 'Crime Drama', 'Melodrama', 'Drama']",1930,3
1428676,Kes,1970,['United Kingdom'],"['Film adaptation', 'Coming of age', 'Family Drama', 'British New Wave', 'Drama']",1970,0
28199463,Screaming Eagles,1956,['United States of America'],"['War film', 'Drama']",1950,6
5990408,That's My Boy,1951,['United States of America'],['Comedy'],1950,1
23751253,Cheburashka,1971,['Soviet Union'],"['Animation', 'Short Film', 'Stop motion', 'Family Film']",1970,1
36388452,Forced Entry,1973,['United States of America'],"['Pornographic movie', 'Horror']",1970,3
5452611,Johnny Reno,1966,['United States of America'],"['Action/Adventure', 'Western']",1960,6
33227139,Govindha Govindha,1993,[],"['Action', 'Crime Fiction', 'Drama']",1990,3
23201395,Kalidas,1931,['India'],"['Musical', 'Historical drama']",1930,1
26640845,From Hell to Texas,1958,['United States of America'],"['Action', 'Romance Film', 'Western']",1950,8
20119087,Journey to the Center of the Earth,2008,['United States of America'],"['Action', 'Film adaptation', 'Drama', 'Adventure', 'Television movie', 'Science Fiction', 'Fantasy']",2000,8
11227875,The Four Skulls of Jonathan Drake,1959,['United States of America'],"['Black-and-white', 'Thriller', 'Horror', 'Supernatural', 'Science Fiction']",1950,9
6457618,Bitter Harvest,1963,['United Kingdom'],"['Film adaptation', 'Drama', 'Indie', 'Romance Film']",1960,3
11020786,Lighter Than Hare,1960,['United States of America'],"['Animation', 'Short Film', 'Comedy', 'Science Fiction', 'Family Film']",1960,0
26540889,The Iron Duke,1934,['United Kingdom'],"['Historical fiction', 'Biopic [feature]']",1930,4
3282957,The Main Event,1979,['United States of America'],"['Musical', 'Boxing', 'Comedy', 'Romantic comedy', 'Romance Film', 'Sports']",1970,9
30161154,Scorpion King,1991,[],"['Action', 'Comedy film']",1990,1
25004733,Splatter Farm,1987,['United States of America'],"['Slasher', 'B-movie', 'Horror']",1980,7
18499684,Easy Living,1949,['United States of America'],"['Black-and-white', 'Drama']",1940,9
673613,Bad Boys,1995,['United States of America'],"['Action', 'Crime Fiction', 'Action/Adventure', 'Buddy film', 'Thriller', 'Comedy', 'Drama', 'Buddy cop']",1990,5
3925275,"The One and Only, Genuine, Original Family Band",1968,['United States of America'],"['Musical', 'Comedy', 'Musical comedy', ""Children's/Family"", 'Drama', 'Family Film']",1960,8
1201706,King Rat,1965,['United States of America'],"['Period piece', 'War film', 'Drama']",1960,5
8086374,The Debt Collector,1999,"['United Kingdom', 'Scotland']","['Crime Drama', 'Drama']",1990,9
6141751,The Princess and the Frog,2009,['United States of America'],"['Musical', 'Animation', 'Romance Film', ""Children's/Family"", 'Fairy tale', ""Children's Fantasy"", 'Family Film', 'Fantasy']",2000,9
11698878,Sleepless,2001,['Italy'],"['Psychological thriller', 'Giallo', 'Slasher', 'Thriller', 'Horror']",2000,1
639729,Ice-Cold in Alex,1958,['United Kingdom'],"['Black-and-white', 'War film', 'Drama']",1950,8
3754316,Waking Ned Devine,1998,"['Isle of Man', 'United Kingdom', 'France', 'Ireland', 'United States of America']","['Black comedy', 'Indie', 'Comedy']",1990,8
2866433,Muscle Tussle,1953,['United States of America'],"['Animation', 'Short Film', 'Comedy film']",1950,3
927058,The Wolf Man,1941,['United States of America'],"['Black-and-white', 'Horror', 'Drama', 'Tragedy']",1940,1
16514599,Kotha Bangaru Lokam,2008,['India'],"['Romantic drama', 'World cinema', 'Romance Film', 'Drama']",2000,8
6809632,Kadhal Mannan,1998,['India'],['Romance Film'],1990,8
19347368,Railroadin',1929,['United States of America'],"['Short Film', 'Black-and-white', 'Comedy']",1920,9
23355385,Royal Cavalcade,1935,[],['Drama'],1930,5
4656471,The Mad Adventures of Rabbi Jacob,1973,['France'],"['Religious Film', 'Comedy', 'World cinema']",1970,3
2553711,This Is the Night,1932,['United States of America'],"['Black-and-white', 'Comedy', 'Romance Film', 'Romantic comedy']",1930,2
6290600,"Go West, Young Man",1936,['United States of America'],"['Comedy', 'Black-and-white']",1930,6
25951913,Ma and Pa Kettle Go to Town,1950,['United States of America'],['Comedy'],1950,0
22072852,Christmas in Boston,2005,['Canada'],"['Romantic comedy', 'Television movie', 'Christmas movie']",2000,5
28182616,They Were Sisters,1945,['United Kingdom'],['Drama'],1940,5
2592742,A Damsel in Distress,1937,['United States of America'],"['Musical', 'Black-and-white', 'Comedy']",1930,7
7301220,Quartet,1948,['United Kingdom'],"['Film adaptation', 'Comedy', 'Drama']",1940,8
29377746,Loved,1997,['United States of America'],"['Courtroom Drama', 'Drama']",1990,7
1795280,Meenaxi: A Tale of Three Cities,2004,['India'],"['Art film', 'Romantic drama', 'World cinema', 'Romance Film', 'Drama']",2000,4
4044836,The Mad Ghoul,1943,['United States of America'],"['Black-and-white', 'Science Fiction', 'Horror']",1940,3
210860,Super Mario Bros.,1993,"['United Kingdom', 'United States of America']","['Action', 'Fantasy Adventure', 'Indie', 'Comedy', 'Thriller', 'Buddy film', 'Adventure', 'Doomsday film', 'Dystopia', 'Superhero movie', 'Science Fiction', 'Family Film', 'Fantasy']",1990,3
11445373,White Heat,1949,['United States of America'],"['Black-and-white', 'Crime Fiction', 'Gangster Film', 'Thriller', 'Film noir', 'Crime Thriller', 'Drama']",1940,9
19349575,Wide Open Spaces,1947,['United States of America'],"['Animation', 'Short Film', 'Comedy', 'Family Film']",1940,7
26792725,The Candidate,2008,['Denmark'],['Thriller'],2000,8
2672060,Hag in a Black Leather Jacket,1964,['United States of America'],"['Black-and-white', 'Indie', 'Short Film']",1960,4
4498755,The Zombie Movie,2003,['Spain'],"['Action', 'Crime Fiction', 'Comedy', 'Thriller', 'Zombie Film', 'Crime Thriller', 'Comedy film', 'Horror']",2000,3
164205,It's a Good Life,1961,['United States of America'],"['Mystery', 'Short Film', 'Thriller', 'Horror', 'Science Fiction', 'Drama', 'Fantasy']",1960,1
6014008,The Brotherhood of the Bell,1970,['United States of America'],"['Psychological thriller', 'Drama', 'Thriller']",1970,0
26587696,Orkkuka Vallappozhum,2009,['India'],['Drama'],2000,9
10700202,Heera Panna,1973,['India'],['Romance Film'],1970,3
18246000,Cherrybomb,2009,['United Kingdom'],"['Indie', 'Thriller', 'Teen', 'Romance Film', 'Drama']",2000,9
14437070,Scotched in Scotland,1954,['United States of America'],"['Short Film', 'Black-and-white', 'Comedy']",1950,4
240483,Battle of Britain,1969,['United Kingdom'],"['Action', 'History', 'Action/Adventure', 'Epic', 'War film', 'Drama']",1960,9
1258370,The Mouse That Roared,1959,"['United Kingdom', 'England']","['Political cinema', 'Political satire', 'Parody', 'Satire', 'Comedy']",1950,9
25247178,The Eagle Path,2009,"['Thailand', 'Hong Kong', 'United States of America']","['Action', 'Action/Adventure', 'Thriller', 'World cinema', 'Chinese Movies']",2000,9
27904601,Already Dead,2007,['United States of America'],"['Psychological thriller', 'Suspense', 'Mystery', 'Thriller', 'Crime Thriller']",2000,7
32636168,Curse of the Komodo,2004,['United States of America'],"['Horror', 'Science Fiction']",2000,4
28385370,The Ottoman Republic,2008,[],"['Drama', 'Comedy film']",2000,8
25016098,U Me Aur Hum,2008,['India'],"['Musical', 'Romantic drama', 'Bollywood', 'World cinema', 'Romance Film', 'Drama']",2000,8
12732451,State of Play,2009,"['United Kingdom', 'France', 'United States of America']","['Mystery', 'Thriller', 'Crime Thriller', 'Political drama', 'Drama', 'Political thriller']",2000,9
16484660,Anaconda 3: The Offspring,2008,['Romania'],"['Horror', 'Natural horror films']",2000,8
11361551,Brother Orchid,1940,['United States of America'],"['Black-and-white', 'Crime Fiction', 'Gangster Film', 'Comedy', 'Crime Comedy', 'Drama']",1940,0
25431214,Evidam Swargamanu,2009,['India'],['Drama'],2000,9
11214758,Fiddlers Three,1944,['United Kingdom'],"['Musical', 'Comedy film', 'Adventure', 'Science Fiction', 'Fantasy']",1940,4
2500390,Hazaaron Khwaishein Aisi,2005,['India'],"['Art film', 'Romantic drama', 'World cinema', 'Romance Film', 'Drama']",2000,5
29504548,Call Out the Marines,1941,['United States of America'],"['Musical', 'Comedy']",1940,1
457590,Kameradschaft,1931,"['France', 'Germany', 'Weimar Republic']","['Black-and-white', 'Docudrama', 'Drama']",1930,1
33471617,Beat,1997,['South Korea'],"['Action', 'Crime Fiction', 'Drama']",1990,7
12908588,Mehboob Ki Mehndi,1971,['India'],"['Musical', 'Romance Film']",1970,1
25131366,Sevasadanam,1938,['India'],['Drama'],1930,8
19408783,Spooky Hooky,1936,['United States of America'],"['Black-and-white', 'Short Film', 'Comedy', 'Family Film']",1930,6
21174235,Humpday,2009,['United States of America'],['Comedy'],2000,9
475482,Branded to Kill,1967,['Japan'],"['Surrealism', 'Black-and-white', 'Crime Fiction', 'Thriller', 'World cinema', 'Crime Thriller', 'Drama', 'Japanese Movies']",1960,7
17114714,A New Wave,2007,['United States of America'],"['Action', 'Heist', 'Crime Fiction', 'Indie', 'Action/Adventure', 'Comedy']",2000,7
22271345,Un amore perfetto,2002,['Italy'],['Romantic comedy'],2000,2
13098785,Sweet Charity,1969,['United States of America'],"['Musical', 'Comedy', 'Romance Film', 'Romantic comedy']",1960,9
12674042,Ten Tall Men,1951,['United States of America'],"['Comedy', 'Adventure']",1950,1
24723825,Ripper 2: Letter from Within,2003,['United Kingdom'],"['Slasher', 'B-movie', 'Horror']",2000,3
4023052,Ishq,1997,['India'],"['Romantic drama', 'Comedy', 'Bollywood', 'World cinema', 'Romance Film', 'Romantic comedy', 'Drama']",1990,7
21664269,"Patrik 1,5",2008,['Sweden'],"['LGBT', 'Comedy', 'World cinema', 'Drama', 'Gay Themed', 'Gay', 'Gay Interest', 'Comedy-drama', 'Feature film']",2000,8
7173361,Betty Boop's Crazy Inventions,1933,['United States of America'],"['Animation', 'Short Film', 'Comedy', 'Family Film']",1930,3
2052231,Heartburn,1986,['United States of America'],"['Film à clef', 'Romantic drama', 'Comedy', 'Romance Film', 'Drama', 'Marriage Drama', 'Romantic comedy', 'Comedy-drama']",1980,6
13870073,Sebastian Star Bear: First Mission,1991,['Netherlands'],"[""Children's"", 'Animation']",1990,1
4032619,Free Willy 3: The Rescue,1997,['United States of America'],"['Family Drama', 'Family-Oriented Adventure', ""Children's/Family"", 'Adventure', 'Drama', 'Coming of age', 'Animal Picture', 'Family Film']",1990,7
21860614,Naan Avanillai 2,2009,['India'],"['Mystery', 'Romance Film']",2000,9
752036,Man in the Wilderness,1971,['United States of America'],"['Action', 'Action/Adventure', 'Western', 'Adventure']",1970,1
1141701,Santa And The Three Bears,1970,['United States of America'],"['Animation', 'Family-Oriented Adventure', ""Children's/Family"", 'Holiday Film', 'Drama', 'Family Film', 'Fantasy']",1970,0
25974181,Fleshtone,1994,['United States of America'],['Thriller'],1990,4
12208340,Paradise Park,1990,['United States of America'],['Drama'],1990,0
3520726,Female Vampire,1973,"['France', 'Belgium']","['Creature Film', 'Sexploitation', 'Horror', 'Erotica', 'Adult', 'Cult']",1970,3
13939322,Cruel World,2005,['United States of America'],"['Thriller', 'Comedy film', 'Horror']",2000,5
25583729,Assault Girls,2009,['Japan'],"['Japanese Movies', 'Action/Adventure', 'Science Fiction', 'World cinema']",2000,9
9317122,Before the Devil Knows You're Dead,2007,['United States of America'],"['Drama', 'Crime Fiction', 'Indie', 'Family Drama', 'Thriller', 'Crime Thriller']",2000,7
14904772,Mob Queen,1998,['United States of America'],"['Comedy', 'Crime Comedy']",1990,8
1553602,Four Days in September,1997,['Brazil'],"['Thriller', 'World cinema', 'Political drama', 'Drama', 'Political thriller']",1990,7
25569607,Jaguar,1996,['France'],"['Adventure Comedy', 'Comedy', 'World cinema', 'Adventure', 'Drama']",1990,6
22570919,Aalukkoru Aasai,2004,[],"['Comedy', 'Family Film']",2000,4
1164290,A Taxing Woman,1987,['Japan'],"['Japanese Movies', 'Comedy', 'Satire', 'Comedy of manners', 'Romantic comedy']",1980,7
1590523,La Symphonie pastorale,1946,['France'],"['Romantic drama', 'World cinema', 'Romance Film', 'Drama']",1940,6
3228403,Ghost in the Shell,1995,"['Japan', 'United States of America']","['Action', 'Animation', 'Japanese Movies', 'Thriller', 'Anime', 'Science Fiction', 'Fantasy']",1990,5
22545502,Sally in our Alley,1931,['United Kingdom'],"['Musical', 'Comedy film', 'Romance Film', 'Drama']",1930,1
16931947,Martian Child,2007,['United States of America'],"['Film adaptation', 'Indie', 'Family Drama', 'Comedy', 'Drama', 'Melodrama', 'Comedy-drama', 'Science Fiction', 'Family Film']",2000,7
31633054,Voodoo,1995,['United States of America'],"['Zombie Film', 'Teen', 'Horror']",1990,5
7864161,The Incredible Hulk Returns,1988,['United States of America'],"['Action', 'Superhero', 'Superhero movie', 'Sci-Fi Adventure', 'Adventure', 'Drama']",1980,8
3238135,House of the Dead,2003,"['Germany', 'United States of America', 'Canada']","['Action', 'Action/Adventure', 'Thriller', 'Horror', 'World cinema', 'Teen', 'Zombie Film']",2000,3
16698126,The Ghouls,2003,['United States of America'],"['Creature Film', 'Indie', 'Horror', 'Zombie Film']",2000,3
15215908,Anasuya,2007,['India'],"['Crime Fiction', 'Mystery', 'Thriller']",2000,7
3520781,Dr. Dolittle 3,2006,['United States of America'],"['Comedy', 'Family Film']",2000,6
5047902,De Lift,1983,['Netherlands'],['Horror'],1980,3
10387338,She Married Her Boss,1935,['United States of America'],"['Black-and-white', 'Comedy', 'Comedy film', 'Romance Film']",1930,5
8630196,Virasat,1997,['India'],"['Musical', 'Bollywood', 'World cinema', 'Romance Film', 'Drama']",1990,7
18231745,Dough Boys,2009,['United States of America'],"['Crime Drama', 'Crime Fiction', 'Drama']",2000,9
20267384,Christmas Story,2007,['Finland'],"['Period piece', 'Fantasy Drama', 'Family Drama', 'Holiday Film', 'Drama', 'Family Film']",2000,7
3110093,The Unforgiven,1960,['United States of America'],"['Action', 'Drama', 'Action/Adventure', 'Western']",1960,0
34984057,Will to Live,1999,['Japan'],[],1990,9
4324255,Dr. Otto and the Riddle of the Gloom Beam,1986,['United States of America'],"['Indie', 'Comedy', 'Slapstick', ""Children's""]",1980,6
1389371,Since Otar Left,2003,"['France', 'Belgium']","['Drama', 'World cinema']",2000,3
21867426,Retrato de Familia,1976,['Spain'],"['War film', 'Drama']",1970,6
9612535,The Lightning Warrior,1931,['United States of America'],"['Action', 'Black-and-white', 'Western', 'Adventure', 'Drama', 'Family Film']",1930,1
27457018,La Morte Vivante,1982,['France'],"['World cinema', 'Horror']",1980,2
4294276,The Van,1977,['United States of America'],"['Comedy', 'Cult', 'Sex comedy']",1970,7
29747330,Teri Meherbaniyan,1985,['India'],"['Drama', 'Thriller', 'World cinema']",1980,5
28822768,Two Mothers for Zachary,1996,['United States of America'],['Drama'],1990,6
8614120,Saptapadi,1961,['India'],['Drama'],1960,1
29245287,August 1,1988,['India'],"['Action', 'Drama', 'Bollywood']",1980,8
20398873,Look for a Star,2009,['Hong Kong'],"['Romantic drama', 'Comedy', 'World cinema', 'Romance Film', 'Chinese Movies', 'Drama', 'Romantic comedy', 'Comedy-drama']",2000,9
12917721,Sacred Ground,1983,['United States of America'],"['Revisionist Western', 'Action/Adventure', 'Western', 'Drama']",1980,3
15903243,The Secret of the Grain,2007,"['France', 'Tunisia']","['Family Drama', 'Ensemble Film', 'World cinema', 'Drama', 'Slice of life story']",2000,7
939519,Alien Adventure,1999,['Belgium'],"['Animation', 'Comedy', 'Alien Film', 'Science Fiction']",1990,9
2259783,Confessions from a Holiday Camp,1977,['United Kingdom'],"['Slapstick', 'Comedy', 'Sex comedy']",1970,7
3997782,Chaos Theory,2007,['United States of America'],"['Romantic drama', 'Comedy', 'Romance Film', 'Romantic comedy', 'Comedy-drama', 'Drama']",2000,7
12182188,Back Street,1932,['United States of America'],"['Black-and-white', 'Drama']",1930,2
10537506,Ivor the Invisible,2001,['United Kingdom'],"['Animated cartoon', 'Animation', 'Short Film']",2000,1
844320,The Libertine,1969,"['France', 'Italy']","['Romantic drama', 'Comedy', 'World cinema', 'Romance Film', 'Romantic comedy', 'Drama']",1960,9
3778528,Windstruck,2004,['South Korea'],"['Crime Fiction', 'Comedy', 'Comedy film', 'Romance Film', 'Drama']",2000,4
2551631,Underclassman,2005,['United States of America'],"['Action', 'Drama', 'Crime Fiction', 'Action/Adventure', 'Comedy']",2000,5
2061547,City That Never Sleeps,1953,['United States of America'],"['Black-and-white', 'Crime Fiction', 'Thriller', 'Film noir', 'Drama']",1950,3
9125767,Against All Flags,1952,['United States of America'],"['Action', 'Adventure']",1950,2
1572988,The Jacket,2005,"['Germany', 'United States of America']","['Psychological thriller', 'Mystery', 'Indie', 'Thriller', 'Drama', 'Time travel', 'Supernatural', 'Science Fiction', 'Fantasy']",2000,5
10931684,Big Leaguer,1953,['United States of America'],['Drama'],1950,3
11868578,Kadhalil Vizhunthen,2008,['India'],['Romance Film'],2000,8
8154771,Dr. Jekyll and Ms. Hyde,1995,"['United Kingdom', 'United States of America']","['Parody', 'Horror Comedy', 'Comedy']",1990,5
24062726,Youth on Parole,1937,['United States of America'],"['Drama', 'Crime Fiction']",1930,7
7440348,Neo Ned,2005,['United States of America'],"['Romantic drama', 'Indie', 'Romance Film', 'Drama']",2000,5
14790815,Goryeojang,1963,['South Korea'],['Drama'],1960,3
14165416,Fellini: I'm a Born Liar,2003,"['United Kingdom', 'France', 'Italy']","['Film & Television History', 'Biography', 'Documentary', 'World cinema', 'Film']",2000,3
25230351,Jyothi,1976,['India'],['Drama'],1970,6
11117698,All the King's Men,1999,['United Kingdom'],"['Action', 'Period piece', 'Drama', 'Television movie']",1990,9
13161231,Dicky Moe,1962,['United States of America'],"['Animation', 'Short Film', 'Comedy', 'Family Film']",1960,2
4835894,Clifford's Really Big Movie,2004,['United States of America'],"['Animation', 'Family-Oriented Adventure', ""Children's/Family"", 'Adventure', 'Family Film']",2000,4
25555004,Taboo,2002,['United States of America'],"['Slasher', 'Teen', 'Horror']",2000,2
23732448,The Sum of Us,1994,"['New Zealand', 'Australia']","['Film adaptation', 'LGBT', 'Family Drama', 'Indie', 'Comedy', 'Romantic drama', 'World cinema', 'Romance Film', 'Drama', 'Gay Themed', 'Gay', 'Gay Interest', 'Romantic comedy', 'Comedy-drama']",1990,4
14487270,Agent trouble,1987,['France'],"['Psychological thriller', 'Mystery', 'Thriller']",1980,7
9520522,Day the World Ended,1955,['United States of America'],"['Indie', 'Horror', 'Disaster', 'Science Fiction']",1950,5
13141602,Amy's Orgasm,2001,['United States of America'],"['Indie', 'Comedy', 'Romance Film', 'Romantic comedy', 'Sex comedy']",2000,1
2095475,Maya Memsaab,1993,['India'],"['Drama', 'Thriller', 'World cinema']",1990,3
20520779,His Better Elf,1958,['United States of America'],"['Animation', 'Short Film', 'Comedy film', 'Family Film']",1950,8
36467408,Cinderella Meets Fella,1938,['United States of America'],"['Short Film', 'Adventure', 'Comedy film']",1930,8
8597587,The Drifter,1988,['United States of America'],"['Suspense', 'Crime Fiction', 'Thriller', 'Erotic thriller', 'Crime Thriller']",1980,8
992419,Rock 'n' Roll High School,1979,['United States of America'],"['Musical', 'Indie', 'Comedy', 'Musical comedy', 'Punk rock', 'Absurdism']",1970,9
26118123,The Stranger's Return,1933,['United States of America'],"['Romance Film', 'Drama']",1930,3
248613,The Land Girls,1998,"['United Kingdom', 'France', 'England']","['Romantic drama', 'Romance Film', 'Comedy-drama', 'War film', 'Drama']",1990,8
7427284,Iraq for Sale: The War Profiteers,2006,['United States of America'],"['Social issues', 'Political cinema', 'Indie', 'Documentary', 'War film', 'Culture & Society']",2000,6
11399740,Le Cerveau,1969,['France'],"['Crime Fiction', 'Caper story', 'Comedy', 'Crime Comedy']",1960,9
18698088,The October Man,1947,['United Kingdom'],"['Suspense', 'Film adaptation', 'Black-and-white', 'Mystery', 'Thriller', 'Crime Thriller', 'Drama']",1940,7
16742289,On the Silver Globe,1987,['Poland'],"['Surrealism', 'Science Fiction', 'World cinema']",1980,7
915487,The Gun in Betty Lou's Handbag,1992,['United States of America'],"['Screwball comedy', 'Libraries and librarians', 'Mystery', 'Courtroom Comedy', 'Comedy', 'Thriller', 'Crime Comedy']",1990,2
648781,Treasure Planet,2002,['United States of America'],"['Animation', 'Adventure', 'Romance Film', 'Family-Oriented Adventure', ""Children's/Family"", 'Science Fiction', 'Family Film']",2000,2
25821952,Winchell,1998,['United States of America'],"['Biography', 'Biopic [feature]', 'Television movie', 'Drama']",1990,8
872770,X the Unknown,1956,['United Kingdom'],"['Creature Film', 'Thriller', 'Horror', 'Sci-Fi Horror', 'Science Fiction']",1950,6
6057501,The Pink Jungle,1968,['United States of America'],"['Adventure Comedy', 'Action', 'Spy', 'Crime Fiction', 'Comedy', 'Adventure']",1960,8
14510130,Blanche Fury,1948,['United Kingdom'],"['Period piece', 'Crime Fiction', 'Mystery', 'Thriller', 'Melodrama', 'Crime Thriller', 'Drama']",1940,8
23242616,Second to Die,2002,['United States of America'],"['Psychological thriller', 'Indie', 'Thriller', 'Erotic thriller', 'Television movie', 'Crime Thriller']",2000,2
28122716,Boilesk,1933,['United States of America'],['Short Film'],1930,3
6182610,Brothers of the Head,2005,"['United Kingdom', 'England']","['Music', 'Musical', 'Film adaptation', 'Indie', 'Mockumentary', 'Drama', 'Period piece', 'Comedy-drama']",2000,5
4003996,Heroes,1977,['United States of America'],"['Romantic drama', 'Comedy', 'Romance Film', 'Drama']",1970,7
1841267,Care Bears: Journey to Joke-a-lot,2004,"['Canada', 'United States of America']","['Musical', ""Children's Fantasy"", 'Animation', 'Comedy', ""Children's/Family"", ""Children's"", 'Computer Animation']",2000,4
4893989,War of the Buttons,1994,['Ireland'],"['Adventure', 'Drama', 'Family Film']",1990,4
12985157,The KarateGuard,2005,[],"['Animated cartoon', 'Family Film']",2000,5
235288,Courage Under Fire,1996,['United States of America'],"['Detective fiction', 'Crime Fiction', 'Mystery', 'Thriller', 'War film', 'Gulf War', 'Drama', 'Detective', 'Political drama', 'Political thriller']",1990,6
2102014,The Golden Child,1986,['United States of America'],"['Adventure Comedy', 'Action', 'Action/Adventure', 'Comedy', 'Adventure', 'Stop motion', 'Fantasy Comedy', 'Fantasy']",1980,6
16189113,The Slammin' Salmon,2009,['United States of America'],"['Gross out', 'Gross-out film', 'Indie', 'Comedy', 'Slapstick']",2000,9
1837593,The Blue Gardenia,1953,['United States of America'],"['Black-and-white', 'Crime Fiction', 'Thriller', 'Crime Drama', 'Film noir', 'Crime Thriller', 'Drama']",1950,3
12696181,Pest from the West,1939,['United States of America'],"['Short Film', 'Black-and-white', 'Comedy']",1930,9
33652153,City of the Rising Sun,1998,[],['Drama'],1990,8
17733263,Bottle Shock,2008,['United States of America'],"['Period piece', 'Drama', 'Indie', 'Comedy', 'Comedy-drama', 'Ensemble Film']",2000,8
13180718,The Gentle Sex,1943,['United Kingdom'],"['Black-and-white', 'Comedy', 'Romance Film', 'War film', 'Drama']",1940,3
226198,Sleepless in Seattle,1993,['United States of America'],"['Comedy', 'Romance Film', 'Romantic comedy', 'Comedy-drama', 'Drama']",1990,3
20946228,Anaconda 4: Trail of Blood,2008,"['Romania', 'United States of America']","['Horror', 'Natural horror films']",2000,8
5190465,Things Behind the Sun,2001,['United States of America'],"['Indie', 'Drama']",2000,1
427011,Chameli,2003,['India'],"['Art film', 'Romantic drama', 'Bollywood', 'World cinema', 'Romance Film', 'Drama']",2000,3
21013373,"Give 'em Hell, Malone",2009,['United States of America'],"['Action', 'Crime Fiction', 'Mystery', 'Action/Adventure', 'Thriller', 'Crime Thriller']",2000,9
11036705,Cold Heart,2000,['United States of America'],"['Drama', 'Crime Fiction', 'Indie', 'Thriller', 'Erotic thriller', 'Crime Thriller']",2000,0
36318657,"My Son, the Hero",1962,['Italy'],"['Fantasy', 'Adventure', 'World cinema']",1960,2
5249887,Chashme Buddoor,1981,['India'],"['Romantic drama', 'Bollywood', 'World cinema', 'Romance Film', 'Drama']",1980,1
31420015,Voices Within: The Lives of Truddi Chase,1990,['United States of America'],['Drama'],1990,0
2093928,Snow Dogs,2002,"['Canada', 'United States of America']","['Comedy', 'Animal Picture', 'Family-Oriented Adventure', 'Sports', 'Adventure', 'Family Film']",2000,2
963023,Titus,1999,"['Italy', 'United States of America']","['Period piece', 'Fantasy', 'War film', 'Costume drama', 'Drama', 'Tragedy']",1990,9
25610080,Chain Lightning,1950,['United States of America'],"['Action', 'Drama']",1950,0
154699,Sands of Iwo Jima,1949,['United States of America'],"['Action', 'Combat Films', 'Black-and-white', 'Action/Adventure', 'Epic', 'War film', 'Drama']",1940,9
18903874,The Heart Is a Lonely Hunter,1968,['United States of America'],"['Film adaptation', 'Coming of age', 'Americana', 'Drama']",1960,8
152749,Les Diaboliques,1954,['France'],"['Psychological thriller', 'Black-and-white', 'Crime Fiction', 'Mystery', 'Thriller', 'World cinema', 'Film noir', 'Crime Thriller', 'Drama']",1950,4
5120552,Demonlover,2002,['France'],"['Mystery', 'Thriller', 'World cinema', 'Erotic thriller', 'Crime Thriller', 'Drama']",2000,2
1611941,Panic in the Streets,1950,['United States of America'],"['Psychological thriller', 'Black-and-white', 'Chase Movie', 'Thriller', 'Film noir', 'Drama']",1950,0
24522644,The Secret in Their Eyes,2009,"['Argentina', 'Spain']","['Crime Fiction', 'Mystery', 'Romantic drama', 'Thriller', 'World cinema', 'Romance Film', 'Drama', 'Period piece']",2000,9
8400375,Leap of Love,2008,['Singapore'],['Romance Film'],2000,8
17470965,Hook Ya Crook,2009,['India'],"['Comedy', 'World cinema']",2000,9
2226983,The Big Bang,1987,"['France', 'Belgium']","['Science Fiction', 'Animation']",1980,7
4299478,Hidden Agenda,1990,['United Kingdom'],"['Crime Fiction', 'Mystery', 'Thriller', 'Crime Thriller', 'Drama', 'Political thriller']",1990,0
9618920,Captive Wild Woman,1943,['United States of America'],"['Romantic drama', 'Horror', 'Sci-Fi Horror', 'Science Fiction']",1940,3
8749884,Onionhead,1958,['United States of America'],"['Romantic comedy', 'Comedy']",1950,8
165751,Come Undone,2000,"['France', 'Belgium']","['LGBT', 'Romantic drama', 'World cinema', 'Romance Film', 'Drama']",2000,0
24570224,Ghar,1978,['India'],['Bollywood'],1970,8
14163169,Bcuz of U,2004,['Philippines'],"['Filipino Movies', 'Romantic drama', 'Comedy', 'World cinema', 'Romance Film', 'Drama']",2000,4
6224371,The Cavalier,1928,['United States of America'],"['Silent film', 'Indie', 'Western']",1920,8
8326277,Stealing Time,2003,['United States of America'],"['Action', 'Heist', 'Crime Fiction', 'Action/Adventure', 'Comedy', 'Crime Comedy', 'Drama']",2000,3
18179608,Luck,2009,['India'],"['Action', 'Musical', 'Thriller', 'Bollywood', 'World cinema']",2000,9
27756613,The In Crowd,1988,['United States of America'],"['Period piece', 'Romantic drama', 'Dance', 'Romance Film', 'Drama']",1980,8
28408046,Uppalawanna,1997,['Sri Lanka'],['Drama'],1990,7
24065137,Meet the Boyfriend,1937,['United States of America'],"['Musical', 'Black-and-white', 'Comedy', 'Romance Film']",1930,7
17423555,Tara Road,2005,"['Ireland', 'United Kingdom']","['Film adaptation', 'Drama']",2000,5
19636496,Bandhish,1980,['India'],"['Action', 'Drama', 'Crime Fiction', 'Romance Film']",1980,0
6964613,Lancelot and Guinevere,2000,['United Kingdom'],"['Action', 'Action/Adventure', 'Costume drama', 'Adventure', 'Drama', 'Fantasy']",2000,0
16489478,Kovil,2003,['India'],"['Romantic drama', 'World cinema', 'Romance Film', 'Drama']",2000,3
14470369,The Big Shakedown,1934,['United States of America'],"['Black-and-white', 'Crime Fiction', 'Melodrama', 'Drama']",1930,4
316092,The Score,2001,"['Germany', 'United States of America']","['Action', 'Crime Fiction', 'Action/Adventure', 'Thriller', 'Crime Thriller', 'Drama', 'Suspense', 'Heist']",2000,1
7116446,Special Studies Film II,2003,['United States of America'],"['Short Film', 'Comedy', 'Horror']",2000,3
25238567,Her Fatal Ways,1990,['Hong Kong'],['Chinese Movies'],1990,0
24420399,The Republic of Love,2004,"['Canada', 'United Kingdom']","['Film adaptation', 'Drama', 'Indie', 'Romantic drama', 'Romance Film', 'Romantic comedy']",2000,4
26633421,Steamin' and Dreamin': The Grandmaster Cash Story,2009,[],['Comedy'],2000,9
7400070,Two Family House,2002,['United States of America'],"['Drama', 'Americana', 'Family Drama']",2000,2
23066976,Assignment to Kill,1968,['United States of America'],"['Drama', 'Crime Fiction']",1960,8
1257745,The Elementary School,1991,"['Czech Republic', 'Czechoslovakia']","['War film', 'Comedy', 'Drama']",1990,1
19793983,The Granny,1995,['United States of America'],"['Comedy', 'Horror', 'Black comedy', 'Fantasy Comedy', 'Fantasy']",1990,5
27150405,Vajram,2004,['India'],"['Action', 'Drama']",2000,4
3859693,Trafic,1971,"['France', 'Italy']","['Art film', 'Comedy', 'World cinema', 'Drama']",1970,1
2450545,The Cave,2005,"['Germany', 'United States of America']","['Action', 'Action/Adventure', 'Science Fiction', 'Thriller', 'Horror']",2000,5
16286493,Born to Kill,1996,['South Korea'],"['Action', 'Action/Adventure', 'Thriller', 'World cinema', 'Crime Thriller']",1990,6
241603,Austin Powers: The Spy Who Shagged Me,1999,['United States of America'],"['Action', 'Time travel', 'Parody', 'Comedy', 'Absurdism']",1990,9
7950561,Padmashree Laloo Prasad Yadav,2005,['India'],"['Comedy', 'World cinema']",2000,5
9521170,The Intruder,1962,['United States of America'],"['Indie', 'Political drama', 'Drama']",1960,2
10030316,Garçon!,1983,['France'],"['Romantic drama', 'Comedy film', 'Romance Film', 'Comedy-drama', 'Drama']",1980,3
1385251,Wedding Crashers,2005,['United States of America'],"['Comedy', 'Romance Film', 'Romantic comedy', 'Sex comedy']",2000,5
27009201,Papa Kehte Hai,1996,[],['Romance Film'],1990,6
19374272,Another Country,1984,['United Kingdom'],"['Gay Themed', 'LGBT', 'Romantic drama', 'Romance Film', 'Drama']",1980,4
12201894,Squeeze Play!,1983,['United States of America'],"['Comedy', 'Sex comedy']",1980,3
28069333,Gundagardi,1997,['India'],['Action'],1990,7
22641486,The End of Poverty?,2008,['United States of America'],"['Social issues', 'Political cinema', 'History', 'Documentary', 'Political drama', 'Culture & Society']",2000,8
2811692,Infamous,2006,['United States of America'],"['LGBT', 'Crime Fiction', 'Biography', 'Drama']",2000,6
26380612,Broke Sky,2007,['United States of America'],"['Psychological thriller', 'Drama', 'Crime Fiction', 'Indie', 'Thriller', 'Crime Thriller']",2000,7
973155,Shaft,2000,"['Germany', 'United States of America']","['Action', 'Crime Fiction', 'Action/Adventure', 'Thriller', 'Remake']",2000,0
5697483,Seven Chances,1925,['United States of America'],"['Black-and-white', 'Drama', 'Indie', 'Comedy', 'Silent film', 'Romantic comedy', 'Comedy of Errors']",1920,5
1296482,Crossroads,1986,['United States of America'],"['Music', 'Mystery', 'Romance Film', 'Drama']",1980,6
5309887,Calcutta Mail,2003,['India'],"['Suspense', 'Bollywood', 'World cinema']",2000,3
23924255,Exposed,1983,['United States of America'],"['Music', 'Drama']",1980,3
8445116,A Pain in the Pullman,1936,['United States of America'],"['Short Film', 'Black-and-white', 'Comedy']",1930,6
11857195,The Wonderful Wizard of Ha's,2007,[],"['Musical', 'Animation', 'Short Film', ""Children's""]",2000,7
3752653,Junebug,2005,['United States of America'],"['Drama', 'Family Drama', 'Indie', 'Comedy', 'Comedy of manners', 'Comedy-drama']",2000,5
11216928,Fantaghirò 2,1992,['Italy'],"['Adventure', 'Family Film']",1990,2
29166421,The Younger Generation,1929,['United States of America'],"['Family Drama', 'Drama']",1920,9
20518783,Niagara Fools,1956,['United States of America'],"['Animation', 'Short Film', 'Comedy film', 'Family Film']",1950,6
31158746,Bungalow,2002,['Germany'],"['Comedy', 'World cinema']",2000,2
9179205,This Man's Navy,1945,['United States of America'],"['War film', 'Adventure', 'Drama']",1940,5
18516420,On the Loose,1985,['Sweden'],['Short Film'],1980,5
4858883,Tanoshii Moomin Ikka: Muumindani no Suisei,1992,"['Netherlands', 'Japan']","['Animation', 'Japanese Movies', 'Thriller', 'Anime', 'Adventure', 'Family Film', 'Fantasy']",1990,2
28660300,Proyecto Dos,2008,['Spain'],['Action'],2000,8
21042990,Episode,1935,['Austria'],"['Romance Film', 'Romantic comedy', 'Comedy']",1930,5
9201848,The Thundering Herd,1925,['United States of America'],"['Black-and-white', 'Indie', 'Western', 'Silent film']",1920,5
7353520,Midnight Sun,2006,['Japan'],['Japanese Movies'],2000,6
1693729,Underworld,1985,['United Kingdom'],"['Action', 'Indie', 'Horror', 'Science Fiction']",1980,5
5331313,Caved In: Prehistoric Terror,2006,"['Canada', 'United States of America']","['Monster', 'Sci-Fi Horror', 'Creature Film', 'Horror', 'Television movie', 'Science Fiction', 'Natural horror films', 'Fantasy']",2000,6
23435112,Inside Detroit,1956,['United States of America'],"['Action', 'Drama', 'Crime Fiction', 'Romance Film']",1950,6
21193739,Bram Stoker's Dracula's Curse,2006,['United States of America'],"['Indie', 'Slasher', 'Horror']",2000,6
1756354,Mayabazar,1957,['India'],"['Drama', 'Comedy']",1950,7
22089686,A Lawless Street,1955,['United States of America'],"['Action/Adventure', 'Western']",1950,5
22996497,Pilgrim's Progress: Journey to Heaven,2008,['United States of America'],"['Adventure', 'Fantasy']",2000,8
2619009,Cruel Intentions 2,2000,['United States of America'],"['Comedy', 'Teen', 'Melodrama', 'Comedy-drama', 'Drama']",2000,0
4200912,Zebra Lounge,2001,['Canada'],"['Erotic thriller', 'Thriller']",2000,1
23146599,Killer Fish,1979,"['Brazil', 'United Kingdom', 'Italy', 'United States of America']","['Crime Fiction', 'Thriller', 'Horror']",1970,9
31192936,Ayalathe Adheham,1992,[],"['Family Film', 'Drama', 'Comedy film']",1990,2
1847843,On the Line,2001,['United States of America'],"['Comedy', 'Teen', 'Romance Film', 'Romantic comedy']",2000,1
17368102,Evening of Roses,2009,['China'],"['Chinese Movies', 'Romance Film']",2000,9
4126394,Oru Vadakkan Veeragadha,1989,['India'],['Martial Arts Film'],1980,9
35033672,The Birthday Dragon,1992,['Canada'],"['Family Film', 'Animation']",1990,2
2933385,Freddy's Dead: The Final Nightmare,1991,['United States of America'],"['Slasher', 'Teen', 'Horror', 'Supernatural', 'Cult']",1990,1
4288725,Lisbon Story,1994,"['Portugal', 'Spain', 'France', 'Germany']","['Musical', 'Romantic drama', 'Indie', 'World cinema', 'Drama']",1990,4
15488314,Blood Monkey,2007,['United States of America'],"['Monster movie', 'Horror', 'B-movie', 'Natural horror films']",2000,7
20620714,Thee,2009,['India'],"['Action', 'Drama']",2000,9
24050095,The Pilot,1980,['United States of America'],"['Action', 'Drama']",1980,0
16731647,Gunmen,1994,['United States of America'],"['Action', 'Crime Fiction', 'Action/Adventure', 'Buddy film', 'Thriller', 'Comedy']",1990,4
22281533,Santo Luzbel,1997,['Mexico'],"['Political drama', 'Drama', 'World cinema']",1990,7
5413458,Havana,1990,['United States of America'],"['Period piece', 'Romantic drama', 'Romance Film', 'War film', 'Drama']",1990,0
23252456,Malabar Princess,2004,['France'],['Drama'],2000,4
4633684,8 Seconds,1994,['United States of America'],"['Indie', 'Biography', 'Romantic drama', 'Biographical film', 'Romance Film', 'Drama', 'Biopic [feature]', 'Sports']",1990,4
11659396,Up,2009,['United States of America'],"['Animation', 'Comedy', 'Adventure', 'Drama', 'Family Film', 'Fantasy']",2000,9
1134155,The Misfits,1961,['United States of America'],"['Black-and-white', 'Romantic drama', 'Action/Adventure', 'Western', 'Comedy', 'Romance Film', 'Drama']",1960,1
899442,Charade,1963,['United States of America'],"['Mystery', 'Comedy', 'Thriller', 'Black comedy', 'Romance Film', 'Crime Thriller', 'Suspense', 'Romantic comedy']",1960,3
25625475,Silent Witness,1985,['United States of America'],['Drama'],1980,5
13927420,The Red Mill,1927,['United States of America'],"['Black-and-white', 'Indie', 'Comedy', 'Silent film', 'Romantic comedy', 'Slapstick']",1920,7
12674356,Gardener of Eden,2007,['United States of America'],"['Indie', 'Comedy', 'Black comedy', 'Comedy-drama', 'Drama']",2000,7
19799767,Nilam,1949,"['Singapore', 'Malaysia']",['Drama'],1940,9
5948294,Sex and Death 101,2007,['United States of America'],"['Comedy', 'Black comedy', 'Romantic comedy', 'Romance Film', 'Fantasy Comedy', 'Drama', 'Sex comedy']",2000,7
274258,Dilwale Dulhania Le Jayenge,1995,['India'],"['Musical', 'Romantic drama', 'Comedy', 'Bollywood', 'World cinema', 'Romance Film', 'Drama', 'Coming of age', 'Family Film']",1990,5
3771410,Revenge of the Creature,1955,['United States of America'],"['Creature Film', 'Black-and-white', 'Science Fiction', 'Horror', 'Sci-Fi Horror']",1950,5
25267846,BFF: Best Friends Forever,2009,['Philippines'],"['Filipino Movies', 'Comedy', 'World cinema']",2000,9
7742723,Cold Prey,2006,['Norway'],"['Crime Fiction', 'Mystery', 'Slasher', 'Thriller', 'Horror', 'World cinema', 'Drama']",2000,6
3148613,"Zoltan, Hound of Dracula",1978,"['Italy', 'United States of America']","['Costume Horror', 'Thriller', 'Horror']",1970,8
1166822,Mickey's Twice Upon a Christmas,2004,['United States of America'],"['Animation', ""Children's/Family"", 'Holiday Film', 'Computer Animation']",2000,4
2262672,For Richer or Poorer,1997,['United States of America'],"['Slapstick', 'Comedy', 'Romance Film', 'Romantic comedy', 'Family Film', 'Comedy of Errors']",1990,7
16800566,Sharpe's Peril,2008,['United Kingdom'],"['Action', 'Drama', 'Adventure']",2000,8
7987387,Booty and the Beast,1953,['United States of America'],"['Short Film', 'Black-and-white', 'Comedy']",1950,3
11456006,The Legend 2,1993,['Hong Kong'],"['Action', 'Action/Adventure', 'Comedy', 'World cinema', 'Chinese Movies', 'Martial Arts Film', 'Adventure']",1990,3
24966098,Hack!,2007,['United States of America'],"['B-movie', 'Teen', 'Horror']",2000,7
6438082,The Honeytrap,2002,['United Kingdom'],"['Thriller', 'Indie', 'Drama']",2000,2
766887,Bring It On,2000,['United States of America'],"['Comedy', 'Teen', 'Comedy of manners', 'Sports']",2000,0
24892602,Swamp Devil,2008,['Canada'],['Horror'],2000,8
24494541,French Postcards,1979,"['France', 'Germany', 'United States of America']","['Coming of age', 'Comedy', 'World cinema', 'Romantic comedy', 'Romance Film', 'Comedy-drama']",1970,9
2707573,Moon 44,1990,"['Germany', 'United States of America']","['Action', 'Action Thrillers', 'Indie', 'Action/Adventure', 'Thriller', 'World cinema', 'Adventure', 'Science Fiction']",1990,0
21816045,Man with the Gun,1955,['United States of America'],"['Action', 'Western']",1950,5
4747767,Follow That Camel,1967,['United Kingdom'],"['Parody', 'Comedy']",1960,7
692652,Stakeout,1987,['United States of America'],"['Action', 'Action/Adventure', 'Comedy', 'Romance Film', 'Romantic comedy']",1980,7
8339172,"Shake, Rattle and Roll 2k5",2005,['Philippines'],"['Filipino Movies', 'Comedy', 'Horror', 'World cinema']",2000,5
24519898,Rafferty and the Gold Dust Twins,1975,['United States of America'],['Comedy'],1970,5
35296215,Sail a Crooked Ship,1961,['United States of America'],"['Comedy', 'Crime Fiction']",1960,1
33242772,Andy Colby's Incredible Adventure,1988,['United States of America'],"[""Children's"", 'Comedy', 'Adventure', 'Science Fiction', 'Family Film', 'Fantasy']",1980,8
8061503,Rogues of Sherwood Forest,1950,['United States of America'],"['Action', 'Costume Adventure', 'Action/Adventure', 'Costume drama', 'Adventure', 'Drama', 'Swashbuckler films', 'Historical fiction']",1950,0
17528498,A Colt Is My Passport,1967,['Japan'],"['Action', 'Black-and-white', 'Crime Fiction', 'Thriller', 'World cinema', 'Film noir', 'Crime Thriller', 'Drama', 'Japanese Movies']",1960,7
5292955,"Come, Let's Fall In Love",2002,['India'],"['Musical', 'Romantic drama', 'Comedy', 'Bollywood', 'World cinema', 'Romance Film', 'Drama']",2000,2
25964824,Thalastaanam,1992,['India'],"['Action', 'Drama']",1990,2
105434,Trainspotting,1996,['United Kingdom'],"['Film adaptation', 'Crime Fiction', 'Indie', 'Comedy', 'Buddy film', 'Black comedy', 'Addiction Drama', 'Drama', 'Comedy-drama', 'Cult']",1990,6
1956661,Pixel Perfect,2004,['United States of America'],"['Musical', 'Comedy', 'Teen', ""Children's/Family"", 'Drama', 'Science Fiction', 'Family Film', 'Fantasy']",2000,4
33730710,The House in Nightmare Park,1973,[],['Horror'],1970,3
16471234,Against a Crooked Sky,1975,['United States of America'],"['Revisionist Western', 'Action/Adventure', 'Western', 'Drama']",1970,5
1830491,Running on Karma,2003,"['China', 'Hong Kong']","['Action', 'Action Thrillers', 'Action/Adventure', 'Comedy', 'Thriller', 'World cinema', 'Chinese Movies', 'Action Comedy']",2000,3
2826307,Children of the Corn III: Urban Harvest,1995,['United States of America'],"['Supernatural', 'Cult', 'Horror']",1990,5
29163831,Night Flight,1933,['United States of America'],['Drama'],1930,3
9188909,Ayyamna al-Holwa,1955,['Egypt'],"['Musical', 'Comedy', 'Romance Film', 'Drama']",1950,5
931950,Cocoon: The Return,1988,['United States of America'],"['Comedy-drama', 'Science Fiction', 'Drama']",1980,8
16881835,Let the Right One In,2008,['Sweden'],"['Creature Film', 'World cinema', 'Horror', 'Romance Film', 'Drama', 'Fantasy']",2000,8
29558941,Lost Angels,1989,['United States of America'],"['Indie', 'Drama', 'Teen']",1980,9
27713413,Prem Kaa Game,2009,['India'],"['Romantic drama', 'World cinema', 'Romance Film', 'Drama']",2000,9
15462809,Andaz,1994,['India'],"['Action', 'Drama', 'Crime Fiction', 'Comedy']",1990,4
4129173,No. 2,2006,['New Zealand'],"['Drama', 'Indie', 'World cinema', 'Comedy-drama']",2000,6
2997985,The Happy Elf,2005,['United States of America'],"['Music', 'Musical', 'Animation', ""Children's/Family"", 'Holiday Film', ""Children's"", 'Computer Animation', ""Children's Fantasy"", 'Family Film']",2000,5
15558139,Mahadev Ka Sajjanpur,2008,['India'],"['Musical', 'Comedy', 'Bollywood', 'World cinema']",2000,8
28348527,The Star Reporter,1932,['United Kingdom'],"['Crime Fiction', 'Short Film', 'Drama']",1930,2
31963128,Never on Tuesday,1989,['United States of America'],"['Comedy', 'Drama', 'Adventure']",1980,9
20836583,Allan Quatermain and the Temple of Skulls,2008,['United States of America'],"['Action', 'Costume Adventure', 'Indie', 'Action/Adventure', 'Thriller', 'Adventure']",2000,8
36057868,Enakkoru Magan Pirappan,1996,['India'],['Comedy film'],1990,6
5406415,Ayşecik ve Sihirli Cüceler Rüyalar Ülkesinde,1971,['Turkey'],['Fantasy'],1970,1
12995896,The Stone Angel,2008,['Canada'],"['Film adaptation', 'Drama', 'Family Drama', 'Indie']",2000,8
9943176,The Fighting Sullivans,1944,['United States of America'],"['Family Drama', 'Biographical film', 'War film', 'Drama']",1940,4
9846378,The Rebel,2007,['Vietnam'],"['Action', 'Action/Adventure', 'World cinema', 'Martial Arts Film']",2000,7
171076,Mr. Holland's Opus,1995,['United States of America'],"['Musical', 'Inspirational Drama', 'Family Drama', 'Drama', 'Family Film']",1990,5
936234,The Sea Hawk,1940,['United States of America'],"['Action', 'Black-and-white', 'Action/Adventure', 'Adventure', 'Swashbuckler films']",1940,0
6167301,SARS Wars,2004,['Thailand'],"['Action/Adventure', 'Comedy', 'Horror', 'World cinema', 'Zombie Film']",2000,4
3908916,The Apple War,1971,['Sweden'],['Comedy'],1970,1
1715414,In the Heat of the Night,1967,['United States of America'],"['Crime Fiction', 'Mystery', 'Thriller', 'Crime Drama', 'Crime Thriller', 'Drama']",1960,7
9423251,English Babu Desi Mem,1996,['India'],"['Drama', 'World cinema']",1990,6
20267161,Home of Angels,1994,['United States of America'],"['Comedy', 'Drama', 'Fantasy']",1990,4
16179544,Englishkaran,2005,['India'],['Comedy'],2000,5
6727572,Oliver Twist,1922,['United States of America'],"['Black-and-white', 'Drama', 'Indie', 'Silent film']",1920,2
6172917,Greedy,1994,['United States of America'],"['Comedy', 'Satire', 'Comedy of manners', 'Domestic Comedy']",1990,4
4509510,Akkada Abbai Ikkada Ammayi,1996,['India'],"['Action', 'Romance Film']",1990,6
26258656,Crows ZERO 2,2009,['Japan'],"['Action', 'Crime Fiction', 'Gangster Film', 'Action/Adventure', 'World cinema', 'Martial Arts Film', 'Adventure', 'Drama', 'Japanese Movies']",2000,9
13914496,Amaram,1991,['India'],"['Romance Film', 'Drama']",1990,1
1239627,Two for the Seesaw,1962,['United States of America'],"['Romance Film', 'Film adaptation', 'Drama']",1960,2
9936509,Pirate Treasure,1934,['United States of America'],"['Action', 'Black-and-white', 'Adventure']",1930,4
17367782,Iron Man,1931,['United States of America'],"['Black-and-white', 'Pre-Code', 'Drama']",1930,1
3328486,I Stand Alone,1998,['France'],"['Crime Fiction', 'Drama', 'World cinema']",1990,8
1482794,Merrily We Live,1938,['United States of America'],"['Black-and-white', 'Comedy', 'Satire', 'Comedy of manners']",1930,8
3041378,Daraar,1996,['India'],['Bollywood'],1990,6
14237319,Shoot the Moon,1982,['United States of America'],"['Romantic drama', 'Family Drama', 'Marriage Drama', 'Romance Film', 'Drama']",1980,2
255898,Mad Max,1979,['Australia'],"['Action', 'Thriller', 'World cinema', 'Apocalyptic and post-apocalyptic fiction', 'Adventure', 'Tragedy', 'Biker Film', 'Chase Movie', 'Doomsday film', 'Science Fiction', 'Cult']",1970,9
1032266,Mozart and the Whale,2005,['United States of America'],"['Romantic drama', 'Romance Film', 'Comedy-drama', 'Drama']",2000,5
16586995,Quality Time,2008,['United States of America'],"['Indie', 'Thriller', 'Black comedy', 'Science Fiction']",2000,8
13863650,Noose,1948,['United Kingdom'],"['Film noir', 'Crime Fiction', 'Drama']",1940,8
3822078,"Love, Honour and Obey",2000,['United Kingdom'],"['Action', 'Crime Fiction', 'Gangster Film', 'Comedy', 'Black comedy', 'Drama', 'Heist', 'Caper story', 'Crime Comedy']",2000,0
2920843,"Move Over, Darling",1963,['United States of America'],"['Romance Film', 'Romantic comedy', 'Comedy']",1960,3
30920276,Cry of the Hunted,1953,['United States of America'],"['Action', 'Film noir', 'Drama']",1950,3
22097562,The Last Grenade,1970,['United Kingdom'],"['Action', 'Drama', 'Action/Adventure', 'War film']",1970,0
27807569,Excited,2009,['Canada'],"['Indie', 'Comedy', 'Romance Film', 'Romantic comedy']",2000,9
67420,On Deadly Ground,1994,['United States of America'],"['Action', 'Action Thrillers', 'Action/Adventure', 'Thriller', 'Adventure']",1990,4
1134919,The Blue Lagoon,1980,['United States of America'],"['Coming of age', 'Romantic drama', 'Teen', 'Romance Film', 'Adventure', 'Drama']",1980,0
25757130,No Time for Flowers,1953,['United States of America'],"['Romance Film', 'Romantic comedy', 'Romantic drama']",1950,3
5574573,Varsham,2004,['India'],"['Romantic drama', 'Thriller', 'World cinema', 'Romance Film', 'Drama']",2000,4
3693882,Beyond Tomorrow,1940,['United States of America'],"['Romantic drama', 'Romance Film', 'Drama', 'Fantasy']",1940,0
26104928,The Hare Census,1973,['Bulgaria'],['Comedy film'],1970,3
28893717,Baby Cakes,1989,['United States of America'],"['Romance Film', 'Drama', 'Comedy film']",1980,9
5632884,Penelope,1966,['United States of America'],"['Comedy', 'Crime Fiction']",1960,6
4071544,Waist Deep,2006,['United States of America'],"['Action', 'Crime Fiction', 'Gangster Film', 'Romance Film', 'Crime Thriller', 'Drama']",2000,6
18223613,Pluto's Party,1952,['United States of America'],"['Animation', 'Short Film', 'Comedy', 'Family Film']",1950,2
12213224,Terror Toons 2: The Sick and Silly Show,2007,['United States of America'],"['Comedy', 'Horror']",2000,7
9009864,Murderers Among Us,1946,['Germany'],"['Thriller', 'Romance Film', 'War film', 'Drama']",1940,6
12561211,Fate Is the Hunter,1964,['United States of America'],"['Action', 'Black-and-white', 'Drama', 'Disaster']",1960,4
26671984,Steppin: The Movie,2009,['United States of America'],"['Music', 'Musical', 'Comedy', 'Musical comedy', 'Dance', 'Romance Film', 'Romantic comedy']",2000,9
17450157,I.C.U.,2009,['Australia'],"['Psychological thriller', 'Suspense', 'Slasher', 'Thriller', 'Horror', 'World cinema', 'Teen']",2000,9
744783,Kolya,1996,['Czech Republic'],"['Musical', 'Comedy', 'Childhood Drama', 'World cinema', 'Melodrama', 'Political drama', 'Drama']",1990,6
25896181,Fidelity,2000,['France'],['Drama'],2000,0
11875403,Supergator,2007,['United States of America'],"['Monster', 'Indie', 'Horror']",2000,7
12047781,Bahumati,2007,['India'],['Comedy'],2000,7
13535665,Ma mère,2004,"['France', 'Spain']","['Erotic Drama', 'World cinema', 'Romance Film', 'Drama']",2000,4
32405340,César,1936,['France'],['Drama'],1930,6
25371771,An Unfinished Affair,1996,['United States of America'],"['Romantic drama', 'Thriller', 'Erotic thriller', 'Romance Film', 'Television movie', 'Drama']",1990,6
32607519,Rahtree Reborn,2009,['Thailand'],"['Romance Film', 'Comedy', 'Horror']",2000,9
8138535,Barefoot in the Park,1967,['United States of America'],"['Romance Film', 'Romantic comedy', 'Comedy']",1960,7
9986386,The Blue Butterfly,2004,['Canada'],"['Family Drama', 'Biography', 'Adventure', 'Drama', 'Family Film']",2000,4
2314753,Andaaz,2003,['India'],"['Musical', 'Romantic drama', 'Bollywood', 'World cinema', 'Romance Film', 'Drama']",2000,3
9084256,"Ispiritista: Itay, may moomoo!",2005,['Philippines'],"['Filipino Movies', 'Comedy horror', 'Romantic drama', 'Comedy', 'World cinema', 'Romance Film', 'Drama', 'Horror', 'Romantic comedy']",2000,5
16348127,Tokyo Chorus,1931,['Japan'],"['Black-and-white', 'Art film', 'Japanese Movies', 'Comedy', 'World cinema', 'Silent film', 'Drama']",1930,1
3570864,Cake,2005,"['Canada', 'United States of America']","['Short Film', 'Comedy', 'Romance Film', 'Romantic comedy', 'Drama']",2000,5
21169981,If the Sun Rises in the West,1998,['South Korea'],['Romantic comedy'],1990,8
27560130,Here Come the Marines,1952,['United States of America'],['Comedy film'],1950,2
17521789,Vaada Raha... I Promise,2009,['India'],['Drama'],2000,9
35473991,April Fools,2007,[],['Horror'],2000,7
12135314,Calle mayor,1956,"['France', 'Spain']","['Black-and-white', 'Drama']",1950,6
7416129,The Skull,1965,"['United Kingdom', 'United States of America']","['Psychological thriller', 'Thriller', 'Horror', 'Supernatural', 'Cult']",1960,5
29169424,The Garment Jungle,1957,['United States of America'],"['Crime Fiction', 'Film noir', 'Social problem film', 'Crime Drama', 'Drama']",1950,7
2867034,September Sessions,2002,[],"['Short Film', 'Sports', 'Documentary']",2000,2
15896980,Thoondle,2008,['India'],['Drama'],2000,8
14979283,10 to Midnight,1983,['United States of America'],"['Action', 'Crime Fiction', 'Action Thrillers', 'Action/Adventure', 'Thriller', 'Crime Thriller']",1980,3
15310429,L'Homme à tout faire,1980,['Canada'],"['Romance Film', 'Drama']",1980,0
28074722,Bandhan,1969,['India'],"['Musical', 'Drama', 'Family Film']",1960,9
20361883,Mr Bones 2: Back from the Past,2008,['South Africa'],"['Comedy', 'Fantasy Comedy']",2000,8
26822445,Valliettan,2000,['India'],"['Action', 'Thriller', 'Drama']",2000,0
5536031,Nishabd,2007,['India'],"['Bollywood', 'Drama']",2000,7
2216381,The Intern,2000,['United States of America'],"['Indie', 'Comedy', 'Romance Film', 'Romantic comedy']",2000,0
3096492,Chapter 27,2007,"['Canada', 'United States of America']","['Crime Fiction', 'Indie', 'Biographical film', 'Docudrama', 'Drama']",2000,7
10069983,Wild West Days,1937,['United States of America'],"['Action', 'Black-and-white', 'Western', 'Adventure']",1930,7
12431569,Backfire,1987,"['Canada', 'United States of America']","['Crime Fiction', 'Mystery', 'Thriller', 'Erotic thriller', 'Drama']",1980,7
27863458,Killing Car,1993,['France'],"['Action/Adventure', 'Thriller', 'World cinema']",1990,3
24978786,"Me & You, Us, Forever",2008,['United States of America'],"['Romance Film', 'Romantic drama', 'Drama']",2000,8
19636925,The Wedding Night,1935,['United States of America'],"['Romantic drama', 'Romance Film', 'Melodrama', 'Drama']",1930,5
2399730,Prem Sanyas,1925,"['India', 'Germany', 'Weimar Republic']","['Silent film', 'Black-and-white', 'Indie']",1920,5
26015028,Oru Mukham Pala Mukham,1983,['India'],"['Action', 'Drama']",1980,3
51888,Indiana Jones and the Last Crusade,1989,[],['Adventure'],1980,9
7940609,Wife to be Sacrificed,1974,['Japan'],"['Romantic drama', 'Thriller', 'World cinema', 'Romance Film', 'Drama', 'Softcore Porn', 'Japanese Movies', 'Pornographic movie', 'Erotic thriller', 'Pinku eiga', 'Erotica', 'Adult']",1970,4
2295321,Homicide,1991,['United States of America'],"['Crime Fiction', 'Mystery', 'Thriller', 'Crime Thriller', 'Drama']",1990,1
10855054,Miss Evers' Boys,1997,['United States of America'],"['Courtroom Drama', 'Historical fiction', 'Docudrama', 'Drama', 'Medical fiction']",1990,7
8408054,The Abominable Snow Rabbit,1961,['United States of America'],"['Animation', 'Short Film', 'Comedy', 'Family Film']",1960,1
11437048,Nightmare City,1980,"['Spain', 'Mexico', 'Italy']","['Zombie Film', 'World cinema', 'Horror']",1980,0
15510725,Les 3 P'tits Cochons,2007,['Canada'],"['Comedy-drama', 'Family Drama', 'Comedy']",2000,7
13331336,Wagon Heels,1945,['United States of America'],"['Animation', 'Short Film', 'Western', 'Comedy film', 'Family Film']",1940,5
7513015,The Rains of Ranchipur,1955,['United States of America'],"['Remake', 'Romance Film', 'Natural disaster', 'Disaster', 'Drama']",1950,5
17475229,Lucky Cisco Kid,1940,['United States of America'],"['Action', 'Black-and-white', 'Western']",1940,0
17764658,Born to Be Bad,1934,['United States of America'],"['Black-and-white', 'Romantic drama', 'Romance Film', 'Drama']",1930,4
4705899,In Search of Dr. Seuss,1994,['United States of America'],"['Language & Literature', ""Children's Fantasy"", ""Children's/Family""]",1990,4
5589759,Mounam Pesiyadhe,2002,['India'],['Romantic comedy'],2000,2
75270,The Outlaw Josey Wales,1976,['United States of America'],"['Revisionist Western', 'Action/Adventure', 'Western', 'War film']",1970,6
4346063,Priyasakhi,2005,['India'],"['Musical', 'Romantic drama', 'Bollywood', 'World cinema', 'Romance Film', 'Drama']",2000,5
18066436,Empire of Passion,1978,"['France', 'Japan']","['Crime Fiction', 'Japanese Movies', 'Art film', 'World cinema', 'Drama']",1970,8
4742175,Mortuary,2006,['United States of America'],"['Zombie Film', 'Cult', 'Horror']",2000,6
3266309,Flight of the Phoenix,2004,['United States of America'],"['Action', 'Airplanes and airports', 'Film adaptation', 'Action/Adventure', 'Disaster', 'Adventure', 'Drama']",2000,4
3818512,"15, Park Avenue",2005,['India'],"['Musical', 'Art film', 'Romantic drama', 'Bollywood', 'World cinema', 'Romance Film', 'Drama']",2000,5
1110047,October Sky,1999,['United States of America'],"['Film adaptation', 'Family Drama', 'Biography', 'Biographical film', 'Drama', 'Period piece', 'Coming of age', 'Family Film']",1990,9
5278636,The Pink Panther 2,2009,['United States of America'],"['Action', 'Detective fiction', 'Crime Fiction', 'Mystery', 'Action/Adventure', 'Comedy', 'Slapstick', 'Detective', 'Crime Comedy', 'Family Film']",2000,9
12640256,Candy Mountain,1987,"['Canada', 'France']","['Drama', 'Indie', 'Musical Drama', 'Comedy-drama', 'Road movie', 'Comedy of Errors']",1980,7
556241,Robin Hood: Men in Tights,1993,"['United States of America', 'France']","['Parody', 'Comedy', 'Slapstick', 'Adventure']",1990,3
29223770,The Boy Who Stole a Million,1960,['United Kingdom'],['Comedy-drama'],1960,0
6552222,Bluebeard,1944,['United States of America'],"['Suspense', 'Black-and-white', 'Crime Fiction', 'Mystery', 'Thriller', 'Film noir']",1940,4
28835025,Shola Aur Shabnam,1961,['India'],"['Drama', 'Family Film']",1960,1
839547,Young Mr. Lincoln,1939,['United States of America'],"['Black-and-white', 'Biography', 'Biopic [feature]', 'Historical fiction', 'Political drama', 'Drama', 'Courtroom Drama']",1930,9
7324939,Navarasa,2005,['India'],['Drama'],2000,5
18499806,Edge of the City,1957,['United States of America'],"['Black-and-white', 'Crime Fiction', 'Drama']",1950,7
5326407,Perceval le Gallois,1979,"['France', 'Germany', 'Italy']",['World cinema'],1970,9
2510954,An Unfinished Life,2005,"['Germany', 'United States of America']","['Melodrama', 'Family Drama', 'Drama']",2000,5
36465711,The Satisfiers of Alpha Blue,1980,['United States of America'],['Pornographic movie'],1980,0
4342090,Red Cockroaches,2003,['Cuba'],"['Science Fiction', 'Drama', 'Horror']",2000,3
22740691,Map of the Sounds of Tokyo,2009,['Spain'],"['Crime Fiction', 'Romantic drama', 'Thriller', 'World cinema', 'Romance Film', 'Crime Thriller', 'Drama']",2000,9
307080,La Bamba,1987,['United States of America'],"['Musical', 'Biography', 'Biographical film', 'Docudrama', 'Drama', 'Tragedy', 'Period piece', 'Biopic [feature]']",1980,7
26953347,God Forgives... I Don't!,1969,['Italy'],"['Action', 'Action/Adventure', 'Western', 'World cinema', 'Spaghetti Western']",1960,9
113445,Tender Mercies,1983,['United States of America'],"['Musical', 'Drama', 'Indie', 'Family Drama', 'Romantic drama', 'Romance Film', 'Christian film']",1980,3
7272571,Lycanthrope,1999,['United States of America'],['Horror'],1990,9
6455928,The Girl Who Leapt Through Time,2006,['Japan'],"['Animation', 'World cinema', 'Romance Film', ""Children's/Family"", ""Children's Fantasy"", 'Japanese Movies', 'Coming of age', 'Anime', 'Fantasy']",2000,6
10640941,Maaveeran,1986,['India'],['Action'],1980,6
2513887,Queen Christina,1933,['United States of America'],"['Historical drama', 'Biographical film', 'Drama']",1930,3
4762648,University of Laughs,2004,['Japan'],['Japanese Movies'],2000,4
17987664,Caregiver,2008,['Philippines'],"['Filipino Movies', 'Drama', 'World cinema']",2000,8
6973699,And God Created Woman,1988,['United States of America'],"['Indie', 'Comedy', 'Remake', 'Romantic comedy', 'Drama']",1980,8
64394,Goodfellas,1990,['United States of America'],"['Film adaptation', 'Crime Fiction', 'Gangster Film', 'Biographical film', 'Thriller', 'Crime Drama', 'Drama']",1990,0
25990872,1st to Die,2003,[],"['Action', 'Psychological thriller', 'Film adaptation', 'Crime Fiction', 'Mystery', 'Action/Adventure', 'Thriller', 'Crime Thriller', 'Drama', 'Television movie']",2000,3
12759686,The Burrowers,2008,['United States of America'],"['Action/Adventure', 'Western', 'Science Fiction', 'Horror']",2000,8
19924729,Shakuntala,1940,['India'],"['Historical drama', 'Biographical film']",1940,0
4753099,Big Stan,2007,['United States of America'],"['Action', 'Prison', 'Action/Adventure', 'Comedy', 'Crime Comedy', 'Martial Arts Film']",2000,7
18358585,Paris Holiday,1958,"['Switzerland', 'United States of America']","['Screwball comedy', 'Comedy']",1950,8
16512279,The Garage,1979,['Soviet Union'],"['Drama', 'Comedy']",1970,9
8407597,Beanstalk Bunny,1955,['United States of America'],"['Animated cartoon', 'Short Film', 'Family Film']",1950,5
3151378,Summer Stock,1950,['United States of America'],['Musical'],1950,0
24369142,Payroll,1961,['United Kingdom'],"['Psychological thriller', 'Crime Fiction', 'Crime Drama', 'Drama']",1960,1
16823471,National Lampoon's Pucked,2006,['United States of America'],"['Sports', 'Slapstick', 'Comedy']",2000,6
21250095,The Hungry Ghosts,2009,['United States of America'],"['Drama', 'Indie', 'Slice of life story', 'Ensemble Film']",2000,9
1790524,Carry On Camping,1969,['United Kingdom'],"['Sex comedy', 'Comedy', 'Slapstick', 'Absurdism']",1960,9
76368,Sunset Boulevard,1950,['United States of America'],"['Film noir', 'Drama']",1950,0
3737023,Who's Singin' over There?,1980,['Yugoslavia'],['Comedy'],1980,0
2576435,Ring of Bright Water,1969,['United Kingdom'],"['Family Drama', 'Animal Picture', 'Family-Oriented Adventure', ""Children's/Family"", 'Adventure', 'Drama', 'Family Film']",1960,9
10037860,Gold Diggers: The Secret of Bear Mountain,1995,"['Canada', 'United States of America']","['Family-Oriented Adventure', ""Children's/Family"", 'Adventure', 'Drama']",1990,5
7305989,Abominable,2006,['United States of America'],"['Thriller', 'Horror']",2000,6
10893024,Able Edwards,2004,['United States of America'],"['Black-and-white', 'Drama', 'Parody', 'Indie', 'Comedy', 'Experimental film', 'Science Fiction']",2000,4
22787868,Louisa,1950,['United States of America'],"['Black-and-white', 'Comedy', 'Romance Film', 'Romantic comedy', 'Domestic Comedy']",1950,0
2990847,It's Alive,1974,['United States of America'],"['Monster movie', 'Horror']",1970,4
12569994,Alfred the Great,1969,['United Kingdom'],"['Action', 'Costume Adventure', 'Costume drama', 'Adventure', 'Drama', 'Period piece', 'Historical fiction', 'War film']",1960,9
28002998,Eichmann,2007,"['Hungary', 'United Kingdom']","['History', 'Biography', 'Biographical film', 'War film', 'Drama']",2000,7
16048756,Kamen Rider Den-O & Kiva: Climax Deka,2008,[],['Drama'],2000,8
17611985,Three Monkeys,2008,"['France', 'Turkey', 'Italy']","['Mystery', 'Thriller', 'World cinema', 'Melodrama', 'Drama', 'Ensemble Film']",2000,8
15173704,Little Toys,1933,['China'],"['Silent film', 'War film', 'Drama']",1930,3
27691005,Polizón a bordo,1941,['Spain'],[],1940,1
25513116,Decalogue I,1988,['Poland'],['Drama'],1980,8
20864101,SupahPapalicious,2008,['Philippines'],"['Filipino Movies', 'Comedy', 'World cinema', 'Romance Film', 'Romantic comedy']",2000,8
13915390,Mrigaya,1989,['India'],['Drama'],1980,9
4128830,Frostbite,2006,['Sweden'],"['Comedy horror', 'Indie', 'Comedy', 'Horror', 'World cinema', 'Black comedy']",2000,6
286266,Stalker,1979,"['Russia', 'Soviet Union', 'Germany']","['Science Fiction', 'World cinema']",1970,9
5474325,The Return of a Man Called Horse,1976,['United States of America'],"['Revisionist Western', 'Action/Adventure', 'Western', 'Adventure', 'Drama']",1970,6
4741992,Bite the Bullet,1975,['United States of America'],"['Costume Adventure', 'Chase Movie', 'Action/Adventure', 'Western']",1970,5
5026362,Paranoia 1.0,2004,"['Romania', 'Iceland', 'United States of America']","['Psychological thriller', 'Indie', 'Thriller', 'Crime Thriller', 'Science Fiction']",2000,4
3625302,Robbie,1979,['United Kingdom'],"['Short Film', 'Horror']",1970,9
2406870,Valley Girl,1983,['United States of America'],"['Coming of age', 'Comedy', 'Teen', 'Comedy of manners', 'Romantic comedy', 'Romance Film']",1980,3
241171,Weird Science,1985,['United States of America'],"['Buddy film', 'Comedy', 'Teen', 'Romance Film', 'Science Fiction', 'Cult', 'Fantasy']",1980,5
4112484,Never So Few,1959,['United States of America'],"['Action', 'Drama', 'Action/Adventure', 'Romance Film', 'War film']",1950,9
1188824,The Big Bounce,2004,['United States of America'],"['Heist', 'Crime Fiction', 'Comedy', 'Thriller']",2000,4
8528525,Adventures in Dinosaur City,1992,['United States of America'],"['Adventure', 'Family Film', 'Fantasy']",1990,2
28723481,Lakshmi Kataksham,1970,['India'],['Musical'],1970,0
9466167,Christmas in July,1940,['United States of America'],"['Black-and-white', 'Screwball comedy', 'Comedy', 'Romance Film', 'Romantic comedy', 'Comedy of Errors']",1940,0
21008187,The Nanny Express,2009,['United States of America'],"['Romantic drama', 'Romance Film', 'Television movie', 'Drama']",2000,9
17934960,Spanish Judges,2000,['United States of America'],"['Crime Fiction', 'Indie', 'Thriller', 'Crime Thriller', 'Drama']",2000,0
3307040,Tremors 4: The Legend Begins,2004,['United States of America'],"['Action', 'Action/Adventure', 'Horror Comedy', 'Thriller', 'Comedy', 'Creature Film', 'Western', 'Horror', 'Science Fiction']",2000,4
4499305,The Navigator,1924,['United States of America'],"['Black-and-white', 'Drama', 'Indie', 'Comedy', 'Silent film', 'Slapstick']",1920,4
1377519,Rabbit Fire,1951,['United States of America'],"['Animation', 'Short Film', 'Comedy', 'Family Film']",1950,1
437840,Drunken Master,1978,['Hong Kong'],"['Action', 'Martial Arts Film', 'Action Comedy', 'Action/Adventure', 'Comedy', 'World cinema', 'Chinese Movies']",1970,8
9760696,"El Mismo Amor, la Misma Lluvia",1999,"['Argentina', 'United States of America']","['Drama', 'Indie', 'Comedy', 'Romantic comedy']",1990,9
4118310,Tarzan & Jane,2002,['United States of America'],"['Animated cartoon', 'Animation', ""Children's/Family"", 'Adventure', 'Family Film']",2000,2
19004390,Dubai,2005,['Philippines'],"['Filipino Movies', 'Romance Film', 'Drama']",2000,5
14844801,The Naked Brothers Band: The Sidekick,2008,['United States of America'],"['Music', 'Comedy', 'Documentary', 'Mockumentary']",2000,8
171550,Ulee's Gold,1997,['United States of America'],"['Indie', 'Family Drama', 'Drama']",1990,7
9268438,Hobbi al-Wahid,1960,['Egypt'],"['Romance Film', 'Drama']",1960,0
28788568,The Conspirators,1944,['United States of America'],"['Romance Film', 'Drama', 'Thriller']",1940,4
26077606,Funny Things Happen Down Under,1965,"['New Zealand', 'Australia']",['Musical'],1960,5
304692,Battle Royale,2000,['Japan'],"['Action', 'Japanese Movies', 'Action Thrillers', 'Thriller', 'Adventure', 'Science Fiction', 'Drama']",2000,0
18311588,Daybreak,2008,['Philippines'],"['Filipino Movies', 'LGBT', 'World cinema', 'Drama']",2000,8
3827058,"Au Revoir, UFO",2004,['South Korea'],"['Romance Film', 'Drama']",2000,4
28284316,It All Came True,1940,['United States of America'],"['Crime Fiction', 'Drama', 'Comedy film']",1940,0
2314090,Italian for Beginners,2000,"['Sweden', 'Denmark']","['Romantic drama', 'Comedy', 'World cinema', 'Romance Film', 'Drama', 'Dogme 95', 'Romantic comedy', 'Comedy-drama', 'Ensemble Film']",2000,0
10507423,Marathon Man,1976,['United States of America'],"['Action', 'Psychological thriller', 'Film adaptation', 'Crime Fiction', 'Mystery', 'Thriller', 'Crime Thriller', 'Drama', 'New Hollywood']",1970,6
1474328,Serendipity,2001,['United States of America'],"['Comedy', 'Romance Film', 'Romantic comedy', 'Fantasy']",2000,1
5202494,Dallas: War of the Ewings,1998,['United States of America'],['Drama'],1990,8
14544803,Fuelin' Around,1949,['United States of America'],"['Short Film', 'Black-and-white', 'Comedy']",1940,9
23866633,The Night Strangler,1973,['United States of America'],"['Crime Fiction', 'Mystery', 'Horror']",1970,3
25287793,Flexing with Monty,2008,['United States of America'],"['LGBT', 'Indie', 'Comedy', 'Thriller', 'Black comedy']",2000,8
3822458,Confessions of a Nazi Spy,1939,['United States of America'],"['Action', 'Spy', 'Detective fiction', 'Black-and-white', 'Crime Fiction', 'Mystery', 'Drama', 'Detective', 'War film', 'Propaganda film']",1930,9
10435439,The Warlords,2007,"['China', 'Hong Kong']","['Action', 'Costume Adventure', 'Action/Adventure', 'World cinema', 'Chinese Movies', 'Martial Arts Film', 'Drama', 'Period piece', 'War film']",2000,7
4213599,As You Like It,1936,['United Kingdom'],"['Black-and-white', 'Comedy', 'Romance Film', 'Romantic comedy', 'Costume drama']",1930,6
10731077,Teresa Venerdì,1941,['Italy'],"['Black-and-white', 'Romantic drama', 'Comedy', 'Romance Film', 'Melodrama', 'Comedy-drama']",1940,1
30018178,Krishan Avtaar,1993,['India'],['Action'],1990,3
100274,Hudson Hawk,1991,['United States of America'],"['Action', 'Crime Fiction', 'Action/Adventure', 'Comedy', 'Parody', 'Caper story', 'Action Comedy', 'Crime Comedy']",1990,1
22489028,The Wizard of Gore,2007,['United States of America'],"['Mystery', 'Slasher', 'Splatter film', 'Horror']",2000,7
32907382,The Shadow of Lightning Ridge,1921,[],['Silent film'],1920,1
1071647,Something Wild,1986,['United States of America'],"['Action', 'Crime Fiction', 'Indie', 'Action/Adventure', 'Comedy', 'Black comedy', 'Romance Film', 'Drama', 'Romantic comedy']",1980,6
4354571,Matchstick Men,2003,['United States of America'],"['Film adaptation', 'Crime Fiction', 'Family Drama', 'Comedy', 'Thriller', 'Black comedy', 'Drama', 'Caper story', 'Crime Drama', 'Comedy-drama']",2000,3
24895047,"My Friend, Kolka!",1961,['Soviet Union'],['Drama'],1960,1
2852763,Anbe Sivam,2003,['India'],"['Musical', 'Comedy', 'World cinema', 'Tamil cinema', 'Drama']",2000,3
14144273,Riding with Buffalo Bill,1954,['United States of America'],"['Adventure', 'Black-and-white']",1950,4
15665280,Doraemon: Nobita in the Wan-Nyan Spacetime Odyssey,2004,['Japan'],['Japanese Movies'],2000,4
6242323,Simon,2004,['Netherlands'],"['Comedy', 'Drama', 'World cinema']",2000,4
32181593,Who Drives Me Mad?,1995,['South Korea'],"['Comedy', 'Romance Film', 'Melodrama', 'Drama']",1990,5
23195317,Tokyo: The Last Megalopolis,1988,['Japan'],"['Japanese Movies', 'Horror', 'Anime', 'Adventure', 'Adult', 'Fantasy']",1980,8
10395434,Practically Yours,1944,['United States of America'],"['Black-and-white', 'Comedy', 'Romance Film', 'Comedy of Errors']",1940,4
5875943,Metalstorm: The Destruction of Jared-Syn,1983,['United States of America'],"['Science Fiction', 'Western', 'Adventure']",1980,3
12896715,Dimenticare Palermo,1990,"['France', 'Italy']","['Crime Fiction', 'Thriller', 'Crime Drama', 'Political drama', 'Drama']",1990,0
3528114,"Oh, What a Night",1992,"['Canada', 'United States of America']","['Teen', 'Drama']",1990,2
13604898,Jungle Woman,1944,['United States of America'],"['Black-and-white', 'Jungle Film', 'Horror', 'Sci-Fi Horror', 'Science Fiction', 'Drama']",1940,4
8549241,Get Shorty,1995,['United States of America'],"['Crime Fiction', 'Comedy', 'Thriller', 'Crime Comedy']",1990,5
26100183,See Anthony Run,2005,['United States of America'],['Short Film'],2000,5
18004401,Pappan Priyappetta Pappan,1986,['India'],"['Comedy', 'Fantasy']",1980,6
11977524,Tom and Jerry: Shiver Me Whiskers,2006,['United States of America'],"['Family Film', 'Animation']",2000,6
2099630,The Hill,1965,['United Kingdom'],"['War film', 'Drama']",1960,5
9020005,O Costa do Castelo,1943,['Portugal'],"['Romance Film', 'Comedy']",1940,3
3004194,The Business,2005,['United Kingdom'],"['Action', 'Crime Fiction', 'Gangster Film', 'Comedy', 'Thriller', 'Crime Thriller', 'Drama']",2000,5
24486323,"Peace, Love & Understanding",1992,['United States of America'],"['Animation', 'Short Film', 'Comedy film']",1990,2
7701650,Totally Awesome,2006,"['Canada', 'United States of America']","['Parody', 'Comedy']",2000,6
2513971,The Terror,1963,['United States of America'],"['Thriller', 'Horror', 'B-movie', 'Crime Thriller', 'Supernatural']",1960,3
29068128,Two Deaths,1995,['United Kingdom'],"['Erotic Drama', 'Romantic drama', 'Romance Film', 'War film', 'Drama', 'Period piece', 'Erotic thriller', 'Political drama']",1990,5
3150776,Big Top Bunny,1951,['United States of America'],"[""Children's/Family""]",1950,1
2046012,Creepshow 2,1987,['United States of America'],"['Creature Film', 'Cult', 'Horror']",1980,7
12096671,The Zero Boys,1985,['United States of America'],"['Action', 'Psychological thriller', 'Action/Adventure', 'Slasher', 'Thriller', 'Horror']",1980,5
30415422,Pavithra Bandham,1996,['India'],['Family Film'],1990,6
9381862,Arasatchi,2004,['India'],"['Musical', 'Bollywood', 'World cinema', 'Drama']",2000,4
9936264,The Phantom of the Air,1933,['United States of America'],"['Action', 'Black-and-white', 'Adventure']",1930,3
9796711,Seven Years in Tibet,1997,"['United Kingdom', 'United States of America']","['History', 'Biography', 'Action/Adventure', 'War film', 'Adventure', 'Drama']",1990,7
21006677,Li'l Abner,1940,['United States of America'],['Comedy'],1940,0
3469003,Thumbelina,1994,"['Ireland', 'United States of America']","['Music', 'Animation', ""Children's"", 'Adventure', 'Family Film', 'Fantasy']",1990,4
4845539,Look Who's Talking Now,1993,['United States of America'],"['Animal Picture', 'Domestic Comedy', 'Comedy']",1990,3
2534857,Night of the Creeps,1986,['United States of America'],"['Horror Comedy', 'Comedy', 'Horror', 'Zombie Film', 'Alien Film', 'Sci-Fi Horror', 'Science Fiction']",1980,6
4180278,Inspector Gadget,1999,['United States of America'],"['Action/Adventure', 'Comedy', 'Superhero movie', 'Science Fiction', 'Family Film']",1990,9
17704856,La Linea,2007,"['Mexico', 'United States of America']","['Action', 'Drama', 'Crime Fiction', 'World cinema']",2000,7
9678972,Chandralekha,1995,['India'],"['Romance Film', 'Tragedy']",1990,5
9523974,A.W.O.L.,2006,['United States of America'],"['Psychological thriller', 'Action', 'Drama', 'Indie', 'Short Film', 'Thriller', 'War film']",2000,6
27874961,The Iron Rose,1973,['France'],"['Psychological thriller', 'World cinema', 'Horror']",1970,3
660343,"One, Two, Three",1961,['United States of America'],"['Black-and-white', 'Screwball comedy', 'Political satire', 'Satire', 'Comedy', 'Political cinema', 'Parody', 'Comedy of manners']",1960,1
2368824,The Extra,2005,['Australia'],"['Romance Film', 'Romantic comedy', 'Comedy']",2000,5
8625702,Train to Pakistan,1999,"['United Kingdom', 'India']","['World cinema', 'Historical fiction', 'Political drama', 'Drama']",1990,9
4277883,Home of the Giants,2007,['United States of America'],"['Crime Fiction', 'Indie', 'Crime Drama', 'Sports', 'Drama']",2000,7
948548,Clash of the Titans,1981,['United States of America'],"['Monster', 'Action/Adventure', 'Romance Film', 'Costume drama', 'Adventure', 'Stop motion', 'Family Film', 'Fantasy']",1980,1
24868569,Sau Crore,1991,['India'],"['Musical', 'Bollywood', 'World cinema', 'Drama']",1990,1
3999425,Inferno,1980,['Italy'],"['Slasher', 'Horror', 'World cinema', 'Supernatural']",1980,0
1094668,Asoka,2001,['India'],"['Action', 'Musical', 'Romantic drama', 'Bollywood', 'World cinema', 'Romance Film', 'Drama', 'History', 'Epic', 'War film']",2000,1
10583724,Diamond Jim,1935,['United States of America'],"['Black-and-white', 'Biographical film', 'Biopic [feature]', 'Docudrama', 'Drama']",1930,5
6701473,Star,2001,['India'],['World cinema'],2000,1
27484031,Left Bank Linkeroever,2008,['Belgium'],"['Thriller', 'World cinema', 'Sports', 'Drama']",2000,8
28896404,The Sainted Sisters,1948,['United States of America'],['Comedy'],1940,8
4120842,The Pirates Who Don't Do Anything: A VeggieTales Movie,2008,['United States of America'],"['Music', 'Fantasy Adventure', 'Animation', 'Comedy', 'Christian film', ""Children's/Family"", ""Children's"", ""Children's Fantasy""]",2000,8
30640377,Manamagan Thevai,1957,['India'],"['Drama', 'Comedy film']",1950,7
14299993,The Crimson Charm,1971,['Hong Kong'],"['Wuxia', 'Chinese Movies']",1970,1
5984222,Cry Uncle!,1971,['United States of America'],"['Black comedy', 'Comedy']",1970,1
430975,Harvard Man,2002,"['Canada', 'United States of America']","['Crime Fiction', 'Gangster Film', 'Indie', 'Thriller', 'Black comedy', 'Crime Thriller', 'Drama', 'Comedy of Errors', 'Coming of age', 'Crime Drama', 'Comedy-drama', 'Sports']",2000,2
19590392,Calling Bulldog Drummond,1951,['United Kingdom'],"['Spy', 'Crime Fiction', 'Mystery']",1950,1
885308,Laws of Attraction,2004,"['United Kingdom', 'Germany', 'Ireland', 'United States of America']","['Screwball comedy', 'Comedy', 'Romance Film', 'Romantic comedy']",2000,4
9996003,Magnificent Bodyguards,1978,"['China', 'Hong Kong']","['Action', 'Period piece', 'Action/Adventure', 'World cinema', 'Chinese Movies', 'Martial Arts Film']",1970,8
30751678,Wrestlemaniac,2005,['United States of America'],['Horror'],2000,5
8302293,The Restless,2006,['South Korea'],"['Family Drama', 'Action/Adventure', 'Romantic drama', 'World cinema', 'Romance Film', 'Martial Arts Film', 'Drama', 'Fantasy']",2000,6
9104215,Woh Kaun Thi?,1964,['India'],"['Black-and-white', 'Bollywood']",1960,4
12564335,From Within,2009,['United States of America'],"['Psychological thriller', 'Mystery', 'Thriller', 'Horror', 'Cult']",2000,9
8049233,Of Human Bondage,1934,['United States of America'],"['Film adaptation', 'Black-and-white', 'Romance Film', 'Pre-Code', 'Drama']",1930,4
22683298,Hum Tum Pe Marte Hain,1999,['India'],['Romance Film'],1990,9
7003043,Gray Matters,2007,['United States of America'],"['LGBT', 'Indie', 'Comedy', 'Romance Film', 'Romantic comedy']",2000,7
13872901,Seema Simham,2002,['India'],['Action'],2000,2
29881363,Yummy Yummy,1998,[],['Short Film'],1990,8
16202712,Something Money Can't Buy,1952,['United Kingdom'],['Comedy-drama'],1950,2
24087983,Night of Henna,2008,['United States of America'],['Indie'],2000,8
27831415,Nair Saab,1989,['India'],"['Action', 'Drama']",1980,9
1856185,Jeffrey,1995,['United States of America'],"['LGBT', 'Indie', 'Comedy', 'Romance Film', 'Drama', 'Gay Themed', 'Gay', 'Gay Interest', 'Romantic comedy', 'Sex comedy']",1990,5
3316533,Poltergeist III,1988,['United States of America'],['Horror'],1980,8
10192270,Follow the Sun,1951,['United States of America'],"['Comedy', 'Biographical film', 'Sports', 'Drama']",1950,1
12421231,The Brave Engineer,1950,['United States of America'],"['Animation', 'Short Film', 'Comedy', 'Family Film']",1950,0
14233418,100 Women,2002,['United States of America'],"['Indie', 'Comedy', 'Romance Film', 'Romantic comedy']",2000,2
1010796,The Gate,1987,"['Canada', 'United States of America']","['Indie', 'Horror', 'Zombie Film', 'Stop motion']",1980,7
840058,42nd Street,1933,['United States of America'],"['Musical', 'Black-and-white', 'Backstage Musical', 'Musical comedy', 'Pre-Code']",1930,3
1744708,Margaret's Museum,1995,"['Canada', 'United Kingdom']","['Period piece', 'Romantic drama', 'Indie', 'Romance Film', 'Drama']",1990,5
29129627,Les gens qui s'aiment,1999,"['Spain', 'Luxembourg', 'Belgium', 'France']","['Drama', 'Comedy']",1990,9
5569740,The Junky's Christmas,1993,['United States of America'],"['Short Film', 'Animation']",1990,3
7347460,We're Not Dressing,1934,['United States of America'],"['Musical', 'Comedy', 'Musical comedy', 'Ensemble Film']",1930,4
5045255,Attagasam,2004,['India'],"['Action', 'Tollywood', 'Thriller']",2000,4
1164535,Road Trip,2000,['United States of America'],"['Stoner film', 'Comedy', 'Adventure', 'Sex comedy']",2000,0
12378678,Bear Feat,1947,['United States of America'],"['Short Film', 'Animation']",1940,7
25910532,A Dog of Flanders,1999,['United States of America'],"['Period piece', 'Family Drama', 'Drama', 'Family Film']",1990,9
1796156,Coma,1978,['United States of America'],"['Suspense', 'Film adaptation', 'Mystery', 'Thriller']",1970,8
16167372,Kadhal Virus,2002,['India'],"['Romantic drama', 'World cinema', 'Romance Film', 'Drama']",2000,2
22240282,The Meerkats,2008,['United Kingdom'],"['Animals', 'Educational', 'Documentary', 'Nature']",2000,8
26093388,Baby Blue Marine,1976,['United States of America'],['Drama'],1970,6
580994,The Man in the Gray Flannel Suit,1956,['United States of America'],['Drama'],1950,6
4646185,The Sum of All Fears,2002,"['Germany', 'United States of America']","['Action', 'Spy', 'Film adaptation', 'Action Thrillers', 'Action/Adventure', 'Thriller', 'Drama', 'Suspense', 'Doomsday film', 'War film', 'Political thriller']",2000,2
9082223,If all the Guys in the World,1955,"['France', 'West Germany']","['Black-and-white', 'Adventure', 'Drama']",1950,5
18112074,Jack Brown Genius,1996,"['New Zealand', 'Australia']","['World cinema', 'Fantasy']",1990,6
10699799,Prem Nagar,1974,['India'],['Bollywood'],1970,4
12497755,Wag Kang Lilingon,2006,['Philippines'],"['Filipino Movies', 'World cinema', 'Horror']",2000,6
4217166,There's Only One Jimmy Grimble,1999,"['United Kingdom', 'France']","['Comedy-drama', 'Comedy', 'Teen']",1990,9
20636989,The Passing of Mr. Quinn,1928,['United Kingdom'],['Mystery'],1920,8
1809543,Armaan,1966,['Pakistan'],"['Black-and-white', 'Comedy', 'Drama']",1960,6
3318002,District B13,2004,['France'],"['Action', 'Crime Fiction', 'Action Thrillers', 'Action/Adventure', 'Thriller', 'World cinema', 'Parkour in popular culture', 'Martial Arts Film', 'Science Fiction']",2000,4
4586256,How to Make a Monster,1958,['United States of America'],"['Horror', 'Science Fiction']",1950,8
8580865,Namastey London,2007,['India'],"['Romantic drama', 'Comedy', 'Bollywood', 'World cinema', 'Romance Film', 'Romantic comedy', 'Drama']",2000,7
5045155,For Heaven's Sake,1926,['United States of America'],"['Black-and-white', 'Indie', 'Comedy', 'Silent film']",1920,6
6713041,Diary of the Dead,2007,['United States of America'],"['Indie', 'Action/Adventure', 'Horror', 'Zombie Film', 'Disaster', 'Science Fiction']",2000,7
4359960,Rebels,2001,['Czech Republic'],"['Musical', 'Coming of age', 'Comedy', 'Musical comedy', 'Romance Film', 'Comedy-drama']",2000,1
935425,Manderlay,2005,"['Switzerland', 'Sweden', 'Israel', 'France', 'Spain', 'Denmark', 'Argentina', 'United Kingdom', 'Germany', 'Netherlands', 'United States of America']","['Period piece', 'Drama', 'Indie', 'Avant-garde', 'World cinema', 'Experimental film', 'Melodrama']",2000,5
7318083,Enjo,1958,['Japan'],"['Black-and-white', 'Japanese Movies', 'Drama']",1950,8
1362608,Material Girls,2006,['United States of America'],"['Comedy', 'Satire', 'Teen', 'Romance Film', 'Romantic comedy']",2000,6
12813383,Two Smart People,1946,['United States of America'],"['Black-and-white', 'Crime Fiction', 'Comedy', 'Crime Comedy', 'Drama']",1940,6
7287758,Destricted,2006,"['United Kingdom', 'United States of America']","['LGBT', 'Indie', 'Avant-garde', 'Romance Film', 'Drama', 'Short Film', 'Hardcore pornography', 'Experimental film', 'Adult']",2000,6
6602433,God Wants Me To Forgive Them!?!,1994,[],"['Musical', 'Animation', 'Short Film', ""Children's""]",1990,4
2694295,Duelist,2005,['South Korea'],"['Action', 'Mystery', 'Martial Arts Film']",2000,5
4916040,The Caiman,2006,"['France', 'Italy']","['Romance Film', 'Comedy', 'Drama']",2000,6
20529563,The Perfect Couple,2007,['South Korea'],['Romantic comedy'],2000,7
8356351,The Valachi Papers,1972,"['France', 'Italy', 'United States of America']","['Film adaptation', 'Crime Fiction', 'Biopic [feature]', 'World cinema', 'Crime Drama', 'Docudrama', 'Drama']",1970,2
20348262,Moon,2009,['United Kingdom'],"['Psychological thriller', 'Science Fiction', 'Thriller']",2000,9
10931912,Bastard Swordsman,1983,['Hong Kong'],"['Wuxia', 'Chinese Movies', 'Martial Arts Film']",1980,3
27754332,Sammy Going South,1963,['United Kingdom'],"['Adventure', ""Children's/Family""]",1960,3
4254331,405,2000,['United States of America'],"['Action', 'Indie', 'Short Film', 'Comedy', 'Thriller']",2000,0
15609471,Expresso,2007,['United Kingdom'],"['Short Film', 'Comedy']",2000,7
2589373,Gordy,1995,['United States of America'],"[""Children's Fantasy"", 'Comedy', 'Animal Picture', ""Children's/Family"", 'Family Film']",1990,5
32610315,Live Evil,2008,['United States of America'],"['B-movie', 'Horror Comedy', 'Horror']",2000,8
23621135,Cannibal Terror,1981,['France'],"['Slasher', 'B-movie', 'Horror']",1980,1
2357737,The Russian Dolls,2005,"['United Kingdom', 'France']","['Romantic drama', 'Comedy', 'World cinema', 'Romance Film', 'Romantic comedy', 'Drama']",2000,5
13332421,Grandma's Boy,1922,['United States of America'],"['Comedy-drama', 'Family Film']",1920,2
7839293,Saatanan radikaalit,1971,['Finland'],['Comedy'],1970,1
15922019,Tesna koža,1982,['Yugoslavia'],['Comedy'],1980,2
3663004,Running On Empty,1982,['Australia'],"['Action', 'Drama', 'Coming of age']",1980,2
1416638,The Incredible Mr. Limpet,1964,['United States of America'],"['Animation', 'Comedy', 'Fantasy Comedy', 'Drama', 'Family Film', 'Fantasy']",1960,4
7062627,Emmtan-Magan,2006,['India'],"['Romance Film', 'Drama']",2000,6
3222171,Alvin and the Chipmunks Meet the Wolfman,2000,['United States of America'],"['Animation', 'Family Film', 'Horror']",2000,0
10394962,Daughters of Destiny,1954,"['France', 'Italy']","['Black-and-white', 'Comedy', 'Comedy-drama', 'Drama']",1950,4
13070578,Nothing to Lose,2002,"['Hong Kong', 'Singapore', 'Thailand']","['Crime Fiction', 'Comedy', 'Chinese Movies', 'Drama']",2000,2
4288454,The New Barbarians,1983,['Italy'],"['Action', 'Action/Adventure', 'Thriller', 'World cinema', 'Apocalyptic and post-apocalyptic fiction', 'Adventure', 'Dystopia', 'Science Fiction']",1980,3
25414990,Nomos 4000,1962,['Greece'],['Drama'],1960,2
1456011,The Final Season,2007,['United States of America'],"['Indie', 'Americana', 'Sports', 'Drama']",2000,7
25687480,Four Faces West,1948,['United States of America'],"['Action', 'Drama', 'Action/Adventure', 'Western']",1940,8
443556,Monster,2003,"['Germany', 'United States of America']","['Period piece', 'LGBT', 'Crime Fiction', 'Drama', 'Biography', 'Indie', 'Biographical film']",2000,3
10712737,Cleaver,2007,['United States of America'],"['Short Film', 'Comedy', 'Documentary', 'Drama']",2000,7
1564113,The Big Heat,1953,['United States of America'],"['Suspense', 'Black-and-white', 'Crime Fiction', 'Film noir', 'Drama']",1950,3
25129197,The Image,1969,['United Kingdom'],"['Short Film', 'Horror']",1960,9
2798426,Auto Focus,2002,['United States of America'],"['Period piece', 'Drama', 'Crime Fiction', 'Indie', 'Biography', 'Biographical film', 'Biopic [feature]']",2000,2
1331578,White Noise,2005,"['United Kingdom', 'United States of America', 'Canada']","['Supernatural', 'Thriller']",2000,5
21405106,Trishna,2009,['India'],['Drama'],2000,9
15544513,The Umbrella Coup,1980,['France'],"['Comedy', 'Crime Fiction']",1980,0
19884979,The Last Producer,2000,['United States of America'],"['Action', 'Drama', 'Indie', 'Action/Adventure', 'Comedy', 'Black comedy']",2000,0
17028085,Forever the Moment,2008,['South Korea'],"['Sports', 'Inspirational Drama', 'Drama']",2000,8
33585127,Ghosts,2005,"['France', 'Germany']","['LGBT', 'Thriller', 'World cinema']",2000,5
4891218,To the Devil a Daughter,1976,"['United Kingdom', 'West Germany']","['Supernatural', 'Cult', 'Horror']",1970,6
6768266,Paap,2004,['India'],"['Crime Fiction', 'Romantic drama', 'World cinema', 'Romance Film', 'Drama']",2000,4
12757367,Mon fils à moi,2006,"['France', 'Belgium']",['Drama'],2000,6
22645212,De zwarte meteoor,2000,['Netherlands'],"['Sports', 'Drama']",2000,0
1948742,Udayananu Tharam,2005,['India'],['Comedy film'],2000,5
18388326,You Can't Take It With You,1938,['United States of America'],"['Black-and-white', 'Screwball comedy', 'Comedy', 'Romance Film', 'Romantic comedy']",1930,8
18640799,Ghajini,2008,['India'],"['Action', 'Mystery', 'Thriller', 'Bollywood', 'Romance Film', 'Drama']",2000,8
4165797,Séraphin: un homme et son péché,2002,['Canada'],"['Period piece', 'Romantic drama', 'Romance Film', 'Drama']",2000,2
26617962,Dard,1981,['India'],"['Bollywood', 'Crime Fiction']",1980,1
7756010,Anna and the Moods,2007,['Iceland'],"['Short Film', 'Animation']",2000,7
3816065,Torremolinos 73,2003,"['Spain', 'Denmark']","['Period piece', 'Comedy', 'World cinema', 'Comedy-drama', 'Drama', 'Sex comedy']",2000,3
20067217,Chance of a Lifetime,1951,['United Kingdom'],['Drama'],1950,1
3654682,Fists in the Pocket,1965,['Italy'],"['Black-and-white', 'Horror', 'World cinema', 'Drama']",1960,5
2805992,Barsaat,2005,['India'],"['Romantic drama', 'World cinema', 'Romance Film', 'Drama']",2000,5
29366077,The Golden Lady,1979,"['United Kingdom', 'Hong Kong']","['Action', 'Spy', 'Thriller', 'Chinese Movies', 'Adventure']",1970,9
11137131,Sylvia,1965,['United States of America'],['Drama'],1960,5
21756406,Aranya Rodan,1992,['India'],"['Drama', 'Crime Fiction']",1990,2
18760155,Hazaar Chaurasi Ki Maa,1998,['India'],"['Drama', 'World cinema']",1990,8
5474385,American Perfekt,1997,['United States of America'],"['Action', 'Psychological thriller', 'Crime Fiction', 'Action Thrillers', 'Action/Adventure', 'Thriller', 'Crime Thriller', 'Drama']",1990,7
8582101,Bednye Rodstvenniki,2005,['Russia'],['Comedy'],2000,5
9398346,The Search for One-eye Jimmy,1994,['United States of America'],['Comedy'],1990,4
4765882,Unaccustomed As We Are,1929,['United States of America'],"['Black-and-white', 'Short Film', 'Comedy', 'Slapstick']",1920,9
14708304,Crank: High Voltage,2009,['United States of America'],"['Action', 'Crime Fiction', 'Comedy', 'Thriller']",2000,9
860223,Black XXX-Mas,1999,['Belgium'],"['Short Film', 'Comedy film']",1990,9
25918008,Deep Freeze,2003,['United States of America'],"['Horror', 'B-movie']",2000,3
22523378,New Town Killers,2008,['United Kingdom'],"['Psychological thriller', 'Chase Movie', 'Indie', 'Thriller', 'Crime Thriller']",2000,8
18427933,A Dispatch from Reuters,1940,['United States of America'],"['Black-and-white', 'Biographical film', 'Biopic [feature]', 'Historical fiction', 'Docudrama', 'Drama']",1940,0
30683911,Lake Consequence,1993,['United States of America'],"['LGBT', 'Softcore Porn', 'Drama', 'Romance Film', 'Melodrama', 'Adult']",1990,3
27326318,Ottakkayyan,2007,[],['Thriller'],2000,7
4791264,Zazie dans le Métro,1960,"['France', 'Italy']","['Comedy', 'World cinema']",1960,0
22275512,The Last Gangster,1937,['United States of America'],"['Drama', 'Crime Fiction']",1930,7
3377846,Crime and Punishment in Suburbia,2000,['United States of America'],"['Crime Fiction', 'Indie', 'Drama']",2000,0
1374292,High Crimes,2002,['United States of America'],"['Psychological thriller', 'Mystery', 'Thriller', 'Crime Thriller', 'Drama', 'Courtroom Drama']",2000,2
17890202,Rama Ram Kya Hai Drama,2008,['India'],"['Musical', 'Comedy', 'Bollywood', 'World cinema', 'Romance Film', 'Drama']",2000,8
23315871,Saikin-rettō,2009,['Japan'],"['Parody', 'Japanese Movies']",2000,9
3756621,My Wife is a Gangster 2,2003,['South Korea'],"['Action/Adventure', 'World cinema']",2000,3
972958,The Transporter,2002,"['France', 'United States of America']","['Action', 'Action Thrillers', 'Action/Adventure', 'Thriller', 'Crime Thriller', 'Martial Arts Film']",2000,2
3699931,Undisputed,2002,"['Germany', 'United States of America']","['Action', 'Boxing', 'Prison', 'Crime Fiction', 'Action/Adventure', 'Thriller', 'Drama', 'Sports']",2000,2
23433487,Assault of Darkness,2009,['Ireland'],['Horror'],2000,9
548239,Dogfight,1991,['United States of America'],"['Period piece', 'Coming of age', 'Romantic drama', 'Romance Film', 'Drama']",1990,1
527414,Cannibal! The Musical,1996,['United States of America'],"['Musical', 'Indie', 'Hybrid Western', 'Comedy', 'Horror Comedy', 'Musical comedy', 'Parody', 'Horror', 'Cult']",1990,6
10839638,Great Expectations,1999,['United Kingdom'],"['Costume drama', 'Drama']",1990,9
11143195,Melnattu Marumagal,1975,['India'],['Romance Film'],1970,5
25955119,Butterfly Kiss,2006,['Russia'],"['Action', 'Romance Film', 'Crime Fiction']",2000,6
2755190,Berlin Express,1948,['United States of America'],"['Action', 'Black-and-white', 'Spy', 'Action Thrillers', 'Thriller', 'Film noir', 'Drama']",1940,8
1013377,Pretty Baby,1978,['United States of America'],"['History', 'Drama']",1970,8
2456645,Wilt,1989,['United Kingdom'],"['Comedy film', 'Crime Fiction']",1980,9
6741028,Our Song,2000,['United States of America'],"['Coming of age', 'Indie', 'Drama', 'Feminist Film']",2000,0
20166236,Dada's Dance,2008,['China'],"['Coming of age', 'World cinema', 'Chinese Movies', 'Drama']",2000,8
1335244,Electric Dreams,1984,"['United Kingdom', 'United States of America']","['Drama', 'Comedy', 'Romantic comedy', 'Science Fiction', 'Fantasy Comedy']",1980,4
9172170,Extermineitors IV: Como hermanos gemelos,1992,['Argentina'],"['Action', 'Comedy', 'Adventure', 'Family Film']",1990,2
2065224,Dil Ka Rishta,2003,['India'],"['Romance Film', 'Romantic drama', 'Bollywood']",2000,3
26736842,Identity Unknown,1945,['United States of America'],"['Drama', 'War film', 'Thriller']",1940,5
4410141,The Nanny Diaries,2007,['United States of America'],"['Workplace Comedy', 'Film adaptation', 'Comedy', 'Romance Film', 'Romantic comedy', 'Comedy-drama', 'Drama']",2000,7
6238106,The Darjeeling Limited,2007,['United States of America'],"['Indie', 'Comedy', 'Comedy-drama', 'Road movie', 'Adventure', 'Drama']",2000,7
15181224,Aliens in the Attic,2009,"['Canada', 'United States of America']","['Comedy', 'Adventure', 'Family-Oriented Adventure', ""Children's/Family"", 'Science Fiction', 'Family Film', 'Fantasy']",2000,9
4396698,Deal of the Century,1983,['United States of America'],"['Parody', 'Satire', 'Comedy']",1980,3
290633,The Object of My Affection,1998,['United States of America'],"['LGBT', 'Comedy', 'Romance Film', 'Drama', 'Gay Themed', 'Gay', 'Gay Interest', 'Romantic comedy', 'Comedy-drama']",1990,8
6439404,I Like It Like That,1994,['United States of America'],"['LGBT', 'Indie', 'Family Drama', 'Drama', 'Comedy', 'Romance Film', 'Comedy-drama']",1990,4
9293418,Whisky Galore!,1949,"['United Kingdom', 'Scotland']","['Ealing Comedies', 'Black-and-white', 'Comedy']",1940,9
11929259,Saratoga,1937,['United States of America'],"['Romance Film', 'Romantic comedy', 'Drama']",1930,7
12800555,Roberta,1935,['United States of America'],"['Musical', 'Black-and-white']",1930,5
6075313,Sitting Bull,1954,"['Mexico', 'United States of America']","['Cavalry Film', 'Western', 'Indian Western']",1950,4
9609238,The Lone Defender,1930,['United States of America'],"['Action', 'Black-and-white', 'Western', ""Children's/Family"", 'Adventure', 'Drama', 'Family Film']",1930,0
22277632,Transmorphers: Fall of Man,2009,['United States of America'],"['Action', 'Indie', 'Science Fiction']",2000,9
15082206,The Sannikov Land,1973,['Soviet Union'],"['Adventure', 'Fantasy']",1970,3
11665498,REC,2007,['Spain'],"['Horror', 'World cinema', 'Romance Film', 'Zombie Film', 'Supernatural']",2000,7
14844719,My Mother and Her Guest,1961,['South Korea'],"['Romance Film', 'Drama']",1960,1
1267059,The Sea Inside,2004,"['France', 'Spain', 'Italy']","['Biographical film', 'Biopic [feature]', 'World cinema', 'Drama']",2000,4
6060651,Who Was That Lady?,1960,['United States of America'],"['Black-and-white', 'Indie', 'Comedy']",1960,0
15871712,Citizen Duane,2006,['Canada'],"['Comedy', 'Teen']",2000,6
8644317,Waking Up in Reno,2002,['United States of America'],"['Comedy', 'Comedy of manners', 'Romance Film', 'Romantic comedy', 'Road movie', 'Drama']",2000,2
1141059,The Clearing,2004,"['Germany', 'United States of America']","['Psychological thriller', 'Crime Fiction', 'Mystery', 'Thriller', 'Crime Thriller', 'Drama']",2000,4
11137167,Inkaar,1978,['India'],"['Mystery', 'Thriller', 'World cinema']",1970,8
3990450,The Great Buck Howard,2008,['United States of America'],"['Indie', 'Comedy', 'Comedy-drama', 'Drama']",2000,8
20034976,Coming Out,2000,['South Korea'],['Short Film'],2000,0
17390669,Night of the Running Man,1994,['United States of America'],"['Action', 'Film adaptation', 'Crime Fiction', 'Action/Adventure', 'Thriller', 'Crime Thriller', 'Drama', 'Suspense']",1990,4
25227518,Jesse Stone: Sea Change,2007,['United States of America'],"['Film adaptation', 'Crime Fiction', 'Thriller', 'Television movie', 'Crime Thriller', 'Drama']",2000,7
12287985,Till Human Voices Wake Us,2002,"['New Zealand', 'Australia', 'United States of America']","['Mystery', 'Romantic drama', 'Thriller', 'World cinema', 'Romance Film', 'Drama']",2000,2
25939183,Across the Hall,2009,['United States of America'],"['Psychological thriller', 'Thriller', 'Erotic thriller', 'Crime Thriller']",2000,9
5907962,Daivanamathil,2005,['India'],"['Drama', 'Malayalam Cinema']",2000,5
22508943,Wannabes,2000,['United States of America'],"['Crime Fiction', 'Gangster Film', 'Crime Thriller', 'Drama']",2000,0
14375363,Raven's End,1963,['Sweden'],"['Black-and-white', 'Drama']",1960,3
3059526,The Park,2003,"['Hong Kong', 'Thailand']","['Chinese Movies', 'World cinema', 'Horror', 'Drama']",2000,3
1666977,Musafir,2004,['India'],"['Action', 'Crime Fiction', 'Action/Adventure', 'Thriller', 'World cinema', 'Drama']",2000,4
7885300,Kireedam,2007,['India'],['Drama'],2000,7
12574857,Bow Barracks Forever,2004,['India'],"['Indie', 'Drama', 'World cinema']",2000,4
30528116,Trick Baby,1972,['United States of America'],"['Action', 'Blaxploitation', 'Drama', 'Crime Fiction', 'Action/Adventure']",1970,2
888336,Stitch! The Movie,2003,['United States of America'],"[""Children's Fantasy"", 'Animation', 'Comedy', ""Children's/Family"", ""Children's"", 'Family Film']",2000,3
11524447,Franz Liszt. Dreams of love,1970,"['Hungary', 'Soviet Union']","['Musical', 'Romance Film', 'Drama']",1970,0
2075256,Cruising,1980,['United States of America'],"['Action', 'Film adaptation', 'LGBT', 'Crime Fiction', 'Action/Adventure', 'Thriller', 'Crime Thriller', 'Drama', 'New Hollywood']",1980,0
18850187,1920,2008,['India'],"['Musical', 'Thriller', 'Bollywood', 'Horror', 'World cinema']",2000,8
1649228,Easy Virtue,1928,['United Kingdom'],"['Black-and-white', 'Drama', 'Indie', 'Silent film']",1920,8
17002077,Halloweentown,1998,['United States of America'],"[""Children's Fantasy"", ""Children's/Family""]",1990,8
3245137,Deewane Huye Pagal,2005,['India'],"['Romantic drama', 'Comedy', 'Bollywood', 'World cinema', 'Romance Film', 'Romantic comedy', 'Drama']",2000,5
3863417,Beer League,2006,['United States of America'],"['Sports', 'Indie', 'Comedy']",2000,6
11380181,Sawdust and Tinsel,1955,['Sweden'],"['Black-and-white', 'Art film', 'World cinema', 'Drama']",1950,5
30232904,Lonesome,1929,['United States of America'],"['Romantic drama', 'Comedy', 'Silent film', 'Romance Film', 'Drama']",1920,9
32426892,Often an Orphan,1949,['United States of America'],"['Animation', 'Short Film', 'Comedy film', 'Family Film']",1940,9
25763006,Something Beneath,2007,['Canada'],"['Creature Film', 'Monster movie', 'Horror', 'Science Fiction']",2000,7
12565373,Watchers II,1990,"['Canada', 'United States of America']","['Creature Film', 'Horror', 'Sci-Fi Horror', 'Science Fiction']",1990,0
20125873,And You Thought Your Parents Were Weird,1991,['United States of America'],"['Science Fiction', 'Comedy', 'Family Film']",1990,1
9998022,La Mary,1974,['Argentina'],"['Melodrama', 'Drama']",1970,4
25547948,The Big Street,1942,['United States of America'],"['Romance Film', 'Romantic drama', 'Drama']",1940,2
6449600,Kenny,2006,"['New Zealand', 'Australia']","['Indie', 'Comedy', 'World cinema', 'Mockumentary']",2000,6
5465180,Half-Wits Holiday,1947,['United States of America'],"['Black-and-white', 'Short Film', 'Comedy', 'Slapstick']",1940,7
6809250,Outside Providence,1999,['United States of America'],"['Coming of age', 'Stoner film', 'Comedy', 'Teen', 'Romantic comedy', 'Romance Film']",1990,9
4491061,Jack-O,1995,['United States of America'],"['Monster movie', 'Slasher', 'Horror', 'B-movie']",1990,5
669150,Legend of the Liquid Sword,1993,['Hong Kong'],"['Fantasy Adventure', 'Action/Adventure', 'Comedy', 'World cinema', 'Chinese Movies', 'Martial Arts Film', 'Adventure', 'Wuxia', 'Fantasy']",1990,3
1507610,The Rugrats Movie,1998,['United States of America'],"['Animation', ""Children's"", 'Comedy', ""Children's/Family"", 'Adventure', 'Family Film']",1990,8
2022395,The Electric Horseman,1979,['United States of America'],"['Romantic drama', 'Romance Film', 'Comedy-drama', 'Drama']",1970,9
13166220,Midnight Ride,1990,['United States of America'],"['Action', 'Slasher', 'Thriller']",1990,0
27176420,Dad for a Day,2009,['Argentina'],['Comedy'],2000,9
12606849,Lola Montès,1955,"['France', 'Germany']","['Period piece', 'Biographical film', 'Biopic [feature]', 'World cinema', 'Drama']",1950,5
657159,Conquest of the Planet of the Apes,1972,['United States of America'],"['Action', 'Adventure', 'Science Fiction', 'Cult']",1970,2
7951528,"Too Much, Too Soon",1958,['United States of America'],"['Drama', 'Biographical film', 'Biopic [feature]']",1950,8
5172645,Top Banana,1954,['United States of America'],"['Musical', 'Comedy', 'Musical comedy']",1950,4
2330988,Flushed Away,2006,"['United Kingdom', 'United States of America']","['Animation', 'Comedy', 'Family-Oriented Adventure', ""Children's/Family"", 'Adventure', 'Family Film']",2000,6
4915922,Caótica Ana,2007,['Spain'],"['Romance Film', 'Mystery', 'Drama']",2000,7
1745050,Mr. & Mrs. Smith,2005,['United States of America'],"['Action', 'Action/Adventure', 'Comedy', 'Thriller', 'Black comedy', 'Romantic comedy', 'Romance Film']",2000,5
18702599,Hiruko the Goblin,1991,['Japan'],"['Creature Film', 'Japanese Movies', 'Horror Comedy', 'Comedy', 'World cinema', 'Horror', 'Black comedy']",1990,1
18176131,Texas Night Train,2001,['United States of America'],['Horror'],2000,1
12706663,Wonderland,1999,['United Kingdom'],['Drama'],1990,9
1343178,The Alamo,1960,['United States of America'],"['Action', 'Biography', 'Action/Adventure', 'Roadshow theatrical release', 'Drama', 'Western', 'Epic', 'War film']",1960,0
7677968,976-EVIL,1988,['United States of America'],"['Slasher', 'Teen', 'Horror']",1980,8
1591874,Executive Suite,1954,['United States of America'],"['Film adaptation', 'Drama']",1950,4
25943455,Tomten är far till alla barnen,1999,['Sweden'],['Comedy'],1990,9
3672312,Goodbye Casanova,2000,['United States of America'],['Drama'],2000,0
11135832,Kitaab,1977,['India'],"['Musical', 'Comedy', 'Bollywood', 'World cinema', 'Drama']",1970,7
14521896,The Awakening,1980,['United Kingdom'],"['Suspense', 'Psychological thriller', 'Thriller', 'Horror', 'Supernatural']",1980,0
6057698,A Man Could Get Killed,1966,['United States of America'],"['Action', 'Spy', 'Comedy']",1960,6
12686515,Sardari Begum,1996,['India'],"['Art film', 'Docudrama', 'Drama']",1990,6
15671530,Not My Kid,1985,['United States of America'],"['Teen', 'Drama']",1980,5
8414188,The Naked Prey,1966,"['United States of America', 'South Africa']","['Action', 'Action/Adventure', 'Thriller', 'Adventure']",1960,6
5600770,The King,2005,"['United Kingdom', 'United States of America']","['Crime Fiction', 'Indie', 'Drama']",2000,5
6081561,Le gendarme et les extra-terrestres,1979,['France'],['Comedy'],1970,9
5481500,Pitfall,1962,['Japan'],"['Surrealism', 'Black-and-white', 'Crime Fiction', 'Art film', 'World cinema', 'Drama', 'Japanese Movies', 'Fantasy']",1960,2
23666206,Mizhikal Sakshi,2008,['India'],['Drama'],2000,8
7660521,The Atomic Submarine,1959,['United States of America'],"['Action', 'Black-and-white', 'Thriller', 'Alien Film', 'Science Fiction']",1950,9
13715502,Entrails of a Virgin,1986,['Japan'],"['Creature Film', 'Japanese Movies', 'Horror', 'World cinema', 'Pinku eiga', 'Erotica']",1980,6
18943073,The Master Touch,1972,"['West Germany', 'Italy']","['Action', 'Crime Fiction', 'Thriller', 'World cinema', 'Crime Thriller', 'Drama', 'Heist', 'History']",1970,2
3676154,That Hamilton Woman,1941,"['United Kingdom', 'United States of America']","['Black-and-white', 'Biography', 'Romantic drama', 'Romance Film', 'Costume drama', 'Drama', 'Period piece', 'Biopic [feature]', 'Melodrama']",1940,1
635989,F.I.S.T,1978,['United States of America'],"['Crime Fiction', 'New Hollywood', 'Political drama', 'Drama']",1970,8
31985780,Deiva Magan,1969,[],['Drama'],1960,9
1091333,"Paris, When It Sizzles",1964,['United States of America'],"['Romance Film', 'Romantic comedy', 'Comedy']",1960,4
24035889,The Phantom of 42nd Street,1945,['United States of America'],"['Suspense', 'Mystery', 'Thriller', 'Detective']",1940,5
3032135,Little Big League,1994,['United States of America'],"['Sports', 'Comedy', 'Family Film']",1990,4
163478,The Man in the Glass Booth,1975,['United States of America'],"['Drama', 'Indie', 'Political drama', 'Courtroom Drama']",1970,5
5284869,Election 2,2006,['Hong Kong'],"['Action', 'Crime Fiction', 'Action/Adventure', 'Thriller', 'World cinema', 'Chinese Movies', 'Drama']",2000,6
11237656,Kaajal,1965,['India'],"['Musical', 'Romantic drama', 'Bollywood', 'World cinema', 'Romance Film', 'Drama']",1960,5
29629615,Shadow of the Boomerang,1961,['Australia'],['Drama'],1960,1
1786421,Smoke,1995,"['Germany', 'United States of America', 'Japan']","['Japanese Movies', 'Indie', 'Comedy', 'Drama']",1990,5
443011,Lara Croft Tomb Raider: The Cradle of Life,2003,"['Japan', 'United Kingdom', 'Germany', 'United States of America']","['Action', 'Fantasy Adventure', 'Japanese Movies', 'Action/Adventure', 'Thriller', 'Adventure', 'Fantasy']",2000,3
3539185,Too Late For Love,1968,['Hong Kong'],['Chinese Movies'],1960,8
21860736,Pratighatana,1986,['India'],['Drama'],1980,6
28725374,Churam,1997,['India'],"['Romance Film', 'Crime Fiction', 'Drama']",1990,7
16166129,Eazhaiyin Sirippil,2000,['India'],[],2000,0
12275242,Christmas Caper,2007,['United States of America'],"['Comedy', ""Children's/Family"", 'Holiday Film', 'Christmas movie', 'Family Film']",2000,7
4213204,Bird on a Wire,1990,['United States of America'],"['Action', 'Crime Fiction', 'Action/Adventure', 'Comedy']",1990,0
15178041,Red Mercury,2005,['United Kingdom'],"['Action', 'Crime Fiction', 'Action/Adventure', 'Thriller', 'Political thriller']",2000,5
26199920,A Peasant on a Bicycle,1974,['Bulgaria'],['Drama'],1970,4
8231128,Tahader Katha,1992,['India'],"['Musical', 'Bollywood', 'World cinema', 'Drama']",1990,2
159171,City of Angels,1998,"['Germany', 'United States of America']","['Romantic fantasy', 'Romantic drama', 'Thriller', 'Remake', 'Romance Film', 'Drama', 'Fantasy']",1990,8
22785960,Kick,2009,['India'],['Comedy'],2000,9
20675539,Chirosathi,2008,['India'],"['Action', 'Drama', 'Comedy']",2000,8
2116395,A Foreign Field,1993,['United Kingdom'],"['Indie', 'Comedy', 'Comedy-drama', 'Drama']",1990,3
241469,Pandemonium,1982,['United States of America'],"['Mystery', 'Comedy film', 'Horror']",1980,2
7768616,"Don Q, Son of Zorro",1925,['United States of America'],"['Action', 'Black-and-white', 'Indie', 'Silent film', 'Superhero movie', 'Adventure']",1920,5
19014723,Table for Three,2009,['United States of America'],"['Indie', 'Comedy', 'Romance Film', 'Romantic comedy']",2000,9
9377241,Who's Afraid of Virginia Woolf?,1966,['United States of America'],"['Film adaptation', 'Marriage Drama', 'Black comedy', 'Drama']",1960,6
6517412,Do You Remember Dolly Bell?,1981,"['Yugoslavia', 'Bosnia and Herzegovina']","['Coming of age', 'Romantic drama', 'Comedy', 'World cinema', 'Romance Film', 'Political drama', 'Drama']",1980,1
7321030,Visiting Hours,1982,['Canada'],"['Psychological thriller', 'Slasher', 'Thriller', 'Horror']",1980,2
3654486,Story of a Prostitute,1965,['Japan'],"['Black-and-white', 'Art film', 'Erotic Drama', 'Romantic drama', 'World cinema', 'Romance Film', 'Drama', 'Japanese Movies', 'Erotica', 'War film']",1960,5
13001345,Damini,1993,['India'],['Bollywood'],1990,3
11270888,"You, Me & Marley",1992,"['Northern Ireland', 'United Kingdom', 'England', 'Ireland']","['Indie', 'Drama']",1990,2
2011045,Annamayya,1997,['India'],"['Musical', 'Historical drama']",1990,7
472870,Funny Face,1957,['United States of America'],"['Musical', 'Romance Film', 'Comedy']",1950,7
1749996,Forklift Driver Klaus - The First Day on the Job,2000,['Germany'],"['Action', 'Animation', 'Parody', 'Short Film', 'Comedy', 'Horror Comedy', 'Horror']",2000,0
1283031,Scaredy Cat,1948,['United States of America'],"['Animation', 'Short Film', 'Comedy', 'Family Film']",1940,8
1241609,Down to the Sea in Ships,1922,['United States of America'],"['Black-and-white', 'Indie', 'Silent film', 'Romance Film', 'Drama']",1920,2
16750096,Anna's Storm,2007,['Canada'],"['Action', 'Drama', 'Indie', 'Thriller', 'Television movie', 'Science Fiction']",2000,7
5748569,How to Cheat in the Leaving Certificate,1998,['Ireland'],"['Black-and-white', 'Heist', 'Indie', 'Comedy Thriller', 'Comedy']",1990,8
9244831,Graveyard of Honor,2002,['Japan'],"['Action', 'Crime Fiction', 'Japanese Movies', 'Action/Adventure', 'Thriller', 'World cinema', 'Crime Thriller']",2000,2
9803242,Strange Confession,1945,['United States of America'],['Mystery'],1940,5
6076089,Mister Foe,2007,"['United Kingdom', 'Scotland']","['Film adaptation', 'Mystery', 'Indie', 'Thriller', 'Romance Film', 'Black comedy', 'Drama', 'Coming of age', 'Romantic comedy', 'Comedy-drama']",2000,7
4316523,The Three Musketeers,1973,"['United Kingdom', 'Spain', 'United States of America']","['Action', 'Film adaptation', 'Action/Adventure', 'Comedy', 'Costume drama', 'Adventure', 'Drama', 'Swashbuckler films', 'Period piece']",1970,3
6392747,A Home Too Far,1990,['Taiwan'],['War film'],1990,0
10934699,Syngenor,1990,['United States of America'],"['Horror', 'Science Fiction']",1990,0
20518759,Calling All Cuckoos,1956,['United States of America'],"['Animation', 'Short Film', 'Comedy film', 'Family Film']",1950,6
12606644,Le Plaisir,1952,['France'],"['Black-and-white', 'Art film', 'Comedy', 'World cinema', 'Drama']",1950,2
8279606,The Black Widow,1947,['United States of America'],"['Action', 'Spy', 'Black-and-white', 'Adventure']",1940,7
5164905,Alien Abduction: Incident in Lake County,1998,['United States of America'],['Documentary'],1990,8
755231,Mo' Better Blues,1990,['United States of America'],"['Musical', 'Drama', 'Indie', 'Romantic drama', 'Comedy', 'Romance Film']",1990,0
7482821,"Bravo, My Life!",2005,['South Korea'],['Drama'],2000,5
12847616,The Strait Story,2005,['Taiwan'],['Romantic drama'],2000,5
22540513,Harvest Home,2009,['United States of America'],"['Family Drama', 'Short Film', 'Drama']",2000,9
14760799,"30,000 Leagues Under the Sea",2007,['United States of America'],"['Science Fiction', 'Adventure', 'Drama']",2000,7
4550882,We Are Marshall,2006,['United States of America'],"['Docudrama', 'Sports', 'Drama']",2000,6
2339510,La Strada,1954,['Italy'],['Drama'],1950,4
34042335,Ramayanam,1997,[],['Historical fiction'],1990,7
24165842,Waterfront Lady,1935,['United States of America'],"['Crime Fiction', 'Crime Drama', 'Melodrama', 'Drama']",1930,5
29891355,Captain Sindbad,1963,"['West Germany', 'United States of America']","['Action', 'Adventure', 'Fantasy']",1960,3
10111917,Joymati,1935,['India'],['Historical drama'],1930,5
24984663,Mermaid Legend,1984,['Japan'],['Japanese Movies'],1980,4
27545105,Crazy Over Horses,1951,['United States of America'],"['Action', 'Sports', 'Comedy film']",1950,1
2173342,Two Mules for Sister Sara,1970,"['Mexico', 'United States of America']","['Action', 'Comedy Western', 'Action/Adventure', 'Western', 'Comedy', 'War film']",1970,0
26861924,A Little Life-Opera,1997,"['China', 'Hong Kong']","['Chinese Movies', 'Drama', 'Romantic drama']",1990,7
15258024,Dark Waters,1944,['United States of America'],"['Psychological thriller', 'Black-and-white', 'Thriller', 'Film noir']",1940,4
2031778,Kounterfeit,1996,['United States of America'],"['Crime Fiction', 'Gangster Film', 'Thriller', 'Crime Thriller', 'Drama']",1990,6
29943,The Breakfast Club,1985,['United States of America'],"['Coming of age', 'Comedy', 'Teen', 'Comedy-drama', 'Drama', 'Ensemble Film']",1980,5
9550033,Believe,2007,['United States of America'],"['Indie', 'Parody', 'Satire', 'Comedy', 'Mockumentary']",2000,7
4718224,Punchline,1988,['United States of America'],"['Stand-up comedy', 'Comedy', 'Comedy-drama', 'Drama']",1980,8
14565728,The Prince and the Pauper,1937,['United States of America'],"['Swashbuckler films', 'Black-and-white', 'Family Drama', 'Costume drama', 'Adventure', 'Drama', 'Family Film']",1930,7
9577427,Khamosh,1985,['India'],"['Mystery', 'Thriller']",1980,5
8794664,Bulandi,1990,['Pakistan'],['Romance Film'],1990,0
18108844,"Big Girl, Little Girl",2004,['United Kingdom'],['Short Film'],2000,4
9667958,ABCD,2005,['India'],"['Drama', 'Indie', 'Family Drama', 'Romantic drama', 'World cinema', 'Romance Film']",2000,5
5105287,Desyat Negrityat,1987,['Soviet Union'],"['Psychological thriller', 'Mystery', 'Thriller', 'Whodunit', 'Ensemble Film']",1980,7
2002104,Halloween II,1981,['United States of America'],"['Slasher', 'Teen', 'Horror', 'Cult']",1980,1
3524282,Dressed to Kill,1946,['United States of America'],"['Film adaptation', 'Mystery', 'Thriller', 'Crime Thriller', 'Drama']",1940,6
2932845,Necronomicon,1994,"['France', 'United States of America']","['Horror', 'Anthology']",1990,4
26723623,Luv,1967,['United States of America'],['Comedy'],1960,7
20693306,Ethir Neechal,1968,['India'],['Drama'],1960,8
17410037,The Bloody Exorcism of Coffin Joe,1974,['Brazil'],['Horror'],1970,4
8526620,Mechenosets,2006,['Russia'],['Action'],2000,6
14429341,The Best Little Whorehouse in Texas,1982,['United States of America'],"['Musical', 'LGBT', 'Comedy', 'Musical comedy', 'Romance Film', 'Romantic comedy', 'Sex comedy']",1980,2
859131,Kalathur Kannamma,1960,['India'],"['Romantic drama', 'World cinema', 'Romance Film', 'Drama']",1960,0
4936733,When Night is Falling,1996,['Canada'],"['LGBT', 'Erotic Drama', 'Indie', 'Romance Film', 'Drama', 'Feminist Film', 'Gay Themed', 'Gay', 'Gay Interest']",1990,6
14989417,Joan of Paris,1942,['United States of America'],"['Black-and-white', 'War film', 'Drama']",1940,2
9127195,Vikram,1986,['India'],[],1980,6
5830099,Summer Catch,2001,['United States of America'],"['Comedy', 'Teen', 'Romantic comedy', 'Romance Film', 'Comedy-drama', 'Sports', 'Drama']",2000,1
2654324,The Churning,1976,['India'],"['Drama', 'Art film', 'Bollywood']",1970,6
18060738,Lower Learning,2008,['United States of America'],"['Indie', 'Comedy']",2000,8
29397331,Bloody Mary,2006,['United States of America'],"['Slasher', 'B-movie', 'Horror']",2000,6
27366091,The Desperadoes,1943,['United States of America'],"['Action', 'Western', 'Action/Adventure', 'Buddy film']",1940,3
18699834,Susana,1951,['Mexico'],"['Art film', 'Drama', 'World cinema']",1950,1
650922,Ghost Dad,1990,['United States of America'],"['Drama', 'Heaven-Can-Wait Fantasies', 'Comedy', 'Fantasy Comedy', 'Family Film']",1990,0
20337153,Aaynate,2008,['India'],['Drama'],2000,8
8817538,Wee Wee Monsieur,1938,['United States of America'],"['Black-and-white', 'Short Film', 'Comedy', 'Slapstick']",1930,8
8300648,The Go-Between,1970,"['United Kingdom', 'England']","['Film adaptation', 'Romantic drama', 'Romance Film', 'Drama']",1970,0
29074804,Super Fly T.N.T.,1973,['United States of America'],"['Action', 'Blaxploitation', 'Crime Fiction']",1970,3
11577392,Love Story,1970,['United States of America'],"['Film adaptation', 'Romantic drama', 'New Hollywood', 'Romance Film', 'Drama', 'Tragedy']",1970,0
28148776,Happy End,1966,['Czech Republic'],['Comedy'],1960,6
14679509,I Take This Woman,1931,['United States of America'],"['Romance Film', 'Black-and-white']",1930,1
2155117,Slaughter High,1986,"['United Kingdom', 'United States of America']","['Indie', 'Slasher', 'Teen', 'Horror', 'B-movie']",1980,6
1665752,White Men Can't Jump,1992,['United States of America'],"['Buddy film', 'Comedy', 'Sports', 'Drama']",1990,2
1712237,Goin' Down the Road,1970,['Canada'],"['Road movie', 'Coming of age', 'Drama']",1970,0
17796380,Code Name: Emerald,1985,['United States of America'],"['Action', 'Spy', 'Docudrama', 'War film', 'Adventure', 'Drama']",1980,5
15453375,Where East is East,1929,['United States of America'],"['Black-and-white', 'Silent film', 'Melodrama', 'Adventure', 'Drama']",1920,9
22832896,Dogtooth,2009,['Greece'],"['Family Drama', 'Drama']",2000,9
30515,The Big Country,1958,['United States of America'],"['Epic Western', 'Western', 'Action/Adventure', 'Romance Film', 'Drama']",1950,8
23227434,Oru CBI Diary Kurippu,1988,['India'],"['Action', 'Mystery', 'Bollywood', 'Thriller']",1980,8
8931289,The Underneath,1995,['United States of America'],"['Psychological thriller', 'Neo-noir', 'Crime Fiction', 'Indie', 'Thriller', 'Film noir', 'Crime Thriller', 'Drama', 'Caper story']",1990,5
12163624,Brass Target,1978,['United States of America'],"['Action', 'Mystery', 'Thriller', 'War film', 'Adventure', 'Drama']",1970,8
6166728,Monster Maker,1989,['United Kingdom'],"['Film adaptation', 'Drama', 'Family Film']",1980,9
11929565,The Girl from Missouri,1934,['United States of America'],"['Comedy', 'Romance Film', 'Romantic comedy', 'Comedy-drama', 'Drama']",1930,4
30886728,711 Ocean Drive,1950,[],['Film noir'],1950,0
24283702,Dhara,2008,['India'],"['Musical', 'Bollywood', 'World cinema', 'Drama']",2000,8
22453313,K-20: Legend of the Mask,2008,['Japan'],"['Action', 'Crime Fiction', 'Japanese Movies', 'World cinema', 'Adventure', 'Drama']",2000,8
1529461,The Men Who Tread On the Tiger's Tail,1952,['Japan'],"['Costume Adventure', 'Samurai cinema', 'Japanese Movies', 'World cinema', 'Adventure', 'Drama']",1950,2
22204593,Ladies Tailor,1985,['India'],"['Romantic drama', 'World cinema', 'Romance Film', 'Drama']",1980,5
9129510,Lightspeed,2006,['United States of America'],"['Action', 'Action/Adventure', 'Superhero movie', 'Television movie', 'Science Fiction', 'Fantasy']",2000,6
1107390,Tanner '88,1988,['United States of America'],['Comedy'],1980,8
6322029,Goldfinger,1964,['United Kingdom'],"['Action', 'Crime Fiction', 'Action/Adventure', 'Thriller', 'Glamorized Spy Film']",1960,4
8497020,Gordon's War,1973,['United States of America'],"['Action', 'Crime Fiction', 'Adventure']",1970,3
23815816,The St. Tammany Miracle,1994,['United States of America'],"['Family Drama', 'Sports', 'Drama', 'Family Film']",1990,4
468293,Philadelphia,1993,['United States of America'],"['LGBT', 'Drama', 'Courtroom Drama', 'Tragedy', 'Medical fiction', 'Gay Themed', 'Gay', 'Gay Interest']",1990,3
30330769,"Dawson, Island 10",2009,"['Brazil', 'Chile', 'Venezuela']","['Drama', 'World cinema']",2000,9
17441828,Waltz with Bashir,2008,"['Switzerland', 'Australia', 'Israel', 'France', 'Finland', 'Belgium', 'Germany', 'United States of America']","['History', 'Animation', 'Biographical film', 'Avant-garde', 'Experimental film', 'War film', 'Drama']",2000,8
21165146,Grumpy,1930,['United States of America'],"['Crime Fiction', 'Comedy-drama']",1930,0
1076211,The Englishman Who Went Up a Hill But Came Down a Mountain,1995,['United Kingdom'],"['Period piece', 'Comedy', 'Comedy of manners']",1990,5
15120787,Hurlyburly,1998,['United States of America'],"['Period piece', 'Indie', 'Comedy', 'Drama']",1990,8
2384316,Carry On Sergeant,1958,['United Kingdom'],['Comedy'],1950,8
25919422,Black Oxen,1923,['United States of America'],"['Silent film', 'Science Fiction', 'Fantasy']",1920,3
24603817,Oru Minnaminunginte Nurunguvettam,1987,['India'],['Drama'],1980,7
25446751,Patnam Vachina Pativrathalu,1982,['India'],"['Action', 'Comedy', 'Family Film']",1980,2
34142673,Miracle on 34th Street,1973,['United States of America'],"['Drama', 'Family Film', 'Fantasy']",1970,3
18822912,Kovak Box,2006,"['United Kingdom', 'Spain']","['Psychological thriller', 'Suspense', 'Mystery', 'Thriller']",2000,6
1747692,Mission Kashmir,2000,['India'],"['Musical', 'Action/Adventure', 'Bollywood', 'World cinema', 'War film', 'Adventure', 'Drama']",2000,0
20831047,Swing!,1938,['United States of America'],"['Musical', 'Black-and-white', 'Drama']",1930,8
1186616,The Shining,1980,"['United Kingdom', 'United States of America']","['Surrealism', 'Psychological thriller', 'Film adaptation', 'Drama', 'Slasher', 'Horror', 'New Hollywood', 'Supernatural']",1980,0
68078,All That Jazz,1979,['United States of America'],"['Musical', 'LGBT', 'New Hollywood', 'Fantasy', 'Drama', 'Tragedy']",1970,9
14503463,Rameswaram,2009,['India'],['Romance Film'],2000,9
2064125,December Boys,2007,"['Australia', 'United Kingdom', 'New Zealand', 'United States of America']","['Period piece', 'Film adaptation', 'Drama', 'Coming of age', 'Indie', 'World cinema']",2000,7
133480,Bugsy,1991,['United States of America'],"['Crime Fiction', 'Gangster Film', 'Biography', 'Romantic drama', 'Romance Film', 'Drama', 'Period piece', 'Biopic [feature]', 'Crime Drama']",1990,1
5229759,The Man of the Story,1995,"['Japan', 'India']","['Japanese Movies', 'Biography', 'Historical Epic', 'Drama']",1990,5
31072248,Men Without Souls,1940,['United States of America'],"['Action', 'Crime Fiction', 'Drama']",1940,0
16612265,Jack and Jill vs. the World,2008,['Canada'],"['Comedy', 'Romance Film', 'Romantic comedy', 'Comedy-drama']",2000,8
3260061,Khaidi,1983,['India'],['Action'],1980,3
26461395,Bedevilled,1955,['United States of America'],"['Drama', 'Crime Fiction']",1950,5
7275748,Frankenstein's Bloody Terror,1968,"['West Germany', 'Spain']","['Creature Film', 'Monster', 'Horror', 'World cinema']",1960,8
13608130,Uthiripookkal,1979,['India'],['Drama'],1970,9
217819,Ryan's Daughter,1970,"['United Kingdom', 'United States of America']","['Period piece', 'Romantic drama', 'Romance Film', 'Melodrama', 'Roadshow theatrical release', 'Drama']",1970,0
11373959,Daag,1952,['India'],['Bollywood'],1950,2
8573342,Miss Cast Away and the Island Girls,2004,['United States of America'],"['Parody', 'Comedy', 'Adventure']",2000,4
1888433,The Americanization of Emily,1964,['United States of America'],"['Black-and-white', 'Comedy', 'Black comedy', 'Romantic comedy', 'Romance Film', 'War film', 'Drama']",1960,4
13508675,Blood Rage,1987,['United States of America'],['Slasher'],1980,7
378213,Scanners,1981,['Canada'],"['Action', 'Psychological thriller', 'Indie', 'Horror', 'Science Fiction', 'Cult']",1980,1
410832,Sniper,1993,['United States of America'],"['Action', 'Action/Adventure', 'Thriller']",1990,3
8288100,Libel,1959,['United Kingdom'],"['Black-and-white', 'Crime Fiction', 'Drama', 'Courtroom Drama']",1950,9
15438660,Raman Thediya Seethai,2008,['India'],['Drama'],2000,8
1528430,Beavis and Butt-head Do America,1996,['United States of America'],"['Gross out', 'Gross-out film', 'Animation', 'Buddy film', 'Comedy', 'Road movie', 'Cult']",1990,6
23010798,Badge 373,1973,['United States of America'],"['Drama', 'Crime Fiction', 'Thriller']",1970,3
7413769,Student No.1,2001,['India'],"['Action', 'Crime Fiction', 'Drama']",2000,1
24020300,Walls of Glass,1985,['United States of America'],"['Romance Film', 'Drama', 'Comedy film']",1980,5
10241832,The Rage,2008,['United States of America'],"['Indie', 'Horror', 'Zombie Film', 'Science Fiction']",2000,8
31649925,Teresa de Jesús,1984,['Spain'],['Drama'],1980,4
22378190,I hartopehtra,1964,['Greece'],['Comedy'],1960,4
15336744,18 Again!,1988,['United States of America'],"['Slapstick', 'Comedy', 'Fantasy']",1980,8
15464579,July Days,1923,['United States of America'],"['Black-and-white', 'Indie', 'Short Film', 'Comedy', 'Silent film', 'Family Film']",1920,3
5471774,My House in Umbria,2003,"['United Kingdom', 'Italy']","['Mystery', 'Thriller', 'Television movie', 'Drama', 'Ensemble Film']",2000,3
1563877,The Dark Corner,1946,['United States of America'],"['Crime Fiction', 'Mystery', 'Thriller', 'Film noir', 'Crime Thriller', 'Drama']",1940,6
30208791,Belphegor the Mountebank,1921,['United Kingdom'],['Silent film'],1920,1
14746919,Hot Ice,1955,['United States of America'],"['Short Film', 'Black-and-white', 'Comedy']",1950,5
20581119,Pyar Ki Kahani,1971,['India'],"['Drama', 'World cinema']",1970,1
30671819,A Lesson in Love,1931,['United States of America'],['Short Film'],1930,1
7489503,Keep in Style,1933,['United States of America'],"['Short Film', 'Animation']",1930,3
3312337,The Legend of Frosty the Snowman,2005,['United States of America'],"[""Children's Fantasy"", 'Animation', ""Children's/Family"", 'Holiday Film', 'Family Film']",2000,5
5541000,Fear X,2003,"['United Kingdom', 'Denmark', 'United States of America']","['Psychological thriller', 'Mystery', 'Thriller', 'World cinema', 'Crime Thriller']",2000,3
6029822,The Hidan of Maukbeiangjow,1973,['United States of America'],"['Crime Fiction', 'Comedy', 'Horror', 'Romance Film', 'Science Fiction', 'Drama']",1970,3
23592729,Love Khichdi,2009,['India'],"['Musical', 'Comedy', 'Bollywood', 'World cinema', 'Romance Film', 'Drama']",2000,9
576217,Don't Tell Mom the Babysitter's Dead,1991,['United States of America'],"['Domestic Comedy', 'Comedy', 'Teen']",1990,1
19985540,Ullasamga Utsahamga,2008,['India'],['Romance Film'],2000,8
23685888,Big Beat,1993,['Czech Republic'],"['Musical', 'Comedy']",1990,3
8537601,Beauty No. 2,1965,['United States of America'],['Black-and-white'],1960,5
88075,Shakespeare in Love,1998,"['United Kingdom', 'United States of America']","['Romantic drama', 'Comedy', 'Romance Film', 'Costume drama', 'Drama', 'Period piece', 'Romantic comedy', 'Comedy-drama']",1990,8
21684643,Jothe Jotheyali,2006,['India'],['Romance Film'],2000,6
6589209,Prom Night III: The Last Kiss,1989,['Canada'],"['Indie', 'Horror']",1980,9
1158236,King of the Hill,1993,['United States of America'],['Drama'],1990,3
23274964,Tatlong Taong Walang Diyos,1976,['Philippines'],"['Filipino Movies', 'War film']",1970,6
307604,Renaissance Man,1994,['United States of America'],"['Comedy', 'Comedy-drama']",1990,4
8283222,Jungle Drums of Africa,1953,['United States of America'],"['Action', 'Black-and-white', 'Adventure']",1950,3
26178788,My Blue Heaven,1950,['United States of America'],"['Musical', 'Comedy']",1950,0
25713949,Shyama,1986,['India'],"['Romance Film', 'Drama']",1980,6
5297549,Bleach: Memories of Nobody,2006,['Japan'],"['Fantasy Adventure', 'Japanese Movies', 'Anime', 'Fantasy']",2000,6
17006492,Dead Heat,2002,"['Canada', 'Germany']","['Action', 'Crime Fiction', 'Gangster Film', 'Thriller', 'Crime Thriller', 'Drama']",2000,2
3043980,Pit Fighter,2005,['United States of America'],"['Action', 'Action Thrillers', 'Action/Adventure', 'Thriller', 'World cinema', 'Martial Arts Film', 'Drama']",2000,5
24490519,Shagird,1967,['India'],"['Romantic drama', 'Bollywood', 'World cinema', 'Romance Film', 'Drama']",1960,7
18959332,Got 2 Believe,2002,['Philippines'],"['Filipino Movies', 'Romantic drama', 'Comedy', 'World cinema', 'Romance Film', 'Romantic comedy', 'Drama']",2000,2
16877124,The Seekers,1954,"['New Zealand', 'United Kingdom']",['Adventure'],1950,4
25218335,The Petty Girl,1950,['United States of America'],"['Musical', 'Romantic comedy', 'Comedy']",1950,0
3825901,Thru the Mirror,1936,['United States of America'],['Short Film'],1930,6
1093860,Mr. Mike's Mondo Video,1979,['United States of America'],"['Indie', 'Mondo film', 'Parody', 'Comedy']",1970,9
7201681,Heaven's Soldiers,2005,['South Korea'],"['Action', 'Science Fiction', 'Comedy']",2000,5
24960167,Daffy Duck in Hollywood,1938,[],"['Animation', 'Short Film', 'Comedy film', 'Family Film']",1930,8
29360653,The Willies,1991,['United States of America'],"['Thriller', 'Horror', 'Teen', 'Supernatural', 'Fantasy']",1990,1
12664320,The Perfect Murder,1988,"['United Kingdom', 'India']","['Detective fiction', 'Crime Fiction', 'Mystery', 'Comedy', 'Thriller', 'Crime Comedy', 'Detective']",1980,8
31052078,Finnegan Begin Again,1985,[],"['Romance Film', 'Drama', 'Comedy film']",1980,5
13947013,Frankenstein,2004,['United States of America'],"['Mystery', 'Science Fiction', 'Horror']",2000,4
18531659,The Hungry Bachelors Club,1999,['United States of America'],"['Indie', 'Comedy', 'Romance Film', 'Romantic comedy', 'Comedy-drama', 'Ensemble Film']",1990,9
713375,My Stepmother Is an Alien,1988,['United States of America'],"['Indie', 'Comedy', 'Romance Film', 'Parody', 'Domestic Comedy', 'Romantic comedy', 'Science Fiction', 'Family Film']",1980,8
7373179,Bedtime Story,1964,['United States of America'],['Comedy'],1960,4
14594030,Footsteps in the Fog,1955,['United Kingdom'],"['Crime Drama', 'Crime Fiction', 'Drama']",1950,5
26003401,Curse,1987,['United States of America'],['Horror'],1980,7
2780022,Arthur 2: On the Rocks,1988,['United States of America'],"['Comedy', 'Romance Film', 'Romantic comedy', 'Slapstick']",1980,8
10940332,Prince of Foxes,1949,['United States of America'],"['Action', 'Black-and-white', 'Action/Adventure', 'Epic', 'Costume drama', 'Adventure', 'Drama']",1940,9
12595674,"Elisa, vida mía",1977,['Spain'],"['Family Drama', 'Drama']",1970,7
13553983,Laadam,2008,['India'],"['Thriller', 'Crime Fiction']",2000,8
9362760,Love on Delivery,1994,['Hong Kong'],"['Chinese Movies', 'Comedy']",1990,4
10597070,The Barber of Seville,1944,['United States of America'],['Animation'],1940,4
27244510,Lord Camber's Ladies,1932,['United Kingdom'],['Drama'],1930,2
1592450,Broadway Melody of 1938,1937,['United States of America'],"['Musical', 'Black-and-white', 'Backstage Musical', 'Romance Film']",1930,7
5506192,Swaham,1994,['India'],"['Drama', 'Art film']",1990,4
3934285,Hoot,2006,['United States of America'],"['Film adaptation', 'Comedy', 'Teen', 'Family-Oriented Adventure', ""Children's/Family"", 'Adventure', 'Coming of age', 'Family Film']",2000,6
28335313,That Woman Opposite,1957,['United Kingdom'],"['Film adaptation', 'Drama', 'Thriller']",1950,7
20657842,Friends,1999,['India'],"['Drama', 'Comedy']",1990,9
3595972,The Devil-Ship Pirates,1947,['United Kingdom'],"['Historical fiction', 'Adventure']",1940,7
4427791,Regarding Henry,1991,['United States of America'],"['Drama', 'Medical fiction']",1990,1
20519199,Otto; or Up with Dead People,2007,"['Canada', 'Germany']","['LGBT', 'Comedy', 'World cinema', 'Zombie Film', 'Creature Film', 'Gay Themed', 'Gay', 'Gay Interest', 'Horror', 'Cult']",2000,7
32013798,Main Aur Mera Haathi,1981,[],"['Action', 'Drama', 'Family Film']",1980,1
849594,Charley Varrick,1973,['United States of America'],"['Action', 'Crime Fiction', 'Action Thrillers', 'Gangster Film', 'Action/Adventure', 'Thriller', 'Crime Thriller', 'Chase Movie']",1970,3
2055612,Last Order: Final Fantasy VII,2005,['Japan'],"['Animation', 'Japanese Movies', 'Short Film', 'Science Fiction', 'Fantasy']",2000,5
25846068,"Tora-san, His Tender Love",1970,['Japan'],"['Japanese Movies', 'Comedy', 'World cinema']",1970,0
1004644,Robot Monster,1953,['United States of America'],"['Dystopia', 'Alien Film', 'Science Fiction']",1950,3
26432074,Nakshathrakkannulla Rajakumaran Avanundoru Rajakumari,2002,['India'],"['Romance Film', 'Comedy', 'Drama']",2000,2
21909087,The Cellar,1989,['United States of America'],"['Thriller', 'Horror']",1980,9
9598213,Mafioso,1962,['Italy'],"['Black-and-white', 'Crime Fiction', 'Comedy', 'World cinema', 'Drama']",1960,2
31322428,Council of the Gods,1950,"['Germany', 'German Democratic Republic']","['Drama', 'World cinema']",1950,0
24356120,Delta Heat,1992,['United States of America'],"['Action', 'Crime Fiction', 'Action/Adventure', 'Thriller', 'Crime Thriller', 'Drama']",1990,2
23867726,Still Walking,2008,[],['Drama'],2000,8
20948963,Un giorno nella vita,1946,['Italy'],"['War film', 'Drama']",1940,6
7244806,Jade Warrior,2006,"['China', 'Finland', 'Estonia', 'Netherlands']","['Action', 'Action/Adventure', 'Thriller', 'World cinema', 'Wuxia', 'Chinese Movies', 'Martial Arts Film']",2000,6
15758048,Swagatam,2008,['India'],['Drama'],2000,8
44210,The Life of Emile Zola,1937,['United States of America'],"['Black-and-white', 'Biography', 'Biographical film', 'Biopic [feature]', 'Political drama', 'Drama']",1930,7
20211517,The Flower of Love,1961,['India'],"['Drama', 'World cinema']",1960,1
35715425,Iru Malargal,1967,['India'],"['Romance Film', 'Drama']",1960,7
34234355,Adela,2008,['Philippines'],"['Filipino Movies', 'Drama', 'World cinema']",2000,8
8476634,Black and Tan,1929,['United States of America'],"['Musical', 'Black-and-white', 'Musical Drama', 'Short Film', 'Drama']",1920,9
1820344,Deadfall,1993,['United States of America'],"['Crime Fiction', 'Crime Thriller', 'Drama']",1990,3
10537701,"Munster, Go Home",1966,['United States of America'],['Comedy'],1960,6
1320563,Shall We Dance,1996,['Japan'],"['Japanese Movies', 'Comedy', 'World cinema', 'Dance', 'Romance Film', 'Drama']",1990,6
10641551,Life Gamble,1979,['Hong Kong'],"['Action/Adventure', 'World cinema', 'Chinese Movies', 'Martial Arts Film']",1970,9
11543613,Goldrush: A Real Life Alaskan Adventure,1998,['United States of America'],"['Romance Film', 'Adventure']",1990,8
767193,Woman in the Moon,1929,"['Weimar Republic', 'Germany']","['Black-and-white', 'Indie', 'Romantic drama', 'World cinema', 'Romance Film', 'Drama', 'Silent film', 'Science Fiction']",1920,9
6460984,Gold of the Seven Saints,1961,['United States of America'],"['Western', 'Adventure']",1960,1
460291,Maîtresse,1976,['France'],"['Romantic drama', 'Satire', 'Comedy', 'World cinema', 'Romance Film', 'Drama', 'Romantic comedy', 'Sex comedy']",1970,6
25948781,Pig,1998,['United States of America'],"['Surrealism', 'Short Film', 'Horror', 'Silent film']",1990,8
1376802,Billion Dollar Brain,1967,['United Kingdom'],"['Spy', 'Film adaptation', 'Political thriller', 'Thriller', 'Drama']",1960,7
21236436,The White Reindeer,1952,['Finland'],"['World cinema', 'Drama', 'Horror']",1950,2
3446942,Africa Screams,1949,['United States of America'],"['Adventure Comedy', 'Black-and-white', 'Slapstick', 'Comedy', 'Jungle Film', 'Family Film', 'Adventure']",1940,9
16593269,Moscow-Cassiopeia,1974,['Soviet Union'],"['Comedy film', 'Adventure', 'Science Fiction', 'Family Film']",1970,4
17905510,The Collector,1965,"['United Kingdom', 'United States of America']","['Psychological thriller', 'Suspense', 'Film adaptation', 'Mystery', 'Thriller', 'Drama']",1960,5
177783,Morning Glory,1933,['United States of America'],"['Black-and-white', 'Drama']",1930,3
30857702,Virgin Territory,2007,"['United Kingdom', 'France', 'Italy', 'United States of America']","['Comedy', 'World cinema', 'Romance Film', 'Romantic comedy']",2000,7
16184877,Dark Honeymoon,2008,['United States of America'],"['Mystery', 'Slasher', 'Thriller', 'Horror', 'Crime Thriller', 'Drama']",2000,8
31163684,Bad for Each Other,1953,['United States of America'],"['Drama', 'Medical fiction']",1950,3
23984600,The Stork Club,1945,['United States of America'],"['Musical', 'Black-and-white', 'Backstage Musical', 'Romantic drama', 'Comedy', 'Romance Film', 'Drama', 'Romantic comedy']",1940,5
31153555,Mukham,1990,['India'],"['Crime Fiction', 'Mystery', 'Thriller']",1990,0
3239974,Dinosaurus!,1960,['United States of America'],"['Stop motion', 'Science Fiction', 'Fantasy']",1960,0
518928,Secret Window,2004,['United States of America'],"['Psychological thriller', 'Mystery', 'Thriller', 'Horror']",2000,4
15211311,The Four Feathers,1977,['United Kingdom'],"['Period piece', 'Film adaptation', 'Television movie', 'War film', 'Drama']",1970,7
23086136,Men in War,1957,['United States of America'],"['Action', 'Black-and-white', 'Action/Adventure', 'Western', 'War film', 'Drama']",1950,7
31388469,Kannika,1947,[],[],1940,7
8135762,Method,2004,"['United Kingdom', 'Romania', 'United States of America']","['Psychological thriller', 'Suspense', 'Thriller']",2000,4
7889019,Snow Blind,2006,['United States of America'],"['Indie', 'Biography', 'Documentary', 'Extreme Sports', 'Sports']",2000,6
6749329,Tachiguishi-Retsuden,2006,['Japan'],"['Comedy', 'Japanese Movies']",2000,6
11728791,The Man from Snowy River,1920,['Australia'],"['Indie', 'Western', 'Silent film', 'Drama']",1920,0
33626986,The Year of Getting to Know Us,2008,['United States of America'],"['Film adaptation', 'Drama', 'Family Drama', 'Indie', 'Comedy', 'Comedy-drama']",2000,8
33121,Wings of Desire,1987,"['France', 'West Germany']","['Romantic fantasy', 'Romantic drama', 'World cinema', 'Romance Film', 'Drama', 'Fantasy']",1980,7
7151411,Ruk jung,2006,['Thailand'],"['Romance Film', 'Comedy', 'Drama']",2000,6
664496,The Last Seduction,1994,['United States of America'],"['Neo-noir', 'Crime Fiction', 'Mystery', 'Indie', 'Thriller', 'Crime Thriller', 'Drama', 'Suspense', 'Erotic thriller']",1990,4
11540062,True Grit: A Further Adventure,1978,['United States of America'],['Western'],1970,8
4406418,I Walk Alone,1948,['United States of America'],"['Film adaptation', 'Crime Fiction', 'Gangster Film', 'Thriller', 'Film noir', 'Crime Thriller', 'Drama', 'Crime Drama']",1940,8
26553611,Synanon,1965,['United States of America'],"['Addiction Drama', 'Drama']",1960,5
11499843,Judgment,1990,['United States of America'],"['Drama', 'Television movie']",1990,0
28739065,Sylvia and the Ghost,1946,['France'],"['Romantic fantasy', 'Heaven-Can-Wait Fantasies', 'Haunted House Film', 'Fantasy']",1940,6
11159206,Zoo in Budapest,1933,['United States of America'],"['Black-and-white', 'Romantic drama', 'Romance Film', 'Melodrama', 'Drama']",1930,3
2492199,Winter Light,1963,['Sweden'],"['Black-and-white', 'Art film', 'World cinema', 'Drama']",1960,3
16673113,Brainsmasher... A Love Story,1993,['United States of America'],"['Action', 'Comedy film']",1990,3
612018,The Flintstones in Viva Rock Vegas,2000,['United States of America'],"['Slapstick', 'Comedy', 'Family Film', 'Fantasy']",2000,0
12697384,The Song of Life,1931,['Germany'],['Drama'],1930,1
5246741,Thirupaachi,2005,['India'],"['Action', 'Romance Film', 'Thriller']",2000,5
2229732,Mr. Hobbs Takes a Vacation,1962,['United States of America'],"['Satire', 'Comedy', 'Domestic Comedy', 'Drama', 'Family Film']",1960,2
29502323,Broken Promises: Taking Emily Back,1993,['United States of America'],['Drama'],1990,3
27682014,Alag Alag,1985,['India'],"['Musical', 'Romance Film', 'Family Film']",1980,5
2866230,Code Name: The Cleaner,2007,['United States of America'],"['Action', 'Action/Adventure', 'Comedy', 'Slapstick']",2000,7
4616833,Ernest in the Army,1998,['United States of America'],"['Parody', 'Slapstick', 'Comedy', 'Family Film']",1990,8
3384409,The Gods Must Be Crazy II,1990,"['United States of America', 'South Africa']","['Indie', 'Action/Adventure', 'Comedy', 'World cinema', 'Slapstick', 'Adventure', 'Cult']",1990,0
3565240,The Son,2002,"['France', 'Belgium']","['Mystery', 'Family Drama', 'World cinema', 'Social problem film', 'Drama']",2000,2
10693049,Winx Club - Il Segreto Del Regno Perduto,2007,['Italy'],"['Animated cartoon', ""Children's"", 'Fantasy']",2000,7
25411910,Fauj Mein Mauj,2009,['India'],['Comedy'],2000,9
10973019,Eva,1962,"['France', 'Italy']","['Film adaptation', 'Romantic drama', 'Romance Film', 'Drama']",1960,2
15259992,Genealogy,1979,['South Korea'],"['Melodrama', 'Drama']",1970,9
26723671,Charlie Chan and the Curse of the Dragon Queen,1981,['United States of America'],"['Mystery', 'Crime Thriller', 'Thriller']",1980,1
7407088,Goodbye Again,1961,"['France', 'United States of America']","['Film adaptation', 'Black-and-white', 'Romance Film', 'Drama']",1960,1
3494676,Major League II,1994,['United States of America'],"['Baseball', 'Sports', 'Comedy']",1990,4
19938041,Darker than Amber,1970,['United States of America'],"['Action', 'Crime Fiction', 'Mystery', 'Melodrama', 'Crime Thriller', 'Drama']",1970,0
22971483,Dug's Special Mission,2009,['United States of America'],"['Computer Animation', 'Animation']",2000,9
451877,The Killer,1989,"['China', 'Hong Kong']","['Action', 'Crime Fiction', 'Action/Adventure', 'Thriller', 'World cinema', 'Chinese Movies', 'Drama']",1980,9
3979884,Valley of the Wolves: Iraq,2006,['Turkey'],"['Action', 'Drama', 'Action/Adventure', 'War film']",2000,6
4331430,Giliw Ko,1939,['Philippines'],"['Musical', 'Filipino Movies', 'Black-and-white', 'Romance Film']",1930,9
15323823,Love on the Dole,1941,['United Kingdom'],"['Black-and-white', 'Drama']",1940,1
4320746,Slayers Gorgeous,1998,['Japan'],"['Japanese Movies', 'Comedy', 'Anime', 'Adventure']",1990,8
9485983,Last Exit,2006,['Canada'],"['Action', 'Drama']",2000,6
23740170,Gandharvam,1993,['India'],"['Romance Film', 'Drama']",1990,3
13842574,The Cracksman,1963,['United Kingdom'],"['Heist', 'Crime Fiction', 'Parody', 'Comedy', 'Slapstick']",1960,3
10229940,Hindustan Ki Kasam,1999,['India'],"['Action/Adventure', 'World cinema']",1990,9
7185078,Deep End,1970,"['Australia', 'Finland', 'West Germany', 'United Kingdom', 'Germany', 'England', 'Poland', 'United States of America']","['Romance Film', 'Drama']",1970,0
2380622,"Brother Sun, Sister Moon",1972,"['United Kingdom', 'Italy']","['Biography', 'Biographical film', 'World cinema', 'Christian film', 'Costume drama', 'Drama', 'Period piece', 'Biopic [feature]', 'Hagiography']",1970,2
11680708,La Setta,1991,['Italy'],"['Supernatural', 'Fantasy', 'Horror']",1990,1
21306748,Jawani Diwani: A Youthful Joyride,2006,['India'],"['Musical', 'Romantic drama', 'Bollywood', 'World cinema', 'Romance Film', 'Drama']",2000,6
10575225,Blood Feast 2: All U Can Eat,2002,['United States of America'],"['Horror Comedy', 'Splatter film', 'Horror', 'Slasher', 'B-movie', 'Cult']",2000,2
17874813,Hypnotic Hick,1953,[],['Animation'],1950,3
3747529,Jack Frost,1996,['United States of America'],"['Monster movie', 'Comedy', 'Slasher', 'Horror', 'B-movie', 'Science Fiction']",1990,6
22787040,Ambush Bay,1966,['United States of America'],"['Action', 'Drama', 'Action/Adventure', 'War film']",1960,6
31737525,Oonche Log,1985,['India'],"['Drama', 'World cinema']",1980,5
1269856,Burke & Wills,1985,['Australia'],"['Period piece', 'Action/Adventure', 'World cinema', 'Adventure', 'Drama']",1980,5
22114746,Naanayam,2009,['India'],['Thriller'],2000,9
74848,Killer of Sheep,1981,['United States of America'],"['Black-and-white', 'Drama', 'Family Drama', 'Indie']",1980,1
4717197,The Iron Horse,1924,['United States of America'],"['Black-and-white', 'Drama', 'Indie', 'Epic Western', 'Action/Adventure', 'Western', 'Silent film']",1920,4
4711743,The Devil and Max Devlin,1981,['United States of America'],"['Heaven-Can-Wait Fantasies', 'Comedy', 'Religious Film', 'Fantasy Comedy', 'Family Film', 'Fantasy']",1980,1
27488355,Raam,2009,['India'],['Comedy film'],2000,9
10525221,Where's Lazlo?,2007,['United States of America'],['Fantasy'],2000,7
924101,Lilja 4-ever,2002,"['Sweden', 'Denmark']","['Crime Fiction', 'Art film', 'World cinema', 'Drama']",2000,2
18082866,Moby Dick,1930,['United States of America'],"['Adventure', 'Black-and-white']",1930,0
2623071,Oscar,1991,['United States of America'],"['Crime Fiction', 'Gangster Film', 'Comedy', 'Slapstick']",1990,1
18449579,The Last Run,1971,['United States of America'],"['Action', 'Crime Fiction']",1970,1
5909788,Head Over Heels,1979,['United States of America'],"['Romance Film', 'Romantic comedy', 'Comedy']",1970,9
18081866,Next Time We Love,1936,['United States of America'],"['Black-and-white', 'Romance Film', 'Melodrama', 'Drama']",1930,6
27370872,Gunsmoke IV: The Long Ride,1993,['United States of America'],"['Western', 'Television movie', 'Action/Adventure']",1990,3
3543676,Demolition High,1996,['United States of America'],"['Action', 'Action Thrillers', 'Thriller', 'Teen']",1990,6
4033849,Second in Command,2006,"['Romania', 'United States of America']","['Action', 'Action Thrillers', 'Action/Adventure', 'Thriller', 'Political thriller']",2000,6
2910322,Perfect Stranger,2007,['United States of America'],"['Psychological thriller', 'Suspense', 'Mystery', 'Thriller', 'Crime Thriller', 'Drama']",2000,7
16252026,The Phantom of Hollywood,1974,['United States of America'],"['Mystery', 'Crime Fiction']",1970,4
6509690,Lewis and Clark and George,1997,['United States of America'],"['Crime Fiction', 'Comedy', 'Thriller', 'Drama']",1990,7
6073447,Children of the Corn 666: Isaac's Return,1999,['United States of America'],"['Supernatural', 'Cult', 'Horror']",1990,9
1364234,The Hurricane,1937,['United States of America'],"['Action', 'Film adaptation', 'Black-and-white', 'Action/Adventure', 'Romance Film', 'Natural disaster', 'Disaster', 'Adventure', 'Drama']",1930,7
3681052,Thousands Cheer,1943,['United States of America'],"['Musical', 'Comedy']",1940,3
5787130,Magic in the Water,1995,"['Canada', 'United States of America']","[""Children's Fantasy"", 'Family Drama', ""Children's/Family"", 'Adventure', 'Drama', 'Family Film', 'Fantasy']",1990,5
8589723,"Shake, Rattle & Roll 8",2006,['Philippines'],"['Filipino Movies', 'Comedy horror', 'Comedy', 'Horror', 'World cinema']",2000,6
2030233,What Ever Happened to Baby Jane?,1991,['United States of America'],"['Psychological thriller', 'Suspense', 'Thriller', 'Television movie', 'Drama']",1990,1
1570843,The Hills Have Eyes,1977,['United States of America'],"['Monster movie', 'Slasher', 'Horror', 'Road-Horror', 'Cult']",1970,7
35897035,Hide and Seek,2007,['Philippines'],"['Filipino Movies', 'Thriller', 'Horror', 'World cinema']",2000,7
17920,Life of Brian,1979,['United Kingdom'],"['Parody', 'Comedy', 'Cult']",1970,9
11837755,The People,1972,['United States of America'],"['Science Fiction', 'Drama']",1970,2
15858518,Anbe Vaa,1966,['India'],"['Romance Film', 'Comedy']",1960,6
12007271,The Blood Spattered Bride,1974,['Spain'],"['World cinema', 'Horror']",1970,4
2739726,Suicide Club,2001,['Japan'],"['Psychological thriller', 'LGBT', 'Crime Fiction', 'Mystery', 'Indie', 'Thriller', 'World cinema', 'Drama', 'Japanese Movies', 'Horror']",2000,1
12296019,The Woman in Red,1935,['United States of America'],"['Black-and-white', 'Drama']",1930,5
11624958,Nine Two Eleven,1957,['India'],"['Romantic drama', 'Thriller', 'World cinema', 'Romance Film', 'Drama']",1950,7
4155050,Stranger Than Fiction,2006,['United States of America'],"['Comedy', 'Black comedy', 'Comedy-drama', 'Drama', 'Fantasy']",2000,6
7792274,Thalaimagan,2006,['India'],"['Musical', 'Bollywood', 'World cinema', 'Drama']",2000,6
8486301,Revelation,2001,['United Kingdom'],"['Thriller', 'Horror', 'Supernatural', 'Fantasy']",2000,1
13485985,"Angus, Thongs and Perfect Snogging",2008,"['United Kingdom', 'United States of America']","['Coming of age', 'Comedy', 'Teen', 'Romance Film', 'Romantic comedy']",2000,8
26650366,The Monk,1990,"['United Kingdom', 'Spain']",['Historical drama'],1990,0
19048609,Action for Slander,1937,['United Kingdom'],"['Social problem film', 'Drama']",1930,7
8283109,Flying Disc Man from Mars,1950,['United States of America'],"['Action', 'Black-and-white', 'Adventure']",1950,0
3630720,The Alley of Miracles,1995,['Mexico'],"['LGBT', 'Drama', 'World cinema']",1990,5
7308322,Boys Love,2006,['Japan'],"['LGBT', 'Romantic drama', 'World cinema', 'Romance Film', 'Drama', 'Gay Themed', 'Gay', 'Japanese Movies', 'Gay Interest']",2000,6
15411235,Narradores de Javé,2003,"['Brazil', 'France']",['Drama'],2000,3
16901157,The Other Conquest,1999,['Mexico'],"['Indie', 'Drama']",1990,9
13598172,Variola Vera,1982,"['Serbia', 'Yugoslavia']","['Horror', 'Disaster', 'Drama', 'Medical fiction']",1980,2
3732626,"My Mother, the Mermaid",2004,['South Korea'],"['Drama', 'Fantasy']",2000,4
2421437,A Midsummer Night's Sex Comedy,1982,['United States of America'],"['Sex comedy', 'Parody', 'Comedy', 'Romance Film', 'Romantic comedy', 'Ensemble Film']",1980,2
2250068,Ultraman,2004,['Japan'],"['Superhero movie', 'Japanese Movies']",2000,4
28355486,Small Town Story,1953,['United Kingdom'],['Drama'],1950,3
18098742,Free Style,2009,['United States of America'],"['Family Drama', ""Children's/Family"", 'Sports', 'Drama', 'Family Film']",2000,9
14471796,The Brotherhood,1968,['United States of America'],"['Crime Fiction', 'Gangster Film', 'Thriller', 'Crime Thriller', 'Drama']",1960,8
13289421,Delirious,2006,"['United Kingdom', 'United States of America']","['Drama', 'Parody', 'Indie', 'Satire', 'Comedy', 'Romance Film']",2000,6
6698438,The Caterpillar Wish,2006,['Australia'],['Drama'],2000,6
896285,A Grand Day Out,1989,['United Kingdom'],"['Adventure Comedy', 'Fantasy Adventure', 'Animation', 'Short Film', 'Comedy', 'Stop motion', 'Fantasy']",1980,9
10235844,Ab Ke Baras,2002,['India'],"['Musical', 'Romantic drama', 'Bollywood', 'World cinema', 'Romance Film', 'Drama']",2000,2
5641788,The Martins,2001,['United Kingdom'],"['Family Drama', 'Comedy', 'Crime Comedy']",2000,1
8854150,The Picture of Dorian Gray,1945,['United States of America'],"['Film adaptation', 'Crime Fiction', 'Thriller', 'Costume drama', 'Drama', 'Period piece', 'Horror', 'Supernatural', 'Fantasy']",1940,5
5712265,Humraaz,2002,['India'],"['Musical', 'Romantic drama', 'Bollywood', 'World cinema', 'Romance Film', 'Drama']",2000,2
14296848,Death Ship,1980,['Canada'],"['Supernatural', 'Slasher', 'Horror']",1980,0
2096043,The Skeleton Key,2005,"['Germany', 'United States of America']","['Mystery', 'Gothic Film', 'Thriller', 'Horror', 'Drama']",2000,5
18865496,The Outsider,2002,['United States of America'],"['Romantic drama', 'Action/Adventure', 'Western', 'Romance Film', 'Drama']",2000,2
24555795,Female Ninja Magic: 100 Trampled Flowers,1974,['Japan'],['Japanese Movies'],1970,4
1811429,Diabolical Tales: Part I,2006,['United States of America'],"['Science Fiction', 'Short Film', 'Comedy']",2000,6
11058754,Girl with Green Eyes,1964,['United Kingdom'],"['Film adaptation', 'Coming of age', 'Romantic drama', 'Romance Film', 'Kitchen sink realism', 'Drama']",1960,4
1909633,Warning Shot,1967,['United States of America'],['Mystery'],1960,7
8683288,Plaster Caster,2001,['United States of America'],"['Music', 'Biography', 'Documentary', 'Culture & Society']",2000,1
9389794,Intimate Stories,2002,"['Argentina', 'Spain']","['Drama', 'Indie', 'Comedy', 'World cinema']",2000,2
22306475,Turtles Are Surprisingly Fast Swimmers,2005,['Japan'],"['Comedy', 'Japanese Movies']",2000,5
26638009,Fruit and Nut,2009,['India'],"['Musical', 'Comedy', 'Bollywood', 'World cinema', 'Romance Film', 'Romantic comedy']",2000,9
6971856,Fun Bar Karaoke,1996,['Thailand'],"['Crime Fiction', 'Comedy', 'Drama']",1990,6
9993539,Do Jasoos,1975,['India'],"['Mystery', 'Comedy']",1970,5
12602864,Mi querida señorita,1972,['Spain'],"['Romance Film', 'Drama']",1970,2
577663,Singles,1992,['United States of America'],"['Romance Film', 'Romantic comedy', 'Comedy']",1990,2
4681267,Hercules in the Haunted World,1961,['Italy'],"['Action', 'Costume Adventure', 'Action/Adventure', 'World cinema', 'Sword and Sandal', 'Adventure', 'Mythological Fantasy', 'Horror', 'Fantasy']",1960,1
9220849,La cicala,1980,['Italy'],['Drama'],1980,0
1777408,"Stay Away, Joe",1968,['United States of America'],"['Musical', 'Action/Adventure', 'Western', 'Comedy', 'Romance Film']",1960,8
99948,Cabin Boy,1994,['United States of America'],"['Screwball comedy', 'Comedy', 'Fantasy Comedy', 'Cult']",1990,4
3105139,The Mirror Has Two Faces,1996,['United States of America'],"['Romantic drama', 'Comedy', 'Remake', 'Romance Film', 'Drama', 'Romantic comedy', 'Melodrama', 'Comedy-drama']",1990,6
24160876,Sphinx,1981,"['Netherlands', 'United States of America']",['Mystery'],1980,1
3557065,Seraphim Falls,2006,['United States of America'],"['Action', 'Psychological thriller', 'Action Thrillers', 'Revisionist Western', 'Action/Adventure', 'Thriller', 'Drama', 'Period piece', 'Western', 'War film']",2000,6
12979792,Eşkıya,1996,['Turkey'],"['Drama', 'Crime Fiction', 'Thriller']",1990,6
7960697,The Toolbox Murders,1978,['United States of America'],"['Indie', 'Slasher', 'Horror', 'Cult']",1970,8
30246289,33 Scenes from Life,2008,"['Germany', 'Poland']",['Drama'],2000,8
30862627,Ashaant,1993,[],['Action'],1990,3
29017966,The Fiend,1972,['United Kingdom'],['Horror'],1970,2
928593,The Crowd,1928,['United States of America'],"['Silent film', 'Black-and-white', 'Drama']",1920,8
5659888,Facing the Giants,2006,['United States of America'],"['Indie', 'Christian film', 'Sports', 'Drama']",2000,6
24771652,Rettaisuzhi,2009,[],['Drama'],2000,9
4971866,Wolves of Wall Street,2002,['United States of America'],"['Creature Film', 'Horror']",2000,2
19512369,One True Love,2008,['Philippines'],"['Filipino Movies', 'Romantic drama', 'World cinema', 'Romance Film', 'Drama']",2000,8
1364751,On Dangerous Ground,1952,['United States of America'],"['Black-and-white', 'Crime Fiction', 'Thriller', 'Film noir', 'Drama']",1950,2
17590460,Angel and Big Joe,1975,['United States of America'],"['Indie', 'Short Film', 'Drama']",1970,5
4980155,Border,1997,['India'],"['Musical', 'Action', 'Action/Adventure', 'Bollywood', 'World cinema', 'War film', 'Drama']",1990,7
21595282,The Unsent Letter,1959,"['Russia', 'Soviet Union']","['Black-and-white', 'World cinema', 'Adventure', 'Drama']",1950,9
6940101,The Black Cat,2006,"['Canada', 'United States of America']","['Psychological thriller', 'Television movie', 'Horror']",2000,6
7173935,Not Now,1936,['United States of America'],"['Animation', 'Short Film', 'Comedy', 'Family Film']",1930,6
18956814,Destroyer,1943,['United States of America'],"['War film', 'Black-and-white']",1940,3
837494,Boiler Room,2000,['United States of America'],['Drama'],2000,0
24075769,Si le soleil ne revenait pas,1987,[],['Drama'],1980,7
9051776,Bliss,1985,"['New Zealand', 'Australia']","['Drama', 'Indie', 'Comedy', 'World cinema', 'Black comedy']",1980,5
2473923,"Simon, King Of The Witches",1971,['United States of America'],"['Supernatural', 'Drama', 'Horror']",1970,1
5368180,Les Amours d'Astrée et de Céladon,2007,"['France', 'Spain', 'Italy']","['Art film', 'Romantic drama', 'World cinema', 'Romance Film', 'Drama']",2000,7
20722483,Periyar,2006,['India'],['Biographical film'],2000,6
2489108,Lawn Dogs,1997,"['United Kingdom', 'United States of America']","['Drama', 'Coming of age', 'Family Drama', 'Indie', 'Comedy', 'Childhood Drama']",1990,7
1644867,Ram Teri Ganga Maili,1985,['India'],"['Musical', 'Romantic drama', 'Bollywood', 'World cinema', 'Romance Film', 'Drama']",1980,5
5396840,Tenchi Muyo! Daughter of Darkness,1997,['Japan'],"['Animation', 'Comedy', 'Anime', 'Science Fiction', 'Fantasy']",1990,7
311935,The Good Son,1993,['United States of America'],"['Psychological thriller', 'Suspense', 'Thriller', 'Crime Thriller', 'Drama']",1990,3
6102235,The Brave Little Toaster Goes to Mars,1998,['United States of America'],"['Animation', ""Children's"", 'Comedy', 'Adventure', 'Science Fiction', 'Family Film']",1990,8
5925262,Hayride to Hell,1995,['Australia'],['Short Film'],1990,5
12890638,Lost Boys II: The Tribe,2008,"['Canada', 'United States of America']","['Comedy', 'Teen', 'Horror', 'Cult']",2000,8
3096476,Penny Dreadful,2006,['United States of America'],"['Psychological thriller', 'Slasher', 'Horror', 'Cult']",2000,6
1287385,Million Dollar Baby,2004,['United States of America'],"['Boxing', 'Sports', 'Drama', 'Tragedy']",2000,4
2241866,Moment by Moment,1978,['United States of America'],"['Romantic drama', 'Romance Film', 'Melodrama', 'Drama']",1970,8
9517607,Balkanski špijun,1984,['Yugoslavia'],['Comedy'],1980,4
17830752,Birds of America,2008,['United States of America'],"['Indie', 'Comedy', 'Domestic Comedy', 'Comedy-drama', 'Drama']",2000,8
28963604,Last Night at the Alamo,1998,['United States of America'],"['Drama', 'Comedy']",1990,8
10696616,The Stars Fell on Henrietta,1995,['United States of America'],"['Americana', 'Drama']",1990,5
8773991,Witchery,1988,"['Italy', 'United States of America']",['Horror'],1980,8
21861929,Peter Gaya Kaam Se,2009,['India'],"['Musical', 'Action/Adventure', 'World cinema', 'Romance Film']",2000,9
21107874,I Am Omega,2007,['United States of America'],"['Action', 'Thriller', 'Horror']",2000,7
24440474,Panic Beats,1983,['Spain'],"['World cinema', 'Haunted House Film', 'Horror']",1980,3
21132353,Casper,1995,['United States of America'],"['Comedy', 'Horror', 'Black comedy', 'Comedy-drama', 'Family Film', 'Fantasy']",1990,5
25333857,The Zoo Gang,1985,['United States of America'],"['Comedy', 'Teen']",1980,5
6945089,Walk in the Spring Rain,1970,['United States of America'],"['Romance Film', 'Drama']",1970,0
8608738,The Greek Tycoon,1978,['United States of America'],"['Romance Film', 'Romantic drama', 'Drama']",1970,8
28362996,Uncle Sam,1996,['United States of America'],"['Parody', 'Slasher', 'Horror Comedy', 'Horror', 'B-movie', 'Zombie Film']",1990,6
9522039,Prajapathi,2006,['India'],"['Action', 'Thriller']",2000,6
302757,From Justin to Kelly,2003,['United States of America'],"['Musical', 'Comedy', 'Teen', 'Romance Film', 'Romantic comedy', 'Beach Film']",2000,3
19609617,Rajput,1982,['India'],"['Action', 'Crime Fiction', 'World cinema', 'Romance Film']",1980,2
14614768,Talk About a Stranger,1952,['United States of America'],"['Black-and-white', 'Mystery', 'Film noir', 'Drama']",1950,2
8662998,Jeena Sirf Merre Liye,2002,['India'],"['Musical', 'Romantic drama', 'Bollywood', 'World cinema', 'Romance Film', 'Drama']",2000,2
3872285,I Married a Communist,1949,['United States of America'],"['Spy', 'Black-and-white', 'Crime Fiction', 'Film noir', 'Propaganda film']",1940,9
6484015,2002,2001,['Hong Kong'],"['Science Fiction', 'Chinese Movies']",2000,1
7225213,The Oxford Murders,2008,"['United Kingdom', 'France', 'Spain']","['Detective fiction', 'Crime Fiction', 'Mystery', 'Thriller', 'Detective', 'Whodunit']",2000,8
25965217,The Tall Target,1951,['United States of America'],['Thriller'],1950,1
12669668,Junoon,1992,['India'],"['Thriller', 'Horror']",1990,2
5297163,In God We Tru$t,1980,['United States of America'],['Comedy'],1980,0
3549468,Captain Video: Master of the Stratosphere,1951,['United States of America'],"['Action', 'Black-and-white', 'Adventure', 'Science Fiction']",1950,1
711970,Thoroughly Modern Millie,1967,['United States of America'],"['Musical', 'Screwball comedy', 'Parody', 'Comedy', 'Musical comedy', 'Romance Film', 'Romantic comedy']",1960,7
3511101,Skidoo,1968,['United States of America'],"['Crime Fiction', 'Parody', 'Comedy', 'Crime Comedy', 'Escape Film']",1960,8
32408836,Yuvathurki,1996,[],['Action'],1990,6
9061009,To Be Fat Like Me,2007,"['Canada', 'United States of America']","['Drama', 'Television movie']",2000,7
210151,"Lock, Stock and Two Smoking Barrels",1998,['United Kingdom'],"['Crime Fiction', 'Caper story', 'Buddy film', 'Thriller', 'Crime Comedy']",1990,8
8073502,Unconquered,1947,['United States of America'],"['Action/Adventure', 'Western', 'Adventure', 'Epic', 'Drama']",1940,7
35800169,The Bonnie Parker Story,1958,['United States of America'],"['Film noir', 'Biographical film']",1950,8
1811784,Where the Boys Are,1960,['United States of America'],"['Coming of age', 'Comedy', 'Romance Film', 'Romantic comedy']",1960,0
34191167,Goshta Choti Dongraevadhi,2009,[],['Drama'],2000,9
7832924,Priyamudan,1998,['India'],"['Musical', 'Romantic drama', 'Bollywood', 'World cinema', 'Romance Film', 'Drama']",1990,8
12835632,Kill the Umpire,1950,['United States of America'],"['Sports', 'Comedy']",1950,0
5883755,Lost Junction,2003,['United States of America'],"['Psychological thriller', 'Thriller', 'Romance Film', 'Crime Thriller', 'Drama']",2000,3
5064685,Vasool Raja MBBS,2004,['India'],"['Musical', 'Bollywood', 'World cinema']",2000,4
7660132,The Haunted Strangler,1957,['United Kingdom'],"['Psychological thriller', 'Thriller', 'Horror', 'Crime Thriller']",1950,7
5600552,Valentín,2003,"['Spain', 'Netherlands', 'Argentina', 'France', 'Italy']","['Drama', 'Romantic drama', 'Indie', 'Comedy', 'World cinema', 'Romance Film']",2000,3
8860361,Chand Ke Paar Chalo,2006,['India'],"['Musical', 'Romantic drama', 'Bollywood', 'World cinema', 'Romance Film', 'Drama']",2000,6
11316134,The Tunnel of Love,1958,['United States of America'],"['Black-and-white', 'Comedy', 'Romance Film', 'Romantic comedy']",1950,8
19890229,Running Mates,2000,['United States of America'],"['Political cinema', 'Comedy', 'Drama']",2000,0
1934127,The Brothers McMullen,1995,['United States of America'],"['Indie', 'Family Drama', 'Romantic drama', 'Comedy', 'Romance Film', 'Drama', 'Domestic Comedy', 'Romantic comedy', 'Comedy-drama']",1990,5
7023734,S.S. Doomtrooper,2006,['United States of America'],"['Horror', 'Science Fiction']",2000,6
12108366,Spider Lilies,2007,"['China', 'Taiwan']","['LGBT', 'Erotic Drama', 'Romantic drama', 'World cinema', 'Romance Film', 'Chinese Movies', 'Drama']",2000,7
146077,Empire of the Sun,1987,['United States of America'],"['Period piece', 'Film adaptation', 'Coming of age', 'Biography', 'Childhood Drama', 'War film', 'Drama']",1980,7
2804661,The Cider House Rules,1999,['United States of America'],"['Period piece', 'Film adaptation', 'Coming of age', 'Romantic drama', 'Romance Film', 'Americana', 'Drama']",1990,9
9390791,Hermanas,2005,"['Brazil', 'Argentina', 'Spain']","['Indie', 'Drama']",2000,5
36291706,Trading Mom,1994,['United States of America'],"['Family Film', 'Comedy film', 'Fantasy']",1990,4
12765279,Three for the Show,1955,['United States of America'],"['Musical', 'Dance', 'Comedy']",1950,5
8175422,T-Rex: Back to the Cretaceous,1998,"['Canada', 'United States of America']","['Fantasy Adventure', 'Adventure', ""Children's/Family"", 'Science Fiction', 'Family Film']",1990,8
9895860,Mango Kiss,2004,['United States of America'],"['Gay Themed', 'LGBT', 'Gay', 'Gay Interest', 'Comedy', 'Romance Film', 'Romantic comedy']",2000,4
1328216,Multiple Maniacs,1970,['United States of America'],"['Black-and-white', 'Crime Fiction', 'Comedy']",1970,0
14774895,Madame Aema,1982,['South Korea'],['Erotica'],1980,2
7451665,Chitchat on the nile,1971,['Egypt'],"['Drama', 'Comedy']",1970,1
2877584,Double Wedding,1937,['United States of America'],"['Black-and-white', 'Comedy', 'Romance Film', 'Romantic comedy']",1930,7
16134497,Shocking Pink,1965,[],"['Animation', 'Short Film', 'Comedy film']",1960,5
5083033,Never a Dull Moment,1968,['United States of America'],"['Crime Fiction', 'Mystery', 'Comedy', 'Adventure', 'Drama', 'Family Film']",1960,8
27998686,Free Fall,1999,"['Germany', 'United States of America', 'Canada']","['Action', 'Thriller', 'Drama']",1990,9
4282271,Terror Squad,1987,['United States of America'],"['Action', 'Action Thrillers', 'Drama']",1980,7
35196086,Skate or Die,2008,['France'],['Action'],2000,8
25989167,Rampo,1994,['Japan'],"['Japanese Movies', 'Mystery', 'Thriller', 'World cinema', 'Erotic thriller', 'Drama']",1990,4
6352734,Creepshow 3,2006,['United States of America'],"['Science Fiction', 'Slasher', 'Horror', 'B-movie', 'Cult']",2000,6
5977710,J-Men Forever,1979,[],"['Black comedy', 'Parody', 'Comedy']",1970,9
2926668,DOA: Dead or Alive,2006,"['United Kingdom', 'Germany', 'United States of America']","['Action', 'Action/Adventure', 'Thriller', 'Adventure', 'Martial Arts Film']",2000,6
30891336,Oru Maravathoor Kanavu,1998,[],"['Musical', 'Drama', 'Comedy film']",1990,8
22308889,Ken Russell's Fall of the Louse of Usher,2002,['United Kingdom'],"['Musical', 'Comedy horror', 'C-Movie', 'Black comedy', 'Drama', 'Comedy film', 'Horror', 'Science Fiction', 'Cult']",2000,2
33830782,Swanthamevide Bandhamevide,1984,[],"['Action', 'Drama']",1980,4
26675487,Prematho Raa,2001,['India'],['Romance Film'],2000,1
524250,The Sex Monster,1999,['United States of America'],"['LGBT', 'Indie', 'Comedy', 'Sex comedy']",1990,9
1645598,The Big Sleep,1946,['United States of America'],"['Crime Fiction', 'Mystery', 'Thriller', 'Film noir']",1940,6
7643463,Double Dragon,1994,['United States of America'],"['Martial Arts Film', 'Science Fiction']",1990,4
3557194,Deathlands: Homeward Bound,2003,['United States of America'],"['Dystopia', 'Thriller', 'Adventure', 'Television movie', 'Science Fiction']",2000,3
5746917,Held Up,1999,['United States of America'],"['Comedy', 'Crime Comedy', 'Comedy of Errors']",1990,9
28240999,Lord Jeff,1938,['United States of America'],"['Drama', 'Crime Fiction']",1930,8
14655668,The Criminal Code,1931,['United States of America'],['Black-and-white'],1930,1
12689587,Monrak luk thung,1970,['Thailand'],"['Musical', 'Romance Film', 'Comedy']",1970,0
28646059,One Hundred Mornings,2009,['Ireland'],"['Drama', 'Indie', 'World cinema', 'Science Fiction']",2000,9
12384049,College Coach,1933,['United States of America'],"['Black-and-white', 'Drama']",1930,3
11335015,Avishkaar,1973,['India'],"['Romantic drama', 'Bollywood', 'World cinema', 'Romance Film', 'Drama']",1970,3
28557670,White Lightnin',2009,['United Kingdom'],"['Crime Fiction', 'Thriller', 'Biopic [feature]', 'Crime Thriller', 'Drama']",2000,9
1405466,The Singles Ward,2002,['United States of America'],"['Comedy', 'Romance Film', 'Romantic comedy', 'Religious Film']",2000,2
12509757,Dragonfly,2002,"['Germany', 'United States of America']","['Mystery', 'Romantic drama', 'Thriller', 'Romance Film', 'Supernatural', 'Science Fiction', 'Drama']",2000,2
16782047,The Informers,1963,['United Kingdom'],['Crime Fiction'],1960,3
1705452,Freeway II: Confessions of a Trickbaby,1999,['United States of America'],"['Crime Fiction', 'Indie', 'Comedy', 'Thriller', 'Crime Thriller']",1990,9
34639978,Im Banne des Unheimlichen,1968,['Germany'],"['Crime Fiction', 'Mystery', 'Thriller']",1960,8
23633579,The Vyborg Side,1939,['Soviet Union'],['Drama'],1930,9
24668730,Se los Chupó la bruja,1958,['Mexico'],"['Comedy', 'Horror']",1950,8
8042486,In Society,1944,['United States of America'],"['Black-and-white', 'Comedy', 'Family Film']",1940,4
20952950,Rat,2001,"['United Kingdom', 'Ireland', 'United States of America']","['Indie', 'Comedy', 'Black comedy', 'Fantasy']",2000,1
22606928,The Last Eve,2005,['United States of America'],"['Action', 'Action/Adventure']",2000,5
1047447,Manon des Sources,1986,"['France', 'Switzerland', 'Italy']",['Drama'],1980,6
10068813,The Mark of the Hawk,1957,"['United Kingdom', 'United States of America']",['Drama'],1950,7
24817139,Across the Bridge,1957,"['United Kingdom', 'United States of America']","['Psychological thriller', 'Thriller', 'Film noir', 'Crime Thriller']",1950,7
1323106,Gremlins 2: The New Batch,1990,['United States of America'],"['Creature Film', 'Parody', 'Comedy', 'Horror Comedy', 'Horror', 'Black comedy', 'Cult']",1990,0
171058,Chaplin,1992,"['United Kingdom', 'France', 'Italy', 'United States of America']","['Period piece', 'Drama', 'Biography', 'Indie', 'Biographical film', 'Biopic [feature]', 'Costume drama']",1990,2
25081906,Inspirations,1997,"['Israel', 'United States of America']","['Music', 'Dance', 'Documentary']",1990,7
27215149,London Melody,1938,['United Kingdom'],['Musical'],1930,8
848685,Cyclo,1995,"['France', 'Hong Kong', 'Vietnam']","['Crime Fiction', 'Coming of age', 'World cinema', 'Crime Drama', 'Chinese Movies', 'Drama']",1990,5
5936873,CATS,1998,"['United Kingdom', 'United States of America']","['Musical', 'Drama']",1990,8
6587401,"Sex, love and other perversions",2006,['Mexico'],"['Drama', 'Comedy']",2000,6
4186781,Volunteers,1985,['United States of America'],"['Adventure Comedy', 'Buddy film', 'Comedy']",1980,5
15114362,Unfaithfully Yours,1984,['United States of America'],"['Romance Film', 'Romantic comedy', 'Comedy']",1980,4
19703518,Perkins' 14,2009,['United States of America'],"['Psychological thriller', 'Slasher', 'Horror', 'B-movie']",2000,9
9701398,Family Law,2006,"['Spain', 'Argentina', 'France', 'Italy']","['Drama', 'Indie', 'Comedy', 'World cinema', 'Comedy-drama']",2000,6
24366494,Paranormal Activity,2009,['United States of America'],"['Suspense', 'Indie', 'Horror', 'Supernatural', 'Haunted House Film']",2000,9
22050579,Million Dollar Baby,1941,['United States of America'],['Black-and-white'],1940,1
8039370,Open Graves,2009,"['Spain', 'United States of America']","['Slasher', 'Thriller', 'Horror']",2000,9
24355525,Zone Troopers,1985,['United States of America'],"['Indie', 'War film', 'Science Fiction', 'Cult']",1980,5
239532,Topaz,1969,"['United Kingdom', 'United States of America']","['Spy', 'Suspense', 'Film adaptation', 'Crime Fiction', 'Mystery', 'Thriller', 'Drama']",1960,9
1802864,According to Spencer,2001,"['Germany', 'United States of America']","['Coming of age', 'Indie', 'Comedy', 'Romance Film', 'Romantic comedy']",2000,1
2051753,Stuck On You,2003,['United States of America'],['Comedy'],2000,3
22351106,Ex Cathedra,2009,['United Kingdom'],"['Thriller', 'Drama']",2000,9
12969971,Something to Live for: The Alison Gertz Story,1992,['United States of America'],"['Biopic [feature]', 'Television movie', 'Docudrama', 'Drama']",1990,2
3947481,The Great Debaters,2007,['United States of America'],"['Period piece', 'Inspirational Drama', 'Biography', 'Drama']",2000,7
8433150,Kung Fu Mahjong 2,2005,['Hong Kong'],"['Action', 'Martial Arts Film', 'Action Comedy', 'Action/Adventure', 'Comedy', 'World cinema', 'Chinese Movies']",2000,5
14232786,Proud Flesh,1925,['United States of America'],"['Black-and-white', 'Drama', 'Indie', 'Comedy', 'Silent film', 'Romantic comedy']",1920,5
31322545,Jacke wie Hose,1953,['German Democratic Republic'],['Comedy film'],1950,3
20089025,Speedy Delivery,2008,['United States of America'],['Documentary'],2000,8
5972799,Merci Docteur Rey,2002,"['United States of America', 'France']","['LGBT', 'Comedy', 'World cinema']",2000,2
534778,Child's Play 3,1991,['United States of America'],"['Slasher', 'Comedy', 'Horror', 'Supernatural', 'Cult']",1990,1
29254831,Salute the Toff,1952,[],"['Drama', 'Crime Fiction']",1950,2
7190451,Where Love Has Gone,1964,['United States of America'],"['Crime Fiction', 'Romantic drama', 'Romance Film', 'Drama', 'Courtroom Drama']",1960,4
17884084,Open Your Eyes,2008,['United States of America'],"['Short Film', 'Drama']",2000,8
36309399,Sedam i po,2006,['Serbia'],"['Black comedy', 'Drama', 'Comedy film']",2000,6
2190622,16 Blocks,2006,"['Germany', 'United States of America']","['Action', 'Crime Fiction', 'Action/Adventure', 'Thriller', 'Crime Thriller']",2000,6
10249080,La Vie En Rose,2007,"['United Kingdom', 'France', 'Czech Republic']","['Musical', 'Biography', 'Biographical film', 'World cinema', 'Drama']",2000,7
3652063,Crowned and Dangerous,1997,['United States of America'],"['Crime Fiction', 'Mystery', 'Comedy', 'Thriller', 'Television movie']",1990,7
3227001,No Smoking,1951,['India'],"['Musical', 'Thriller', 'Bollywood', 'World cinema']",1950,1
11481973,Lakshyam,2007,['India'],['Action'],2000,7
8057286,A Cosmic Christmas,1977,['Canada'],"['Animation', 'Short Film', 'Science Fiction']",1970,7
18510429,False Pretenses,1935,['United States of America'],"['Comedy', 'Black-and-white']",1930,5
12994797,Fist of Fury 1991,1991,['Hong Kong'],"['Action', 'Chinese Movies', 'Comedy']",1990,1
12976768,Service for Ladies,1932,['United Kingdom'],"['Romantic comedy', 'Black-and-white']",1930,2
1847229,Hoodlum,1997,['United States of America'],"['Action', 'Period piece', 'Drama', 'Crime Fiction', 'Gangster Film']",1990,7
4369095,Krampack,2000,['Spain'],"['Comedy', 'LGBT']",2000,0
5371392,Varavelpu,1989,['India'],"['Black comedy', 'Drama', 'Comedy film']",1980,9
9766869,Seducing Mr. Perfect,2006,['South Korea'],['Romance Film'],2000,6
6809638,Aasai,1995,['India'],"['Drama', 'World cinema']",1990,5
24470766,12 Storeys,1997,['Singapore'],"['Drama', 'Comedy']",1990,7
5600651,Tango,1998,"['Argentina', 'Spain', 'Puerto Rico']","['Musical', 'Romantic drama', 'World cinema', 'Romance Film', 'Drama']",1990,8
8114429,The Sadist,1963,['United States of America'],"['Psychological thriller', 'Black-and-white', 'Indie', 'Slasher', 'Thriller', 'Horror', 'B-movie']",1960,3
17064258,Illusion,2004,['United States of America'],"['Romantic drama', 'Indie', 'Romance Film', 'Drama']",2000,4
32999017,Yankee Pasha,1954,['United States of America'],"['Romance Film', 'Adventure']",1950,4
3254614,Taj Mahal—An Eternal Love Story,2005,"['India', 'Pakistan']","['Musical', 'Romance Film', 'Drama']",2000,5
8994872,I Love You Too,2001,['Netherlands'],"['Romantic drama', 'World cinema', 'Romance Film', 'Drama']",2000,1
7224803,Walking Tall,2004,['United States of America'],"['Action', 'Crime Fiction', 'Action/Adventure', 'Comedy', 'Thriller', 'Biographical film', 'Drama']",2000,4
453830,...tick...tick...tick...,1970,['United States of America'],['Blaxploitation'],1970,0
1594408,Turbo: A Power Rangers Movie,1997,['United States of America'],"['Action', 'Superhero', ""Children's/Family"", 'Martial Arts Film', 'Adventure', ""Children's Fantasy"", 'Superhero movie', 'Family Film']",1990,7
359571,The Life of David Gale,2003,"['United Kingdom', 'Germany', 'United States of America']","['Crime Fiction', 'Mystery', 'Thriller', 'Crime Drama', 'Melodrama', 'Crime Thriller', 'Drama']",2000,3
3488543,Ladybugs,1992,['United States of America'],"['Sports', 'Screwball comedy', 'Comedy', ""Children's/Family"", 'Family Film', 'Comedy of Errors']",1990,2
7443317,Everyone But Japan Sinks,2006,['Japan'],"['Japanese Movies', 'Comedy', 'World cinema', 'Black comedy', 'Natural disaster']",2000,6
87983,Stand by Me,1986,['United States of America'],"['Period piece', 'Film adaptation', 'Coming of age', 'Teen', 'Adventure', 'Drama']",1980,6
10125157,Gunman,1983,['Thailand'],"['Action', 'Crime Fiction', 'Thriller']",1980,3
25829108,The Lawyer,1970,['United States of America'],"['Detective fiction', 'Crime Fiction', 'Mystery', 'Thriller', 'Crime Thriller', 'Drama', 'Courtroom Drama', 'Detective']",1970,0
21912615,Kidz in the Wood,1996,['United States of America'],"['Family-Oriented Adventure', ""Children's/Family""]",1990,6
1126385,Unfaithful,2002,"['France', 'Germany', 'United States of America']","['Crime Fiction', 'Romantic drama', 'Thriller', 'Romance Film', 'Crime Thriller', 'Drama', 'Erotic thriller', 'Erotica']",2000,2
20819304,The Gunsaulus Mystery,1921,['United States of America'],"['Crime Fiction', 'Mystery', 'Silent film', 'Drama']",1920,1
8419530,West 32nd,2007,"['United States of America', 'South Korea']","['Crime Fiction', 'Gangster Film', 'Indie', 'Film noir', 'Drama']",2000,7
31092702,John Loves Mary,1949,['United States of America'],['Comedy'],1940,9
8718670,Banaras - A Mystic Love Story,2006,['India'],"['Musical', 'Bollywood', 'World cinema', 'Drama']",2000,6
308898,A Fish Called Wanda,1988,"['United Kingdom', 'United States of America']","['Heist', 'Crime Fiction', 'Screwball comedy', 'Caper story', 'Comedy', 'Crime Comedy']",1980,8
2580131,The Giant Spider Invasion,1975,['United States of America'],"['Monster movie', 'Monster', 'Horror', 'Sci-Fi Horror', 'Science Fiction']",1970,5
7413271,Sundown: The Vampire in Retreat,1990,['United States of America'],"['Action/Adventure', 'Western', 'Comedy', 'Horror', 'Supernatural']",1990,0
3931502,Akeelah and the Bee,2006,['United States of America'],"['Coming of age', 'Family Drama', 'Childhood Drama', 'Drama', 'Family Film']",2000,6
32854372,Just Before Nightfall,1971,['France'],"['Crime Fiction', 'Thriller', 'World cinema', 'Romance Film', 'Crime Thriller', 'Drama', 'Suspense', 'Erotic thriller', 'Crime Drama']",1970,1
32922108,A Man Alone,1955,['United States of America'],['Western'],1950,5
23836054,Born Into Exile,1997,"['Canada', 'United States of America']",['Drama'],1990,7
3419072,"Abraxas, Guardian of the Universe",1990,"['Canada', 'United States of America']","['Science Fiction', 'Adventure']",1990,0
734419,More,1969,"['Luxembourg', 'France', 'Germany', 'West Germany', 'United States of America']","['Crime Fiction', 'Art film', 'World cinema', 'Romance Film', 'Drama']",1960,9
12737417,Vijaypath,1994,['India'],['Bollywood'],1990,4
18538183,Big Ain't Bad,2002,['United States of America'],"['Romance Film', 'Romantic comedy', 'Comedy']",2000,2
23258338,Tea and Sympathy,1956,['United States of America'],['LGBT'],1950,6
34515864,Les Misérables,2000,"['Spain', 'France', 'Germany', 'Italy', 'United States of America']","['Historical fiction', 'Drama']",2000,0
11123401,Obaltan,1960,"['Korea', 'South Korea']","['Drama', 'Thriller', 'World cinema']",1960,0
19152358,"Silent Night, Bloody Night",1974,['United States of America'],"['Psychological thriller', 'Slasher', 'Thriller', 'Horror', 'B-movie']",1970,4
2580403,American Pie,1999,['United States of America'],"['Coming of age', 'Comedy', 'Teen', 'Romantic comedy', 'Romance Film', 'Sex comedy']",1990,9
23290339,Weighed But Found Wanting,1974,['Philippines'],"['Filipino Movies', 'Drama', 'World cinema']",1970,4
5908214,Hridayathil Sookshikkan,2005,['India'],"['Drama', 'Comedy', 'Romance Film', 'Malayalam Cinema']",2000,5
2261864,The Cheyenne Social Club,1970,['United States of America'],"['Action', 'Comedy Western', 'Western', 'Comedy']",1970,0
13399075,The Circus Clown,1934,['United States of America'],"['Black-and-white', 'Comedy-drama', 'Comedy']",1930,4
7348608,The Crucified Lovers,1954,['Japan'],"['Black-and-white', 'Japanese Movies', 'Drama']",1950,4
21176707,My Wife's Murder,2005,['India'],"['Thriller', 'World cinema']",2000,5
12246065,The Taking of Flight 847: The Uli Derickson Story,1988,['United States of America'],"['Docudrama', 'Thriller', 'Political thriller']",1980,8
4030302,Butterfly: A Grimm Love Story,2007,['Germany'],"['Psychological thriller', 'Crime Fiction', 'Thriller', 'Horror', 'World cinema', 'Drama']",2000,7
9974516,Little Fauss and Big Halsy,1970,['United States of America'],"['Biker Film', 'Romantic drama', 'Adventure', 'Drama']",1970,0
17578623,Il Divo,2008,"['France', 'Italy']","['Art film', 'Biography', 'Biopic [feature]', 'World cinema', 'Political drama', 'Drama']",2000,8
11792000,Violent Summer,1959,['Italy'],"['Black-and-white', 'Romantic drama', 'World cinema', 'Romance Film', 'War film', 'Drama']",1950,9
354122,Gallipoli,1981,"['New Zealand', 'Australia']","['War film', 'Drama', 'World cinema']",1980,1
3112909,Fantastic Mr. Fox,2009,"['United Kingdom', 'United States of America']","['Animation', 'Comedy', 'Stop motion', ""Children's/Family"", 'Adventure', 'Family Film']",2000,9
2236468,Ek Ajnabee,2005,['India'],"['Action', 'Crime Fiction', 'Action Thrillers', 'Action/Adventure', 'Thriller', 'Bollywood', 'World cinema', 'Crime Thriller', 'Drama']",2000,5
6764111,God Tussi Great Ho,2006,['India'],"['Musical', 'Comedy', 'Bollywood', 'World cinema', 'Romantic comedy']",2000,6
2469205,Life Is Ruff,2005,['United States of America'],"['Comedy', ""Children's""]",2000,5
5885921,"Packing the Monkeys, Again!",2004,['Serbia and Montenegro'],['Drama'],2000,4
18372339,Jaal: The Trap,2003,['India'],"['Action', 'Musical', 'Drama', 'World cinema', 'Romance Film']",2000,3
8987889,Rocket Science,2007,['United States of America'],"['Drama', 'Indie', 'Coming of age', 'Comedy', 'Teen', 'Comedy-drama']",2000,7
1365310,Ride the Pink Horse,1947,['United States of America'],"['Black-and-white', 'Crime Fiction', 'Thriller', 'Film noir', 'Crime Thriller', 'Drama']",1940,7
5442467,Alien Arsenal,1999,['United States of America'],"['Science Fiction', 'Teen']",1990,9
9005101,Aao Pyaar Karen,1994,['India'],"['Romance Film', 'Drama']",1990,4
29050251,Chakkara Muthu,2006,['India'],"['Romance Film', 'Comedy', 'Drama']",2000,6
6811437,Sleepy-Time Tom,1951,['United States of America'],"['Animated cartoon', 'Short Film', 'Comedy', 'Family Film']",1950,1
62689,The Great Dictator,1940,['United States of America'],"['Black-and-white', 'Political satire', 'Satire', 'Comedy', 'Anti-war', 'Political cinema', 'Anti-war film', 'War film']",1940,0
12381664,Anak-Anak Borobudur,2007,['Indonesia'],['Drama'],2000,7
2467316,Rhapsody in August,1991,['Japan'],"['Japanese Movies', 'Family Drama', 'World cinema', 'Drama']",1990,1
15897270,Akku,2008,['India'],['Drama'],2000,8
5429993,Step Up,2006,['United States of America'],"['Musical', 'Crime Fiction', 'Romantic drama', 'Teen', 'Dance', 'Romance Film', 'Drama']",2000,6
21433950,The Atomic City,1952,['United States of America'],"['Thriller', 'Drama']",1950,2
592766,Backdraft,1991,['United States of America'],"['Action', 'Detective fiction', 'Crime Fiction', 'Action Thrillers', 'Mystery', 'Action/Adventure', 'Thriller', 'Crime Thriller', 'Disaster', 'Drama', 'Detective']",1990,1
27253748,Rasikan,2004,['India'],['Comedy-drama'],2000,4
5668453,Five Graves to Cairo,1943,['United States of America'],"['Spy', 'Black-and-white', 'War film', 'Adventure']",1940,3
7276753,Dr. Jekyll y el Hombre Lobo,1972,['Spain'],"['Creature Film', 'Horror']",1970,2
10202962,The Royal Mounted Rides Again,1945,['United States of America'],"['Action', 'Detective fiction', 'Black-and-white', 'Detective', 'Adventure']",1940,5
19408705,Two Too Young,1936,['United States of America'],"['Black-and-white', 'Short Film', 'Comedy', 'Family Film']",1930,6
3463364,High School Musical,2006,['United States of America'],"['Musical', 'Family Drama', 'Comedy', 'Teen', ""Children's"", 'Drama', 'Romantic comedy', 'Family Film']",2000,6
8102390,Little Giant,1946,['United States of America'],"['Black-and-white', 'Crime Fiction', 'Comedy', 'Family Film']",1940,6
10513672,Life with Tom,1953,['United States of America'],"['Animation', 'Short Film', 'Comedy', 'Family Film']",1950,3
33895400,Beyond the Fire,2009,[],"['Romance Film', 'Drama']",2000,9
3803362,Blood Bath,1966,['United States of America'],"['Black-and-white', 'Horror', 'B-movie', 'Cult']",1960,6
1518575,Rugrats in Paris: The Movie,2000,['United States of America'],"['Animation', 'Family-Oriented Adventure', ""Children's/Family"", ""Children's""]",2000,0
6963236,Kshatriya,1993,['India'],"['Action', 'Drama', 'War film']",1990,3
13393290,Death Screams,1982,['United States of America'],"['Indie', 'Slasher', 'Horror']",1980,2
18634533,Bad Lieutenant: Port of Call New Orleans,2009,['United States of America'],"['Indie', 'Thriller', 'Crime Drama', 'Crime Thriller', 'Drama']",2000,9
25549734,Coolie No. 1,1995,['India'],['Bollywood'],1990,5
14603950,The Secret of Moonacre,2008,"['Australia', 'France', 'United Kingdom', 'Hungary', 'New Zealand']","['Fantasy Adventure', 'Film adaptation', ""Children's Fantasy"", 'Romance Film', 'Adventure', 'Family Film', 'Fantasy']",2000,8
10332120,The Mountain of the Cannibal God,1978,['Italy'],"['Slasher', 'Horror', 'B-movie', 'Adventure']",1970,8
8864659,The Man Who Laughs,1928,['United States of America'],"['Expressionism', 'Black-and-white', 'Horror', 'Silent film', 'Drama']",1920,8
13309790,I Passed for White,1960,['United States of America'],"['Black-and-white', 'Romantic drama', 'Romance Film', 'Melodrama', 'Drama']",1960,0
9742232,None Shall Escape,1944,['United States of America'],"['Black-and-white', 'Crime Fiction', 'Legal drama', 'War film', 'Drama']",1940,4
5579768,Bad Company,1972,['United States of America'],"['Action', 'Western', 'Action/Adventure', 'Acid western']",1970,2
4923868,Wild Hearts Can't Be Broken,1991,['United States of America'],"['Biography', 'Family Drama', 'Romance Film', 'Family-Oriented Adventure', ""Children's/Family"", 'Adventure', 'Drama', 'Biopic [feature]', 'Family Film']",1990,1
19205177,Ladies Who Do,1963,['United Kingdom'],"['Comedy', 'Satire']",1960,3
11637110,Joshua,2007,['United States of America'],"['Indie', 'Thriller', 'Horror', 'Drama']",2000,7
28368552,The Jade Faced Assassin,1971,['Hong Kong'],"['Wuxia', 'Chinese Movies', 'Adventure']",1970,1
3829690,Law of Desire,1987,['Spain'],"['LGBT', 'Crime Fiction', 'Comedy', 'World cinema', 'Romantic comedy', 'Romance Film', 'Drama']",1980,7
26069199,The Fourth Wish,1976,['Australia'],['Drama'],1970,6
1524536,Sahara,2005,"['Spain', 'United Kingdom', 'Germany', 'United States of America']","['Action', 'Film adaptation', 'Action/Adventure', 'Buddy film', 'Comedy', 'Adventure']",2000,5
2489557,Wild in the Streets,1968,['United States of America'],"['Political satire', 'Satire', 'Comedy', 'Teen', 'Political cinema', 'Parody', 'Comedy-drama', 'Cult']",1960,8
26625210,Manmatha,2007,['India'],['Comedy'],2000,7
5344149,The Sandlot 2,2005,['United States of America'],"['Period piece', 'Coming of age', 'Comedy', ""Children's/Family"", 'Sports', 'Family Film']",2000,5
14728039,Love's Unfolding Dream,2007,['United States of America'],"['Period piece', 'Romantic drama', 'Romance Film', 'Christian film', 'Television movie', 'Drama']",2000,7
16493989,The Man Inside,1958,['United Kingdom'],"['Crime Fiction', 'Adventure', 'Drama']",1950,8
21776050,Nahapet,1977,['Armenia'],['Drama'],1970,7
161874,"Divorce, Italian Style",1962,['Italy'],"['Black-and-white', 'Satire', 'Comedy', 'World cinema', 'Domestic Comedy']",1960,2
4501615,The Incredible Melting Man,1977,['United States of America'],"['Creature Film', 'Science Fiction', 'Horror', 'Sci-Fi Horror', 'Cult']",1970,7
4227563,Cain's Cutthroats,1971,['United States of America'],"['Action', 'Drama', 'Western', 'Comedy']",1970,1
6987295,The Teenage Textbook Movie,1998,['Singapore'],['Comedy'],1990,8
22878411,Crack in the Mirror,1960,['United States of America'],"['Crime Fiction', 'Mystery', 'Drama']",1960,0
21260903,Dead On: Relentless II,1992,['United States of America'],"['Action', 'Drama', 'Action/Adventure', 'Thriller']",1990,2
12261755,Nanhe,2007,['India'],"['Musical', 'Bollywood', 'World cinema', 'Drama']",2000,7
5218383,Vallavan,2006,['India'],"['Action', 'Romance Film', 'Thriller']",2000,6
6478729,The ButterCream Gang,1992,['United States of America'],"['Family Drama', ""Children's"", 'Family-Oriented Adventure', ""Children's/Family"", 'Adventure', 'Drama', 'Family Film']",1990,2
12613369,El clavo,1944,['Spain'],"['Black-and-white', 'Drama']",1940,4
10707864,Son of the Bride,2001,"['Argentina', 'Spain']","['Drama', 'Indie', 'Comedy', 'World cinema', 'Romance Film']",2000,1
9815449,Catherine the Great,1934,['United Kingdom'],"['Black-and-white', 'Biography', 'Biographical film', 'Romance Film', 'Costume drama', 'Drama']",1930,4
5860215,Ang Tanging Ina,2003,['Philippines'],"['Filipino Movies', 'Comedy', 'World cinema', 'Filipino', 'Drama']",2000,3
22759151,Apogee of Fear,2008,[],"['Short Film', 'Science Fiction']",2000,8
11631970,Buddies Thicker Than Water,1962,['United States of America'],['Comedy'],1960,2
710822,The Adventures of Pinocchio,1996,"['United Kingdom', 'France', 'Germany', 'Czech Republic', 'Italy', 'United States of America']","['Musical', 'Adventure', 'Family Film', 'Fantasy']",1990,6
13086330,Getting It Right,1989,"['United Kingdom', 'United States of America']","['Coming of age', 'Comedy', 'Romantic comedy', 'Sex comedy']",1980,9
15441313,Long John Silver,1954,['Australia'],"['Action', 'Film adaptation', 'Costume Adventure', 'Action/Adventure', 'World cinema', 'Family-Oriented Adventure', 'Swashbuckler films', 'Adventure', 'Drama', 'Family Film']",1950,4
14740284,Cuckoo on a Choo Choo,1952,['United States of America'],"['Short Film', 'Black-and-white', 'Comedy']",1950,2
25806977,The Eternal Struggle,1923,['United States of America'],"['Silent film', 'Crime Fiction', 'Adventure']",1920,3
24786271,Soul Kitchen,2009,"['France', 'Germany']","['Romantic drama', 'Comedy', 'World cinema', 'Romance Film', 'Romantic comedy', 'Drama']",2000,9
20192551,Secrets of the Furious Five,2008,['United States of America'],"['Action', 'Short Film', 'Comedy', 'Family-Oriented Adventure', ""Children's/Family"", 'Family Film', 'Computer Animation']",2000,8
2217954,The Ratings Game,1984,['United States of America'],"['Parody', 'Comedy']",1980,4
19103898,Girls' School,1938,['United States of America'],"['Comedy', 'Black-and-white']",1930,8
9683846,Roadside Romeo,2008,"['India', 'United States of America']","['Computer Animation', 'Animation', 'World cinema', 'Family-Oriented Adventure', ""Children's/Family"", 'Family Film']",2000,8
18762498,The Case of the Frightened Lady,1940,['United Kingdom'],"['Crime Fiction', 'Mystery', 'Thriller']",1940,0
24482536,Haunting Sarah,2005,['United States of America'],"['Mystery', 'Thriller', 'Horror', 'Drama']",2000,5
26352592,À double tour,1959,"['France', 'Italy']","['Thriller', 'Drama']",1950,9
1985184,Baran,2001,['Iran'],"['Romantic drama', 'World cinema', 'Adventure', 'Romance Film', 'Drama']",2000,1
15790575,Chowringhee,1968,['India'],[],1960,8
13496464,Bitter Flowers,2007,['Norway'],"['Action/Adventure', 'Thriller', 'World cinema']",2000,7
24576000,Sins of the Fleshapoids,1965,['United States of America'],"['Science Fiction', 'Cult']",1960,5
13362084,Silent Scream,1980,['United States of America'],"['Thriller', 'Horror']",1980,0
15599802,Henry Poole is Here,2008,['United States of America'],"['Indie', 'Comedy', 'Black comedy', 'Comedy-drama', 'Drama']",2000,8
15098769,Bootleggers,1961,['Soviet Union'],"['Short Film', 'Comedy']",1960,1
2056480,"See No Evil, Hear No Evil",1989,['United States of America'],"['Action', 'Crime Fiction', 'Action/Adventure', 'Buddy film', 'Thriller', 'Comedy', 'Slapstick', 'Comedy film']",1980,9
73422,The Day the Earth Stood Still,1951,['United States of America'],"['Cold War', 'Black-and-white', 'Thriller', 'Therimin music', 'Doomsday film', 'Science Fiction', 'Drama']",1950,1
8750529,Susan Lenox,1931,['United States of America'],"['Black-and-white', 'Pre-Code', 'Drama']",1930,1
5986686,The Wilby Conspiracy,1975,['United Kingdom'],"['Film adaptation', 'Political thriller', 'Thriller', 'Escape Film', 'Drama']",1970,5
6500339,Fort Dobbs,1958,['United States of America'],['Western'],1950,8
13269529,Can This Be Love,2005,['Philippines'],"['Filipino Movies', 'Romantic drama', 'Comedy', 'World cinema', 'Romance Film', 'Romantic comedy', 'Drama']",2000,5
20928705,El Caracazo,2005,[],"['Docudrama', 'Political drama', 'Drama']",2000,5
2544108,The Pilgrim,1923,['United States of America'],"['Black-and-white', 'Indie', 'Comedy', 'Silent film']",1920,3
26368892,His Lordship,1932,['United Kingdom'],['Musical comedy'],1930,2
16300437,King & Country,1964,['United Kingdom'],['Drama'],1960,4
31093366,"C'mon, Let's Live a Little",1967,['United States of America'],"['Musical', 'Drama']",1960,7
6267056,Chachi 420,1998,['India'],"['Comedy', 'Bollywood', 'World cinema']",1990,8
181329,Mr. Skeffington,1944,['United States of America'],"['Black-and-white', 'Romantic drama', 'Marriage Drama', 'Romance Film', 'Drama']",1940,4
26363908,Zis Boom Bah,1941,['United States of America'],"['Musical', 'Comedy', 'Musical comedy', 'Romance Film']",1940,1
14272403,Flatfoot in Hong Kong,1976,"['Germany', 'United States of America', 'Italy']","['Action', 'Crime Fiction', 'Mystery', 'Action/Adventure', 'Comedy', 'Thriller', 'World cinema']",1970,6
3641084,Virgin Witch,1972,['United Kingdom'],"['Sexploitation', 'Horror']",1970,2
6116997,Gangotri,2003,['India'],"['Romance Film', 'Tollywood', 'Drama']",2000,3
5195911,Return to Halloweentown,2006,['United States of America'],"['Comedy', 'Television movie', ""Children's/Family"", 'Family Film', 'Fantasy Comedy']",2000,6
5859950,When Worlds Collide,1951,['United States of America'],"['Action/Adventure', 'Thriller', 'Adventure', 'Doomsday film', 'Disaster', 'Science Fiction', 'Fantasy']",1950,1
8922224,Frequently Asked Questions About Time Travel,2009,['United Kingdom'],"['Science Fiction', 'Comedy']",2000,9
24950437,Halloween with the New Addams Family,1977,['United States of America'],"['Comedy', 'Horror']",1970,7
1908968,That Obscure Object of Desire,1977,"['France', 'Spain']","['Surrealism', 'Art film', 'Romantic drama', 'Satire', 'Comedy', 'World cinema', 'Romance Film', 'Black comedy', 'Drama', 'Romantic comedy', 'Sex comedy']",1970,7
8859517,Maniac Magee,2003,['United States of America'],"['Action', 'Comedy', 'Television movie', 'Adventure', 'Family Film', 'Fantasy']",2000,3
1269708,Downtown 81,1981,['United States of America'],"['Biography', 'Indie', 'Comedy-drama', 'Punk rock', 'Drama']",1980,1
20979326,The Living and the Dead,2007,['United Kingdom'],"['Psychological thriller', 'Thriller']",2000,7
31189735,The Mutations,1972,"['United Kingdom', 'United States of America']","['Monster movie', 'Science Fiction', 'Horror', 'Cult']",1970,2
5177301,Ghulami,1985,['India'],"['Bollywood', 'Drama']",1980,5
168571,Mona Lisa,1986,['United Kingdom'],"['Drama', 'Crime Fiction', 'Gangster Film', 'Indie', 'Romantic drama', 'Film noir', 'Romance Film']",1980,6
1384107,Jeepers Creepers II,2003,['United States of America'],"['Monster movie', 'Teen', 'Horror', 'Cult']",2000,3
12551994,The Human Face,2001,"['United Kingdom', 'United States of America']",['Documentary'],2000,1
2283068,Pauly Shore Is Dead,2004,['United States of America'],"['Parody', 'Comedy', 'Black comedy', 'Media Satire']",2000,4
18458655,A Man Called Hero,1999,['Hong Kong'],"['Action', 'Action/Adventure', 'World cinema', 'Wuxia', 'Chinese Movies', 'Martial Arts Film']",1990,9
22795897,Crying Freeman,1995,"['Canada', 'Japan', 'France', 'United States of America']","['Action', 'Japanese Movies', 'Action Thrillers', 'Superhero', 'Superhero movie', 'Martial Arts Film']",1990,5
22799765,Hierro,2009,['Spain'],"['Psychological thriller', 'Mystery', 'Thriller', 'World cinema']",2000,9
33145555,L'amour braque,1985,['France'],"['Romance Film', 'Drama']",1980,5
4539981,Shararat,2003,['Pakistan'],"['Musical', 'Romantic comedy']",2000,3
28385931,A Chinese Torture Chamber Story,1994,['Hong Kong'],"['Chinese Movies', 'Adventure', 'Drama', 'Fantasy']",1990,4
875637,The Bad Sleep Well,1960,['Japan'],"['Japanese Movies', 'Thriller', 'World cinema', 'Drama']",1960,0
13172792,The Million Dollar Duck,1971,['United States of America'],"['Comedy', 'Drama', 'Family Film']",1970,1
3048950,God Told Me To,1976,['United States of America'],"['Detective fiction', 'Crime Fiction', 'Mystery', 'Thriller', 'Crime Thriller', 'Detective', 'Horror', 'B-movie', 'Supernatural', 'Science Fiction', 'Cult']",1970,6
6779988,Who's Minding the Store?,1963,['United States of America'],"['Comedy', 'Romance Film', 'Romantic comedy', 'Slapstick']",1960,3
25876137,Artistka,2007,['Russia'],['Romance Film'],2000,7
5823794,Here Comes the Groom,1951,['United States of America'],"['Musical', 'Romantic comedy']",1950,1
11236137,Khatta Meetha,1981,['India'],"['Comedy', 'Drama', 'Family Film']",1980,1
16219687,The Moon Is... the Sun's Dream,1992,['South Korea'],"['Crime Fiction', 'Thriller', 'Romance Film', 'Drama']",1990,2
19952465,Egklima sta paraskinia,1960,['Greece'],"['Mystery', 'Crime Fiction']",1960,0
55447,Star Wars Episode III: Revenge of the Sith,2005,['United States of America'],"['Action', 'Adventure', 'Science Fiction', 'Tragedy', 'Fantasy']",2000,5
2925896,Lovesick,1983,['United States of America'],"['Comedy', 'Romance Film', 'Romantic comedy', 'Fantasy']",1980,3
584252,Carry On Again Doctor,1969,['United Kingdom'],['Comedy'],1960,9
3866200,The Guyver,1991,"['Japan', 'United States of America']","['Action', 'Action/Adventure', 'Comedy', 'Martial Arts Film', 'Sci-Fi Horror', 'Adventure', 'Japanese Movies', 'Horror', 'Superhero movie', 'Science Fiction']",1990,1
2957178,About Adam,2001,"['United Kingdom', 'Ireland', 'United States of America']","['Drama', 'Indie', 'Romantic drama', 'Comedy', 'Romance Film', 'Romantic comedy', 'Comedy-drama']",2000,1
3185702,Starcrash,1978,"['Italy', 'United States of America']","['Action', 'Indie', 'Adventure', 'Science Fiction', 'Fantasy']",1970,8
22608584,Soap Girl,2002,['United States of America'],"['Romance Film', 'Romantic drama', 'Drama']",2000,2
5040274,Telling Lies in America,1997,['United States of America'],"['Period piece', 'Drama', 'Indie', 'Family Drama', 'Coming of age', 'Romance Film', 'Comedy-drama']",1990,7
22061565,That Evening Sun,2009,['United States of America'],"['Film adaptation', 'Drama', 'Indie', 'Melodrama']",2000,9
20985188,Terminal Error,2002,['United States of America'],"['Action', 'Action Thrillers', 'Action/Adventure', 'Science Fiction', 'Thriller']",2000,2
7819641,Dynamite Warrior,2006,['Thailand'],"['Action', 'Martial Arts Film', 'Action/Adventure', 'Thriller', 'World cinema', 'Supernatural', 'Fantasy']",2000,6
16347105,The Cutting Edge 3: Chasing the Dream,2008,['United States of America'],"['Romance Film', 'Sports', 'Drama']",2000,8
212981,Georgy Girl,1966,['United Kingdom'],"['Comedy', 'Comedy of manners', 'Romance Film', 'Romantic comedy', 'Kitchen sink realism', 'Drama']",1960,6
12447521,All Aboard! Rosie's Family Cruise,2006,['United States of America'],"['Interpersonal Relationships', 'LGBT', 'Documentary', 'Culture & Society', 'Social issues', 'Gay Themed', 'Gay', 'Gay Interest']",2000,6
31335395,Sweet Home,1989,['Japan'],['Horror'],1980,9
2121919,King Kong Escapes,1967,"['Japan', 'United States of America']","['Action', 'Monster', 'Action/Adventure', 'World cinema', 'Adventure', 'Creature Film', 'Monster movie', 'Japanese Movies', 'Horror', 'Science Fiction', 'Fantasy']",1960,7
190423,The Rainmaker,1997,['United States of America'],"['Crime Fiction', 'Thriller', 'Legal drama', 'Drama', 'Courtroom Drama']",1990,7
2772933,Kirikou et la sorcière,1998,"['France', 'Belgium']","['Animation', 'Fantasy']",1990,8
5243087,Gunga Jumna,1961,['India'],"['Musical', 'Bollywood', 'World cinema', 'Drama']",1960,1
36225757,Omkara,2004,['India'],"['Action', 'Crime Fiction', 'Thriller']",2000,4
14900698,Espionage Agent,1939,['United States of America'],"['Action', 'Spy', 'Black-and-white', 'Mystery']",1930,9
3564660,The Silence of the Hams,1994,"['Italy', 'United States of America']","['Indie', 'Parody', 'Comedy', 'Crime Comedy']",1990,4
2889618,Green Fish,1997,['South Korea'],"['Crime Fiction', 'Action/Adventure', 'Thriller', 'World cinema']",1990,7
14069661,Ditto,1937,['United States of America'],"['Short Film', 'Black-and-white', 'Comedy']",1930,7
4771583,Father and Scout,1994,['United States of America'],"['Comedy', 'Television movie', 'Comedy-drama', 'Family Film']",1990,4
14921966,The Right To Remain Silent,1996,['United States of America'],"['Comedy', 'Drama', 'Ensemble Film']",1990,6
31715750,Born to Battle,1935,['United States of America'],"['Action', 'Western', 'Action/Adventure']",1930,5
9652376,The Fireball,1950,['United States of America'],['Drama'],1950,0
13325838,Silent Scream,1990,['United Kingdom'],['Biographical film'],1990,0
16949662,White Lies,1998,['France'],"['Comedy film', 'Crime Fiction']",1990,8
1466210,The Fiendish Plot of Dr. Fu Manchu,1980,"['United Kingdom', 'United States of America']","['Detective fiction', 'Mystery', 'Comedy', 'Thriller', 'Detective', 'Master Criminal Films', 'Fantasy']",1980,0
14739468,Scrambled Brains,1951,['United States of America'],"['Short Film', 'Black-and-white', 'Comedy']",1950,1
3729760,Temmink: The Ultimate Fight,1998,['Netherlands'],"['Action', 'Science Fiction']",1990,8
9990758,Tazza: The High Rollers,2006,['South Korea'],"['Crime Drama', 'Drama']",2000,6
1918494,State and Main,2000,"['France', 'United States of America']","['Americana', 'Parody', 'Comedy']",2000,0
24033849,Power 98,1996,['United States of America'],"['Action', 'Mystery', 'Thriller']",1990,6
4306261,The Eye 10,2005,"['Hong Kong', 'Thailand']","['Suspense', 'Chinese Movies', 'Thriller', 'Horror', 'World cinema', 'Teen', 'Supernatural']",2000,5
89272,Dodge City,1939,['United States of America'],"['Action/Adventure', 'Western']",1930,9
1850265,Nothing Sacred,1937,['United States of America'],"['Screwball comedy', 'Comedy', 'Romance Film', 'Romantic comedy']",1930,7
22158933,Exodus: Tales from the Enchanted Kingdom,2005,['Philippines'],"['Filipino Movies', 'Action/Adventure', 'World cinema', 'Fantasy']",2000,5
5203320,Duck! The Carbine High Massacre,2000,['United States of America'],"['Indie', 'Parody', 'Satire', 'Comedy', 'Teen', 'Black comedy']",2000,0
6612569,Little Murders,1971,['United States of America'],"['Parody', 'Satire', 'Comedy', 'Black comedy']",1970,1
175693,A Certain Sacrifice,1983,['United States of America'],"['Crime Drama', 'Crime Fiction']",1980,3
19817565,Mighty Lak a Goat,1942,['United States of America'],"['Black-and-white', 'Short Film', 'Comedy', 'Family Film']",1940,2
22222683,The Treatment,2006,['United States of America'],"['Romance Film', 'Comedy', 'Drama']",2000,6
10394241,Red: The Dark Side,2007,['India'],"['Thriller', 'World cinema', 'Romance Film', 'Drama']",2000,7
23813404,That Wonderful Urge,1948,['United States of America'],"['Romantic comedy', 'Screwball comedy', 'Comedy']",1940,8
8108210,Pardon My Scotch,1935,['United States of America'],"['Short Film', 'Black-and-white', 'Comedy']",1930,5
19932254,Wanted,1967,['Italy'],"['Action', 'Drama', 'Western', 'Romance Film']",1960,7
4628722,Ae Fond Kiss,2005,"['Spain', 'Belgium', 'United Kingdom', 'Germany', 'Scotland', 'Italy']","['Romance Film', 'Romantic drama', 'Drama']",2000,5
27081302,Adventure in Baltimore,1949,['United States of America'],"['Romantic comedy', 'Comedy', 'Drama']",1940,9
21660079,She,1982,"['Italy', 'United States of America']","['Action', 'Film adaptation', 'World cinema', 'Adventure', 'Fantasy', 'Science Fiction', 'Drama']",1980,2
11407598,"Tramp, Tramp, Tramp",1926,['United States of America'],"['Black-and-white', 'Indie', 'Short Film', 'Comedy', 'Silent film']",1920,6
2571294,Closely Watched Trains,1967,"['Czechoslovakia', 'Czech Republic']","['Coming of age', 'Comedy', 'World cinema', 'Comedy-drama', 'Czechoslovak New Wave', 'War film', 'Drama']",1960,7
24460727,Hacks,1997,['United States of America'],"['Mystery', 'Comedy film']",1990,7
5315100,Jackass: Number Two,2006,['United States of America'],"['Comedy', 'Documentary', 'Extreme Sports', 'Sports', 'Slapstick', 'Bloopers & Candid Camera']",2000,6
33290083,Zombies of Mora Tau,1957,[],['Horror'],1950,7
5377390,Shootout at Lokhandwala,2007,['India'],"['Action/Adventure', 'Drama', 'World cinema']",2000,7
24013428,Porndogs: The Adventures of Sadie,2009,['United States of America'],['Pornographic movie'],2000,9
8048017,An Autumn's Tale,1987,['Hong Kong'],"['World cinema', 'Romance Film', 'Melodrama', 'Chinese Movies', 'Drama']",1980,7
12694069,Adventures of Sir Galahad,1949,['United States of America'],"['Action', 'Black-and-white', 'Adventure']",1940,9
8475503,Paradise Lost,1971,['United States of America'],"['Musical', 'Drama']",1970,1
25760061,Utz,1992,"['United Kingdom', 'Germany']","['Adventure', 'Drama']",1990,2
172008,Coquette,1929,['United States of America'],"['Black-and-white', 'Drama']",1920,9
3020547,Shake Hands with the Devil,1959,"['Ireland', 'United States of America']","['War film', 'Drama']",1950,9
13487382,Pardesi,1957,['India'],"['Historical fiction', 'Adventure']",1950,7
34257158,Military,2003,['India'],[],2000,3
183855,Come to the Stable,1949,['United States of America'],"['Black-and-white', 'Drama']",1940,9
11546067,La Mirada del Otro,1998,['Spain'],"['Erotic Drama', 'Drama']",1990,8
13021625,The Early Bird,1965,['United Kingdom'],['Comedy'],1960,5
5541106,Spider Forest,2004,['South Korea'],"['Psychological thriller', 'Mystery', 'Thriller', 'Horror', 'World cinema', 'Crime Thriller']",2000,4
19267610,A Prize of Arms,1962,['United Kingdom'],"['Crime Fiction', 'Caper story', 'Thriller', 'Drama']",1960,2
8581781,Too Hot to Handle,1960,['United Kingdom'],"['Crime Fiction', 'Comedy', 'Film noir', 'Drama']",1960,0
2721095,The Sniper,1952,['United States of America'],"['Psychological thriller', 'Black-and-white', 'Crime Fiction', 'Thriller', 'Film noir', 'Crime Thriller', 'Drama']",1950,2
6910004,The End of Violence,1997,"['France', 'Germany', 'United States of America']","['Psychological thriller', 'Drama', 'Crime Fiction', 'Indie', 'Thriller', 'Crime Thriller']",1990,7
4442483,Fatty Finn,1980,['Australia'],"['Comedy', ""Children's/Family"", 'Drama', 'Family Film', 'Fantasy']",1980,0
12769985,Cash and Curry,2008,['United Kingdom'],"['Crime Fiction', 'Comedy', 'Drama']",2000,8
1012580,"A Lonesome, Final Battle: The Father of Z-Warrior Son Gokū, who Challenged Freeza",1990,['Japan'],"['Action', 'Animated cartoon', 'Animation', 'World cinema', ""Children's"", 'Japanese Movies', 'Anime', 'Science Fiction', 'Fantasy']",1990,0
11763661,Vantage Point,2008,['United States of America'],"['Action', 'Suspense', 'Crime Fiction', 'Thriller', 'Drama', 'Political thriller']",2000,8
23007411,The Last Good Time,1994,['United States of America'],"['Indie', 'Romance Film', 'Comedy-drama', 'Drama']",1990,4
26838880,Possessed,1983,['Hong Kong'],"['Chinese Movies', 'Crime Fiction', 'Mystery', 'Thriller', 'Horror']",1980,3
9441798,Angels One Five,1952,['United Kingdom'],"['Action', 'Combat Films', 'Drama', 'War film', 'Adventure']",1950,2
9689254,Sendhoorapandi,1993,['India'],"['Drama', 'Family Film']",1990,3
8247632,Let It Snow,2001,['United States of America'],"['Coming of age', 'Comedy', 'Romance Film', 'Romantic comedy', 'Comedy of Errors']",2000,1
20963952,Journey to the Center of the Earth,2008,['United States of America'],"['Indie', 'Action/Adventure', 'Adventure', 'Science Fiction', 'Fantasy']",2000,8
11270245,Pyaar Ishq Aur Mohabbat,2001,['India'],"['Romantic drama', 'World cinema', 'Romance Film', 'Drama']",2000,1
5871230,Tagore,2003,['India'],"['Action/Adventure', 'Drama', 'World cinema']",2000,3
3202391,Denise Calls Up,1996,['United States of America'],"['Indie', 'Comedy', 'Ensemble Film']",1990,6
20309658,Rocky Mountain,1950,['United States of America'],"['Action', 'Action/Adventure', 'Western', 'War film']",1950,0
5303013,Mumbai Express,2005,['India'],"['Action/Adventure', 'Comedy', 'World cinema']",2000,5
27525441,Target of an Assassin,1978,"['United States of America', 'South Africa']","['Action', 'Suspense', 'Action/Adventure', 'Thriller']",1970,8
15132754,Aag Se Khelenge,1989,['India'],"['Drama', 'Thriller', 'World cinema']",1980,9
2180118,True Crime,1995,['United States of America'],"['Psychological thriller', 'Suspense', 'Crime Fiction', 'Mystery', 'Thriller', 'Detective']",1990,5
12690499,Kismat Konnection,2008,['India'],"['Musical', 'Bollywood', 'World cinema', 'Drama']",2000,8
5451230,Sooryavansham,1999,['India'],['World cinema'],1990,9
8103581,Evano Oruvan,2007,['India'],"['Thriller', 'Drama']",2000,7
19093155,New York,2009,['India'],"['Musical', 'Thriller', 'Bollywood', 'World cinema', 'Drama']",2000,9
1987149,See the Sea,1997,['France'],"['Psychological thriller', 'Short Film', 'Thriller', 'World cinema', 'Drama']",1990,7
26013422,Arasu,2007,['India'],['Drama'],2000,7
18076983,Pennies from Heaven,1936,['United States of America'],"['Musical', 'Black-and-white', 'Comedy']",1930,6
13638133,Perdido por perdido,1993,['Argentina'],"['Action', 'Drama']",1990,3
3453263,High Time,1960,['United States of America'],"['Musical', 'Comedy', 'Musical comedy', 'Romance Film', 'Romantic comedy']",1960,0
26025447,Colorz of Rage,1999,['United States of America'],"['Crime Fiction', 'Indie', 'Romantic drama', 'Romance Film', 'Drama']",1990,9
2708426,Dancing Lady,1933,['United States of America'],"['Musical', 'Black-and-white', 'Backstage Musical', 'Comedy', 'Romance Film', 'Romantic comedy', 'Pre-Code']",1930,3
11517618,Shriman Shrimati,1982,['India'],"['Musical', 'Bollywood', 'World cinema', 'Drama']",1980,2
23362921,Summer Love,2006,"['Poland', 'United States of America']","['Action', 'Action/Adventure', 'Western', 'Thriller', 'World cinema']",2000,6
26609228,Michael Collins,1996,"['United Kingdom', 'Ireland', 'United States of America']","['Biography', 'Biographical film', 'Biopic [feature]', 'Political drama', 'War film', 'Drama', 'Political thriller']",1990,6
1523484,Sahara,1984,"['United Kingdom', 'United States of America']","['Period piece', 'Drama', 'Indie', 'Action/Adventure', 'Romantic drama', 'Romance Film', 'Adventure']",1980,4
11151489,Prem Bandhan,1979,['India'],"['Romance Film', 'Adventure', 'Drama']",1970,9
928529,Anacondas: The Hunt for the Blood Orchid,2004,['United States of America'],"['Action', 'Action/Adventure', 'Thriller', 'Jungle Film', 'Horror', 'Adventure', 'Natural horror films']",2000,4
21747613,Alone on the Pacific,1963,['Japan'],"['Japanese Movies', 'Action/Adventure', 'World cinema', 'Adventure', 'Drama']",1960,3
2618881,Swing Girls,2004,['Japan'],"['Musical', 'Japanese Movies', 'Comedy', 'Musical comedy', 'Drama']",2000,4
2949827,Angels in the Outfield,1994,['United States of America'],"['Family Drama', 'Comedy', 'Remake', 'Sports', 'Drama', 'Family Film', 'Fantasy']",1990,4
5813191,The January Man,1989,['United States of America'],"['Action', 'Crime Fiction', 'Mystery', 'Comedy Thriller', 'Thriller', 'Comedy', 'Crime Thriller']",1980,9
19873611,Faceless,1988,"['France', 'Spain']","['Slasher', 'Horror']",1980,8
10939667,Road to Nhill,1997,['Australia'],"['Screwball comedy', 'Comedy', 'Drama']",1990,7
24051463,They Raid By Night,1942,['United States of America'],"['Action', 'Combat Films', 'Drama', 'Action/Adventure', 'War film']",1940,2
3078404,"English, August",1994,['India'],"['Drama', 'Comedy']",1990,4
16768321,The Open Road,2008,['United States of America'],"['Comedy-drama', 'Indie', 'Comedy']",2000,8
2887437,Rocky Balboa,2006,['United States of America'],"['Action', 'Drama', 'Romance Film', 'Sports']",2000,6
17551895,Visioneers,2008,['United States of America'],"['Black comedy', 'Indie', 'Comedy']",2000,8
27913339,Brain of Blood,1972,['United States of America'],"['Creature Film', 'Horror', 'B-movie', 'Science Fiction']",1970,2
6562375,Amityville 3-D,1983,['United States of America'],"['Horror', 'Haunted House Film', 'Supernatural', 'Cult']",1980,3
2952825,Ultimate Avengers,2006,['United States of America'],"['Action', 'Animation', 'Action/Adventure', 'Adventure', 'Superhero movie']",2000,6
10614861,Joroo Ka Ghulam,1972,['India'],"['Comedy', 'World cinema']",1970,2
4427932,The Long Wait,1954,['United States of America'],"['Black-and-white', 'Crime Fiction', 'Mystery', 'Film noir']",1950,4
22125945,Makiusap ka sa Diyos,1991,['Philippines'],"['Filipino Movies', 'Drama', 'World cinema']",1990,1
4252062,Scooby-Doo Meets the Boo Brothers,1987,['United States of America'],"['Family-Oriented Adventure', ""Children's Fantasy"", ""Children's/Family""]",1980,7
19559133,Città violenta,1970,"['France', 'Italy']","['Crime Fiction', 'Gangster Film', 'Thriller', 'World cinema', 'Crime Thriller']",1970,0
2772791,Shame,1968,['Sweden'],"['Black-and-white', 'Crime Fiction', 'World cinema', 'Drama']",1960,8
32683495,Banjo on My Knee,1936,['United States of America'],"['Musical', 'Romantic drama', 'Musical Drama', 'Comedy', 'Romance Film', 'Romantic comedy', 'Drama']",1930,6
5119941,Bloody Mallory,2002,"['France', 'Spain']","['Action', 'Supernatural', 'Action/Adventure', 'Comedy', 'Thriller', 'World cinema', 'Action Comedy', 'Horror', 'Fantasy']",2000,2
4088706,Alienator,1989,['United States of America'],"['Action', 'Science Fiction', 'Thriller']",1980,9
1348785,The Librarian: Quest for the Spear,2004,['United States of America'],"['Action/Adventure', 'Comedy', 'Thriller', 'Adventure', 'Romance Film', 'Drama', 'Fantasy']",2000,4
19202878,Saraswathi Sabatham,1966,['India'],"['Historical drama', 'Comedy', 'Family Film', 'Fantasy']",1960,6
9482929,The Seeker: The Dark Is Rising,2007,['United States of America'],"['Fantasy Adventure', 'Film adaptation', 'Action/Adventure', 'Thriller', 'Adventure', 'Drama', ""Children's Fantasy"", 'Fantasy']",2000,7
1853602,Troll,1986,"['Italy', 'United States of America']","['Mystery', 'Horror', 'Adventure', 'Family Film', 'Fantasy']",1980,6
15200406,The Caller,1987,['United States of America'],['Thriller'],1980,7
8267557,The Lone Ranger Rides Again,1939,['United States of America'],"['Action', 'Black-and-white', 'Western', 'Adventure']",1930,9
17111814,Race to Witch Mountain,2009,['United States of America'],"['Action', 'Thriller', 'Family-Oriented Adventure', ""Children's/Family"", 'Sci-Fi Adventure', 'Adventure', 'Alien Film', 'Science Fiction', 'Family Film', 'Fantasy']",2000,9
4077833,Kick the Moon,2001,['South Korea'],"['Drama', 'Comedy']",2000,1
6900319,Hic-cup Pup,1952,['United States of America'],"['Animation', 'Short Film', 'Comedy', 'Family Film']",1950,2
1597877,Intolerable Cruelty,2003,['United States of America'],"['Screwball comedy', 'Comedy', 'Black comedy', 'Romantic comedy', 'Romance Film', 'Drama']",2000,3
4511738,Heart and Souls,1993,['United States of America'],"['Heaven-Can-Wait Fantasies', 'Comedy', 'Romance Film', 'Romantic comedy', 'Fantasy Comedy', 'Fantasy']",1990,3
6970205,Where's God When I'm S-Scared?,1993,[],"['Musical', 'Animation', 'Short Film', ""Children's""]",1990,3
22747077,Malibu Spring Break,2003,['United States of America'],"['Softcore Porn', 'Comedy', 'Adult']",2000,3
5516824,"20,000 Leagues Under the Sea",1954,['United States of America'],"['Action', 'Action/Adventure', 'Adventure', 'Drama', 'Steampunk', 'Science Fiction', 'Family Film', 'Fantasy']",1950,4
8818806,Behold a Pale Horse,1964,['United States of America'],"['Film adaptation', 'Black-and-white', 'War film', 'Drama']",1960,4
5735181,The Dragon of Evil Against the Saint Warrior,1969,"['Brazil', 'France', 'West Germany']","['Western', 'Drama']",1960,9
9074461,Toplo,1978,['Bulgaria'],['Comedy'],1970,8
12054599,Universal Groove,2007,['Canada'],['Indie'],2000,7
10811795,Trancers II,1991,['United States of America'],"['Action', 'Action/Adventure', 'Indie', 'Science Fiction', 'Thriller', 'Cult']",1990,1
17840309,Tarzan and the Amazons,1945,['United States of America'],"['Action', 'Romance Film', 'Adventure']",1940,5
6503294,Leave It to Beaver,1997,['United States of America'],"['Comedy', 'Comedy film', 'Domestic Comedy', ""Children's/Family"", 'Family Film']",1990,7
14527014,The God King,1975,['Sri Lanka'],"['Historical fiction', 'Drama']",1970,5
18940646,No Orchids for Miss Blandish,1948,['United Kingdom'],"['Crime Fiction', 'Gangster Film', 'Drama']",1940,8
4184687,Devasuram,1993,['India'],"['Action', 'Drama', 'Thriller', 'Malayalam Cinema']",1990,3
12666854,A Funny Thing Happened on the Way to the Forum,1966,"['United Kingdom', 'United States of America']","['Musical', 'Comedy', 'Musical comedy', 'Romance Film', 'Romantic comedy', 'Slapstick']",1960,6
26353271,I Proud to Be an Indian,2004,['India'],"['Action/Adventure', 'Drama', 'World cinema']",2000,4
9131166,Benny's Video,1992,"['Austria', 'Switzerland']","['Crime Fiction', 'Indie', 'Family Drama', 'Thriller', 'World cinema', 'Crime Thriller', 'Drama', 'Horror', 'Crime Drama']",1990,2
796375,Hangmen Also Die,1943,['United States of America'],"['Black-and-white', 'War film', 'Drama']",1940,3
3572019,Eliminators,1986,['United States of America'],"['Time travel', 'Science Fiction', 'Adventure']",1980,6
32655954,Strike Me Lucky,1934,[],['Comedy film'],1930,4
3918152,Nobita's Monstrous Underwater Castle,1983,['Japan'],['Animation'],1980,3
5149870,Mississippi Hare,1949,['United States of America'],['Comedy'],1940,9
7854008,Koeputkiaikuinen ja Simon enkelit,1979,['Finland'],['Comedy'],1970,9
34344124,Terminator 2: Judgment Day,1991,"['United States of America', 'France']","['Action', 'Time travel', 'Action/Adventure', 'Thriller', 'Doomsday film', 'Science Fiction']",1990,1
714358,Quadrophenia,1979,"['United Kingdom', 'England']","['Music', 'Crime Fiction', 'Drama']",1970,9
1506585,Body and Soul,1925,['United States of America'],"['Black-and-white', 'Indie', 'Silent film', 'Race movie', 'Drama']",1920,5
2294895,The Border,1982,['United States of America'],"['Action', 'Crime Fiction', 'Drama']",1980,2
5669008,The Man From Elysian Fields,2002,['United States of America'],"['Drama', 'Indie', 'Romantic drama', 'Film noir', 'Romance Film', 'Slice of life story']",2000,2
5440222,Beau Geste,1926,['United States of America'],"['Action', 'Black-and-white', 'Indie', 'Adventure', 'Drama', 'Foreign legion', 'Silent film', 'War film']",1920,6
5614464,Milenge Milenge,2006,['India'],"['Musical', 'Romantic drama', 'Bollywood', 'World cinema', 'Romance Film', 'Drama']",2000,6
5667662,Phantom,1922,"['Weimar Republic', 'Germany']","['Black-and-white', 'Drama', 'Indie', 'World cinema', 'Silent film', 'Romance Film', 'Fantasy']",1920,2
2035109,Frankenstein Must Be Destroyed,1969,['United Kingdom'],"['Creature Film', 'Monster', 'Gothic Film', 'Horror', 'Costume Horror', 'Science Fiction']",1960,9
5699054,Hard Luck,2006,['United States of America'],"['Action', 'Drama', 'Crime Fiction', 'Action/Adventure', 'Thriller']",2000,6
23302105,The Hole,1997,['South Korea'],['Thriller'],1990,7
2155435,Flying Virus,2001,"['Brazil', 'United States of America']","['Action', 'Action/Adventure', 'Thriller', 'Horror']",2000,1
34328420,Face-Off,1971,['Canada'],"['Sports', 'Drama']",1970,1
15216853,Black Republic,1990,['South Korea'],['Drama'],1990,0
24532496,Bloom,2003,['Ireland'],"['Period piece', 'Film adaptation', 'World cinema', 'Romance Film', 'Drama']",2000,3
2076422,My Left Eye Sees Ghosts,2002,['Hong Kong'],"['Comedy', 'Horror', 'World cinema', 'Romantic comedy', 'Chinese Movies', 'Drama', 'Fantasy']",2000,2
14101294,Britz,2007,['United Kingdom'],"['Drama', 'Television movie']",2000,7
13233387,Dil Dosti Etc,2007,['India'],"['Musical', 'Bollywood', 'World cinema', 'Drama']",2000,7
15996858,Gold Diggers of 1937,1936,['United States of America'],"['Musical', 'Black-and-white', 'Comedy', 'Musical comedy', 'Romance Film', 'Romantic comedy']",1930,6
22335538,Salto nel vuoto,1980,"['France', 'West Germany', 'Italy']",['Drama'],1980,0
4343413,Pulse,1988,['United States of America'],"['Thriller', 'Horror', 'Supernatural', 'Science Fiction']",1980,8
28284724,Clans of Intrigue,1977,['Hong Kong'],"['Wuxia', 'Chinese Movies']",1970,7
18737084,Heroic Duo,2003,['Hong Kong'],"['Action', 'Action Thrillers', 'Action/Adventure', 'Thriller', 'World cinema', 'Chinese Movies']",2000,3
2669274,Jail Bait,1954,['United States of America'],"['Suspense', 'Crime Fiction', 'Gangster Film', 'Thriller', 'Film noir', 'Crime Thriller']",1950,4
27954017,Some Girl,1998,['United States of America'],"['Indie', 'Comedy', 'Romance Film', 'Romantic comedy', 'Drama']",1990,8
28149641,Seclusion Near a Forest,1976,['Czechoslovakia'],"['Drama', 'Comedy']",1970,6
4937126,Baltic Storm,2003,"['United Kingdom', 'Germany']","['Mystery', 'Thriller', 'Political drama', 'Drama', 'Political thriller']",2000,3
6170213,Main Khiladi Tu Anari,1994,['India'],"['Action/Adventure', 'Bollywood', 'Thriller', 'World cinema']",1990,4
8885678,G:MT - Greenwich Mean Time,1999,['United Kingdom'],"['Musical', 'Crime Fiction', 'Drama']",1990,9
5563951,An Airman's Letter to His Mother,1941,['United Kingdom'],"['Short Film', 'Black-and-white']",1940,1
11160368,Swing State,2008,['United States of America'],"['Political cinema', 'History', 'Short Film', 'Documentary', 'Culture & Society']",2000,8
14793527,The Marines Who Never Returned,1963,"['United States of America', 'South Korea']","['War film', 'Drama']",1960,3
9791480,Let Them Chirp Awhile,2007,['United States of America'],"['Indie', 'Comedy', 'Romance Film', 'Comedy-drama', 'Slice of life story']",2000,7
5501567,Experiment in Terror,1962,['United States of America'],"['Psychological thriller', 'Suspense', 'Crime Fiction', 'Thriller', 'Crime Thriller']",1960,2
2332911,I.Q.,1994,['United States of America'],"['Period piece', 'Romantic drama', 'Comedy', 'Romance Film', 'Romantic comedy', 'Drama']",1990,4
151535,Donovan's Reef,1963,['United States of America'],"['Action', 'Action/Adventure', 'Comedy', 'Romance Film', 'Romantic comedy', 'Comedy of Errors']",1960,3
5303308,The Commitments,1991,"['United Kingdom', 'Ireland', 'United States of America']","['Musical', 'Indie', 'Musical Drama', 'Comedy', 'Drama']",1990,1
2179113,Chithram,1988,['India'],"['Malayalam Cinema', 'Screwball comedy']",1980,8
10332103,Persuasion,2007,"['United Kingdom', 'United States of America']","['Period piece', 'Romantic drama', 'Romance Film', 'Costume drama', 'Drama']",2000,7
6643402,If Looks Could Kill - Teen Agent,1991,['United States of America'],"['Action', 'Spy', 'Action/Adventure', 'Comedy']",1990,1
2663129,"Good Night, and Good Luck.",2005,"['Japan', 'United Kingdom', 'France', 'United States of America']","['Biography', 'Historical drama', 'Docudrama', 'Drama', 'Period piece', 'History', 'Japanese Movies', 'Political drama']",2000,5
16494542,The Rape of Richard Beck,1985,['United States of America'],"['Television movie', 'Crime Fiction', 'Drama']",1980,5
35908823,Slutty Summer,2004,['United States of America'],"['LGBT', 'Comedy', 'Romance Film', 'Drama', 'Gay Themed', 'Gay', 'Gay Interest', 'Romantic comedy', 'Comedy-drama', 'Sex comedy']",2000,4
22225351,Macaroni,1985,['Italy'],"['Drama', 'Comedy']",1980,5
27766469,Play'd: A Hip-Hop Story,2002,['United States of America'],"['Hip hop movies', 'Drama']",2000,2
31025068,El Compadre Mendoza,1934,['Mexico'],"['Period piece', 'World cinema', 'War film', 'Drama']",1930,4
2080169,Never Been Kissed,1999,['United States of America'],"['Comedy', 'Teen', 'Romance Film', 'Romantic comedy', 'Drama']",1990,9
22071969,The Human Factor,1979,['United Kingdom'],"['Spy', 'Drama', 'Thriller']",1970,9
1620399,Aladdin and His Wonderful Lamp,1939,['United States of America'],"['Action', 'Animation', 'Short Film', 'Comedy', 'Family Film']",1930,9
9109203,Ore Kadal,2007,['India'],"['Romantic drama', 'Drama']",2000,7
18794137,The Big Circus,1959,['United States of America'],"['Action', 'Drama']",1950,9
28299508,Submarine X-1,1969,['United Kingdom'],"['Action', 'Drama', 'Action/Adventure', 'War film']",1960,9
11293583,How High is Up?,1940,['United States of America'],"['Short Film', 'Black-and-white', 'Comedy']",1940,0
1682637,Teacher's Pet,1930,['United States of America'],"['Short Film', 'Black-and-white', 'Comedy']",1930,0
158568,Martian Successor Nadesico,1996,[],"['Animation', 'Science Fiction', 'Comedy']",1990,6
7838245,Hasami otoko,2005,['Japan'],"['Japanese Movies', 'Slasher', 'Horror', 'World cinema']",2000,5
20904748,Mr. Moto Takes a Chance,1938,['United States of America'],"['Black-and-white', 'Mystery', 'Thriller', 'Adventure', 'Drama']",1930,8
5757360,The Beggar's Opera,1953,['United Kingdom'],"['Musical', 'Crime Fiction', 'History']",1950,3
298925,Take the Money and Run,1969,['United States of America'],"['Crime Fiction', 'Indie', 'Comedy', 'Mockumentary', 'Slapstick', 'Absurdism', 'Parody', 'Crime Comedy', 'Cult']",1960,9
10546396,Journey to the Center of Time,1967,['United States of America'],"['Time travel', 'Science Fiction', 'Adventure']",1960,7
8661478,Book of Love,1990,['United States of America'],"['Romance Film', 'Romantic comedy', 'Comedy']",1990,0
2941812,See Spot Run,2001,"['United States of America', 'Canada', 'Australia']","['Action', 'Crime Fiction', 'Action/Adventure', 'Comedy', 'Animal Picture', 'Slapstick', 'Family Film']",2000,1
10711900,"You, John Jones!",1943,['United States of America'],"['Short Film', 'Propaganda film']",1940,3
14758750,The House on Telegraph Hill,1951,['United States of America'],"['Black-and-white', 'Crime Fiction', 'Mystery', 'Thriller', 'Film noir', 'Crime Thriller', 'Drama']",1950,1
11373575,Sunghursh,1968,['India'],['Bollywood'],1960,8
23023062,Apache Ambush,1955,['United States of America'],"['Action', 'Black-and-white', 'Western']",1950,5
20570658,Sheitan,2006,['France'],"['Comedy', 'Horror', 'World cinema', 'Black comedy']",2000,6
20226885,Apartment for Peggy,1948,['United States of America'],"['Comedy-drama', 'Comedy', 'Drama']",1940,8
1748549,The Rookie,1990,['United States of America'],"['Action', 'Crime Fiction', 'Action/Adventure', 'Buddy film', 'Thriller']",1990,0
32075975,Sharara,1984,[],['Action'],1980,4
6273018,Pas în doi,1985,['Romania'],['Drama'],1980,5
5541530,Memoirs of a Geisha,2005,"['Japan', 'United States of America']","['Period piece', 'Film adaptation', 'Japanese Movies', 'Romantic drama', 'Romance Film', 'Melodrama', 'Drama']",2000,5
13180230,Thee Nagar,2007,['India'],"['Romance Film', 'Drama']",2000,7
8073610,The Tin Drum,1979,"['Yugoslavia', 'France', 'Germany', 'Poland']","['Period piece', 'Art film', 'Childhood Drama', 'World cinema', 'Political drama', 'War film', 'Drama']",1970,9
33235619,L'aventure c'est l'aventure,1972,"['France', 'Italy']","['Political satire', 'Satire', 'Comedy', 'World cinema', 'Black comedy', 'Adventure', 'Crime Comedy', 'Comedy film']",1970,2
2093510,The Dream Team,1989,['United States of America'],"['Screwball comedy', 'Parody', 'Satire', 'Comedy', 'Slapstick', 'Cult']",1980,9
296997,Love's Labour's Lost,2000,"['Canada', 'United Kingdom', 'France', 'United States of America']","['Musical', 'Comedy', 'Jukebox musical', 'Romance Film', 'Romantic comedy']",2000,0
2440669,Ni Liv,1959,['Norway'],['War film'],1950,9
26167528,Bubbling Over,1934,['United States of America'],"['Musical', 'Short Film', 'Comedy']",1930,4
11600033,1776,1972,['United States of America'],"['Musical', 'Period piece', 'Musical comedy']",1970,2
24246906,Diamond City,1949,['United Kingdom'],['Drama'],1940,9
26736753,Zebra Force,1976,['United States of America'],"['Action', 'Crime Fiction']",1970,6
32798656,Moon in Taurus,1980,['Switzerland'],['Drama'],1980,0
32695541,Murder Rock,1984,[],"['Drama', 'Mystery', 'Thriller']",1980,4
1376589,Punk Rock Holocaust,2004,['United States of America'],"['Parody', 'Comedy', 'Horror Comedy', 'Horror', 'Black comedy', 'Punk rock']",2000,4
6953611,The Visitor,1979,"['Italy', 'United States of America']","['Thriller', 'Horror', 'Supernatural', 'Science Fiction']",1970,9
13910386,Love is Cinta,2007,['Indonesia'],['Drama'],2000,7
33179804,Turbulence 3: Heavy Metal,2000,"['United Kingdom', 'United States of America', 'Canada']","['Action', 'Suspense', 'Action/Adventure', 'Thriller', 'Crime Thriller', 'Disaster']",2000,0
31306817,Long Day's Journey into Night,1973,[],['Drama'],1970,3
18710214,Legend of Dinosaurs & Monster Birds,1977,['Japan'],"['Action', 'Japanese Movies', 'Action/Adventure', 'Thriller', 'World cinema', 'Horror']",1970,7
1978686,Athena,1954,['United States of America'],"['Musical', 'Romance Film', 'Comedy']",1950,4
26400346,The little seagull and the cat,1998,['Italy'],['Animation'],1990,8
2551150,Rebound,2005,['United States of America'],"['Sports', 'Comedy', 'Family Film']",2000,5
1223684,Veer-Zaara,2004,['India'],"['Musical', 'Romantic drama', 'Musical Drama', 'Bollywood', 'World cinema', 'Romance Film', 'Drama']",2000,4
12677130,Yiddle With His Fiddle,1936,['Poland'],"['Musical', 'Black-and-white', 'Comedy', 'World cinema']",1930,6
31533575,Kamla,1985,[],['Drama'],1980,5
1712875,Company,2002,['India'],"['Action', 'Drama', 'Crime Fiction', 'Thriller', 'Bollywood']",2000,2
3704027,Miss Julie,1999,"['United Kingdom', 'United States of America']","['Film adaptation', 'Romantic drama', 'Comedy', 'Romance Film', 'Costume drama', 'Drama', 'Period piece', 'Romantic comedy']",1990,9
3033993,Becoming Jane,2007,"['Ireland', 'United Kingdom']","['Biography', 'Romantic drama', 'Biographical film', 'Romance Film', 'Costume drama', 'Drama', 'Period piece', 'Biopic [feature]']",2000,7
9180769,Behind the Camera: The Unauthorized Story of Three's Company,2003,['United States of America'],"['Period piece', 'Comedy', 'Television movie', 'Comedy-drama', 'Docudrama', 'Drama']",2000,3
19528112,One Droopy Knight,1957,['United States of America'],['Short Film'],1950,7
571383,Exorcist II: The Heretic,1977,['United States of America'],"['Psychological thriller', 'Cult', 'Horror']",1970,7
2356365,The Stuff,1985,['United States of America'],"['Satire', 'Horror Comedy', 'Comedy', 'Horror', 'B-movie', 'Cult']",1980,5
19080740,The Beauty Jungle,1964,['United Kingdom'],"['Drama', 'Comedy']",1960,4
16908629,Valencia,1926,['United States of America'],"['Silent film', 'Romance Film', 'Black-and-white']",1920,6
4139200,Kain XVIII,1963,['Soviet Union'],"['Romantic fantasy', 'Satire', 'Comedy', 'Fantasy Comedy', 'Fantasy']",1960,3
952354,Theatre of Blood,1973,"['United Kingdom', 'United States of America']","['Mystery', 'Comedy', 'Horror Comedy', 'Horror']",1970,3
12817161,Mooching Through Georgia,1939,['United States of America'],"['Short Film', 'Slapstick', 'Comedy']",1930,9
7668946,The Consequences of Love,2004,['Italy'],"['Romantic drama', 'Thriller', 'World cinema', 'Romance Film', 'Drama']",2000,4
2313054,The Naked Truth,1957,['United Kingdom'],"['Comedy', 'Black-and-white']",1950,7
8056688,The Prize,1963,['United States of America'],"['Spy', 'Crime Fiction', 'Mystery', 'Thriller', 'Drama', 'Political thriller']",1960,3
1667210,A Kiss Before Dying,1991,"['United Kingdom', 'United States of America']","['Psychological thriller', 'Thriller', 'Film noir', 'Crime Thriller', 'Drama']",1990,1
8684866,Mama Don't Cry,1998,['Russia'],['Action'],1990,8
8421314,Chatham,2007,['United States of America'],"['Romance Film', 'Romantic comedy', 'Comedy']",2000,7
5307150,The Lost Battalion,2001,"['Luxembourg', 'United States of America']","['Period piece', 'Television movie', 'War film', 'Drama']",2000,1
20956661,Look Back in Anger,1980,"['United Kingdom', 'United States of America']",['Drama'],1980,0
2236329,The Parent Trap,1998,['United States of America'],"['Comedy', 'Romance Film', 'Adventure', 'Drama', 'Family Film']",1990,8
24198424,Panique,1947,[],['Drama'],1940,7
19582571,Oh! That Wife of Mine,1967,['Greece'],"['Comedy', 'Black-and-white']",1960,7
2310118,National Lampoon's Pledge This!,2006,['United States of America'],"['Parody', 'Satire', 'Comedy']",2000,6
640651,Blood from the Mummy's Tomb,1971,['United Kingdom'],"['Creature Film', 'Monster movie', 'Horror', 'Archaeology', 'B-movie']",1970,1
5452233,Sara,1992,['Iran'],"['Drama', 'World cinema']",1990,2
6661682,Swayamvaram,1972,['India'],['Drama'],1970,2
8212258,Shinjuku Triad Society,1995,['Japan'],"['Crime Fiction', 'Gangster Film', 'Action/Adventure', 'Thriller', 'World cinema', 'Crime Thriller', 'Japanese Movies', 'Chase Movie']",1990,5
4836572,Oliver!,1968,['United Kingdom'],"['Musical', 'Crime Fiction', 'Musical Drama', 'Childhood Drama', 'Drama', 'Family Film']",1960,8
34744345,A Fire in the Sky,1978,['United States of America'],"['Disaster', 'Science Fiction', 'Drama']",1970,8
6103939,Kickboxer 4,1994,['United States of America'],"['Action', 'Action/Adventure', 'Thriller', 'Sports', 'Martial Arts Film']",1990,4
6774970,Tamas,1987,['India'],['Drama'],1980,7
6266691,White Line Fever,1975,"['Canada', 'United States of America']","['Action', 'Crime Fiction', 'Drama']",1970,5
2001301,The Glass Bottom Boat,1966,['United States of America'],"['Action', 'Spy', 'Musical', 'Mystery', 'Action/Adventure', 'Comedy', 'Slapstick', 'Romantic comedy']",1960,6
4697464,Mad Dog Time,1996,['United States of America'],"['Action', 'Crime Fiction', 'Gangster Film', 'Action/Adventure', 'Comedy', 'Buddy film', 'Black comedy', 'Heist', 'Caper story', 'Crime Comedy']",1990,6
3201442,Casanova,2005,['United States of America'],"['Romantic drama', 'Comedy', 'Romance Film', 'Costume drama', 'Adventure', 'Drama', 'Period piece', 'Romantic comedy']",2000,5
13243296,Weirdsville,2007,"['Canada', 'United States of America']","['Stoner film', 'Indie', 'Comedy', 'Horror']",2000,7
1389571,Koyla,1997,['India'],"['Action', 'Action Thrillers', 'Action/Adventure', 'Thriller', 'Bollywood', 'World cinema']",1990,7
20760084,Address Unknown,1944,['United States of America'],['Drama'],1940,4
4559105,Major League: Back to the Minors,1998,['United States of America'],"['Baseball', 'Sports', 'Comedy']",1990,8
4405535,Bait,2000,"['Canada', 'United States of America']","['Action', 'Crime Fiction', 'Action/Adventure', 'Comedy', 'Thriller', 'Crime Thriller', 'Adventure', 'Drama']",2000,0
99025,Romeo and Juliet,1968,"['United Kingdom', 'Italy']","['Film adaptation', 'Romantic drama', 'Romance Film', 'Roadshow theatrical release', 'Costume drama', 'Drama', 'Tragedy', 'Epic']",1960,8
9689938,Super Fuzz,1981,"['Spain', 'Italy', 'United States of America']","['Action', 'Crime Fiction', 'Action/Adventure', 'Fantasy Comedy', 'Buddy film', 'Comedy', 'Crime Comedy', 'Fantasy', 'Science Fiction']",1980,1
3978163,Failure to Launch,2006,['United States of America'],"['Romance Film', 'Romantic comedy', 'Comedy']",2000,6
903140,Munna Bhai M.B.B.S.,2003,['India'],"['Crime Fiction', 'Comedy', 'Bollywood', 'World cinema']",2000,3
10454296,Heroes,2008,['India'],"['Musical', 'Bollywood', 'World cinema']",2000,8
2317590,The Adventures of Barry McKenzie,1972,"['New Zealand', 'Australia']","['Adventure Comedy', 'Comedy Western', 'Comedy', 'World cinema', 'Adventure']",1970,2
1411271,The Return of Martin Guerre,1982,['France'],"['Period piece', 'Romantic drama', 'World cinema', 'Drama']",1980,2
26178764,Wabash Avenue,1950,['United States of America'],['Musical'],1950,0
15220459,Eye of the Eagle,1997,['Denmark'],"['Action', 'Combat Films', 'War film', 'Adventure', 'Drama', 'Family Film']",1990,7
17511234,Surviving Desire,1991,['United States of America'],"['Drama', 'Indie', 'Romantic drama', 'Comedy', 'Romance Film', 'Romantic comedy', 'Comedy-drama']",1990,1
18571155,When Johnny Comes Marching Home,1942,['United States of America'],"['Musical', 'Black-and-white']",1940,2
633883,Two Weeks Notice,2002,"['United States of America', 'Australia']","['Workplace Comedy', 'Comedy', 'Romance Film', 'Romantic comedy']",2000,2
20079078,The Guv'nor,1935,['United Kingdom'],"['Black-and-white', 'Comedy', 'Comedy of Errors']",1930,5
5251546,Stolen Moments,1920,['United States of America'],"['Black-and-white', 'Indie', 'Short Film', 'Silent film']",1920,0
36057884,Ulle Veliye,1993,['India'],['Crime Fiction'],1990,3
4632649,Dancehall Queen,1997,['Jamaica'],"['Crime Fiction', 'World cinema', 'Melodrama', 'Drama']",1990,7
6276691,Enemy Mine,1985,"['West Germany', 'United States of America']","['Science Fiction', 'Adventure', 'Drama']",1980,5
17734329,Hitch-Hike,1977,['Italy'],"['Suspense', 'Crime Fiction', 'Thriller', 'World cinema', 'Adventure']",1970,7
187720,Little Darlings,1980,['United States of America'],"['Coming of age', 'Comedy', 'Teen', 'Drama']",1980,0
936787,About Last Night,1986,['United States of America'],"['Romantic drama', 'Comedy', 'Romance Film', 'Romantic comedy', 'Comedy-drama', 'Drama']",1980,6
1765938,Convoy,1978,['United States of America'],"['Action', 'Drama', 'Action/Adventure', 'Comedy']",1970,8
3724251,Bombshell,1933,['United States of America'],"['Black-and-white', 'Pre-Code', 'Comedy']",1930,3
32865308,Death Rite,1976,[],['Thriller'],1970,6
13167763,Dillinger Is Dead,1969,['Italy'],"['Art film', 'Drama', 'World cinema']",1960,9
24576535,High Gear,1933,['United States of America'],"['Action', 'Auto racing', 'Action/Adventure', 'Sports']",1930,3
5633334,Olly Olly Oxen Free,1978,['United States of America'],"['Comedy', 'Black comedy', ""Children's/Family"", 'Adventure', 'Family Film']",1970,8
7329501,The Old Garden,2006,['South Korea'],"['Romance Film', 'History', 'Drama']",2000,6
1582009,Yes Boss,1997,['India'],"['Romantic drama', 'Comedy', 'Bollywood', 'World cinema', 'Romance Film', 'Romantic comedy', 'Drama']",1990,7
5242523,Stage Door Canteen,1943,['United States of America'],"['Musical', 'Black-and-white', 'Musical comedy', 'Romance Film']",1940,3
2889278,Palmetto,1998,"['Germany', 'United States of America']","['Suspense', 'Neo-noir', 'Mystery', 'Thriller', 'Film noir', 'Crime Thriller']",1990,8
3725503,Zebraman,2004,['Japan'],"['Action', 'Japanese Movies', 'Action Comedy', 'Action/Adventure', 'Comedy', 'World cinema', 'Superhero movie']",2000,4
18612908,Doraemon: Nobita and Fantastic Three Musketeers,1994,['Japan'],['Japanese Movies'],1990,4
28090138,Singapore,1947,['United States of America'],['Romance Film'],1940,7
13384529,According to Greta,2009,['United States of America'],"['Romantic drama', 'Indie', 'Comedy', 'Romance Film', 'Drama']",2000,9
22845523,The Toy Wife,1938,['United States of America'],"['Black-and-white', 'Historical fiction', 'Drama']",1930,8
8697358,Crazy Stone,2006,"['China', 'Hong Kong']","['Caper story', 'Comedy', 'Action/Adventure', 'Crime Comedy', 'World cinema', 'Black comedy', 'Chinese Movies']",2000,6
1395888,Loafing and Camouflage,1984,['Greece'],['Comedy'],1980,4
6614818,Babar: The Movie,1989,['Canada'],"['Animation', 'Family-Oriented Adventure', ""Children's/Family"", ""Children's"", 'Family Film']",1980,9
1567129,Saraband,2003,"['Denmark', 'Austria', 'Sweden', 'Finland', 'Germany', 'Italy']","['Music', 'Musical', 'Family Drama', 'World cinema', 'Television movie', 'Drama']",2000,3
6590245,Big Bully,1996,['United States of America'],"['Comedy', 'Romantic comedy', 'Comedy-drama', 'Family Film']",1990,6
24324001,Foreign Exchange,2008,['United States of America'],"['Indie', 'Comedy', 'Sex comedy']",2000,8
5490080,Starstruck,1982,"['New Zealand', 'Australia']","['Musical', 'Drama', 'Indie', 'Comedy', 'World cinema', 'Romance Film', 'Romantic comedy']",1980,2
3028248,Chances Are,1989,['United States of America'],"['Romantic fantasy', 'Comedy', 'Romance Film', 'Romantic comedy', 'Religious Film', 'Fantasy Comedy', 'Fantasy']",1980,9
709860,Battle for the Planet of the Apes,1973,['United States of America'],"['Action', 'Adventure', 'Archives and records', 'Apocalyptic and post-apocalyptic fiction', 'Doomsday film', 'Science Fiction', 'Cult']",1970,3
11051069,Sadhna,1958,['India'],['Bollywood'],1950,8
28484547,Johnny Come Lately,1943,['United States of America'],['Drama'],1940,3
18557533,Compressed Hare,1961,[],[],1960,1
2685258,Our Hospitality,1923,['United States of America'],"['Adventure Comedy', 'Black-and-white', 'Drama', 'Indie', 'Comedy', 'Silent film', 'Romantic comedy']",1920,3
20288726,Yuddho,2005,['India'],['Action'],2000,5
4070671,Holiday,1938,['United States of America'],"['Black-and-white', 'Comedy', 'Romance Film', 'Romantic comedy']",1930,8
24121382,Smart Alecks,1942,['United States of America'],"['Crime Fiction', 'Comedy film', 'Romance Film', 'Drama']",1940,2
6613804,Bloodfist III: Forced to Fight,1992,['United States of America'],"['Action', 'Prison', 'Crime Fiction', 'Indie', 'Action/Adventure', 'Prison film', 'Martial Arts Film']",1990,2
17882809,You're Not Built That Way,1936,['United States of America'],"['Animation', 'Short Film', 'Comedy film', 'Family Film']",1930,6
7541527,Mad at the Moon,1992,['United States of America'],"['Creature Film', 'Hybrid Western', 'Western', 'Horror']",1990,2
2552557,Arcadia of My Youth,1982,['Japan'],"['Action', 'Fantasy Adventure', 'World cinema', 'Adventure', 'Japanese Movies', 'Anime', 'Alien Film', 'Science Fiction', 'Fantasy']",1980,2
18902771,Jism,2006,['Pakistan'],['Romance Film'],2000,6
5113356,Pumpkinhead: Ashes to Ashes,2006,"['United Kingdom', 'Romania', 'United States of America']","['Creature Film', 'Monster movie', 'Horror', 'Supernatural']",2000,6
10723448,The Dawns Here Are Quiet,1972,"['Russia', 'Soviet Union']","['Action', 'World cinema', 'War film', 'Drama']",1970,2
6465444,Devdas,1936,['India'],"['Black-and-white', 'Bollywood']",1930,6
706861,Tales from the Crypt presents: Demon Knight,1995,['United States of America'],"['Supernatural', 'Horror']",1990,5
19303258,The Lena Baker Story,2008,['United States of America'],"['Crime Fiction', 'Biographical film', 'Drama', 'Tragedy']",2000,8
3177073,The Boys,1998,['Australia'],"['Crime Fiction', 'Indie', 'Drama']",1990,8
24497330,YMCA Baseball Team,2002,['South Korea'],['Comedy'],2000,2
736266,Short Circuit,1986,['United States of America'],"['Action', 'Action/Adventure', 'Comedy', 'Science Fiction', 'Family Film']",1980,6
13831741,Cerberus,2005,['United States of America'],"['Horror', 'Adventure', 'Science Fiction', 'Fantasy']",2000,5
1733453,Shivering Shakespeare,1930,['United States of America'],"['Black-and-white', 'Short Film', 'Comedy', ""Children's/Family"", 'Slapstick', 'Family Film']",1930,0
1032588,Ladder 49,2004,['United States of America'],"['Action', 'Family Drama', 'Action/Adventure', 'Romantic drama', 'Thriller', 'Romance Film', 'Disaster', 'Drama', 'Tragedy', 'Melodrama']",2000,4
173650,The Cabinet of Dr. Caligari,1920,['Germany'],"['Black-and-white', 'Drama', 'Indie', 'Thriller', 'Horror', 'World cinema', 'Silent film']",1920,0
30985740,Pilots,2000,[],"['Action', 'Musical', 'Comedy film']",2000,0
3695000,Carry On Cabby,1963,['United Kingdom'],"['Parody', 'Slapstick', 'Comedy']",1960,3
23927995,Polygon,1977,['Soviet Union'],"['Animation', 'Short Film', 'Science Fiction']",1970,7
3388331,Jana Aranya,1976,['India'],"['Musical', 'Bengali Cinema', 'World cinema', 'Social problem film', 'Drama']",1970,6
12037272,Stars and Stripes Forever,1952,['United States of America'],"['Musical', 'Biography', 'Biographical film', 'Biopic [feature]', 'Drama']",1950,2
6003182,Khakee,2004,['India'],"['Musical', 'Action/Adventure', 'Bollywood', 'World cinema', 'Drama']",2000,4
24038513,Van Diemen's Land,2009,"['New Zealand', 'Australia']","['Prison', 'Crime Fiction', 'Thriller', 'World cinema', 'Crime Thriller', 'Drama', 'Period piece', 'Horror']",2000,9
8421755,Acosada,1964,"['Argentina', 'Venezuela']",['Drama'],1960,4
2772142,Diggers,2006,['United States of America'],"['Coming of age', 'Indie', 'Comedy', 'Drama']",2000,6
3821533,XX/XY,2002,['United States of America'],"['Romance Film', 'Romantic drama', 'Drama']",2000,2
2520368,Lost and Delirious,2001,['Canada'],"['Film adaptation', 'LGBT', 'Indie', 'Romantic drama', 'Teen', 'Romance Film', 'Drama', 'Gay Themed', 'Gay', 'Coming of age', 'Gay Interest']",2000,1
76018,Who Framed Roger Rabbit,1988,['United States of America'],"['Action', 'Crime Fiction', 'Animation', 'Mystery', 'Action/Adventure', 'Comedy', 'Buddy film', 'Black comedy', 'Parody', 'Fantasy Comedy', 'Family Film', 'Fantasy']",1980,8
20181213,Solaris,1972,"['Russia', 'Soviet Union']","['Art film', 'Mystery', 'World cinema', 'Adventure', 'Romance Film', 'Science Fiction', 'Drama']",1970,2
26665753,Kashmeeram,1994,['India'],"['Action', 'Thriller', 'Bollywood']",1990,4
21015273,The Pebble and the Penguin,1995,"['Ireland', 'United States of America']","['Music', 'Musical', 'Animation', ""Children's"", 'Adventure', 'Family Film']",1990,5
32560814,Smash-Up on Interstate 5,1976,['United States of America'],"['Disaster', 'Drama']",1970,6
445937,Lost Horizon,1973,['United States of America'],"['Musical', 'Roadshow theatrical release']",1970,3
23290290,Zoeken naar Eileen,1987,['Netherlands'],"['Romance Film', 'Thriller']",1980,7
3823023,Serial,1980,['United States of America'],"['Parody', 'Comedy', 'Romance Film', 'Romantic comedy']",1980,0
16648122,Caught,1996,['United States of America'],"['Crime Fiction', 'Thriller', 'Crime Thriller', 'Drama']",1990,6
26800485,The Butcher,2009,['United States of America'],"['Action', 'Crime Fiction', 'Action/Adventure', 'Crime Thriller']",2000,9
2253390,The Descent,2005,['United Kingdom'],"['Thriller', 'Horror', 'Adventure', 'Drama']",2000,5
8968472,Apariencias,2000,['Argentina'],"['LGBT', 'Romantic drama', 'Comedy', 'World cinema', 'Romance Film', 'Drama', 'Comedy of Errors', 'Romantic comedy']",2000,0
10722657,Kaun,1999,['India'],"['Musical', 'Thriller', 'Bollywood', 'Horror', 'World cinema']",1990,9
7135516,Urbania,2000,['United States of America'],"['Gay Themed', 'Film adaptation', 'LGBT', 'Gay', 'Drama', 'Indie', 'Gay Interest']",2000,0
14200012,Horror Hospital,1973,['United Kingdom'],"['Parody', 'Comedy', 'Horror Comedy', 'Horror', 'B-movie', 'Zombie Film', 'Science Fiction']",1970,3
19360383,A Tough Winter,1930,['United States of America'],"['Black-and-white', 'Short Film', 'Comedy', 'Family Film']",1930,0
26301940,Running Wild,1955,"['United States of America', 'South Africa']",['Drama'],1950,5
13525312,Saving Grace B. Jones,2009,['United States of America'],"['Period piece', 'Drama']",2000,9
14740301,Tarantulas: The Deadly Cargo,1977,['United States of America'],"['Thriller', 'Horror']",1970,7
21124360,Deb and Sisi,2008,['Canada'],['Comedy'],2000,8
12509366,The Couch Trip,1988,['United States of America'],"['Screwball comedy', 'Indie', 'Comedy', 'Black comedy', 'Comedy of Errors']",1980,8
12188026,Nicole,1988,['United States of America'],"['Suspense', 'Drama', 'Indie', 'Thriller', 'Erotic thriller', 'Crime Thriller']",1980,8
2567839,Rory O'Shea Was Here,2004,"['United Kingdom', 'France', 'Ireland']","['Indie', 'Comedy', 'Drama']",2000,4
15007384,Le Grand jeu,1934,['France'],"['Romance Film', 'Black-and-white', 'Drama']",1930,4
453196,Scarlet Diva,2000,['Italy'],"['Biography', 'World cinema', 'Comedy-drama', 'Erotica', 'Drama']",2000,0
25854271,"Tora-san, the Intellectual",1975,['Japan'],['Japanese Movies'],1970,5
10791945,Dharma Yuddam,1979,['India'],"['Suspense', 'Thriller']",1970,9
6574466,Suswagatham,1997,['India'],"['Romance Film', 'Drama', 'Family Film']",1990,7
3847881,The Seventh Veil,1945,['United Kingdom'],"['Melodrama', 'Romantic drama', 'Drama']",1940,5
2528212,The Last King of Scotland,2006,"['United Kingdom', 'Germany']","['Historical drama', 'Biographical film', 'Thriller', 'War film', 'Docudrama', 'Drama', 'Period piece', 'Political drama']",2000,6
3150618,The Greengage Summer,1961,['United Kingdom'],"['Coming of age', 'Drama']",1960,1
14695159,Wait Till Your Mother Gets Home!,1983,['United States of America'],['Comedy'],1980,3
23499575,Beyond the Rocks,1922,['United States of America'],"['Black-and-white', 'Romantic drama', 'Silent film', 'Romance Film', 'Melodrama', 'Drama']",1920,2
2010744,Stealth,2005,['United States of America'],"['Action', 'Thriller', 'Adventure', 'Science Fiction']",2000,5
7395236,So Much So Fast,2006,['United States of America'],"['Health & Fitness', 'Interpersonal Relationships', 'Indie', 'Biography', 'Documentary', 'Illnesses & Disabilities', 'Culture & Society']",2000,6
9591329,Dead & Buried,1981,['United States of America'],"['Mystery', 'Thriller', 'Horror', 'Zombie Film', 'Crime Thriller', 'Supernatural', 'Science Fiction']",1980,1
15177168,Asylum Days,2001,['United States of America'],"['Psychological thriller', 'Suspense', 'Thriller']",2000,1
846336,Tokyo Story,1953,['Japan'],"['Japanese Movies', 'Family Drama', 'World cinema', 'Drama']",1950,3
20518266,Private Eye Pooch,1955,['United States of America'],"['Animation', 'Short Film', 'Comedy', 'Family Film']",1950,5
15876371,La vaquilla,1985,['Spain'],"['War film', 'Comedy']",1980,5
3763760,Cashback,2006,['United Kingdom'],"['Romance Film', 'Comedy', 'Drama']",2000,6
18587615,Late Chrysanthemums,1954,['Japan'],"['Black-and-white', 'Japanese Movies', 'Drama']",1950,4
13212536,Klassfesten,2002,['Sweden'],['Comedy'],2000,2
17576975,It's My Life,2009,['India'],['Family Drama'],2000,9
1290721,Dreamscape,1984,['United States of America'],"['Psychological thriller', 'Satire', 'Thriller', 'Horror', 'Stop motion', 'Science Fiction']",1980,4
25737451,Wooly Boys,2001,['United States of America'],"['Indie', 'Action/Adventure', 'Family Drama', 'Drama', 'Coming of age', 'Western', 'Comedy-drama', 'Road movie']",2000,1
560414,The Petrified Forest,1936,['United States of America'],"['Black-and-white', 'Thriller', 'Film noir', 'Drama']",1930,6
1443465,If Only,2004,"['United Kingdom', 'United States of America']","['Romantic drama', 'Romance Film', 'Romantic comedy', 'Television movie', 'Drama', 'Fantasy']",2000,4
20795262,Leptirica,1973,['Yugoslavia'],"['Drama', 'Horror']",1970,3
747689,Hair,1979,"['Germany', 'United States of America']","['Musical', 'LGBT', 'Comedy', 'Drama', 'Anti-war', 'Period piece', 'War film', 'Cult']",1970,9
9130579,Pervert!,2005,['United States of America'],"['LGBT', 'Horror Comedy', 'Comedy', 'Sexploitation', 'Slasher', 'Horror', 'B-movie', 'Cult']",2000,5
17470934,"Moscow, Belgium",2008,['Belgium'],"['Romantic drama', 'Comedy', 'World cinema', 'Romance Film', 'Romantic comedy', 'Drama']",2000,8
689785,The Accused,1988,"['Canada', 'United States of America']","['Crime Fiction', 'Drama', 'Courtroom Drama']",1980,8
17642698,Assault on Dome 4,1996,['United States of America'],"['Action', 'Science Fiction']",1990,6
14515699,Swooner Crooner,1944,['United States of America'],"['Propaganda film', 'Animation']",1940,4
10206962,Wonder Boys,2000,"['Japan', 'United Kingdom', 'Germany', 'United States of America']","['Film adaptation', 'LGBT', 'Comedy', 'Drama', 'Japanese Movies', 'Coming of age', 'Comedy-drama', 'Comedy of manners']",2000,0
5513348,Warlock III: The End of Innocence,1999,['United States of America'],"['Horror', 'Supernatural', 'Cult', 'Fantasy']",1990,9
5566371,The White Sister,1933,['United States of America'],['Drama'],1930,3
6521673,Live Free or Die,2006,['United States of America'],"['Heist', 'Indie', 'Comedy', 'Political drama']",2000,6
33192425,Moment to Moment,1965,['United States of America'],"['Thriller', 'Drama']",1960,5
2485659,Rush,1991,['United States of America'],"['Action', 'Film adaptation', 'Drama', 'Crime Fiction', 'Crime Thriller']",1990,1
29480522,Anaganaga Oka Roju,1997,['India'],"['Romantic drama', 'Thriller', 'World cinema', 'Romance Film', 'Drama']",1990,7
20827623,Shifting Gears: A Bisexual Transmission,2008,['United States of America'],"['Gay pornography', 'Pornographic movie']",2000,8
5230175,Aarya,2007,['India'],"['Romance Film', 'Drama', 'Tamil cinema']",2000,7
2559661,Innocent Steps,2005,['South Korea'],"['Romantic comedy', 'Drama', 'World cinema']",2000,5
13243094,When He's Not a Stranger,1989,['United States of America'],"['Social problem film', 'Drama']",1980,9
1059238,Switching Channels,1988,['United States of America'],"['Media Satire', 'Indie', 'Comedy']",1980,8
2587696,"A Man, a Real One",2003,['France'],"['Drama', 'Comedy']",2000,3
6177791,Invaders from Space,1964,['Japan'],"['Superhero movie', 'Japanese Movies', 'Science Fiction']",1960,4
2475962,Gray Lady Down,1978,['United States of America'],"['Action', 'Action/Adventure', 'Adventure', 'Disaster']",1970,8
6114774,Pretty Poison,1968,['United States of America'],"['Crime Fiction', 'Comedy', 'Thriller', 'Romance Film', 'Drama']",1960,8
4410991,O Pagador de Promessas,1962,"['Brazil', 'Portugal']","['Drama', 'World cinema']",1960,2
7593569,The Battle of Midway,1942,['United States of America'],"['Black-and-white', 'History', 'Short Film', 'Documentary', 'War film', 'Propaganda film']",1940,2
345124,The Pope Must Die,1991,['United Kingdom'],['Comedy'],1990,1
25780238,Children of Invention,2009,['United States of America'],"['Crime Fiction', 'Indie', 'Family Drama', 'Drama']",2000,9
21117005,Pufnstuf,1970,['United States of America'],"['Musical', 'Adventure', 'Family Film', 'Fantasy']",1970,0
10671108,Dirty,2005,['United States of America'],"['Drama', 'Crime Fiction', 'Thriller']",2000,5
2371682,Any Which Way You Can,1980,['United States of America'],"['Action', 'Biker Film', 'Action Comedy', 'Action/Adventure', 'Buddy film', 'Comedy']",1980,0
24559797,The Lieutenant Wore Skirts,1956,['United States of America'],"['Slapstick', 'Comedy']",1950,6
25183229,Hadewijch,2009,['France'],"['Drama', 'World cinema']",2000,9
24542655,Healer,1994,[],"['Drama', 'Medical fiction']",1990,4
25531893,In Love and War,2001,['United States of America'],"['Period piece', 'Romantic drama', 'Romance Film', 'Television movie', 'Drama']",2000,1
9176428,The Chairman,1969,"['United Kingdom', 'United States of America']","['Action', 'Spy', 'Action Thrillers', 'Action/Adventure', 'Thriller']",1960,9
763725,The Witness,1969,"['France', 'Belgium']","['Thriller', 'Romance Film', 'Crime Thriller', 'Drama']",1960,9
11966083,Cambio de Sexo,1976,['Spain'],['Drama'],1970,6
4379279,Alag,2006,['India'],"['Thriller', 'Bollywood', 'World cinema']",2000,6
75264,The Night of the Hunter,1955,['United States of America'],"['Psychological thriller', 'Black-and-white', 'Crime Fiction', 'Mystery', 'Thriller', 'Film noir', 'Crime Thriller', 'Drama', 'Suspense']",1950,5
13450562,To Hare Is Human,1956,['United States of America'],"['Animation', 'Short Film', 'Family Film']",1950,6
30283145,Licence to Steal,1990,[],['Action'],1990,0
24051028,No Time for Sergeants,1958,['United States of America'],"['Film adaptation', 'Black-and-white', 'Comedy', 'Slapstick', 'Drama']",1950,8
6773386,The Errand Boy,1961,['United States of America'],"['Slapstick', 'Comedy']",1960,1
15422381,Los pasos perdidos,2001,"['Argentina', 'Spain']","['Drama', 'Indie', 'World cinema', 'Political drama']",2000,1
2500832,Birds Anonymous,1957,['United States of America'],['Short Film'],1950,7
18153847,Charley and the Angel,1973,['United States of America'],"['Family Drama', 'Heavenly Comedy', 'Comedy', 'Fantasy Comedy', 'Drama', 'Family Film', 'Fantasy']",1970,3
8966172,The 4th floor,1999,['United States of America'],"['Psychological thriller', 'Suspense', 'Mystery', 'Indie', 'Thriller', 'Crime Thriller']",1990,9
4428841,Death of a Scoundrel,1956,['United States of America'],"['Drama', 'Crime Fiction']",1950,6
18632376,Escape 2000,1981,"['New Zealand', 'Australia']","['Action', 'Action Thrillers', 'Action/Adventure', 'Science Fiction', 'Thriller', 'Horror', 'World cinema']",1980,1
2970602,Khalnayak,1993,['India'],"['Musical', 'Action/Adventure', 'Bollywood', 'World cinema']",1990,3
9781685,Alvin Purple Rides Again,1974,['Australia'],"['Comedy', 'Sex comedy']",1970,4
1004155,Mon oncle d'Amérique,1980,['France'],"['Psychological thriller', 'Satire', 'Comedy of manners', 'World cinema', 'Comedy-drama', 'Drama']",1980,0
2773221,Winnie the Pooh and Tigger Too!,1974,['United States of America'],"[""Children's Fantasy"", 'Animation', 'Short Film', 'Comedy', ""Children's/Family""]",1970,4
2061163,The Red House,1947,['United States of America'],"['Psychological thriller', 'Mystery', 'Gothic Film', 'Thriller', 'Film noir', 'Melodrama']",1940,7
29119330,Picture Snatcher,1933,['United States of America'],"['Crime Fiction', 'Crime Drama', 'Adventure', 'Drama']",1930,3
30684592,Streets,1990,['United States of America'],"['Action', 'Thriller', 'Drama']",1990,0
76399,Trouble in Paradise,1932,['United States of America'],"['Black-and-white', 'Crime Fiction', 'Screwball comedy', 'Comedy', 'Romance Film', 'Pre-Code', 'Drama', 'Romantic comedy']",1930,2
262770,The Tango Lesson,1997,"['Kingdom of Great Britain', 'Argentina', 'France', 'United Kingdom', 'Germany', 'Netherlands']","['Music', 'Black-and-white', 'Indie', 'Romantic drama', 'Romance Film', 'Docudrama', 'Drama', 'Dance', 'Comedy-drama']",1990,7
902894,Within the Woods,1979,['United States of America'],"['Short Film', 'Slasher', 'Horror', 'Zombie Film']",1970,9
32340746,Poachers,1975,['Spain'],['Drama'],1970,5
4246248,Glorifying the American Girl,1929,['United States of America'],"['Musical', 'Black-and-white', 'Comedy', 'Musical comedy', 'Pre-Code']",1920,9
23438764,Yankee Zulu,1993,['South Africa'],"['Drama', 'Comedy film']",1990,3
25225101,Eyes in the Night,1942,['United States of America'],"['Film adaptation', 'Detective fiction', 'Crime Fiction', 'Mystery', 'Thriller', 'Crime Thriller', 'Drama', 'Detective']",1940,2
17971153,"Don't Cry, Nanking",1995,['China'],"['Chinese Movies', 'Drama']",1990,5
21993773,Pirates of Tortuga,1961,['United States of America'],"['Action', 'Action/Adventure', 'Adventure', 'Swashbuckler films']",1960,1
14454439,So Long Mr. Chumps,1941,['United States of America'],"['Black-and-white', 'Short Film', 'Comedy', 'Slapstick']",1940,1
4106181,Knock Off,1998,"['Hong Kong', 'United States of America']","['Action', 'Action Thrillers', 'Action/Adventure', 'Thriller', 'Chinese Movies', 'Martial Arts Film', 'Drama', 'Short Film']",1990,8
26998763,Simha,2009,['India'],['Action'],2000,9
5174138,Meet Bill,2007,['United States of America'],"['Comedy', 'Romance Film', 'Romantic comedy', 'Drama']",2000,7
1047827,The Game of Death,1978,"['Hong Kong', 'United States of America']","['Action', 'Action/Adventure', 'Thriller', 'World cinema', 'Chinese Movies', 'Martial Arts Film']",1970,8
10015952,Red Skies of Montana,1952,['United States of America'],"['Adventure', 'Drama']",1950,2
6008226,Jumping Jacks,1952,['United States of America'],"['Slapstick', 'Comedy']",1950,2
17124686,Shotgun Stories,2008,['United States of America'],"['Family Drama', 'Indie', 'Thriller', 'Americana', 'Drama']",2000,8
26470648,The Two Lifes Of Daniel Shore,2009,['Germany'],"['Drama', 'Crime Fiction', 'Thriller']",2000,9
23981586,Nurses on the Line: The Crash of Flight 7,1993,['United States of America'],"['Action/Adventure', 'Adventure', 'Television movie', 'Drama']",1990,3
10561709,Celos,1999,['Spain'],"['Romantic drama', 'World cinema', 'Romance Film', 'Drama']",1990,9
3633996,Stavisky,1974,"['France', 'Italy']","['Period piece', 'Drama', 'Biopic [feature]']",1970,4
23959320,War Wolves,2009,['United States of America'],['Horror'],2000,9
16958933,Inferno,1999,['United States of America'],"['Action', 'Thriller', 'Remake', 'Romance Film', 'Martial Arts Film', 'Drama']",1990,9
914988,Daylight,1996,['United States of America'],"['Action', 'Action/Adventure', 'Thriller', 'Disaster']",1990,6
6012834,Mere Hamdam Mere Dost,1968,['India'],"['Musical', 'Romance Film', 'Thriller']",1960,8
2068139,Diamond Men,2000,['United States of America'],"['Crime Fiction', 'Mystery', 'Indie', 'Buddy film', 'Thriller', 'Comedy', 'Crime Thriller', 'Drama', 'Road movie']",2000,0
2571385,The Illusionist,2006,"['Czech Republic', 'United States of America']","['Film adaptation', 'Crime Fiction', 'Mystery', 'Romantic drama', 'Indie', 'Thriller', 'Romance Film', 'Costume drama', 'Adventure', 'Drama', 'Period piece', 'Fantasy']",2000,6
9010968,Honeydripper,2007,['United States of America'],"['Musical', 'Period piece', 'Drama', 'Indie', 'Musical Drama', 'Ensemble Film']",2000,7
12159269,Bad Charleston Charlie,1973,['United States of America'],"['Gangster Film', 'Parody', 'Indie', 'Comedy']",1970,3
14727566,The Big Doll House,1971,"['Philippines', 'United States of America']","['Action', 'Filipino Movies', 'Crime Fiction', 'Indie', 'Action/Adventure', 'Women in prison films']",1970,1
142481,Moulin Rouge!,2001,"['United Kingdom', 'Australia', 'United States of America']","['Musical', 'Romantic drama', 'Comedy', 'Remake', 'Romance Film', 'Costume drama', 'Drama', 'Period piece', 'Jukebox musical']",2000,1
232795,"South Park: Bigger, Longer & Uncut",1999,['United States of America'],"['Musical', 'Gross out', 'Gross-out film', 'Animation', 'Political satire', 'Animated Musical', 'Satire', 'Comedy', 'Musical comedy', 'Black comedy', 'Absurdism', 'Political cinema', 'Parody', 'War film']",1990,9
11255555,Dil Apna Aur Preet Parai,1960,['India'],"['Musical', 'Bollywood', 'World cinema', 'Drama']",1960,0
28934915,Max Rules,2005,['United States of America'],"['Action', 'Action/Adventure', 'Comedy', ""Children's/Family"", 'Adventure', 'Family Film']",2000,5
3735943,My Right to Ravage Myself,2005,"['France', 'South Korea']",['Drama'],2000,5
20360218,Barbarian,2003,['United States of America'],"['Fantasy', 'Sword and sorcery']",2000,3
709510,King Arthur,2004,"['United Kingdom', 'Ireland', 'United States of America']","['Action', 'Action/Adventure', 'Costume drama', 'Adventure', 'Drama', 'Period piece', 'History', 'War film']",2000,4
4871592,The Ballad of Little Joe,2003,['United States of America'],"['Musical', 'Animation', 'Short Film', ""Children's""]",2000,3
11451426,La Torre de los Siete Jorobados,1944,['Spain'],"['Black-and-white', 'Mystery', 'Comedy', 'Thriller']",1940,4
9316735,"Walk Softly, Stranger",1950,['United States of America'],"['Film noir', 'Black-and-white', 'Drama']",1950,0
28021043,Kodalu Diddina Kapuram,1970,['India'],['Drama'],1970,0
4399374,Gamera 2: Attack of Legion,1996,['Japan'],"['Creature Film', 'Monster movie', 'Japanese Movies', 'World cinema', 'Fantasy']",1990,6
20442820,Like You Know It All,2009,['South Korea'],"['Romantic drama', 'Drama', 'World cinema']",2000,9
25323148,Salve Geral,2009,['Brazil'],"['Drama', 'World cinema']",2000,9
18401762,Engine Sentai Go-onger: Boom Boom! Bang Bang! GekijōBang!!,2008,['Japan'],"['Action', 'Short Film']",2000,8
12867093,Patlabor: The Movie 2,1993,['Japan'],"['Animation', 'Japanese Movies', 'Future noir', 'Anime', 'Science Fiction']",1990,3
24236812,Gumrah,1993,['India'],"['Action/Adventure', 'Thriller', 'Bollywood', 'World cinema', 'Drama']",1990,3
28088223,Krakatit,1948,['Czech Republic'],['Thriller'],1940,8
13242057,A Child's Cry for Help,1994,['United States of America'],['Drama'],1990,4
12344161,Ek Hi Bhool,1981,['India'],"['Musical', 'Bollywood', 'World cinema', 'Drama']",1980,1
2821897,Children of the Corn: The Final Sacrifice,1993,['United States of America'],"['Supernatural', 'Horror']",1990,3
22030168,Ai City,1986,['Japan'],"['Dystopia', 'Japanese Movies', 'Future noir', 'Anime', 'Science Fiction']",1980,6
11699160,The Card Player,2004,['Italy'],"['Giallo', 'Slasher', 'Thriller', 'Horror']",2000,4
7754795,The Front Page,1974,['United States of America'],"['Period piece', 'Comedy', 'Romance Film', 'Romantic comedy', 'Drama']",1970,4
1640608,"C'est la vie, mon chéri",1994,"['China', 'Hong Kong']","['Romantic drama', 'Romance Film', 'Melodrama', 'Chinese Movies', 'Drama']",1990,4
28149365,Stiletto,1969,['United States of America'],"['Drama', 'Crime Fiction']",1960,9
9063572,Trimurti,1995,['India'],"['Action/Adventure', 'Bollywood', 'World cinema']",1990,5
24418098,The Founding of a Republic,2009,['China'],"['World cinema', 'Chinese Movies', 'War film', 'Drama']",2000,9
10933452,Unbeaten 28,1980,"['Hong Kong', 'Taiwan']","['Action/Adventure', 'World cinema', 'Chinese Movies', 'Martial Arts Film']",1980,0
8283339,Panther Girl of the Kongo,1955,['United States of America'],"['Action', 'Black-and-white', 'Horror', 'Adventure', 'Natural horror films']",1950,5
28293297,The Amazing Mrs. Holliday,1943,['United States of America'],"['Musical Drama', 'Adventure', 'Drama']",1940,3
8935844,Camp Cuddly Pines: Power Tool Massacre,2005,['United States of America'],"['Parody', 'Pornographic movie']",2000,5
2681577,The Prophecy: Forsaken,2005,['United States of America'],"['Cult', 'Horror']",2000,5
3950296,The Seniors,1978,[],['Comedy film'],1970,8
4644909,The Ghost Breakers,1940,['United States of America'],"['Black-and-white', 'Screwball comedy', 'Comedy', 'Thriller', 'Horror', 'Haunted House Film']",1940,0
10594712,The Starfish,1928,['France'],"['Surrealism', 'Short Film']",1920,8
3493786,Metropolitan,1989,['United States of America'],"['Indie', 'Comedy', 'Drama']",1980,9
73428,Do the Right Thing,1989,['United States of America'],"['Drama', 'Indie', 'Comedy', 'Ensemble Film']",1980,9
25539481,Decalogue IV,1988,['Poland'],['Drama'],1980,8
1801710,The Magdalene Sisters,2002,"['Ireland', 'United Kingdom']","['Period piece', 'Drama', 'Escape Film']",2000,2
13885547,Crimes Of Fashion,2004,['United States of America'],"['Television movie', 'Gangster Film', 'Comedy']",2000,4
27375080,The Killer Inside Me,1976,['United States of America'],"['Suspense', 'Film adaptation', 'Thriller', 'Film noir', 'Crime Thriller']",1970,6
12558286,"20,000 Years in Sing Sing",1932,['United States of America'],"['Black-and-white', 'Crime Fiction', 'Drama']",1930,2
22841607,Half-Life,2006,['United States of America'],"['Fantasy Drama', 'Indie', 'Science Fiction', 'Drama', 'Fantasy']",2000,6
28256111,What Every Woman Knows,1934,['United States of America'],"['Comedy', 'Comedy film']",1930,4
3585135,Undercurrent,1946,['United States of America'],"['Psychological thriller', 'Black-and-white', 'Crime Fiction', 'Mystery', 'Romantic drama', 'Thriller', 'Film noir', 'Romance Film', 'Crime Thriller', 'Drama']",1940,6
17409304,Swimmers,2005,['United States of America'],"['Indie', 'Drama']",2000,5
1709334,Loving You,1957,['United States of America'],"['Musical', 'Romantic drama', 'Romance Film', 'Drama']",1950,7
34476865,My Lady's Lips,1925,[],"['Drama', 'Crime Fiction']",1920,5
1659846,Guess Who,2005,['Switzerland'],"['Comedy', 'Comedy of manners', 'Romance Film', 'Romantic comedy', 'Domestic Comedy']",2000,5
8476747,Chal Mere Bhai,2000,['India'],"['Action', 'Musical', 'Comedy', 'Romance Film']",2000,0
26188754,The Winged Tiger,1970,['Hong Kong'],"['Wuxia', 'Chinese Movies', 'Martial Arts Film']",1970,0
15620889,Miss London Ltd.,1943,['United Kingdom'],"['Musical', 'War film', 'Comedy film']",1940,3
2565848,Rock 'n' Roll High School Forever,1990,['United States of America'],"['Musical', 'Comedy', 'Teen']",1990,0
22714346,Priyamaina Neeku,2001,['India'],['Romance Film'],2000,1
3650371,Silk,2007,"['Canada', 'Japan', 'United Kingdom', 'France', 'Italy']","['Period piece', 'Film adaptation', 'Japanese Movies', 'Romantic drama', 'World cinema', 'Romance Film', 'Drama']",2000,7
7972574,Their First Mistake,1932,['United States of America'],"['Black-and-white', 'Short Film', 'Comedy', 'Slapstick']",1930,2
10135050,Hotel Angel,1974,['Thailand'],['Drama'],1970,4
5655933,Waking Dreams,2004,['United States of America'],"['Short Film', 'Drama']",2000,4
12044494,The Second Civil War,1997,['United States of America'],"['Political satire', 'Comedy', 'Black comedy', 'Drama', 'Political cinema', 'Parody', 'Television movie', 'Science Fiction']",1990,7
8867686,Death Sentence,2007,['United States of America'],"['Action', 'Drama', 'Crime Fiction', 'Thriller', 'Crime Thriller']",2000,7
15590234,The Chicken Chronicles,1977,['United States of America'],"['Drama', 'Comedy']",1970,7
18724245,Now That Summer is Gone,1938,['United States of America'],"['Animation', 'Short Film', 'Comedy', 'Family Film']",1930,8
15607591,The Climb: Behind the Scenes,2002,['United States of America'],"['Indie', 'Action/Adventure', 'Adventure', 'Christian film', 'Drama']",2000,2
12004855,The Easiest Way,1931,['United States of America'],"['Black-and-white', 'Romance Film', 'Pre-Code', 'Drama']",1930,1
6209086,Sally,1929,['United States of America'],['Musical'],1920,9
6704984,Tokyo Eyes,1998,"['France', 'Japan']","['Crime Fiction', 'Romantic drama', 'Thriller', 'World cinema', 'Romance Film', 'Crime Thriller', 'Drama', 'Japanese Movies']",1990,8
10617098,Bees Saal Baad,1962,['India'],['Bollywood'],1960,2
18732394,Loft,2008,['Belgium'],"['Crime Thriller', 'Thriller', 'World cinema']",2000,8
18774910,Pandorum,2009,"['United Kingdom', 'Germany', 'United States of America']","['Action', 'Indie', 'Thriller', 'Horror', 'Sci-Fi Horror', 'Science Fiction']",2000,9
5768434,The Delicate Art of the Rifle,1996,['United States of America'],['Drama'],1990,6
2533663,Dragon Gate Inn,1966,"['Hong Kong', 'Taiwan']","['Action', 'Wuxia', 'Chinese Movies', 'Adventure']",1960,6
16038391,'Til We Meet Again,1940,['United States of America'],"['Black-and-white', 'Romance Film', 'Melodrama', 'Drama']",1940,0
12481201,What Happened Was,1994,['United States of America'],"['Drama', 'Indie', 'Romantic drama', 'Comedy', 'Black comedy', 'Romantic comedy', 'Romance Film']",1990,4
15073138,Charlie Chan in Shanghai,1935,['United States of America'],"['Crime Fiction', 'Mystery', 'Thriller', 'Comedy film']",1930,5
30296647,Castle in the Desert,1942,['United States of America'],"['Detective fiction', 'Mystery', 'Comedy', 'Thriller', 'Detective', 'Crime Thriller', 'Whodunit']",1940,2
8476426,Barocco,1976,['France'],"['Thriller', 'World cinema']",1970,6
4372392,Imperium: Augustus,2003,"['Spain', 'Austria', 'United Kingdom', 'France', 'Germany', 'Italy']","['Action', 'Biography', 'Romance Film', 'War film', 'Drama', 'History', 'Television movie', 'Political drama']",2000,3
6748794,Azhagai Irukkirai Bayamai Irukkirathu,2006,['India'],"['Musical', 'Romantic drama', 'Bollywood', 'World cinema', 'Romance Film', 'Drama']",2000,6
7576612,Dragon Fighter,2003,"['Bulgaria', 'United States of America']","['Action', 'Action/Adventure', 'Science Fiction', 'Thriller', 'Horror']",2000,3
12556506,Isn't Life Wonderful,1924,['United States of America'],"['Black-and-white', 'Drama', 'Indie', 'Silent film']",1920,4
12722189,Tasveer,2008,['India'],"['Bollywood', 'Thriller']",2000,8
13253566,Role Models,2008,"['Germany', 'United States of America']","['Romance Film', 'Comedy']",2000,8
12593445,Voyage to Nowhere,1986,['Spain'],"['Drama', 'Comedy']",1980,6
6769790,Visit to a Small Planet,1960,['United States of America'],"['Film adaptation', 'Black-and-white', 'Satire', 'Comedy', 'Science Fiction', 'Drama', 'Family Film']",1960,0
21452659,Love and Other Impossible Pursuits,2009,['United States of America'],['Drama'],2000,9
17172484,Hong Kong Bronx,2007,['Hong Kong'],['Chinese Movies'],2000,7
779536,Fat Man and Little Boy,1989,['United States of America'],"['Period piece', 'War film', 'Drama']",1980,9
24282238,Yamraaj,1998,['India'],"['Action', 'Crime Fiction']",1990,8
1022323,King Creole,1958,['United States of America'],"['Musical', 'Romance Film', 'Drama']",1950,8
15945620,Dance of the Wind,1997,['India'],"['Music', 'Art film', 'Drama']",1990,7
17062684,Sweet Nothing in My Ear,2008,['United States of America'],"['Television movie', 'Family Drama', 'Drama']",2000,8
1558226,Kull the Conqueror,1997,"['Italy', 'United States of America']","['Fantasy Adventure', 'Action/Adventure', 'Sword and sorcery', 'Adventure', 'Sword and sorcery films', 'Fantasy']",1990,7
26322133,Mullavalliyum Thenmavum,2003,['India'],"['Romance Film', 'Drama']",2000,3
8637169,Garage Days,2002,"['New Zealand', 'Australia']","['Music', 'Musical', 'Drama', 'Indie', 'Comedy', 'World cinema']",2000,2
6491387,Dr. Giggles,1992,"['Japan', 'United States of America']","['Japanese Movies', 'Slasher', 'Horror', 'Black comedy', 'B-movie']",1990,2
684771,Enemy of the State,1998,['United States of America'],"['Action', 'Action Thrillers', 'Action/Adventure', 'Thriller', 'Crime Thriller', 'Drama', 'Suspense', 'Chase Movie', 'Political thriller']",1990,8
19976618,Le Bal du Comte d'Orgel,1970,['France'],['Drama'],1970,0
18625362,Ration Bored,1943,[],"['Animation', 'Short Film', 'Comedy film', 'Family Film']",1940,3
13374571,Liar's Moon,1982,['United States of America'],"['Coming of age', 'Romantic drama', 'Teen', 'Romance Film', 'Drama']",1980,2
5579795,King-Size Canary,1947,[],['Short Film'],1940,7
27556523,The Young Land,1959,['United States of America'],"['Western', 'Action/Adventure', 'Drama']",1950,9
5079733,Race the Sun,1996,['United States of America'],"['Auto racing', 'Family Drama', 'Comedy', 'Docudrama', 'Sports', 'Drama', 'Family Film']",1990,6
11701,Full Metal Jacket,1987,"['United Kingdom', 'United States of America']","['Action', 'Combat Films', 'Film adaptation', 'Drama', 'Anti-war', 'Period piece', 'Anti-war film', 'War film']",1980,7
9267531,Dracula vs. Frankenstein,1971,['United States of America'],"['Creature Film', 'Monster', 'Indie', 'Horror', 'B-movie', 'Costume Horror']",1970,1
2944826,The Sleeping Pricess in the Devil's Castle,1987,['Japan'],['Japanese Movies'],1980,7
2032945,Match Point,2005,"['Luxembourg', 'United Kingdom']","['Crime Fiction', 'Romantic drama', 'Thriller', 'Romance Film', 'Sports', 'Drama']",2000,5
11965718,Fanny Pelopaja,1984,"['France', 'Spain']","['Crime Fiction', 'Crime Thriller', 'Thriller']",1980,4
18521491,Midnight in Saint Petersburg,1996,"['Russia', 'United Kingdom', 'Canada']","['Spy', 'Thriller']",1990,6
19149206,Exit Speed,2008,['United States of America'],"['Action', 'Action Thrillers', 'Chase Movie', 'Action/Adventure', 'Thriller']",2000,8
23906190,Lucky Bastard,2009,['United States of America'],"['Gay Themed', 'LGBT', 'Drama']",2000,9
8745233,God Is Brazilian,2003,['Brazil'],"['Comedy', 'World cinema', 'Religious Film', 'Comedy-drama', 'Adventure', 'Fantasy']",2000,3
8340706,Killers from Space,1954,['United States of America'],"['Alien Film', 'Science Fiction']",1950,4
161877,This Sporting Life,1963,['United Kingdom'],"['Romantic drama', 'Romance Film', 'British New Wave', 'Sports', 'Kitchen sink realism', 'Drama']",1960,3
8729170,Stateside,2004,"['Germany', 'United States of America']","['Period piece', 'Coming of age', 'Romantic drama', 'Romance Film', 'Drama']",2000,4
61525,Dead End,1937,['United States of America'],"['Film adaptation', 'Black-and-white', 'Crime Fiction', 'Gangster Film', 'Drama']",1930,7
19360428,Batman and Robin,1949,['United States of America'],"['Action', 'Superhero movie', 'Adventure']",1940,9
8193607,Lakeer - Forbidden Lines,2004,['India'],"['Action/Adventure', 'World cinema']",2000,4
5651515,Return of the Living Dead: Necropolis,2005,['United States of America'],"['Zombie Film', 'Cult', 'Horror']",2000,5
25538958,Mickey's Surprise Party,1939,[],"['Short Film', 'Animation']",1930,9
29138388,The Call for Arms,1940,['United Kingdom'],['Short Film'],1940,0
33608328,Männerpension,1996,[],"['Crime Fiction', 'Drama', 'Comedy film']",1990,6
1188139,Interstate 60,2002,"['Canada', 'United States of America']","['Road movie', 'Indie', 'Comedy']",2000,2
2323962,Teenage Mutant Ninja Turtles,1990,"['Hong Kong', 'United States of America']","['Animation', 'Indie', 'Action/Adventure', 'Comedy', 'Chinese Movies', 'Superhero movie', 'Family Film', 'Fantasy']",1990,0
9126846,Go West,2005,"['Bosnia and Herzegovina', 'Croatia']","['LGBT', 'Western', 'Comedy', 'World cinema', 'Drama']",2000,5
32856520,New Faces,1954,['United States of America'],"['Musical', 'Comedy']",1950,4
19876978,Meera,1945,['India'],['Drama'],1940,5
10613136,Night Train to Terror,1985,['United States of America'],['Horror'],1980,5
35986782,Adhisaya Manithan,1990,['India'],['Horror'],1990,0
265242,The Brown Bunny,2003,"['France', 'Japan', 'United States of America']","['Drama', 'Erotic Drama', 'Indie', 'Japanese Movies', 'Romantic drama', 'Romance Film', 'Road movie']",2000,3
19259000,Hochheta Ki,2008,['India'],['Comedy'],2000,8
9752270,Ervinka,1967,['Israel'],"['Comedy', 'Satire', 'Crime Comedy', 'World cinema']",1960,7
6222273,Grilled,2006,['United States of America'],"['Buddy film', 'Comedy', 'Black comedy', 'Workplace Comedy']",2000,6
1771007,The Private Life of Sherlock Holmes,1970,['United Kingdom'],"['Detective fiction', 'Crime Fiction', 'Mystery', 'Comedy', 'Thriller', 'Romance Film', 'Crime Thriller', 'Adventure', 'Detective']",1970,0
5542667,Aakasha Gopuram,2007,['India'],"['Romance Film', 'Drama', 'Bollywood']",2000,7
7084051,One Soldier,1999,['United States of America'],"['Short Film', 'Comedy']",1990,9
30323966,Sacre Bleu Cross,1967,[],"['Short Film', 'Animation']",1960,7
20556389,Mr. St. Nick,2002,"['Canada', 'United States of America']","['Comedy film', ""Children's/Family"", 'Christmas movie', 'Fantasy']",2000,2
28204833,In the Money,1958,['United States of America'],['Comedy film'],1950,8
19498515,Nella città l'inferno,1959,['Italy'],"['Prison', 'Black-and-white', 'Drama']",1950,9
14456164,Up in Daisy's Penthouse,1953,['United States of America'],"['Short Film', 'Black-and-white', 'Comedy']",1950,3
20814932,The Cut,2007,['South Korea'],"['Mystery', 'World cinema', 'Horror']",2000,7
17523604,Sirf,2008,['India'],"['Musical', 'Romantic drama', 'Bollywood', 'World cinema', 'Romance Film', 'Drama']",2000,8
25652572,Mulan,2009,['China'],"['Action/Adventure', 'World cinema', 'Romance Film', 'Chinese Movies', 'Adventure', 'Drama']",2000,9
5792097,Tim,1979,"['New Zealand', 'Australia']","['Romantic drama', 'World cinema', 'Romance Film', 'Drama']",1970,9
11490601,Cartouche,1962,"['France', 'Italy']","['Action/Adventure', 'Comedy', 'World cinema', 'Romance Film', 'Swashbuckler films', 'Adventure']",1960,2
4673186,Barbie of Swan Lake,2003,['United States of America'],"['Animation', ""Children's/Family"", ""Children's"", 'Computer Animation', 'Fairy tale', ""Children's Fantasy"", 'Family Film', 'Fantasy']",2000,3
12794862,The Lady Takes a Sailor,1949,['United States of America'],['Comedy'],1940,9
25708108,Mutiny,1952,['United States of America'],"['Action', 'Action/Adventure', 'Adventure', 'Romance Film']",1950,2
6631279,Little city,1997,['United States of America'],"['Romantic drama', 'Comedy', 'Romance Film', 'Romantic comedy', 'Comedy-drama', 'Drama', 'Ensemble Film']",1990,7
4028796,Kutty,2001,['India'],['Drama'],2000,1
10801490,Sex Drive,2008,['United States of America'],"['Coming of age', 'Comedy', 'Teen', 'Romantic comedy', 'Adventure', 'Sex comedy']",2000,8
5125270,Fairy Idol,2006,['United States of America'],['Parody'],2000,6
1407207,Game Over: Kasparov and the Machine,2003,"['Canada', 'United Kingdom']","['Computers', 'Biography', 'Documentary', 'Culture & Society']",2000,3
22880521,Fly High Run Far,1991,['South Korea'],['Historical drama'],1990,1
2280880,Losin' It,1983,"['Canada', 'United States of America']","['Coming of age', 'Indie', 'Comedy', 'Teen', 'Cult', 'Sex comedy']",1980,3
7434119,Border Line,2002,['Japan'],['Japanese Movies'],2000,2
1365735,The Best Man,1964,['United States of America'],"['Black-and-white', 'Drama']",1960,4
667152,Criminal Law,1989,['United States of America'],"['Suspense', 'Crime Fiction', 'Thriller', 'Crime Thriller', 'Courtroom Drama']",1980,9
4784069,Wassup Rockers,2006,['United States of America'],"['Coming of age', 'Indie', 'Teen', 'Comedy-drama', 'Drama']",2000,6
11039716,Whiteout,2009,"['France', 'United States of America', 'Canada']","['Action', 'Mystery', 'Thriller', 'Crime Thriller']",2000,9
25725663,"Liar, Liar",1993,['Canada'],['Drama'],1990,3
29616771,Kallan Pavithran,1981,['India'],['Drama'],1980,1
10553349,Mister Lonely,2006,"['United Kingdom', 'France', 'Ireland', 'United States of America']","['Drama', 'Indie', 'Comedy', 'Avant-garde', 'Experimental film', 'Black comedy', 'Comedy-drama']",2000,6
6075725,Le gendarme de Saint-Tropez,1964,"['France', 'Italy']",['Comedy'],1960,4
26499601,Rudraksham,1994,['India'],"['Action', 'Romance Film', 'Adventure']",1990,4
5501736,Darling Lili,1970,['United States of America'],"['Spy', 'Musical', 'Musical Drama', 'Comedy', 'Thriller', 'Romance Film', 'Drama', 'Romantic comedy', 'Melodrama', 'War film']",1970,0
8808797,The Prince and Me 2: The Royal Wedding,2006,['United States of America'],"['Romantic drama', 'Comedy', 'Teen', 'Romance Film', 'Romantic comedy', 'Drama']",2000,6
1273569,The Elusive Pimpernel,1950,['United Kingdom'],"['Costume drama', 'Adventure']",1950,0
7077559,New Wave Hookers,1985,['United States of America'],"['Adult', 'Pornographic movie']",1980,5
31845460,Wives Never Know,1936,['United States of America'],"['Comedy', 'Comedy film']",1930,6
21309110,Skyscraper Caper,1968,['United States of America'],"['Animation', 'Short Film', 'Comedy']",1960,8
12932124,Across the Great Divide,1976,['United States of America'],"['Coming of age', ""Children's"", 'Action/Adventure', 'Drama', 'Family Film']",1970,6
12000,Godzilla vs. Biollante,1989,['Japan'],"['Creature Film', 'Monster', 'Japanese Movies', 'Science Fiction', 'Horror', 'Fantasy']",1980,9
13828139,Control,2004,['United States of America'],"['Action', 'Psychological thriller', 'Crime Fiction', 'Action/Adventure', 'Thriller', 'Crime Thriller', 'Science Fiction']",2000,4
10611398,Tower of London,1962,['United States of America'],"['Black-and-white', 'Horror', 'Costume drama', 'Drama']",1960,2
5321349,Dating the Enemy,1996,['Australia'],"['Romance Film', 'Comedy', 'Sex comedy']",1990,6
4662487,Thirupathi,2006,['India'],['Action'],2000,6
3112333,Howling VI: The Freaks,1991,"['United Kingdom', 'United States of America']","['Indie', 'Horror']",1990,1
22954776,Frog Song,2005,['Japan'],"['LGBT', 'Romantic drama', 'World cinema', 'Romance Film', 'Drama', 'Softcore Porn', 'Japanese Movies', 'Pornographic movie', 'Erotica', 'Adult']",2000,5
11815331,The Adventures of Rusty,1945,['United States of America'],"['Black-and-white', 'Drama', 'Family Film']",1940,5
231829,Magnolia,1999,['United States of America'],['Drama'],1990,9
26564947,The Illustrated Man,1969,['United States of America'],"['Film adaptation', 'Science Fiction', 'Drama']",1960,9
3724539,Les Visiteurs du soir,1942,['France'],"['Romantic fantasy', 'Black-and-white', 'Romance Film', 'Fantasy']",1940,2
17080283,Eavesdrop,2008,['United States of America'],"['Indie', 'Comedy', 'Romance Film', 'Drama', 'Ensemble Film']",2000,8
1370478,Lord of Illusions,1995,['United States of America'],"['Detective fiction', 'Mystery', 'Detective', 'Horror', 'Supernatural']",1990,5
2377503,Waiting...,2005,['United States of America'],"['Coming of age', 'Indie', 'Comedy', 'Workplace Comedy', 'Ensemble Film']",2000,5
17705458,Search and Destroy,1995,['United States of America'],"['Crime Fiction', 'Parody', 'Indie', 'Satire', 'Comedy']",1990,5
1305819,C.H.U.D.,1984,['United States of America'],"['Drama', 'Creature Film', 'Monster movie', 'Natural horror films', 'Slasher', 'Horror', 'B-movie', 'Science Fiction', 'Cult']",1980,4
160047,High Fidelity,2000,"['United Kingdom', 'United States of America']","['Music', 'Film adaptation', 'Comedy', 'Romance Film', 'Romantic comedy', 'Drama']",2000,0
3558237,Salaam E Ishq: A Tribute To Love,2007,['India'],"['Musical', 'Romantic drama', 'Bollywood', 'World cinema', 'Romance Film', 'Romantic comedy', 'Drama']",2000,7
34626864,The Classroom of Terror,1976,['Japan'],['Crime Fiction'],1970,6
1087895,Eating Raoul,1982,['United States of America'],"['Black comedy', 'Comedy', 'Cult']",1980,2
21477212,Kali Sankar,2007,['India'],"['Action', 'Romance Film', 'Drama']",2000,7
12652556,Gabriel,2007,"['New Zealand', 'Australia']","['Action', 'Indie', 'Action/Adventure', 'Horror', 'World cinema', 'Fantasy']",2000,7
6872477,The Taste of Others,2000,['France'],"['Romantic drama', 'Comedy', 'World cinema', 'Romance Film', 'Drama', 'Romantic comedy', 'Comedy-drama', 'Comedy of manners']",2000,0
7725128,The Miracle,1959,['United States of America'],['Drama'],1950,9
12795201,Under the Yum Yum Tree,1963,['United States of America'],"['Film adaptation', 'Comedy', 'Romance Film', 'Romantic comedy', 'Drama', 'Sex comedy']",1960,3
11714278,Safety Patrol,1998,['United States of America'],"['Black-and-white', 'Comedy', 'Teen', 'Slapstick']",1990,8
27308175,They Went That-A-Way & That-A-Way,1978,['United States of America'],"['Slapstick', 'Comedy']",1970,8
28067339,Anari No.1,1999,['India'],['World cinema'],1990,9
27694453,Chantal,2007,['United States of America'],['Drama'],2000,7
19042649,The Little Drummer Girl,1983,['United States of America'],"['Spy', 'Thriller', 'Political thriller']",1980,3
19246546,Neel Rajar Deshe,2008,['India'],['Adventure'],2000,8
20138604,Old Sequoia,1945,['United States of America'],"['Animation', 'Short Film', 'Comedy', 'Family Film']",1940,5
22751,Original Sin,2001,"['United States of America', 'France']","['Mystery', 'Thriller', 'Romance Film', 'Drama']",2000,1
3828478,Heroes of the East,1979,['Hong Kong'],"['Action', 'Action/Adventure', 'World cinema', 'Chinese Movies', 'Martial Arts Film']",1970,9
19076629,A Wednesday,2008,['India'],"['Musical', 'Action/Adventure', 'Bollywood', 'World cinema', 'Drama']",2000,8
23561477,Chicken Every Sunday,1949,['United States of America'],"['Romantic comedy', 'Comedy']",1940,9
4949401,The Emperor's New Clothes,2001,"['United Kingdom', 'Germany', 'Italy']","['Film adaptation', 'Animation', 'Romantic drama', 'Comedy', 'Romance Film', 'Drama', 'Romantic comedy', 'Comedy-drama', 'Family Film']",2000,1
5734726,Deus e o Diabo na Terra do Sol,1964,['Brazil'],"['Black-and-white', 'Crime Fiction', 'Western', 'Crime Drama', 'Road movie', 'Adventure', 'Drama']",1960,4
4410064,Kahin Pyaar Na Ho Jaaye,2000,['India'],"['Romance Film', 'Comedy', 'Family Film']",2000,0
31863462,Still Bill,2009,['United States of America'],"['Music', 'Rockumentary', 'Biography', 'Documentary']",2000,9
7605708,Il Paese del Sesso Selvaggio,1973,['Italy'],"['Horror', 'Adventure', 'Romance Film', 'Cult']",1970,3
25615135,Illegal,1955,['United States of America'],"['Film noir', 'Crime Fiction', 'Drama']",1950,5
25132418,Cattle Annie and Little Britches,1981,['United States of America'],"['Western', 'Drama']",1980,1
4800257,The Big Green,1995,['United States of America'],"['Comedy', ""Children's/Family"", 'Sports', 'Family Film']",1990,5
29885413,Pratigyabadh,1991,['India'],['Drama'],1990,1
11502661,Dunderklumpen,1974,['Sweden'],"['Musical', 'Animation', 'Adventure', 'Family Film', 'Fantasy']",1970,4
28749199,Adayalam,1991,['India'],['Mystery'],1990,1
34891696,Gandeevam,1994,['India'],"['Action', 'Drama']",1990,4
22542212,Hurt,2003,['Canada'],"['Indie', 'Drama']",2000,3
23961445,The Live Wire,1935,['United States of America'],"['Black-and-white', 'Drama', 'Thriller']",1930,5
6550694,Magic Carpet Ride,2006,['Turkey'],"['Black comedy', 'Comedy']",2000,6
349941,Being John Malkovich,1999,['United States of America'],"['Comedy', 'Black comedy', 'Workplace Comedy', 'Fantasy Comedy', 'Drama', 'Fantasy']",1990,9
22740580,Wild Grass,2009,"['France', 'Italy']","['Romantic drama', 'Avant-garde', 'World cinema', 'Experimental film', 'Romance Film', 'Drama']",2000,9
17844551,Thakshak,1999,['India'],"['Musical', 'Action/Adventure', 'Bollywood', 'World cinema', 'Romance Film']",1990,9
22516246,La Mujer del Puerto,1936,['Mexico'],"['Black-and-white', 'Romantic drama', 'World cinema', 'Romance Film', 'Drama']",1930,6
17023814,Thun Man Handiya,1970,['Sri Lanka'],['Drama'],1970,0
7049779,Caro diario,1994,"['France', 'Italy']","['Art film', 'Satire', 'Comedy', 'Comedy of manners', 'World cinema', 'Drama']",1990,4
10036523,Scent-imental Over You,1947,['United States of America'],"['Animation', 'Short Film', 'Family Film']",1940,7
3104623,The Magus,1968,['United Kingdom'],"['Psychological thriller', 'Film adaptation', 'Drama', 'Fantasy']",1960,8
4418263,The Betsy,1978,['United States of America'],"['Period piece', 'Film adaptation', 'Drama', 'Indie', 'Romantic drama', 'Romance Film', 'Melodrama']",1970,8
23325791,The Thirst,2006,['United States of America'],"['Creature Film', 'Psychological thriller', 'Horror']",2000,6
226515,Jason and the Argonauts,1963,"['United Kingdom', 'United States of America']","['Action/Adventure', 'Stop motion', 'Costume drama', 'Adventure', 'Family Film', 'Fantasy']",1960,3
8417013,Cold Turkey,1971,['United States of America'],['Satire'],1970,1
4121318,Phantom of the Megaplex,2000,['United States of America'],"['Mystery', 'Comedy', 'Family Film']",2000,0
15962218,Anzio,1968,"['Italy', 'United States of America']","['Action', 'Drama', 'War film']",1960,8
18895115,Gorintaku,2008,['India'],['Drama'],2000,8
19380534,Brief Interviews with Hideous Men,2007,['United States of America'],"['Film adaptation', 'Drama', 'Indie', 'Comedy', 'Black comedy', 'Romantic comedy', 'Romance Film']",2000,7
23600571,Hare-Abian Nights,1959,['United States of America'],"['Animation', 'Short Film', 'Family Film']",1950,9
2721086,Hurry Sundown,1967,['United States of America'],"['Period piece', 'Melodrama', 'Drama']",1960,7
9310096,Five,2003,"['France', 'Iran']","['Art film', 'World cinema', 'Documentary', 'Silent film', 'Drama']",2000,3
12500476,Sissi,1955,['Austria'],"['Romantic drama', 'Comedy', 'Biographical film', 'World cinema', 'Romance Film', 'Romantic comedy', 'Drama']",1950,5
8265956,Naan Avanillai,2007,['India'],"['Drama', 'Crime Fiction', 'Thriller']",2000,7
3596344,The Contact,1997,['South Korea'],"['Romantic drama', 'World cinema', 'Romance Film', 'Drama']",1990,7
6795118,Pagaivan,1997,['India'],['Drama'],1990,7
18654391,The Dock Brief,1962,['United Kingdom'],"['Black-and-white', 'Courtroom Comedy', 'Parody', 'Satire', 'Comedy']",1960,2
35754206,An Angel from Texas,1940,['United States of America'],"['Romance Film', 'Comedy film']",1940,0
24110107,Partir,2009,['France'],"['Romantic drama', 'World cinema', 'Romance Film', 'Melodrama', 'Drama']",2000,9
17792701,Day of Atonement,1992,['France'],['Crime Fiction'],1990,2
1977174,Basic Instinct 2,2006,"['Spain', 'United Kingdom', 'Germany', 'United States of America']","['Psychological thriller', 'Crime Fiction', 'Mystery', 'Thriller', 'Erotic thriller', 'Crime Thriller']",2000,6
28224834,Eva Perón: The True Story,1996,['Argentina'],"['Biography', 'Drama', 'World cinema']",1990,6
919722,Intimacy,2001,"['Spain', 'United Kingdom', 'France', 'Germany']","['Drama', 'Indie', 'World cinema', 'Romance Film', 'Erotica', 'Adult']",2000,1
2359960,Female Jungle,1954,['United States of America'],['Film noir'],1950,4
35014287,Not Only Mrs. Raut,2003,['India'],['Drama'],2000,3
3235479,Oily Hare,1952,['United States of America'],"['Animation', 'Short Film', 'Family Film']",1950,2
13514560,Adventureland,2009,['United States of America'],"['Comedy', 'Teen', 'Romance Film', 'Drama', 'Period piece', 'Coming of age', 'Romantic comedy', 'Comedy-drama']",2000,9
28645571,Toxic Zombies,1980,['United States of America'],"['Horror', 'Zombie Film']",1980,0
563176,Monsieur Ibrahim,2003,['France'],"['Coming of age', 'Buddy film', 'World cinema', 'Drama']",2000,3
19091638,Dunya and Desi,2008,"['Netherlands', 'Belgium']",['Drama'],2000,8
21956466,See Jane Date,2003,"['Canada', 'United States of America']","['Comedy', 'Romance Film', 'Romantic comedy', 'Television movie']",2000,3
28807164,Deadly Advice,1994,['United Kingdom'],"['Drama', 'Comedy']",1990,4
10625487,The Killer Reserved Nine Seats,1974,['Italy'],"['Mystery', 'Thriller', 'Horror']",1970,4
11145424,Satanás,2007,"['Mexico', 'Colombia']","['Drama', 'World cinema']",2000,7
2289768,The King of Marvin Gardens,1972,['United States of America'],"['Family Drama', 'Drama', 'New Hollywood']",1970,2
12239785,Zhizn i priklyucheniya chetyrekh druzei 1/2,1980,"['Russia', 'Soviet Union']","[""Children's"", 'Comedy', 'Family Film']",1980,0
36057874,Kattumarakaran,1995,['India'],['Drama'],1990,5
7094918,Seduced By Madness,1996,['United States of America'],"['Psychological thriller', 'Thriller', 'Television movie', 'Crime Thriller']",1990,6
1166394,The War Lord,1965,['United States of America'],"['History', 'Historical Epic', 'Historical fiction', 'Drama']",1960,5
19204826,Village of Daughters,1962,['United Kingdom'],['Comedy'],1960,2
32799797,Inconceivable,2008,"['Canada', 'United Kingdom', 'France', 'United States of America']","['Drama', 'Comedy']",2000,8
3100376,The Role of Her Life,2004,['France'],['Drama'],2000,4
3735041,Coast Guard,2002,['South Korea'],"['Psychological thriller', 'Action', 'Thriller', 'World cinema', 'Romance Film', 'War film', 'Drama']",2000,2
22047047,The Terminators,2009,['United States of America'],"['Action', 'Indie', 'Science Fiction']",2000,9
770184,The Grifters,1990,['United States of America'],"['Neo-noir', 'Film adaptation', 'Crime Fiction', 'Thriller', 'Black comedy', 'Drama', 'Suspense', 'Crime Drama']",1990,0
176762,Whale Rider,2002,"['Germany', 'New Zealand', 'Australia']","['Indie', 'Family Drama', 'Childhood Drama', 'World cinema', 'Drama', 'Feminist Film', 'Coming of age', 'Family Film']",2000,2
587265,Audition,1999,['Japan'],"['Japanese Movies', 'Mystery', 'Thriller', 'World cinema', 'Horror', 'Drama']",1990,9
3136520,The Boxer,1997,"['United Kingdom', 'Ireland', 'United States of America']","['Boxing', 'Romantic drama', 'Romance Film', 'Sports', 'Political drama', 'Drama']",1990,7
605198,My Own Private Idaho,1991,['United States of America'],"['Gay Themed', 'Gay', 'Gay Interest', 'Buddy film', 'Romance Film', 'Road movie', 'Drama']",1990,1
31101188,A Place for Annie,1994,['United States of America'],['Drama'],1990,4
6060093,Mr. Boogedy,1986,['United States of America'],['Family Film'],1980,6
1644858,Une Femme Est une Femme,1961,"['France', 'Italy']","['Art film', 'Romantic drama', 'Comedy', 'World cinema', 'Romance Film', 'Romantic comedy', 'Drama']",1960,1
17571974,Ball Don't Lie,2009,['United States of America'],['Drama'],2000,9
10440784,Sydney White,2007,['United States of America'],"['Comedy', 'Teen', 'Romance Film', 'Romantic comedy']",2000,7
3799386,Off Limits,1988,['United States of America'],"['Period piece', 'Crime Fiction', 'Thriller', 'Crime Thriller', 'War film', 'Drama']",1980,8
1922815,Cheaper by the Dozen 2,2005,"['Canada', 'United States of America']","['Comedy', 'Domestic Comedy', 'Adventure', 'Family Film']",2000,5
9521099,Sharpe's Mission,1996,['United Kingdom'],"['Period piece', 'Costume Adventure', 'Historical fiction', 'Adventure']",1990,6
3514297,Private Resort,1985,['United States of America'],"['Slapstick', 'Comedy', 'Sex comedy']",1980,5
30812180,Panic in the Skies,1996,['United States of America'],"['Disaster', 'Action/Adventure']",1990,6
23548789,Freakdog,2008,['United Kingdom'],"['Psychological thriller', 'Horror']",2000,8
4306582,The Public Eye,1992,['United States of America'],"['Period piece', 'Crime Fiction', 'Gangster Film', 'Thriller', 'Drama']",1990,2
1173339,Jaws 3-D,1983,['United States of America'],"['Action', 'Suspense', 'Mystery', 'Action/Adventure', 'Thriller', 'Horror', 'Natural horror films']",1980,3
36233317,Speaking of the Weather,1937,['United States of America'],"['Animation', 'Short Film', 'Comedy film']",1930,7
7680299,Drowned Out,2002,"['India', 'England']",['Documentary'],2000,2
12177551,When Do We Eat?,2005,['United States of America'],"['Indie', 'Comedy']",2000,5
2820120,Solo,1996,"['Mexico', 'United States of America']","['Action', 'Action/Adventure', 'Science Fiction', 'Thriller']",1990,6
3276167,Capote,2005,"['Canada', 'United States of America']","['Period piece', 'Crime Fiction', 'Biography', 'Biopic [feature]', 'Crime Drama', 'Drama']",2000,5
21544454,Ghostkeeper,1982,['Canada'],"['Drama', 'Thriller', 'Horror']",1980,2
12780906,Audace colpo dei soliti ignoti,1960,['Italy'],"['Black-and-white', 'Crime Fiction', 'Caper story', 'Comedy', 'Crime Comedy']",1960,0
2411105,The Plague Dogs,1982,"['United Kingdom', 'United States of America']","['Drama', 'Animation', 'Indie', 'Chase Movie', 'Anime', 'Adventure', 'Fantasy']",1980,2
16691326,Bread and Tulips,2000,"['Switzerland', 'Italy']","['Romantic drama', 'Comedy', 'World cinema', 'Romance Film', 'Romantic comedy', 'Drama', 'Comedy of Errors']",2000,0
5830941,No Dough Boys,1944,['United States of America'],"['Black-and-white', 'Short Film', 'Comedy', 'Slapstick', 'Propaganda film']",1940,4
3942986,The Golden Voyage of Sinbad,1974,"['United Kingdom', 'United States of America']","['Fantasy Adventure', 'Action/Adventure', 'Adventure', 'Costume drama', 'Mythological Fantasy', 'Stop motion', 'Science Fiction', 'Family Film', 'Fantasy']",1970,4
30327,The Terminator,1984,['United States of America'],"['Action', 'Indie', 'Action/Adventure', 'Thriller', 'Time travel', 'Doomsday film', 'Stop motion', 'Science Fiction']",1980,4
3868432,Into the Mirror,2003,['South Korea'],['Horror'],2000,3
14330182,Dharm,2007,['India'],"['Musical', 'Art film', 'World cinema', 'Drama']",2000,7
29511764,Dragones: Destino de Fuego,2006,['Peru'],"['Computer Animation', 'Fantasy', 'Family Film']",2000,6
9022958,Great Expectations,1998,['United States of America'],"['Film adaptation', 'Romantic drama', 'Romance Film', 'Drama']",1990,8
3032133,Wayward Son,1999,['United States of America'],"['Period piece', 'Melodrama', 'Drama']",1990,9
21764904,The Joneses,2009,['United States of America'],"['Family Drama', 'Satire', 'Comedy', 'Comedy-drama', 'Drama']",2000,9
10621311,Shaolin Prince,1982,['Hong Kong'],"['Action/Adventure', 'World cinema', 'Chinese Movies', 'Martial Arts Film']",1980,2
42294,The Lost Weekend,1945,['United States of America'],"['Film adaptation', 'Film noir', 'Social problem film', 'Addiction Drama', 'Drama']",1940,5
29214367,Fuse,2004,[],"['Drama', 'Comedy film']",2000,4
7286869,Strawberry Shortcake: The Sweet Dreams Movie,2006,['United States of America'],"['Computer Animation', 'Animation', 'Family-Oriented Adventure', ""Children's/Family"", 'Family Film', ""Children's"", ""Children's Entertainment""]",2000,6
32087007,Sujatha,1980,[],[],1980,0
770066,Country,1984,['United States of America'],['Drama'],1980,4
8603964,Faccia a faccia,1967,"['Spain', 'Italy']","['Action', 'Spaghetti Western', 'Western']",1960,7
31119365,Malappuram Haji Mahanaya Joji,1994,[],['Comedy film'],1990,4
6478040,The Flyboys,2006,['United States of America'],['Adventure'],2000,6
5429235,The Postman Always Rings Twice,1946,['United States of America'],"['Film adaptation', 'Black-and-white', 'Crime Fiction', 'Mystery', 'Thriller', 'Film noir', 'Romance Film', 'Crime Thriller', 'Drama']",1940,6
8714658,Guide,1965,['India'],"['Musical', 'Bollywood', 'World cinema', 'Romance Film', 'Drama']",1960,5
3901979,Trilogy of Terror,1975,['United States of America'],"['Supernatural', 'Thriller', 'Horror']",1970,5
1381483,The Great St Trinian's Train Robbery,1966,['United Kingdom'],"['Action', 'Heist', 'Action/Adventure', 'Comedy']",1960,6
23355005,Folly to Be Wise,1953,['United Kingdom'],['Comedy'],1950,3
6244334,Van Helsing: The London Assignment,2004,['United States of America'],"['Action', 'Animation', 'Action/Adventure', 'Costume Horror', 'Creature Film', 'Monster movie', 'Short Film', 'Horror', 'Fantasy']",2000,4
1792743,Kaante,2002,['India'],"['Action', 'Crime Fiction', 'Musical Drama', 'Action/Adventure', 'Bollywood', 'World cinema', 'Drama', 'Caper story']",2000,2
22756444,Love in Nepal,2004,['India'],"['Romantic drama', 'Comedy', 'World cinema', 'Romance Film', 'Romantic comedy', 'Drama']",2000,4
10909091,Reign of the Fallen,2005,['United States of America'],"['Action', 'Science Fiction']",2000,5
22412482,Lemon Tree,2008,"['Israel', 'France', 'Germany']","['Drama', 'World cinema']",2000,8
757080,The House I Live In,1945,['United States of America'],"['Musical', 'Musical Drama', 'Short Film']",1940,5
144774,Dr. Jekyll and Mr. Hyde,1931,['United States of America'],"['Black-and-white', 'Horror', 'Point of view shot', 'Pre-Code', 'Science Fiction', 'Drama']",1930,1
3333681,Man About Town,2006,['United States of America'],"['Drama', 'Indie', 'Romantic drama', 'Comedy', 'Romance Film', 'Romantic comedy']",2000,6
31434827,Mole Men vs. the Son of Hercules,1961,['Italy'],"['Action', 'Action/Adventure', 'Short Film', 'Adventure', 'Drama', 'Fantasy']",1960,1
6768671,Pachaikili Muthucharam,2007,['India'],['Drama'],2000,7
18115086,Violent Shit III,1999,['Germany'],"['Action', 'Horror', 'B-movie', 'Zombie Film']",1990,9
301314,Kill Bill Volume 1,2003,['United States of America'],"['Action', 'Action/Adventure', 'Thriller', 'Crime Thriller', 'Spaghetti Western', 'Martial Arts Film', 'Drama']",2000,3
6811268,The Idolmaker,1980,['United States of America'],"['Music', 'Musical', 'Period piece', 'Biography', 'Romance Film', 'Drama']",1980,0
23653924,Five Minutes to Live,1961,['United States of America'],"['Black-and-white', 'Crime Fiction', 'Thriller', 'Crime Thriller']",1960,1
24127710,Ellam Avan Seyal,2008,['India'],['Thriller'],2000,8
36261180,Le farò da padre,1974,['Italy'],"['Romance Film', 'Comedy film']",1970,4
594815,What Lies Beneath,2000,['United States of America'],"['Psychological thriller', 'Mystery', 'Thriller', 'Crime Thriller', 'Drama', 'Haunted House Film', 'Suspense', 'Horror', 'Supernatural']",2000,0
17614109,Artemisia,1997,"['France', 'Germany', 'Italy']","['Biographical film', 'World cinema', 'Romance Film', 'Drama', 'Courtroom Drama']",1990,7
2257827,Northwest Frontier,1959,['United Kingdom'],"['British Empire Film', 'Action', 'Chase Movie', 'Action/Adventure', 'War film', 'Adventure', 'Drama']",1950,9
13297418,Hider in the House,1989,['United States of America'],"['Psychological thriller', 'Thriller', 'Horror', 'Adventure']",1980,9
8897938,Meet the Applegates,1990,['United States of America'],['Black comedy'],1990,0
5774697,Guns,1990,['United States of America'],"['Action', 'Drama', 'Sexploitation', 'Thriller']",1990,0
20691913,No Mercy for the Rude,2006,['South Korea'],"['Action', 'Drama', 'Comedy', 'Black comedy']",2000,6
7051491,Poltergeist,1982,['United States of America'],"['Suspense', 'Thriller', 'Horror', 'Supernatural', 'Cult']",1980,2
30874145,Diva,1981,['France'],"['Action', 'Psychological thriller', 'Mystery', 'Thriller', 'World cinema', 'Romance Film', 'Drama']",1980,1
1855172,Pocket Money,1972,['United States of America'],"['Comedy Western', 'Action/Adventure', 'Western', 'Buddy film', 'Comedy']",1970,2
2851281,School Daze,1988,['United States of America'],"['Musical', 'Coming of age', 'Indie', 'Comedy', 'Drama']",1980,8
1983990,Knight Rider 2010,1994,['United States of America'],['Drama'],1990,4
21615815,Shark Swarm,2008,['United States of America'],"['Action', 'Drama', 'Thriller', 'Horror', 'Natural horror films']",2000,8
10699658,Bairaag,1976,['India'],"['Musical', 'Bollywood', 'World cinema']",1970,6
4883476,Is There Life Out There,1994,['United States of America'],"['Drama', 'Television movie']",1990,4
28250307,Witch Hunt,1994,['United States of America'],"['Detective', 'Horror']",1990,4
22040622,The King's Thief,1955,['United States of America'],"['Swashbuckler films', 'Adventure']",1950,5
26630225,Asso,1981,[],['Comedy film'],1980,1
24341490,Lady Black Rose,1978,['Japan'],"['Erotica', 'Japanese Movies', 'Pornographic movie']",1970,8
9649668,Kannukkul Nilavu,2000,['India'],[],2000,0
19887951,Shake Rattle & Roll X,2008,['Philippines'],"['Filipino Movies', 'Comedy', 'Horror', 'World cinema']",2000,8
4661494,Dead Man's Shoes,2004,['United Kingdom'],"['Psychological thriller', 'Crime Fiction', 'Thriller', 'Drama']",2000,4
695249,Home Alone 3,1997,['United States of America'],"['Action', 'Crime Fiction', 'Comedy', 'Domestic Comedy', ""Children's/Family"", 'Slapstick', 'Family Film']",1990,7
16419423,Rainfall at Nighttime,1979,['South Korea'],"['Romance Film', 'Drama']",1970,9
30335583,Palangal,1981,[],"['Romance Film', 'Drama']",1980,1
1705347,The Misadventures of Merlin Jones,1964,['United States of America'],"['Comedy', 'Drama', 'Family Film']",1960,4
958640,SST: Death Flight,1977,['United States of America'],['Drama'],1970,7
2683739,When Dinosaurs Ruled the Earth,1970,['United Kingdom'],"['Adventure', 'Stop motion', 'Science Fiction', 'Fantasy']",1970,0
25041206,Caprices,1942,['France'],['Comedy'],1940,2
23212131,Amanecer,2009,"['Colombia', 'Australia']","['Short Film', 'Drama', 'Family Film']",2000,9
12002,Godzilla vs. King Ghidorah,1991,['Japan'],"['Creature Film', 'Japanese Movies', 'Horror']",1990,1
2159438,Eve's Bayou,1997,['United States of America'],"['Period piece', 'Indie', 'Childhood Drama', 'Melodrama', 'Drama']",1990,7
7210029,Care Bears: Oopsy Does It!,2007,['United States of America'],"[""Children's Fantasy"", 'Animation', ""Children's/Family"", ""Children's"", 'Computer Animation']",2000,7
28752111,The Real Story of Happy Birthday to You,1992,[],['Short Film'],1990,2
14063136,Dog Eat Dog,2001,"['United Kingdom', 'Germany']","['Drama', 'Comedy']",2000,1
8586619,Death Proof,2007,['United States of America'],"['Action', 'Crime Fiction', 'Indie', 'Action/Adventure', 'Thriller', 'Chase Movie', 'Slasher', 'Horror', 'Cult']",2000,7
32300431,I Could Read the Sky,1999,['Ireland'],['Drama'],1990,9
6258743,The Adventure of Iron Pussy,2003,['Thailand'],"['Musical', 'LGBT', 'Superhero', 'Comedy', 'Glamorized Spy Film', 'Adventure', 'Gay Themed', 'Gay', 'Gay Interest', 'Superhero movie']",2000,3
14025121,Los santos inocentes,1984,['Spain'],['Drama'],1980,4
27730398,French Dressing,1964,['United Kingdom'],"['Drama', 'Comedy film']",1960,4
2664350,Meatballs 2,1984,['United States of America'],"['Comedy', 'Sex comedy']",1980,4
2861847,Mad Dog and Glory,1993,['United States of America'],"['Crime Fiction', 'Gangster Film', 'Comedy', 'Romance Film', 'Drama', 'Crime Comedy', 'Romantic comedy', 'Comedy-drama']",1990,3
26834344,Seetamalakshmi,1978,['India'],"['Musical', 'Drama']",1970,8
26138280,Foreign Body,1986,['United Kingdom'],"['Romance Film', 'Romantic comedy', 'Comedy']",1980,6
145359,Star Trek V: The Final Frontier,1989,['United States of America'],"['Western', 'Adventure', 'Space western', 'Science Fiction']",1980,9
23527179,The Shocking Miss Pilgrim,1947,['United States of America'],"['Musical', 'Musical comedy']",1940,7
28068896,Johnnie Walker,1992,['India'],[],1990,2
4409955,Kuruthipunal,1996,['India'],"['Action', 'Drama']",1990,6
3383751,Zwei Frauen,1989,"['Germany', 'United States of America']",['Drama'],1980,9
2980843,Love Comes Softly,2003,['United States of America'],"['Film adaptation', 'Romantic drama', 'Romance Film', 'Christian film', 'Costume drama', 'Drama', 'Period piece', 'Western', 'Television movie']",2000,3
25495137,Money,1993,['India'],['Comedy'],1990,3
1770490,Spinout,1966,['United States of America'],"['Auto racing', 'Musical', 'Comedy', 'Sports', 'Drama']",1960,6
24166693,The Neptune Factor,1973,"['Canada', 'United States of America']","['Action/Adventure', 'Science Fiction', 'Disaster', 'Adventure', 'Cult']",1970,3
2627364,16 Years of Alcohol,2003,['United Kingdom'],"['Indie', 'Drama']",2000,3
4430389,Eternity and a Day,1998,"['France', 'Italy', 'Greece']","['Art film', 'World cinema', 'Road movie', 'Drama']",1990,8
9483286,123,2002,['India'],[],2000,2
6174018,Julie Johnson,2001,['United States of America'],"['LGBT', 'Indie', 'Romance Film', 'Drama', 'Feminist Film', 'Gay Themed', 'Gay', 'Gay Interest']",2000,1
7301880,Alice Adams,1935,['United States of America'],"['Film adaptation', 'Black-and-white', 'Remake', 'Romance Film', 'Drama']",1930,5
463153,I'll Never Forget What's 'Isname,1967,['United Kingdom'],['Satire'],1960,7
22228712,The Man Who Was Sherlock Holmes,1937,['Germany'],"['Romance Film', 'Crime Fiction', 'Comedy']",1930,7
6795123,Raasi,1997,[],[],1990,7
11713601,A Halfway House Christmas,2005,['United States of America'],"['Parody', 'Comedy']",2000,5
4612967,Waqt,1965,['India'],"['Musical', 'Bollywood', 'World cinema', 'Drama']",1960,5
13038387,Lobster Man From Mars,1989,['United States of America'],"['Parody', 'Science Fiction', 'Comedy']",1980,9
11669596,The Lurking Fear,1994,['United States of America'],"['Monster movie', 'B-movie', 'Horror']",1990,4
27874763,Sri Simhachala Kshetra Mahima,1965,['India'],[],1960,5
21918632,The Hangover,2009,"['Germany', 'United States of America']","['Screwball comedy', 'Buddy film', 'Comedy', 'Absurdism']",2000,9
22056357,Traces of Red,1992,['United States of America'],"['Action', 'Crime Fiction', 'Action/Adventure', 'Thriller', 'Crime Thriller', 'Drama']",1990,2
2198959,National Security,2003,['United States of America'],"['Action', 'Crime Fiction', 'Action/Adventure', 'Buddy film', 'Thriller', 'Comedy', 'Action Comedy', 'Crime Comedy']",2000,3
5227184,Shortbus,2006,['United States of America'],"['LGBT', 'Indie', 'Comedy', 'Romance Film', 'Drama', 'Ensemble Film', 'Comedy-drama', 'Erotica', 'Sex comedy']",2000,6
1668414,Tetsuo: The Iron Man,1989,['Japan'],"['Surrealism', 'Black-and-white', 'Avant-garde', 'Thriller', 'World cinema', 'Sci-Fi Horror', 'Japanese Movies', 'Horror', 'Experimental film', 'Science Fiction', 'Cult']",1980,9
29948429,Mere Sajana Saath Nibhana,1992,['India'],"['Musical', 'Drama']",1990,2
2466050,Parts: The Clonus Horror,1979,['United States of America'],"['Dystopia', 'Indie', 'Thriller', 'Horror', 'Sci-Fi Horror', 'Science Fiction']",1970,9
9541205,The Cavern,2005,['United States of America'],"['Indie', 'Horror']",2000,5
1559551,Dark Blood,1993,"['United Kingdom', 'United States of America']",['Thriller'],1990,3
17653406,Deep in My Heart,1999,['United States of America'],['Drama'],1990,9
1553297,Invasion U.S.A.,1985,['United States of America'],"['Action', 'Spy', 'Action/Adventure', 'Thriller', 'Martial Arts Film']",1980,5
19105706,Mother Carey's Chickens,1938,['United States of America'],"['Black-and-white', 'Family Drama', 'Drama']",1930,8
1107052,Micki + Maude,1984,['United States of America'],"['Comedy', 'Romance Film', 'Romantic comedy', 'Comedy-drama']",1980,4
11531376,Pup on a Picnic,1955,['United States of America'],"['Short Film', ""Children's/Family""]",1950,5
24062674,Seran pandiyan,1991,['India'],['Drama'],1990,1
10595471,Kaalia,1981,['India'],"['Action/Adventure', 'World cinema']",1980,1
669480,The Company,2003,"['Germany', 'United States of America']","['Music', 'Indie', 'Dance', 'Romance Film', 'Drama']",2000,3
11021128,Yatra,2007,['India'],['Drama'],2000,7
10189121,Romeo & Juliet: Sealed with a Kiss,2006,['United States of America'],"['Romantic fantasy', ""Children's Fantasy"", 'Animation', ""Children's/Family"", 'Family Film']",2000,6
4125457,Judaai,1997,['India'],"['Musical', 'Bollywood', 'World cinema', 'Drama']",1990,7
427989,Targets,1968,['United States of America'],"['Suspense', 'Thriller']",1960,8
7668793,The Running Man,1987,['United States of America'],"['Action', 'Film adaptation', 'Dystopia', 'Thriller', 'Science Fiction']",1980,7
2664825,Invisible Ghost,1941,['United States of America'],"['Black-and-white', 'Crime Fiction', 'Mystery', 'Action/Adventure', 'Thriller', 'Crime Thriller', 'Adventure', 'Horror']",1940,1
1562677,The Chipmunk Adventure,1987,['United States of America'],"['Animation', ""Children's"", 'Family-Oriented Adventure', ""Children's/Family"", 'Adventure', 'Family Film']",1980,7
1304986,Young Sherlock Holmes,1985,"['United Kingdom', 'United States of America']","['Action', 'Detective fiction', 'Action/Adventure', 'Comedy', 'Thriller', 'Suspense', 'Detective', 'Steampunk', 'Family Film', 'Mystery', 'Family Drama', 'Crime Thriller', 'Costume drama', 'Adventure', 'Drama', 'Period piece', 'Stop motion']",1980,5
1564174,The Big Combo,1955,['United States of America'],"['Black-and-white', 'Crime Fiction', 'Gangster Film', 'Thriller', 'Film noir', 'Drama']",1950,5
3213020,The Prowler,1951,['United States of America'],"['Psychological thriller', 'Black-and-white', 'Thriller', 'Film noir']",1950,1
947450,Tea With Mussolini,1999,"['United Kingdom', 'Italy']","['Period piece', 'Drama', 'Indie', 'Coming of age', 'Comedy', 'Comedy-drama', 'War film']",1990,9
3557540,The Hunt for Red October,1990,['United States of America'],"['Action', 'Action Thrillers', 'Action/Adventure', 'Thriller', 'Drama', 'Political thriller']",1990,0
8993240,Azad,2000,['India'],"['Action', 'Crime Fiction', 'Drama']",2000,0
12169608,Ben 10: Secret of the Omnitrix,2007,['United States of America'],"[""Children's/Family"", 'Doomsday film', 'Science Fiction', 'Fantasy']",2000,7
4199428,Babul,1950,['India'],"['Musical', 'Romantic drama', 'Bollywood', 'World cinema', 'Romance Film', 'Drama']",1950,0
20791313,Too Young to Kiss,1951,['United States of America'],"['Romance Film', 'Comedy']",1950,1
34429476,Aahvaanam,1997,['India'],['Drama'],1990,7
25998637,Cracked Ice,1938,[],"['Animation', 'Short Film', 'Family Film']",1930,8
18618306,Planet of the Apes,1968,['United States of America'],"['Science Fiction', 'Thriller', 'New Hollywood', 'Adventure', 'Cult']",1960,8
29891121,Jet Over the Atlantic,1959,['United States of America'],"['Action', 'Disaster']",1950,9
30640107,Makkalai Petra Maharasi,1957,['India'],"['Romance Film', 'Drama']",1950,7
2649257,Pride and Prejudice,1940,['United States of America'],"['Film adaptation', 'Black-and-white', 'Romance Film', 'Costume drama', 'Drama']",1940,0
11894802,Hard Cash,2002,['United States of America'],"['Action', 'Crime Fiction', 'Action/Adventure', 'Thriller', 'Crime Thriller', 'Adventure', 'Drama', 'Suspense', 'Heist']",2000,2
27128043,The Optimists,2006,"['Monaco', 'Spain', 'Switzerland', 'Serbia']","['Drama', 'World cinema']",2000,6
9384810,Beloved Infidel,1959,['United States of America'],"['Romantic drama', 'Biographical film', 'Biopic [feature]', 'Romance Film', 'Drama']",1950,9
2133173,The Boy in the Plastic Bubble,1976,['United States of America'],"['Romantic drama', 'Family Drama', 'Drama']",1970,6
4399341,Gamera: Guardian of the Universe,1995,['Japan'],"['Monster movie', 'Japanese Movies', 'World cinema']",1990,5
7398707,Breaking News,2004,['Hong Kong'],"['Action', 'Crime Fiction', 'Action/Adventure', 'World cinema', 'Chinese Movies', 'Martial Arts Film', 'Drama']",2000,4
2011090,Psycho IV: The Beginning,1990,['United States of America'],"['Psychological thriller', 'Crime Fiction', 'Mystery', 'Slasher', 'Thriller', 'Horror', 'Supernatural']",1990,0
29041460,This smells bad,2007,['Colombia'],"['Thriller', 'World cinema']",2000,7
14321288,3 Dumb Clucks,1937,['United States of America'],"['Short Film', 'Black-and-white']",1930,7
22739948,Fish Tank,2009,"['United Kingdom', 'Netherlands']","['Coming of age', 'Indie', 'Drama']",2000,9
7693015,The Tiger's Tail,2006,"['Ireland', 'United Kingdom']","['Psychological thriller', 'Mystery', 'Thriller', 'Black comedy', 'Comedy-drama', 'Drama']",2000,6
24061073,Northwest Trail,1945,['United States of America'],"['Western', 'Action/Adventure', 'Northern']",1940,5
2634175,Secret Honor,1984,['United States of America'],"['Political satire', 'Satire', 'Political drama', 'Drama']",1980,4
5566204,Mantrap,1926,['United States of America'],"['Black-and-white', 'Indie', 'Comedy', 'Silent film']",1920,6
6698176,48 Shades,2006,['Australia'],"['Indie', 'Coming of age', 'Comedy', 'Teen', 'Comedy-drama']",2000,6
28614987,My Dear Muthachan,1992,['India'],"['Mystery', 'Comedy', 'Drama']",1990,2
1630107,A Zed & Two Noughts,1985,"['United Kingdom', 'Netherlands']","['Surrealism', 'Avant-garde', 'Experimental film', 'Black comedy', 'Comedy-drama', 'Tragicomedy', 'Drama']",1980,5
24132780,The Girl Said No,1937,['United States of America'],"['Musical', 'Black-and-white', 'Comedy']",1930,7
15354287,The Kings of Appletown,2008,['United States of America'],"['Adventure', 'Comedy-drama']",2000,8
902225,Here Come the Littles,1985,"['Canada', 'Japan', 'France', 'United States of America']","['Animation', 'Japanese Movies', ""Children's""]",1980,5
31323938,The Divided Sky,1964,['German Democratic Republic'],"['Romance Film', 'Drama']",1960,4
328284,Doctor Who and the Curse of Fatal Death,1999,['United Kingdom'],"['Science Fiction', 'Comedy']",1990,9
1623500,No Holds Barred,1989,['United States of America'],['Action'],1980,9
33606762,O' Faaby,1993,['India'],"['Animation', 'Drama', 'Family Film']",1990,3
1854398,A King in New York,1957,"['United Kingdom', 'United States of America']","['Period piece', 'Black-and-white', 'Parody', 'Satire', 'Comedy', 'Comedy of manners', 'Drama']",1950,7
13594320,The Junior Defenders,2007,['United States of America'],"['Parody', 'Comedy', 'Fantasy']",2000,7
17128706,The Midnight Express,1924,['United States of America'],"['Silent film', 'Black-and-white', 'Drama']",1920,4
21870282,Cameron's Closet,1988,"['United Kingdom', 'United States of America']",['Horror'],1980,8
25011989,The Glass Web,1954,['United States of America'],"['Psychological thriller', 'Film noir', 'Thriller']",1950,4
2122364,The Black Sleep,1956,['United States of America'],"['Creature Film', 'Horror']",1950,6
20318189,Spanish Affair,1957,"['Spain', 'United States of America']","['Romantic drama', 'Thriller', 'Romance Film', 'Drama']",1950,7
3145964,"Yours, Mine and Ours",2005,['United States of America'],"['Romance Film', 'Comedy', 'Family Film']",2000,5
24583584,The Road to Romance,1927,[],['Silent film'],1920,7
4118332,The Land Before Time XI: Invasion of the Tinysauruses,2005,['United States of America'],"['Animated cartoon', 'Animation', ""Children's"", 'Adventure', 'Family Film', 'Fantasy']",2000,5
29890957,The Boss,1956,['United States of America'],"['Action', 'Western', 'Thriller', 'Film noir', 'Crime Thriller', 'Drama', 'Political thriller']",1950,6
8883100,Samurai Reincarnation,1981,[],"['Period piece', 'Samurai cinema', 'Fantasy']",1980,1
18383012,Beqasoor,1950,['India'],['Drama'],1950,0
12251889,Summerfield,1977,['Australia'],"['Mystery', 'Drama']",1970,7
574909,Alien Nation,1988,['United States of America'],"['Buddy film', 'Thriller', 'Science Fiction', 'Drama']",1980,8
13771001,Earth,2007,"['United Kingdom', 'Germany', 'United States of America']","['Indie', 'Documentary']",2000,7
6108184,Siddhartha,1972,"['India', 'United States of America']","['Period piece', 'Film adaptation', 'Mystery', 'Drama']",1970,2
34952964,Al Hamawat Al Fatenat,1953,['Egypt'],[],1950,3
33949342,Peach O'Reno,1931,['United States of America'],"['Romance Film', 'Comedy film']",1930,1
3640928,Between Two Worlds,1944,['United States of America'],"['Black-and-white', 'Fantasy']",1940,4
14204108,Double or Mutton,1955,['United States of America'],"['Animation', 'Short Film', 'Comedy', 'Family Film']",1950,5
35634057,Shaitaan,1974,['India'],"['Action', 'Drama', 'Crime Fiction', 'Thriller']",1970,4
21820310,Challenge,2009,['India'],"['Action', 'Drama', 'Comedy film']",2000,9
1015585,Glitter,2001,['United States of America'],"['Musical', 'Romantic drama', 'Romance Film', 'Drama']",2000,1
230536,Good Burger,1997,['United States of America'],"['Screwball comedy', 'Buddy film', 'Comedy', 'Teen', 'Stop motion', 'Family Film']",1990,7
20530049,Woody the Giant Killer,1947,['United States of America'],"['Animation', 'Short Film', 'Comedy', 'Family Film']",1940,7
1198597,The Blue Max,1966,"['United Kingdom', 'United States of America']","['War film', 'Drama']",1960,6
781934,Marvin's Room,1996,['United States of America'],"['Medical fiction', 'Family Drama', 'Drama']",1990,6
1974729,"Tarzan, the Ape Man",1981,['United States of America'],"['Action', 'Action/Adventure', 'Comedy', 'Adventure']",1980,1
4744645,Instinct,1999,['United States of America'],"['Psychological thriller', 'Film adaptation', 'Mystery', 'Thriller', 'Drama']",1990,9
11530657,The Heartbreak Kid,2007,['United States of America'],"['Romance Film', 'Romantic comedy', 'Comedy']",2000,7
4622101,Ika resuraa,2004,['Japan'],"['Comedy', 'Japanese Movies']",2000,4
31504552,Evils of the Night,1985,[],"['Slasher', 'Horror', 'Teen', 'Alien Film', 'Science Fiction']",1980,5
24043483,Raaj-The Showman,2009,['India'],['Action'],2000,9
2502451,Revolver,2005,"['Isle of Man', 'United Kingdom', 'France']","['Crime Fiction', 'Gangster Film', 'Thriller', 'Crime Thriller', 'Drama']",2000,5
28152060,The Romance of Betty Boop,1985,['United States of America'],['Short Film'],1980,5
4785973,The Thousand Eyes of Dr. Mabuse,1960,"['France', 'Germany', 'West Germany', 'Italy']","['Crime Fiction', 'Mystery', 'Thriller', 'World cinema', 'Crime Thriller']",1960,0
4257310,Dear Brigitte,1965,['United States of America'],"['Domestic Comedy', 'Comedy', 'Family Film']",1960,5
18312560,War Made Easy: How Presidents & Pundits Keep Spinning Us to Death,2007,['United States of America'],"['Political cinema', 'War film', 'Documentary']",2000,7
19389755,Asylum Seekers,2009,"['United Kingdom', 'United States of America']","['Mystery', 'Parody', 'Indie', 'Comedy', 'Thriller', 'Horror', 'Black comedy']",2000,9
25507665,The Caller,2008,['United States of America'],"['Psychological thriller', 'Thriller', 'Film noir', 'Crime Thriller']",2000,8
5392223,Cops and Robbersons,1994,['United States of America'],"['Action', 'Action/Adventure', 'Comedy', 'Domestic Comedy', 'Family Film']",1990,4
34324430,Samanyudu,2006,['India'],['Action'],2000,6
1017863,Velocity Trap,1997,['United States of America'],"['Action', 'Science Fiction', 'Adventure']",1990,7
3812366,The Great Outdoors,1988,['United States of America'],"['Comedy', 'Slapstick', 'Adventure', 'Family Film']",1980,8
31384712,Videsi Nair Swadesi Nair,2002,[],"['Drama', 'Comedy film']",2000,2
1915264,"Mirror, Mirror",1990,['United States of America'],"['Indie', 'Supernatural', 'Horror']",1990,0
1040632,Early Summer,1951,['Japan'],"['Art film', 'Japanese Movies', 'Family Drama', 'World cinema', 'Drama']",1950,1
52371,Titanic,1997,['United States of America'],"['Action/Adventure', 'Romantic drama', 'Romance Film', 'Disaster', 'Costume drama', 'Drama', 'Tragedy', 'Period piece', 'Historical fiction']",1990,7
8407658,Buckaroo Bugs,1944,[],"['Short Film', 'Animation']",1940,4
7993552,Herman U. S. A.,2001,['United States of America'],"['Indie', 'Comedy', 'Romance Film', 'Romantic comedy']",2000,1
9169723,I Can Get It for You Wholesale,1951,['United States of America'],"['Romance Film', 'Romantic drama', 'Drama']",1950,1
3692025,Putney Swope,1969,['United States of America'],"['Parody', 'Satire', 'Comedy', 'Media Satire']",1960,9
15461110,Hit the Saddle,1937,['United States of America'],"['B-Western', 'Black-and-white', 'Western']",1930,7
22644882,Angie,1993,['Netherlands'],"['Crime Fiction', 'Thriller']",1990,3
7192381,Animal,2005,['United States of America'],"['Drama', 'Crime Fiction']",2000,5
28839015,As Far as My Feet Will Carry Me,2001,['Germany'],"['Comedy', 'World cinema', 'War film', 'Drama']",2000,1
12918906,The Love Guru,2008,"['United Kingdom', 'Germany', 'United States of America']","['Parody', 'Comedy', 'Comedy of manners', 'Romantic comedy', 'Romance Film', 'Sports']",2000,8
28385470,The Last Lovecraft: Relic of Cthulhu,2009,['United States of America'],"['Indie', 'Comedy']",2000,9
3139727,The Crusades,1935,['United States of America'],"['Action', 'Black-and-white', 'Historical fiction', 'Epic', 'Costume drama', 'Adventure', 'Drama']",1930,5
24479263,Bright Lights,1925,[],['Silent film'],1920,5
13809726,Face of Evil,1996,['United States of America'],"['Psychological thriller', 'Crime Fiction', 'Thriller', 'Television movie', 'Drama']",1990,6
18008366,Silence of the Heart,1984,['United States of America'],"['Family Drama', 'Drama']",1980,4
10458631,Deathsport,1978,['United States of America'],"['Action', 'Action/Adventure', 'Indie', 'Horror', 'Adventure', 'Science Fiction']",1970,8
23432334,"In the Meantime, Darling",1944,['United States of America'],"['Comedy film', 'Domestic Comedy', 'Comedy-drama', 'War film', 'Drama']",1940,4
20812190,Backlash,1987,['Australia'],"['Drama', 'Crime Fiction']",1980,7
4498688,The Aftermath,1982,['United States of America'],"['Action', 'Indie', 'Thriller', 'Horror', 'Adventure', 'Zombie Film', 'Science Fiction']",1980,2
600235,Manhunter,1986,['United States of America'],"['Psychological thriller', 'Crime Fiction', 'Mystery', 'Thriller', 'Crime Thriller', 'Drama', 'Slasher', 'Detective']",1980,6
14884669,Disappearance,2002,['United States of America'],"['Suspense', 'Psychological thriller', 'Mystery', 'Thriller', 'Horror', 'Television movie', 'Supernatural']",2000,2
9362805,The Mad Monk,1993,['Hong Kong'],"['Chinese Movies', 'Comedy']",1990,3
1779669,The Millionairess,1960,['United Kingdom'],"['Romance Film', 'Romantic comedy', 'Comedy']",1960,0
2006607,Green for Danger,1946,['United Kingdom'],"['Black-and-white', 'Crime Fiction', 'Mystery', 'Thriller', 'Whodunit', 'Crime Thriller', 'Drama', 'War film']",1940,6
32406514,Une Ravissante Idiote,1964,['France'],"['Action', 'Spy', 'Action/Adventure', 'Comedy', 'World cinema', 'Comedy of Errors']",1960,4
22525391,Seminole,1953,['United States of America'],"['Action', 'Western']",1950,3
5748716,Return of the Seven,1966,"['Spain', 'United States of America']","['Action/Adventure', 'Western']",1960,6
18067106,Fast and Loose,1930,['United States of America'],"['Romantic comedy', 'Black-and-white']",1930,0
5045608,The Kid Brother,1927,['United States of America'],"['Black-and-white', 'Crime Fiction', 'Indie', 'Comedy', 'Silent film']",1920,7
5034380,Georgia Rule,2007,['United States of America'],"['Family Drama', 'Romantic drama', 'Comedy', 'Romance Film', 'Melodrama', 'Comedy-drama', 'Drama']",2000,7
7010485,The Book of the Dead,2005,['Japan'],"['Animation', 'Japanese Movies', 'Romantic drama', 'World cinema', 'Anime', 'Stop motion', 'Drama']",2000,5
10100595,Junior G-Men of the Air,1942,['United States of America'],"['Action', 'Spy', 'Black-and-white', 'Action/Adventure', 'Adventure', 'War film']",1940,2
4260440,The Starfighters,1964,['United States of America'],"['Action', 'Drama']",1960,4
3585867,Bring It On: All or Nothing,2006,['United States of America'],"['Sports', 'Comedy', 'Teen']",2000,6
22516313,The Aryan Couple,2004,"['United Kingdom', 'United States of America']","['Period piece', 'Political drama', 'Drama']",2000,4
4829197,Thunder,1929,['United States of America'],"['Black-and-white', 'Indie', 'Silent film', 'Melodrama', 'Drama']",1920,9
4843251,Lakshya,2004,['India'],"['Musical', 'Action/Adventure', 'Bollywood', 'World cinema', 'Romance Film', 'War film', 'Drama']",2000,4
27960942,Silly Scandals,1931,['United States of America'],"['Animation', 'Short Film', 'Comedy', 'Family Film']",1930,1
8947921,The Male Animal,1942,['United States of America'],"['Romance Film', 'Comedy']",1940,2
250571,Duel,1971,['United States of America'],"['Road movie', 'Mystery', 'Thriller']",1970,1
6943287,The Tall Men,1955,['United States of America'],"['Action/Adventure', 'Western']",1950,5
19138342,Nasty Boys,1989,['United States of America'],['Drama'],1980,9
17430659,Black Widow,2008,['United States of America'],"['Crime Fiction', 'Mystery', 'Thriller', 'Television movie']",2000,8
33332910,Parda Hai Parda,1992,[],"['Action', 'Drama', 'Comedy film']",1990,2
12418337,Aarilirunthu Arubathu Varai,1979,['India'],['World cinema'],1970,9
1152156,Juliet of the Spirits,1965,"['France', 'Germany', 'Italy']","['Art film', 'Marriage Drama', 'Comedy', 'World cinema', 'Comedy-drama', 'Drama']",1960,5
28604095,Mickey's Mix-Up,1929,['United States of America'],['Short Film'],1920,9
12212748,Bleach: The DiamondDust Rebellion,2007,['Japan'],"['Action', 'Animation', 'Thriller', 'Adventure', 'Japanese Movies', 'Horror', 'Anime', 'Science Fiction']",2000,7
4429283,Hondo,1953,['United States of America'],"['Action/Adventure', 'Western']",1950,3
5634338,Boogiepop and Others,2000,['Japan'],"['Animation', 'Japanese Movies', 'Thriller', 'Anime', 'Fantasy']",2000,0
28072745,Outpost in Morocco,1949,['United States of America'],"['Action', 'Combat Films', 'Action/Adventure', 'Adventure', 'Romance Film']",1940,9
1236447,Dumb & Dumberer: When Harry Met Lloyd,2003,['United States of America'],"['Screwball comedy', 'Buddy film', 'Comedy', 'Teen', 'Slapstick']",2000,3
8849588,The Prime Gig,2000,['United States of America'],"['Crime Fiction', 'Indie', 'Romantic drama', 'Romance Film', 'Drama']",2000,0
28966924,Saptapadi telugu film,1981,['India'],"['Musical', 'Drama', 'Family Film']",1980,1
772732,Taking Lives,2004,"['United States of America', 'Australia']","['Psychological thriller', 'Film adaptation', 'Mystery', 'Thriller', 'Crime Thriller', 'Drama', 'Slasher', 'Erotica']",2000,4
1458772,Muppets from Space,1999,"['United Kingdom', 'United States of America']","[""Children's Fantasy"", 'Comedy', ""Children's/Family"", 'Adventure', 'Family Film', 'Fantasy']",1990,9
24896930,L'Or dans la rue,1935,['France'],['Comedy'],1930,5
164698,Reign of Fire,2002,"['United Kingdom', 'Ireland', 'United States of America']","['Action', 'Fantasy Adventure', 'Action/Adventure', 'Thriller', 'Disaster', 'Adventure', 'Creature Film', 'Doomsday film', 'Science Fiction', 'Fantasy']",2000,2
7731090,9/Tenths,2006,['United States of America'],"['Indie', 'Drama']",2000,6
2621781,Love on a Diet,2001,"['Hong Kong', 'China', 'Japan']","['Romantic drama', 'Comedy', 'World cinema', 'Romance Film', 'Chinese Movies', 'Drama', 'Japanese Movies', 'Romantic comedy']",2000,1
26923633,Akale,2004,['India'],['Drama'],2000,4
9959871,Angels in America,2003,[],"['Gay Themed', 'Gay', 'Gay Interest', 'Fantasy', 'Drama', 'Ensemble Film']",2000,3
21526236,A Matter of Dignity,1957,['Greece'],"['Family Drama', 'Drama', 'World cinema']",1950,7
9571945,The Omega Code,1999,['United States of America'],"['Action', 'Mystery', 'Indie', 'Thriller', 'Christian film', 'Adventure', 'Drama', 'Suspense', 'Melodrama', 'Supernatural']",1990,9
180785,Ring,1998,['Japan'],"['Mystery', 'Japanese Movies', 'Horror']",1990,8
365905,Babes in Toyland,1934,['United States of America'],"['Music', 'Musical', 'Comedy', ""Children's"", 'Christmas movie', 'Drama', 'Stop motion', 'Family Film', 'Fantasy']",1930,4
197558,"Monsters, Inc.",2001,['United States of America'],"['Animation', 'Educational', 'Comedy', ""Children's/Family"", 'Adventure', 'Computer Animation', 'Creature Film', 'Fantasy Comedy', 'Family Film', 'Fantasy']",2000,1
33740907,And Then There Were None,1945,['United States of America'],"['Action', 'Suspense', 'Mystery', 'Action/Adventure', 'Thriller', 'Film noir', 'Crime Thriller']",1940,5
5735156,The Cat and the Canary,1927,"['United Kingdom', 'United States of America']","['Black-and-white', 'Crime Fiction', 'Mystery', 'Comedy', 'Thriller', 'Crime Thriller', 'Drama', 'Horror', 'Silent film']",1920,7
10002175,Our very own,2005,['United States of America'],"['Coming of age', 'Indie', 'Drama']",2000,5
19887961,Agora,2009,['Spain'],"['World cinema', 'Christian film', 'Romance Film', 'Adventure', 'Drama', 'Period piece', 'History', 'Historical Epic', 'Epic']",2000,9
24726441,The Act of the Heart,1970,['Canada'],"['Romance Film', 'Melodrama', 'Drama']",1970,0
9897840,The Night of the Iguana,1964,['United States of America'],"['Film adaptation', 'LGBT', 'Black-and-white', 'Romantic drama', 'Romance Film', 'Drama']",1960,4
4232814,In Hell,2003,['United States of America'],"['Action', 'Prison', 'Crime Fiction', 'Action/Adventure', 'Thriller', 'Martial Arts Film', 'Drama']",2000,3
74956,The Miracle of Morgan's Creek,1944,['United States of America'],"['Black-and-white', 'Screwball comedy', 'Satire', 'Comedy', 'Romance Film', 'Comedy of Errors', 'Parody', 'Romantic comedy']",1940,4
24828637,Avakai Biryani,2008,['India'],"['Romance Film', 'Drama', 'Family Film']",2000,8
24281921,Dalaal,1993,['India'],['Bollywood'],1990,3
33608894,Blood River,2009,['United States of America'],"['Psychological thriller', 'Suspense', 'Western', 'Thriller', 'Horror', 'Crime Thriller']",2000,9
213413,In the Mood for Love,2000,"['France', 'Hong Kong']","['Romantic drama', 'World cinema', 'Romance Film', 'Chinese Movies', 'Drama']",2000,0
11956773,People I Know,2002,"['Germany', 'United States of America']","['Film à clef', 'Crime Fiction', 'Indie', 'Political drama', 'Drama']",2000,2
1757150,Phantom Lady,1944,['United States of America'],"['Psychological thriller', 'Black-and-white', 'Crime Fiction', 'Mystery', 'Thriller', 'Film noir', 'Drama']",1940,4
8272243,The Genius Club,2006,['United States of America'],"['Psychological thriller', 'Drama', 'Indie', 'Thriller', 'Christian film', 'Crime Thriller', 'Political thriller']",2000,6
29230838,Intent to Kill,1958,['United Kingdom'],"['Thriller', 'Drama']",1950,8
25336781,Prison of Secrets,1997,['United States of America'],"['Prison', 'Crime Fiction', 'Drama']",1990,7
27365295,Hell Boats,1970,['United States of America'],"['Combat Films', 'Adventure']",1970,0
1626038,Raja Hindustani,1996,['India'],"['Romantic drama', 'Bollywood', 'World cinema', 'Romance Film', 'Drama']",1990,6
25648285,The Burning Season,1994,['United States of America'],"['Drama', 'Biographical film']",1990,4
12579895,It Grows on Trees,1952,['United States of America'],"['Black-and-white', 'Comedy', 'Fantasy']",1950,2
8386833,The Devil at 4 O'Clock,1961,['United States of America'],"['Action', 'Drama', 'Action/Adventure', 'Adventure', 'Disaster']",1960,1
1332050,First Daughter,1999,['United States of America'],"['Action', 'Thriller', 'Comedy film', 'Romance Film']",1990,9
13806284,My First Wedding,2006,"['Canada', 'United Kingdom']","['Comedy', 'Romance Film', 'Romantic comedy', 'Comedy of Errors']",2000,6
4527254,The Sins of the Children,1930,['United States of America'],"['Black-and-white', 'Drama']",1930,0
17816459,I've Loved You So Long,2008,"['United Kingdom', 'France', 'Germany']","['Mystery', 'Drama', 'World cinema']",2000,8
4366908,Les temps qui changent,2006,['France'],"['LGBT', 'Romantic drama', 'World cinema', 'Romance Film', 'Drama']",2000,6
25783621,James A. Michener's Texas,1995,['United States of America'],"['Historical Epic', 'Historical fiction']",1990,5
264176,Hackers,1995,['United States of America'],"['Action', 'Crime Fiction', 'Action/Adventure', 'Comedy', 'Thriller', 'Teen', 'Crime Thriller', 'Cult', 'Drama', 'Suspense']",1990,5
3325423,My Neighbors the Yamadas,1999,['Japan'],"['Animation', 'Japanese Movies', 'Comedy', 'Domestic Comedy', 'Anime', ""Children's"", 'Family Film']",1990,9
28678178,Broken Blossoms,1936,['United Kingdom'],"['Romance Film', 'Drama']",1930,6
8007011,Money,1991,"['Netherlands', 'Canada', 'France', 'Italy']","['Crime Fiction', 'Thriller', 'World cinema', 'Crime Thriller', 'Drama']",1990,1
9502327,Hors de prix,2006,['France'],"['Romantic drama', 'Comedy', 'World cinema', 'Romance Film', 'Romantic comedy', 'Drama']",2000,6
2798740,Two-Dollar Bettor,1951,['United States of America'],"['Black-and-white', 'Drama']",1950,1
23902011,Uncorked,2009,['United States of America'],['Romance Film'],2000,9
28848113,Yoga Hakwon,2009,['South Korea'],['Horror'],2000,9
12642729,City Girl,1930,['United States of America'],"['Black-and-white', 'Indie', 'Silent film', 'Romance Film', 'Drama']",1930,0
35790652,Ponmanam,1998,['India'],['Drama'],1990,8
9842327,Nomad,1982,['Hong Kong'],['Chinese Movies'],1980,2
25361474,Prince Valiant,1997,"['United Kingdom', 'Germany', 'Ireland']","['Indie', 'Sword and sorcery']",1990,7
3300749,Touch,1997,['United States of America'],"['Parody', 'Satire', 'Comedy', 'Romance Film', 'Romantic comedy']",1990,7
5614173,Our Lips Are Sealed,2000,['United States of America'],"['Comedy', 'Thriller', 'Teen', ""Children's/Family"", 'Adventure', 'Chase Movie', 'Comedy Thriller', 'Family Film']",2000,0
23780258,Necromentia,2009,['United States of America'],['Horror'],2000,9
9600368,The Black Room,1935,['United States of America'],"['Black-and-white', 'Crime Fiction', 'Horror']",1930,5
18227035,Dhoondte Reh Jaaoge,2009,['India'],"['Musical', 'Comedy', 'Bollywood', 'World cinema']",2000,9
15018795,Where Have All The People Gone?,1974,['United States of America'],"['Science Fiction', 'Apocalyptic and post-apocalyptic fiction']",1970,4
4382512,Hood of the Living Dead,2005,['United States of America'],"['Creature Film', 'Zombie Film', 'Horror']",2000,5
8174590,Captain January,1936,['United States of America'],"['Musical', 'Black-and-white', 'Comedy', 'Drama', 'Family Film']",1930,6
6721185,Go Fish,1994,['United States of America'],"['Black-and-white', 'LGBT', 'Indie', 'Drama', 'Comedy', 'Romance Film', 'Romantic comedy']",1990,4
8382241,Bidasari,1965,"['Singapore', 'Malaysia']",['Romantic drama'],1960,5
5989816,Unidentified,2006,['United States of America'],"['Indie', 'Christian film', 'Science Fiction', 'Drama', 'Fantasy']",2000,6
8625061,Chitram,2000,['India'],['Romance Film'],2000,0
7306824,The Big Tease,2000,"['United Kingdom', 'United States of America']","['LGBT', 'Indie', 'Comedy', 'Mockumentary']",2000,0
1456002,Road to Rio,1947,['United States of America'],"['Adventure Comedy', 'Musical', 'Action', 'Action/Adventure', 'Buddy film', 'Comedy', 'Romance Film', 'Adventure', 'Romantic comedy']",1940,7
9779574,The Scarlet Pimpernel,1934,['United Kingdom'],"['Action', 'Film adaptation', 'Black-and-white', 'Action/Adventure', 'Comedy', 'Costume drama', 'Adventure', 'Drama', 'Swashbuckler films']",1930,4
26296937,The Struggle,1931,['United States of America'],['Drama'],1930,1
7271954,Blood and Chocolate,2007,"['United Kingdom', 'Germany', 'Romania', 'United States of America']","['Creature Film', 'Crime Fiction', 'Romantic drama', 'Teen', 'Horror', 'Romance Film', 'Drama']",2000,7
2367984,Absolute Beginners,1986,"['United Kingdom', 'England']","['Musical', 'Film adaptation', 'Teen', 'Romance Film', 'Drama', 'Period piece', 'Coming of age', 'Fantasy']",1980,6
30186271,The Last Exploits of the Olsen Gang,1974,['Denmark'],"['Comedy film', 'Crime Fiction']",1970,4
3748842,Skipped Parts,2001,['United States of America'],"['Indie', 'Romantic drama', 'Comedy', 'Teen', 'Romance Film', 'Drama', 'Period piece', 'Coming of age', 'Romantic comedy', 'Comedy-drama']",2000,1
31510651,The Great Smokey Roadblock,1977,['United States of America'],"['Action', 'Adventure Comedy', 'Action/Adventure', 'Comedy', 'Road movie']",1970,7
26587965,"Katha, Samvidhanam: Kunchacko",2009,['India'],"['Thriller', 'Drama']",2000,9
1862671,Bullet in the Head,1990,['Hong Kong'],"['Action', 'Gangster Film', 'Action/Adventure', 'Thriller', 'World cinema', 'Chinese Movies', 'War film']",1990,0
2542946,When Trumpets Fade,1998,['United States of America'],"['Combat Films', 'War film', 'Drama']",1990,8
3745527,Hellraiser: Hellworld,2005,"['Romania', 'United States of America']","['Slasher', 'Horror', 'Supernatural', 'Cult']",2000,5
1879413,Troop Beverly Hills,1989,['United States of America'],"['Family Film', 'Comedy', 'Comedy of manners']",1980,9
3037946,A Nightmare on Elm Street 3: Dream Warriors,1987,['United States of America'],"['Slasher', 'Teen', 'Horror', 'Supernatural']",1980,7
28432402,Kiss the Bride Goodbye,1945,[],"['Romance Film', 'Drama', 'Comedy film']",1940,5
31934326,Behind the Mask,1992,[],['Action'],1990,2
23632278,Bunny and The Bull,2009,['United Kingdom'],"['Indie', 'Comedy', 'Romance Film', 'Romantic comedy']",2000,9
27382757,Beyond a Reasonable Doubt,2009,['United States of America'],"['Mystery', 'Thriller', 'Remake', 'Crime Thriller', 'Drama', 'Courtroom Drama']",2000,9
5773944,Molly: An American Girl on the Home Front,2006,[],"['Period piece', 'Family Drama', 'Television movie', ""Children's/Family"", 'Drama', 'Family Film']",2000,6
3831954,Dust,2001,"['Republic of Macedonia', 'United Kingdom', 'Germany', 'Italy']","['Period piece', 'Romantic drama', 'Western', 'Action/Adventure', 'Romance Film', 'Drama']",2000,1
35978329,The Singing Vagabond,1935,['United States of America'],['Western'],1930,5
31601544,Then Nilavu,1961,['India'],['Romance Film'],1960,1
35735268,At the End of the Rainbow,1965,['United States of America'],"['Adventure', ""Children's"", 'Family Film', 'Fantasy']",1960,5
13489189,Sex and Zen II,1996,['Hong Kong'],['Chinese Movies'],1990,6
12034233,Deathstalker 2,1987,"['Argentina', 'United States of America']","['Action/Adventure', 'Science Fiction', 'Sword and sorcery', 'Adventure', 'Fantasy']",1980,7
25490826,Follow the Stars Home,2001,['United States of America'],"['Film adaptation', 'Romantic drama', 'Romance Film', 'Melodrama', 'Television movie', 'Drama', 'Family Film']",2000,1
6135756,Time Slip,1979,['Japan'],"['Samurai cinema', 'Japanese Movies', 'Action/Adventure', 'World cinema', 'Martial Arts Film']",1970,9
2949735,Angels in the Outfield,1951,['United States of America'],"['Comedy', 'Sports', 'Family Film', 'Fantasy']",1950,1
16079090,Just Heroes,1989,['Hong Kong'],"['Action', 'Crime Fiction', 'Gangster Film', 'Crime Drama', 'Chinese Movies']",1980,9
3796734,The Inheritance,2003,"['Denmark', 'Sweden', 'United Kingdom', 'Norway']","['Drama', 'World cinema']",2000,3
27877448,Stage Struck,1925,['United States of America'],"['Silent film', 'Comedy']",1920,5
32722745,La-La Loco Baby,2008,['United States of America'],['Short Film'],2000,8
2400759,The Shootist,1976,['United States of America'],"['Revisionist Western', 'Action/Adventure', 'Western', 'Drama']",1970,6
31470322,Thampu,1978,['India'],['Documentary'],1970,8
12575892,The Day the World Ended,2001,['United States of America'],"['Television movie', 'Science Fiction', 'Horror']",2000,1
594105,Mr Deeds,2002,['United States of America'],"['Comedy', 'Remake', 'Romance Film', 'Romantic comedy', 'Slapstick']",2000,2
14828868,Stingaree,1934,['United States of America'],"['Romance Film', 'Comedy', 'Drama']",1930,4
67415,Hard to Kill,1990,"['United Kingdom', 'Germany', 'United States of America']","['Action', 'Action Thrillers', 'Action/Adventure', 'Thriller', 'Martial Arts Film']",1990,0
6857245,Roman-Legion Hare,1955,['United States of America'],"['Animation', 'Short Film', 'Comedy', 'Family Film']",1950,5
7487699,Betty Boop's Hallowe'en Party,1933,['United States of America'],"['Musical', 'Animation', 'Short Film', 'Horror', 'Family Film']",1930,3
2699610,Dead Man on Campus,1998,['United States of America'],"['Stoner film', 'Comedy', 'Comedy film', 'Black comedy']",1990,8
12135919,Tell No One,2006,['France'],"['Psychological thriller', 'Crime Fiction', 'Mystery', 'Thriller', 'World cinema', 'Drama']",2000,6
735240,Agent Cody Banks 2: Destination London,2004,"['United Kingdom', 'United States of America']","['Action', 'Spy', 'Action/Adventure', 'Comedy', 'Family-Oriented Adventure', ""Children's/Family"", 'Adventure', 'Family Film']",2000,4
18195326,Life is Cool,2008,['South Korea'],['Romance Film'],2000,8
30685656,Dancing Mothers,1926,['United States of America'],['Silent film'],1920,6
4499436,Way Down East,1920,['United States of America'],"['Black-and-white', 'Indie', 'Action/Adventure', 'Romantic drama', 'Romance Film', 'Drama', 'Western', 'Silent film']",1920,0
6799781,Simón del desierto,1965,['Mexico'],"['Surrealism', 'Art film', 'History', 'Satire', 'Comedy', 'World cinema', 'Drama']",1960,5
11770301,Cry of Battle,1963,['United States of America'],"['Action', 'Black-and-white', 'Indie', 'War film', 'Adventure', 'Drama']",1960,3
5525737,Shrieker,1998,['United States of America'],"['Creature Film', 'Supernatural', 'Horror']",1990,8
451898,The Hot Spot,1990,['United States of America'],"['Psychological thriller', 'Neo-noir', 'Film adaptation', 'Thriller', 'Romance Film', 'Drama']",1990,0
22290050,Curiosity,2009,['United Kingdom'],"['Short Film', 'Thriller', 'Horror']",2000,9
32959358,Forsaking All Others,1922,[],['Silent film'],1920,2
8641297,Ice Station Zebra,1968,['United States of America'],"['Cold War', 'Action', 'Spy', 'Action/Adventure', 'Thriller', 'Drama']",1960,8
5671546,Friends,2001,['India'],"['Comedy', 'Tamil cinema', 'Romance Film', 'Drama']",2000,1
29617628,Novemberinte Nashtam,1982,['India'],['Drama'],1980,2
5628441,Snake Eater,1989,['Canada'],"['Action', 'Crime Fiction', 'Action/Adventure', 'Thriller']",1980,9
2624370,Why Would I Lie?,1980,['United States of America'],"['Romance Film', 'Comedy', 'Drama']",1980,0
15531705,Ma fille mon ange,2007,['Canada'],['Thriller'],2000,7
8078672,Begin the Beguine,1982,['Spain'],"['Romance Film', 'Melodrama', 'Drama']",1980,2
10640559,Khoon Ka Karz,1991,['India'],"['Action', 'Crime Fiction', 'Drama']",1990,1
13112145,Running Wild,1992,['South Africa'],"['Family Drama', 'Television movie', 'Family Film', 'Adventure', 'Drama']",1990,2
4893170,The Dogs of War,1981,"['United Kingdom', 'United States of America']","['Action', 'Action/Adventure', 'War film']",1980,1
10385898,Seven Days to Noon,1950,['United Kingdom'],"['Psychological thriller', 'Black-and-white', 'Thriller', 'Doomsday film', 'Drama', 'Political thriller']",1950,0
957631,Tanga,1987,['Brazil'],['Comedy'],1980,7
6120213,"Bon Cop, Bad Cop",2006,['Canada'],"['Action', 'Crime Fiction', 'Action/Adventure', 'Buddy film', 'Thriller', 'Comedy']",2000,6
11715767,The Legend of Seven Cutter,2006,['South Korea'],['Comedy'],2000,6
23601212,The Spy with My Face,1965,['United States of America'],"['Action', 'Spy', 'Adventure']",1960,5
18076569,Kambakth Ishq,2008,['India'],"['Musical', 'Romantic drama', 'Bollywood', 'World cinema', 'Romance Film', 'Drama']",2000,8
1381474,The Belles of St Trinian's,1954,['United Kingdom'],['Comedy'],1950,4
35229702,Linda,1993,['United States of America'],"['Drama', 'Crime Fiction', 'Thriller']",1990,3
11584672,APT,2006,['South Korea'],"['Psychological thriller', 'Horror']",2000,6
2709182,Murder at 1600,1997,['United States of America'],"['Action', 'Crime Fiction', 'Mystery', 'Action/Adventure', 'Thriller', 'Whodunit', 'Crime Thriller', 'Drama', 'Political drama', 'Political thriller']",1990,7
11500423,When I Was a Singer,2005,['France'],"['Musical', 'Romance Film', 'Drama']",2000,5
2069002,Action Jackson,1988,['United States of America'],"['Action', 'Crime Fiction', 'Indie', 'Action/Adventure', 'Comedy', 'Thriller', 'Drama', 'Chase Movie']",1980,8
7870124,The Lion in Winter,1968,['United Kingdom'],"['Film adaptation', 'LGBT', 'Biography', 'Historical drama', 'Costume drama', 'Drama', 'Period piece', 'Epic', 'Political drama']",1960,8
25818705,Última Parada 174,2008,['Brazil'],"['Drama', 'World cinema']",2000,8
15253513,Be My Wife,1921,['United States of America'],"['Silent film', 'Black-and-white']",1920,1
8448870,Kaagaz Ke Phool,1959,['India'],"['Musical', 'Bollywood', 'World cinema', 'Drama']",1950,9
374885,Moscow on the Hudson,1984,['United States of America'],"['Romantic drama', 'Comedy', 'Comedy of manners', 'Romance Film', 'Comedy-drama', 'Drama']",1980,4
35382704,Summer School Teachers,1974,['United States of America'],['Thriller'],1970,4
25990814,Belle's Tales of Friendship,1999,['United States of America'],[],1990,9
2439425,Mondays In The Sun,2002,"['France', 'Spain', 'Italy']","['World cinema', 'Social problem film', 'Drama', 'Ensemble Film']",2000,2
919013,Two for the Road,1967,['United Kingdom'],"['Romantic drama', 'Comedy', 'Romance Film', 'Drama', 'Road movie', 'Existentialism', 'Marriage Drama', 'Romantic comedy', 'Comedy-drama']",1960,7
35171008,Sollamale,1998,[],['Romance Film'],1990,8
11716156,Flatland,2007,['United States of America'],"['Indie', 'Satire', 'Fantasy', 'Science Fiction', 'Computer Animation']",2000,7
948784,Bubble Boy,2001,['United States of America'],"['Gross out', 'Gross-out film', 'Comedy', 'Teen', 'Romance Film', 'Adventure', 'Drama', 'Romantic comedy', 'Road movie']",2000,1
1055920,Silent Fall,1994,['United States of America'],"['Psychological thriller', 'Mystery', 'Thriller', 'Drama']",1990,4
16975168,Urduja,2008,['Philippines'],['War film'],2000,8
7936237,Deadly Visions,2004,['United States of America'],"['Thriller', 'Television movie', 'Supernatural', 'Fantasy']",2000,4
24028019,Devil of the Desert Against the Son of Hercules,1964,"['France', 'Spain', 'Italy']","['Action', 'Adventure', 'Science Fiction', 'Fantasy']",1960,4
6086348,Film Geek,2006,['United States of America'],"['Workplace Comedy', 'Indie', 'Comedy']",2000,6
7523896,The World in His Arms,1952,['United States of America'],"['Action', 'Action/Adventure', 'Adventure', 'Romance Film']",1950,2
4523010,Strange Invaders,1983,['United States of America'],"['Mystery', 'Parody', 'Comedy', 'Science Fiction']",1980,3
454223,Pretty in Pink,1986,['United States of America'],"['Romantic drama', 'Comedy', 'Teen', 'Romance Film', 'Drama', 'Coming of age', 'Romantic comedy', 'Comedy-drama']",1980,6
5689382,Tit for Tat,1935,['United States of America'],"['Short Film', 'Black-and-white', 'Comedy']",1930,5
3966684,Miss Potter,2006,"['United Kingdom', 'United States of America']","['Biography', 'Romantic drama', 'Biographical film', 'Romance Film', 'Costume drama', 'Drama', 'Period piece', 'Biopic [feature]']",2000,6
76383,The Ten Commandments,1956,['United States of America'],"['Remake', 'Christian film', 'Roadshow theatrical release', 'Costume drama', 'Adventure', 'Drama', 'History', 'Epic']",1950,6
17975732,Hari Puttar - A Comedy Of Terrors,2008,['India'],['Comedy'],2000,8
10895416,Kismet,1955,['United States of America'],"['Musical', 'Romance Film']",1950,5
1643035,Valiant,2005,"['United Kingdom', 'United States of America']","['Computer Animation', 'Animation', 'Comedy', 'Family-Oriented Adventure', ""Children's/Family"", 'Adventure', 'Family Film']",2000,5
6507424,Stacy,2001,['Japan'],"['Japanese Movies', 'Comedy', 'Horror', 'World cinema', 'Zombie Film']",2000,1
5519614,Samar,1999,['India'],['Drama'],1990,9
4032170,Milk Money,1994,['United States of America'],"['Crime Fiction', 'Comedy', 'Romantic comedy', 'Romance Film']",1990,4
21036936,Thali Bhagyam,1966,['India'],[],1960,6
12035515,Fellowship of the Dice,2005,['United States of America'],"['Indie', 'Parody', 'Comedy', 'Mockumentary']",2000,5
4684910,The Last Shot,2004,['United States of America'],"['Action', 'Crime Fiction', 'Comedy', 'Crime Comedy', 'Comedy of Errors']",2000,4
8260298,The Angrez,2006,['India'],"['Comedy', 'World cinema']",2000,6
15945267,Avatar,2004,['Singapore'],"['Science Fiction', 'Adventure', 'Thriller']",2000,4
1694467,The Hairdresser's Husband,1990,['France'],"['Romantic drama', 'World cinema', 'Romance Film', 'Romantic comedy', 'Comedy-drama', 'Drama']",1990,0
4459184,Scooby-Doo and the Ghoul School,1988,['United States of America'],"[""Children's Fantasy"", ""Children's/Family"", 'Fantasy Comedy', 'Fantasy']",1980,8
10604572,Rebel Intruders,1980,['Hong Kong'],"['Action', 'Martial Arts Film']",1980,0
26996441,The Prince,1996,['India'],"['Action', 'Thriller']",1990,6
19554890,The Thaw,2009,"['Canada', 'United States of America']","['Creature Film', 'Science Fiction', 'Thriller', 'Horror', 'Sci-Fi Horror']",2000,9
2526868,KISS Meets the Phantom of the Park,1978,['United States of America'],"['Musical', 'Television movie', 'Science Fiction', 'Cult']",1970,8
22949552,Welcome to 18,1986,['United States of America'],"['Coming of age', 'Indie', 'Comedy', 'Drama']",1980,6
80533,Johnny Belinda,1948,['United States of America'],['Drama'],1940,8
464883,Miracle,2004,['United States of America'],"['Period piece', 'Sports', 'Drama']",2000,4
12525687,Dead End Drive-In,1986,"['New Zealand', 'Australia']","['Action', 'Action/Adventure', 'Thriller', 'Horror', 'World cinema', 'Science Fiction', 'Drama']",1980,6
882893,4D Man,1959,['United States of America'],"['Indie', 'Horror', 'Sci-Fi Horror', 'Science Fiction']",1950,9
21859735,High Season,1988,['United Kingdom'],"['Parody', 'Comedy', 'Romance Film', 'Romantic comedy']",1980,8
6086631,Lucky Numbers,2000,"['France', 'United States of America']","['Comedy', 'Crime Fiction']",2000,0
10059008,Silent Scream,2005,['United States of America'],"['Indie', 'Slasher', 'Horror']",2000,5
11912430,The Ship That Died of Shame,1955,['United Kingdom'],"['Action', 'Black-and-white', 'Crime Fiction', 'Crime Thriller', 'Adventure', 'Drama', 'War film', 'Fantasy']",1950,5
8276181,Forget Paris,1995,['United States of America'],"['Romantic drama', 'Comedy', 'Romance Film', 'Romantic comedy', 'Comedy-drama', 'Drama']",1990,5
5906390,The Groomsmen,2006,['United States of America'],"['Indie', 'Comedy', 'Romance Film', 'Romantic comedy', 'Comedy-drama', 'Ensemble Film']",2000,6
13911381,Frozen,2007,['India'],"['Black-and-white', 'Drama', 'World cinema']",2000,7
7625729,Look What's Happened to Rosemary's Baby,1976,['United States of America'],"['Supernatural', 'Horror']",1970,6
12976274,Der Andere,1930,['Germany'],"['Drama', 'Crime Fiction']",1930,0
19862695,Friends 'Til the End,1997,['United States of America'],['Drama'],1990,7
3448460,Caffeine,2006,['United States of America'],"['Workplace Comedy', 'Indie', 'Comedy', 'Romance Film', 'Romantic comedy', 'Ensemble Film']",2000,6
29458938,Thirumanassu,1995,[],['Drama'],1990,5
12404999,The Lonely Trail,1936,['United States of America'],"['Action', 'Black-and-white', 'Drama', 'Western']",1930,6
2241567,Barsaat,1949,['India'],"['Musical', 'Romantic drama', 'Bollywood', 'World cinema', 'Romance Film', 'Drama']",1940,9
2394008,Stuart Little,1999,"['Germany', 'United States of America']","[""Children's Fantasy"", 'Comedy', 'Animal Picture', ""Children's/Family"", 'Adventure', 'Family Film', 'Fantasy']",1990,9
6469778,Warning Shadows,1923,"['Weimar Republic', 'Germany']","['Black-and-white', 'Drama', 'Indie', 'Horror', 'World cinema', 'Silent film']",1920,3
1223435,Face to Face,1976,['Sweden'],"['Art film', 'World cinema', 'Drama', 'Fantasy']",1970,6
932171,Brainscan,1994,"['United Kingdom', 'United States of America', 'Canada']","['Teen', 'Horror', 'Sci-Fi Horror', 'Science Fiction', 'Fantasy']",1990,4
10914021,Golden Door,2006,"['France', 'Italy']","['Romantic drama', 'World cinema', 'Romance Film', 'Adventure', 'Drama', 'Fantasy']",2000,6
5276740,Les Nuits de la pleine lune,1984,['France'],"['Romantic drama', 'Comedy of manners', 'World cinema', 'Romance Film', 'Comedy-drama', 'Drama']",1980,4
1304346,When the Last Sword Is Drawn,2003,['Japan'],"['Japanese Movies', 'Action/Adventure', 'World cinema', 'Martial Arts Film', 'Drama']",2000,3
1169305,Okinawa Rendez-vous,2000,['Hong Kong'],"['Romantic drama', 'Thriller', 'World cinema', 'Romance Film', 'Chinese Movies', 'Drama']",2000,0
19953789,Cop Hater,1958,['United States of America'],"['Crime Fiction', 'Mystery', 'Drama']",1950,8
14734284,Everybody Loves Sunshine,1999,['United Kingdom'],"['Crime Fiction', 'Gangster Film', 'Thriller', 'Crime Thriller']",1990,9
9107926,Achuvinte Amma,2005,['India'],"['Comedy', 'Drama', 'Family Film']",2000,5
6313273,The Elementary Particles,2006,['Germany'],"['Coming of age', 'Romance Film', 'Comedy-drama', 'Tragicomedy', 'Drama']",2000,6
2981197,Down to You,2000,['United States of America'],"['Comedy', 'Teen', 'Romance Film', 'Romantic comedy', 'Drama']",2000,0
9622584,Blonde and Blonder,2008,['Canada'],"['Action', 'Action/Adventure', 'Comedy', 'Comedy-drama']",2000,8
33233116,The National Tree,2009,['United States of America'],"['Family Drama', 'Television movie', 'Family Film', 'Drama']",2000,9
31026281,The Daughter of Deceit,1951,['Mexico'],['Drama'],1950,1
23752558,Family Album,1994,['United States of America'],"['Film adaptation', 'Romance Film', 'Television movie', 'Drama']",1990,4
5630352,Why Girls Love Sailors,1927,['United States of America'],"['Black-and-white', 'Indie', 'Short Film', 'Comedy', 'Silent film', 'Slapstick']",1920,7
1430376,Life Is Sweet,1990,['United Kingdom'],"['Domestic Comedy', 'Comedy-drama', 'Ensemble Film']",1990,0
7276187,The Children,1980,['United States of America'],"['Zombie Film', 'Science Fiction', 'Horror']",1980,0
420532,Lucía y el sexo,2001,"['France', 'Spain']","['Erotic Drama', 'Romantic drama', 'World cinema', 'Romance Film', 'Erotica', 'Drama']",2000,1
15584759,Jack and the Beanstalk: The Real Story,2001,['United States of America'],"['Fantasy Adventure', 'Fairy tale', 'Adventure', 'Drama', 'Fantasy']",2000,1
4926508,Vengeance Valley,1951,['United States of America'],"['Action/Adventure', 'Western']",1950,1
9215059,Wake of the Red Witch,1948,['United States of America'],"['Action', 'Action/Adventure', 'Epic', 'Swashbuckler films', 'Adventure', 'Drama']",1940,8
24313378,Tin Man,1983,['United States of America'],['Drama'],1980,3
27573594,Obscene Stalker: It Holds in Darkness!,2002,['Japan'],['Japanese Movies'],2000,2
10723069,Aakhri Khat,1966,['India'],['Drama'],1960,6
3569329,Eddie,1996,['United States of America'],"['Action', 'Action/Adventure', 'Comedy', 'Sports']",1990,6
2019404,A Face in the Crowd,1957,['United States of America'],"['Media Satire', 'Drama']",1950,7
11521879,Solva Saal,1958,['India'],['World cinema'],1950,8
1432870,Committed,2000,['United States of America'],"['Indie', 'Comedy', 'Drama']",2000,0
14634586,Madol Duwa,1976,['Sri Lanka'],['Drama'],1970,6
1339188,Popeye,1980,['United States of America'],"['Action', 'Musical', 'Superhero', 'Action/Adventure', 'Comedy', 'Family-Oriented Adventure', 'Cult', 'Adventure', 'Superhero movie', 'Family Film']",1980,0
19933711,Footprints on the Moon,1975,['Italy'],['Horror'],1970,5
14508032,Ran Salu,1967,['Sri Lanka'],"['Melodrama', 'Drama']",1960,7
30863297,Yonggary,1967,"['Japan', 'South Korea']","['Science Fiction', 'Sci-Fi Horror', 'Horror']",1960,7
2122517,A Walk in the Clouds,1995,"['Mexico', 'United States of America']","['Period piece', 'Romantic drama', 'Romance Film', 'Drama']",1990,5
20867795,Travels with My Aunt,1972,['United States of America'],"['Comedy', 'Adventure']",1970,2
30865328,Kim Possible: So the Drama,2005,['United States of America'],"['Animation', 'Comedy', 'Teen', 'Family Film']",2000,5
34140684,Come rubammo la bomba atomica,1967,[],['Comedy film'],1960,7
17344938,120,2008,['Turkey'],"['Historical fiction', 'War film', 'Drama']",2000,8
24564971,The Playboys,1992,"['United Kingdom', 'Ireland', 'United States of America']","['Period piece', 'Romantic drama', 'Romance Film', 'Drama']",1990,2
1998691,The Alligator People,1959,['United States of America'],"['Creature Film', 'Monster movie', 'Horror', 'Science Fiction']",1950,9
548669,Demolition Man,1993,['United States of America'],"['Action', 'Crime Fiction', 'Action/Adventure', 'Science Fiction', 'Thriller']",1990,3
7364229,Anna Karenina,1948,['United Kingdom'],"['Film adaptation', 'Black-and-white', 'Romantic drama', 'Romance Film', 'Costume drama', 'Drama']",1940,8
12127937,Lt. Robin Crusoe USN,1966,['United States of America'],"['Comedy', 'Adventure', 'Drama', 'Family Film']",1960,6
25493367,Antham,1992,['India'],['Action'],1990,2
32669004,Kannagi,1942,[],['Fantasy'],1940,2
27869241,Thumb Fun,1952,['United States of America'],"['Animation', 'Short Film', 'Comedy', 'Family Film']",1950,2
8250443,Kings of the Sun,1963,['United States of America'],"['Action', 'Action/Adventure', 'Historical fiction', 'Epic', 'Adventure', 'Drama']",1960,3
6684715,Pudhiya Geethai,2003,['India'],"['Romantic drama', 'World cinema', 'Romance Film', 'Drama']",2000,3
9065304,The Taste of Tea,2004,['Japan'],"['Japanese Movies', 'Comedy', 'World cinema', 'Comedy-drama', 'Drama', 'Slice of life story']",2000,4
31322483,Man of Straw,1951,['German Democratic Republic'],"['Drama', 'Comedy film']",1950,1
9212687,Das wilde Leben,2007,['Germany'],"['Political drama', 'Drama', 'World cinema']",2000,7
12824577,Hiram na Mukha,1992,['Philippines'],['Filipino Movies'],1990,2
34260270,Chota Jadugar,2003,['India'],['Fantasy'],2000,3
18953471,Yes Man,2008,"['United States of America', 'Australia']","['Romance Film', 'Comedy']",2000,8
9700302,Intellectual Property,2006,['United States of America'],"['Psychological thriller', 'Drama', 'Indie', 'Thriller']",2000,6
600320,Scream 2,1997,['United States of America'],"['Mystery', 'Indie', 'Comedy', 'Teen', 'Thriller', 'Horror Comedy', 'Media Satire', 'Parody', 'Slasher', 'Horror']",1990,7
24732078,Journey,1972,['Canada'],['Drama'],1970,2
11275640,Flower Drum Song,1961,['United States of America'],"['Musical', 'Romance Film', 'Musical comedy']",1960,1
10149834,Ponyo,2008,['Japan'],"['Animation', 'World cinema', ""Children's"", 'Adventure', 'Drama', ""Children's Fantasy"", 'Japanese Movies', 'Anime', 'Family Film', 'Fantasy']",2000,8
3337648,Beep Prepared,1961,['United States of America'],['Short Film'],1960,1
6619702,Pippi Longstocking,1997,"['Sweden', 'Germany', 'Canada']","['Musical', 'Animation', ""Children's"", 'Comedy', 'Adventure', 'Family Film']",1990,7
3117439,The Spiderwick Chronicles,2008,['United States of America'],"['Fantasy Adventure', 'Adventure', 'Family Film', 'Fantasy']",2000,8
12544749,Butterfly Kiss,1995,['United Kingdom'],"['LGBT', 'Crime Fiction', 'Comedy', 'Romance Film', 'Black comedy', 'Drama', 'Gay Themed', 'Gay', 'Gay Interest', 'Road movie']",1990,5
287404,The Paradine Case,1947,['United States of America'],"['Suspense', 'Black-and-white', 'Mystery', 'Film noir', 'Drama', 'Courtroom Drama']",1940,7
1776723,The Tomb of Ligeia,1965,"['United Kingdom', 'United States of America']","['Period piece', 'Gothic Film', 'Thriller', 'Horror', 'Costume Horror', 'Costume drama', 'Drama']",1960,5
2505688,Little Nellie Kelly,1940,['United States of America'],"['Musical', 'Black-and-white', 'Comedy', 'Musical comedy']",1940,0
5498784,Mrs. Winterbourne,1996,['United States of America'],"['Film adaptation', 'Comedy', 'Romance Film', 'Romantic comedy', 'Comedy-drama', 'Comedy of Errors', 'Drama']",1990,6
3346585,In Cold Blood,1967,['United States of America'],"['Courtroom Drama', 'Film adaptation', 'Crime Fiction', 'New Hollywood', 'Drama']",1960,7
35785282,Anita Takes a Chance,2001,['Spain'],"['Drama', 'Comedy']",2000,1
29332575,Devdoot,1995,['India'],['Action'],1990,5
2115510,Message in a Bottle,1999,['United States of America'],"['Film adaptation', 'Romantic drama', 'Romance Film', 'Drama']",1990,9
16005026,Seenugadu Chiranjeevi Fan,2006,['India'],"['Romantic drama', 'World cinema', 'Romance Film', 'Drama']",2000,6
14104063,Just Tell Me What You Want,1980,['United States of America'],"['Romantic comedy', 'Comedy-drama', 'Comedy']",1980,0
24388963,Thieves,1996,['France'],"['Romantic drama', 'Drama']",1990,6
32660977,Color Me Dead,1969,[],['Thriller'],1960,9
5541078,The i Inside,2004,"['United Kingdom', 'United States of America']","['Psychological thriller', 'Mystery', 'Thriller', 'Crime Thriller', 'Supernatural']",2000,4
8824700,Candyman 3: Day of the Dead,1999,['United States of America'],"['Slasher', 'Thriller', 'Horror']",1990,9
3948455,Universal Soldier,1992,['United States of America'],"['Action', 'Drama', 'Indie', 'Action/Adventure', 'Martial Arts Film', 'Science Fiction']",1990,2
13697089,Follow a Star,1959,['United Kingdom'],"['Musical', 'Black-and-white', 'Comedy', 'Slapstick']",1950,9
2763180,Fun with Dick and Jane,2005,['United States of America'],"['Comedy', 'Crime Fiction']",2000,5
12080301,The Hottest State,2006,['United States of America'],"['Romantic drama', 'Indie', 'Romance Film', 'Drama']",2000,6
7494939,Men of Respect,1991,['United States of America'],"['Film adaptation', 'Crime Fiction', 'Gangster Film', 'Crime Drama', 'Crime Thriller', 'Drama', 'Tragedy']",1990,1
1963987,Go for Broke!,1951,['United States of America'],"['Action', 'Black-and-white', 'Drama', 'Action/Adventure', 'War film']",1950,1
10809256,Drink-Drank-Drunk,2005,['Hong Kong'],"['Chinese Movies', 'Comedy', 'World cinema']",2000,5
12466332,A Prayer for the Dying,1987,"['United Kingdom', 'United States of America']","['Action', 'Film adaptation', 'Crime Fiction', 'Gangster Film', 'Indie', 'Action/Adventure', 'Thriller', 'Crime Thriller', 'Drama', 'Political thriller']",1980,7
15272880,Little Caesar,1931,['United States of America'],"['Black-and-white', 'Crime Fiction', 'Gangster Film', 'Mystery', 'Crime Drama', 'Pre-Code', 'Drama']",1930,1
213149,Shanghai Noon,2000,"['Hong Kong', 'United States of America']","['Action', 'Action/Adventure', 'Hybrid Western', 'Comedy', 'Thriller', 'Buddy film', 'Chinese Movies', 'Martial Arts Film', 'Costume drama', 'Adventure', 'Comedy Western', 'Action Comedy', 'Western']",2000,0
1617266,Find Me Guilty,2006,['United States of America'],"['Crime Fiction', 'Gangster Film', 'Comedy', 'Docudrama', 'Drama', 'Courtroom Drama', 'Courtroom Comedy', 'Crime Comedy', 'Comedy-drama']",2000,6
12244463,Prisoners of the Sun,1990,['United States of America'],"['Horror', 'Political drama', 'Adventure', 'Drama', 'Courtroom Drama']",1990,0
17323415,Bride Wars,2009,['United States of America'],"['Romance Film', 'Romantic comedy', 'Comedy']",2000,9
2694342,The Third Wheel,2002,['United States of America'],"['Romance Film', 'Romantic comedy', 'Comedy']",2000,2
3278100,3 Ninjas Kick Back,1994,"['Japan', 'United States of America']","['Action', 'Action/Adventure', 'Comedy', ""Children's/Family"", 'Martial Arts Film', 'Adventure', 'Japanese Movies', 'Action Comedy', 'Family Film']",1990,4
8626157,The Seat Filler,2005,['United States of America'],"['Romance Film', 'Romantic comedy', 'Comedy']",2000,5
24051439,The Beatniks,1960,['United States of America'],"['Crime Fiction', 'Indie', 'Drama']",1960,0
1591865,Broken Lance,1954,['United States of America'],"['Family Drama', 'Action/Adventure', 'Western', 'Drama']",1950,4
18716845,I Love Melvin,1953,['United States of America'],"['Musical', 'Romance Film', 'Comedy']",1950,3
798491,The 6th Day,2000,"['Canada', 'United States of America']","['Action', 'Crime Fiction', 'Action Thrillers', 'Action/Adventure', 'Thriller', 'Science Fiction']",2000,0
27835872,Thunder Alley,1967,['United States of America'],"['Action', 'Romance Film', 'Drama']",1960,7
26499456,Bedrooms,2009,['United States of America'],"['Romantic drama', 'Indie', 'Romance Film', 'Drama']",2000,9
24003057,Bhagavan,2009,[],['Thriller'],2000,9
585172,Go,1999,['United States of America'],"['Crime Fiction', 'Coming of age', 'Comedy', 'Thriller', 'Black comedy']",1990,9
26851379,The Passing of the Third Floor Back,1935,['United Kingdom'],"['Comedy', 'Drama', 'Fantasy']",1930,5
9632379,The Fighting Marines,1935,['United States of America'],"['Action', 'Black-and-white', 'Action/Adventure', 'Adventure', 'War film', 'Drama']",1930,5
5566347,Reckless,1935,['United States of America'],"['Musical', 'Black-and-white', 'Drama']",1930,5
32639774,Headspace,2005,[],"['Psychological thriller', 'Mystery', 'Horror', 'Science Fiction']",2000,5
26049342,Posse from Hell,1961,['United States of America'],['Western'],1960,1
31189608,The Only Way,1927,[],"['Silent film', 'Adventure', 'Drama']",1920,7
1025150,Saw,2004,"['United States of America', 'Australia']","['Psychological thriller', 'Crime Fiction', 'Mystery', 'Indie', 'Slasher', 'Thriller', 'Horror']",2000,4
3574776,Popeye's Voyage: The Quest for Pappy,2004,"['Canada', 'United States of America']","['Animation', 'Short Film', 'Comedy film', 'Romance Film', 'Family Film']",2000,4
8695,Dr. Strangelove or: How I Learned to Stop Worrying and Love the Bomb,1964,['United Kingdom'],"['Drama', 'Comedy']",1960,4
1370930,Cul-de-Sac,1966,['United Kingdom'],"['Comedy Thriller', 'Thriller', 'Crime Comedy', 'Comedy', 'Black comedy', 'Drama']",1960,6
32639664,Jumpin' Jupiter,1955,['United States of America'],"['Animation', 'Short Film', 'Comedy film', 'Science Fiction', 'Family Film']",1950,5
5670753,Lone Wolf and Cub: Sword of Vengeance,1972,['Japan'],"['Action', 'Samurai cinema', 'Japanese Movies', 'Action/Adventure', 'World cinema', 'Martial Arts Film']",1970,2
19240936,Leaves of Grass,2009,['United States of America'],"['Crime Fiction', 'Indie', 'Comedy', 'Thriller', 'Black comedy', 'Drama', 'Comedy Thriller', 'Comedy-drama']",2000,9
16823746,Big City Blues,1932,['United States of America'],['Black-and-white'],1930,2
156641,Stalag 17,1953,['United States of America'],"['Black-and-white', 'Comedy', 'Comedy-drama', 'War film', 'Drama', 'Ensemble Film']",1950,3
26068632,The Final Cut,1996,"['Canada', 'United States of America']","['Action', 'Thriller', 'Drama']",1990,6
7081414,Starting Out in the Evening,2007,['United States of America'],"['Film adaptation', 'Drama', 'Indie', 'Romance Film']",2000,7
10847572,Sherman's March,2007,['United States of America'],"['History', 'Indie', 'Documentary', 'War film']",2000,7
4956346,L.A. Takedown,1989,['United States of America'],"['Thriller', 'Crime Fiction']",1980,9
454718,The Santa Clause 2,2002,['United States of America'],"['Comedy', ""Children's/Family"", 'Holiday Film', 'Christmas movie', 'Romantic comedy', 'Fantasy Comedy', 'Family Film', 'Fantasy']",2000,2
180917,Valiant Is the Word for Carrie,1936,['United States of America'],"['Black-and-white', 'Melodrama', 'Drama']",1930,6
19024526,Antichrist,2009,"['Denmark', 'Sweden', 'France', 'Germany', 'Poland', 'Italy']","['Psychological thriller', 'Indie', 'Thriller', 'World cinema', 'Drama', 'Horror', 'Erotic thriller', 'Supernatural', 'Fantasy']",2000,9
7892732,Epic Movie,2007,['United States of America'],"['Action', 'Parody', 'Action/Adventure', 'Comedy', 'Slapstick', 'Adventure']",2000,7
10195558,Fool Coverage,1952,['United States of America'],"['Animation', 'Short Film', 'Family Film']",1950,2
77744,Wayne's World,1992,['United States of America'],"['Music', 'Buddy film', 'Satire', 'Comedy', 'Cult', 'Absurdism']",1990,2
1554502,The Edukators,2004,"['Austria', 'Germany']","['Crime Fiction', 'Comedy', 'World cinema', 'Romance Film', 'Drama', 'Political cinema', 'Coming of age', 'Crime Drama', 'Comedy-drama', 'Political drama']",2000,4
1876167,The Clairvoyant,1935,['United Kingdom'],"['Psychological thriller', 'Film adaptation', 'Black-and-white', 'Mystery', 'Thriller', 'Drama']",1930,5
3444797,Conan the Barbarian,1982,['United States of America'],"['Action', 'Fantasy Adventure', 'Action/Adventure', 'Thriller', 'Costume drama', 'Adventure', 'Sword and sorcery films', 'Sword and sorcery', 'Fantasy']",1980,2
29133741,Death Note: The Last Name,2006,"['Japan', 'United States of America']","['Crime Fiction', 'Japanese Movies', 'Adventure', 'Drama']",2000,6
11496773,Operation Bikini,1963,['United States of America'],"['War film', 'Drama']",1960,3
4173594,The Dust Factory,2004,['United States of America'],"['Family Drama', ""Children's/Family"", 'Adventure', 'Drama', ""Children's Fantasy"", 'Coming of age', 'Heaven-Can-Wait Fantasies', 'Family Film', 'Fantasy']",2000,4
31145076,Idavela,1982,[],[],1980,2
2039953,Hard Rain,1998,"['Denmark', 'New Zealand', 'Japan', 'United Kingdom', 'France', 'Germany', 'United States of America']","['Action', 'Crime Fiction', 'Japanese Movies', 'Action Thrillers', 'Action/Adventure', 'Thriller', 'Disaster']",1990,8
2920309,Just Like a Woman,1992,['United Kingdom'],"['LGBT', 'Comedy', 'Drama']",1990,2
32544504,Fareb,1996,['India'],"['Action', 'Drama', 'Crime Fiction', 'Thriller', 'Bollywood']",1990,6
15841116,La Garçonne,1936,['France'],['Drama'],1930,6
2332364,The Strange Love of Martha Ivers,1946,['United States of America'],"['Black-and-white', 'Crime Fiction', 'Crime Drama', 'Film noir', 'Melodrama', 'Drama']",1940,6
26847186,How I Got Lost,2009,['United States of America'],"['Indie', 'Drama']",2000,9
2436406,48 Hrs.,1982,['United States of America'],"['Action', 'Crime Fiction', 'Action/Adventure', 'Buddy film', 'Thriller', 'Comedy', 'Drama', 'Buddy cop', 'Action Comedy']",1980,2
3910144,Full Contact,1993,['Hong Kong'],"['Action', 'Crime Fiction', 'Action/Adventure', 'Thriller', 'World cinema', 'Chinese Movies', 'Martial Arts Film']",1990,3
3451589,Otoko-tachi no Yamato,2005,['Japan'],"['Japanese Movies', 'War film']",2000,5
6394592,Wing and a Prayer,1944,['United States of America'],"['War film', 'Drama']",1940,4
22114629,Police Police,2009,['India'],"['Action', 'Short Film']",2000,9
28207840,Crazy Town,1932,['United States of America'],['Short Film'],1930,2
9653698,Big Dreams Little Tokyo,2006,['United States of America'],"['Indie', 'Comedy', 'Comedy of manners', 'Romance Film']",2000,6
7473588,The Feeding,2006,['United States of America'],"['Creature Film', 'Horror']",2000,6
21037,Meet the Feebles,1989,['New Zealand'],"['Gross out', 'Gross-out film', 'Parody', 'Comedy', 'Black comedy']",1980,9
43566,Heat,1995,['United States of America'],"['Action', 'Psychological thriller', 'Crime Fiction', 'Action/Adventure', 'Thriller', 'Crime Thriller', 'Drama', 'Heist']",1990,5
14984169,Starcrossed,2005,['United States of America'],"['LGBT', 'Short Film', 'Science Fiction', 'Drama']",2000,5
33806367,KT,2002,['South Korea'],[],2000,2
15708013,Hōtai Club,2007,['Japan'],['Japanese Movies'],2000,7
7504062,Betty Boop with Henry the Funniest Living American,1935,['United States of America'],"['Animation', 'Short Film', 'Comedy', 'Family Film']",1930,5
8785217,Snow Queen,2002,"['United Kingdom', 'United States of America', 'Canada']","['Coming of age', 'Television movie', 'Adventure', 'Family Film', 'Fantasy']",2000,2
31769079,"Lovely, Still",2008,[],"['Romance Film', 'Drama']",2000,8
3041142,Crying Fist,2005,['South Korea'],"['Sports', 'Drama']",2000,5
10615587,Buddha Mil Gaya,1971,['India'],"['Musical', 'Mystery', 'Romance Film', 'Drama']",1970,1
31303771,The Glitter Dome,1984,"['Canada', 'United States of America']","['Drama', 'Crime Fiction']",1980,4
2554065,Terror Train,1980,"['Canada', 'United States of America']","['Indie', 'Slasher', 'Thriller', 'Horror', 'Teen']",1980,0
28698003,A Sigh,2000,['China'],['Chinese Movies'],2000,0
10140847,Sky Raiders,1941,['United States of America'],"['Action', 'Black-and-white', 'Action/Adventure', 'Thriller', 'War film', 'Adventure']",1940,1
3125976,The Window,1949,['United States of America'],"['Psychological thriller', 'Black-and-white', 'Crime Fiction', 'Film noir', 'Drama']",1940,9
26272116,Julie Walking Home,2002,"['Canada', 'Germany', 'Poland', 'United States of America']","['Romance Film', 'Romantic drama', 'Drama']",2000,2
1717500,Stuart Saves His Family,1995,"['Germany', 'United States of America']","['Family Drama', 'Comedy', 'Satire', 'Black comedy']",1990,5
20530024,The Mad Hatter,1947,['United States of America'],"['Animation', 'Short Film', 'Comedy film', 'Family Film']",1940,7
3861641,Tell Me Something,1999,['South Korea'],"['Crime Thriller', 'Thriller', 'World cinema']",1990,9
1078863,The X Files,1998,"['Canada', 'United States of America']","['Mystery', 'Thriller', 'Detective', 'Science Fiction']",1990,8
1364205,Kentucky,1938,['United States of America'],"['Romantic drama', 'Romance Film', 'Melodrama', 'Sports', 'Drama']",1930,8
30116603,Zakhmi Sipahi,1995,[],['Action'],1990,5
171026,Cape Fear,1991,['United States of America'],"['Psychological thriller', 'Suspense', 'Crime Fiction', 'Thriller', 'Remake', 'Crime Thriller', 'Drama']",1990,1
2935497,Naked Souls,1995,['United States of America'],"['Indie', 'Slasher', 'Thriller', 'Horror']",1990,5
1031588,Flesh & Blood,1985,"['Spain', 'Netherlands', 'United States of America']","['Action/Adventure', 'Adventure', 'Erotica', 'Swashbuckler films']",1980,5
1367189,Needing You,2000,['Hong Kong'],"['Romantic drama', 'Comedy', 'World cinema', 'Romance Film', 'Chinese Movies', 'Drama', 'Romantic comedy', 'Comedy-drama']",2000,0
11188284,Pardesi Babu,1998,['India'],"['Romantic comedy', 'Buddy film', 'Comedy']",1990,8
7806593,Adaikalam,2006,['India'],['Family Drama'],2000,6
33209993,Fallen Arches,1999,['United States of America'],"['Crime Fiction', 'Gangster Film', 'Indie', 'Comedy', 'Drama']",1990,9
5524650,Hands of the Ripper,1971,['United Kingdom'],"['Period piece', 'Slasher', 'Horror', 'Cult']",1970,1
2862848,The Moon Warriors,1993,['Hong Kong'],"['Romantic drama', 'Action/Adventure', 'World cinema', 'Romance Film', 'Chinese Movies', 'Martial Arts Film', 'Drama', 'Wuxia', 'Fantasy']",1990,3
24808130,Kamen Rider × Kamen Rider Double & Decade: Movie War 2010,2009,[],"['Action', 'Science Fiction']",2000,9
7818551,Dhee,2007,['India'],['Comedy'],2000,7
14570274,The Yoke's on Me,1944,['United States of America'],"['Black-and-white', 'Short Film', 'Propaganda film']",1940,4
2465292,Avenging Angelo,2002,"['France', 'Switzerland', 'United States of America']","['Action', 'Crime Fiction', 'Gangster Film', 'Action/Adventure', 'Comedy', 'Thriller', 'Romance Film', 'Crime Comedy', 'Romantic comedy']",2000,2
61483,The Informer,1935,['United States of America'],"['Black-and-white', 'Political drama', 'Drama']",1930,5
4969126,The Return of the Musketeers,1989,"['United Kingdom', 'France', 'Spain']","['Action', 'Action/Adventure', 'Comedy', 'Costume drama', 'Adventure', 'Swashbuckler films']",1980,9
6712075,George and the Dragon,2004,['United States of America'],"['Fantasy Adventure', 'Fantasy', 'Comedy', 'Sword and sorcery', 'Costume drama', 'Fantasy Comedy', 'Sword and sorcery films']",2000,4
5108489,Amar Prem,1971,['India'],"['Musical', 'Romantic drama', 'Bollywood', 'World cinema', 'Romance Film', 'Melodrama', 'Drama']",1970,1
4418072,Eddie's Million Dollar Cook-Off,2003,['United States of America'],['Teen'],2000,3
24755786,Charlie Chan in Panama,1940,['United States of America'],"['Action', 'Spy', 'Detective fiction', 'Crime Fiction', 'Action Thrillers', 'Mystery', 'Crime Thriller', 'Detective']",1940,0
17161827,The Mating of Millie,1948,['United States of America'],"['Romantic comedy', 'Black-and-white', 'Comedy']",1940,8
30578319,Bailey's Billion$,2005,['Canada'],"['Comedy', 'Family Film', 'Adventure']",2000,5
3248340,Kung Fu Panda,2008,['United States of America'],"['Action', 'Animation', 'Comedy', ""Children's/Family"", 'Martial Arts Film', 'Adventure', 'Computer Animation', 'Family Film']",2000,8
1356628,Les liaisons dangereuses,1959,"['France', 'Italy']","['Black-and-white', 'Romantic drama', 'World cinema', 'Romance Film', 'Erotica', 'Drama']",1950,9
19080460,Reluctant Bride,1955,['United Kingdom'],['Comedy'],1950,5
8172248,"Run, Fat Boy, Run",2007,['United Kingdom'],"['Comedy', 'Romantic comedy', 'Romance Film', 'Sports', 'Slapstick']",2000,7
29100198,Wine,1924,['United States of America'],"['Silent film', 'Comedy-drama']",1920,4
381810,Lagaan: Once Upon a Time in India,2001,['India'],"['Musical', 'Musical Drama', 'Political satire', 'Comedy', 'Romantic drama', 'Bollywood', 'World cinema', 'Romance Film', 'Drama', 'Period piece', 'Comedy-drama', 'Sports', 'Political drama']",2000,1
11543265,Charodey,1982,['Soviet Union'],"['Musical', 'Science Fiction', 'Comedy']",1980,2
23790720,Ocean of Pearls,2008,['United States of America'],"['Indie', 'Drama']",2000,8
4390553,City of the Living Dead,1980,['Italy'],"['Zombie Film', 'Splatter film', 'Horror']",1980,0
4788925,Bee Season,2005,['United States of America'],"['Film adaptation', 'Coming of age', 'Family Drama', 'Drama']",2000,5
526367,Scott of the Antarctic,1948,['United Kingdom'],"['Action', 'Action/Adventure', 'Biographical film', 'Historical fiction', 'Docudrama', 'Adventure', 'Drama']",1940,8
25080361,Jim the World's Greatest,1976,['United States of America'],['Drama'],1970,6
12732947,Gambling Lady,1934,['United States of America'],"['Black-and-white', 'Crime Fiction', 'Romance Film', 'Drama']",1930,4
2110936,Navy SEALs,1990,['United States of America'],"['Action', 'Action/Adventure', 'Thriller', 'War film']",1990,0
27860593,Pallavur Devanarayanan,1999,['India'],['Drama'],1990,9
1397183,The V.I.P.s,1963,['United Kingdom'],['Drama'],1960,3
3718428,Left Behind: The Movie,2001,"['Israel', 'United States of America', 'Canada']","['Action', 'Action/Adventure', 'Indie', 'Thriller', 'Christian film', 'Disaster', 'Drama', 'Airplanes and airports', 'Supernatural', 'Science Fiction', 'Fantasy']",2000,1
6715354,I Hired a Contract Killer,1990,"['Sweden', 'France', 'Finland', 'United Kingdom', 'Germany']","['Black comedy', 'Comedy', 'Drama']",1990,0
22114003,Frisco Jenny,1932,['United States of America'],"['Black-and-white', 'Crime Drama', 'Melodrama', 'Pre-Code', 'Drama']",1930,2
1908729,Runaway Bride,1999,['United States of America'],"['Comedy', 'Romance Film', 'Romantic comedy', 'Road movie']",1990,9
23435148,Morning Walk,2009,['India'],"['Drama', 'World cinema']",2000,9
25008136,Kiss of the Vampire,2007,['United States of America'],"['Romantic drama', 'Horror', 'Romance Film', 'Drama']",2000,7
20903033,Benaam,1974,['India'],"['Mystery', 'Thriller', 'World cinema', 'Drama']",1970,4
18562918,Pula Rangadu,1967,['India'],['Drama'],1960,7
13065473,The Bachelor Father,1931,['United States of America'],"['Black-and-white', 'Comedy-drama', 'Drama']",1930,1
36388033,Nightmare in the Daylight,1992,['United States of America'],"['Thriller', 'Drama']",1990,2
26188661,Live Wires,1946,['United States of America'],"['Comedy', 'Crime Fiction']",1940,6
16732594,Chicago Joe and the Showgirl,1990,['United Kingdom'],"['Period piece', 'Crime Fiction', 'Thriller', 'Crime Thriller', 'Drama']",1990,0
2184195,Return to the 36th Chamber,1980,['Hong Kong'],"['Chinese Movies', 'Martial Arts Film', 'Comedy']",1980,0
13672638,Bleeders,1997,"['Canada', 'United States of America']","['Creature Film', 'Horror', 'B-movie', 'Science Fiction']",1990,7
30875502,Jumpin' Jack Flash,1986,['United States of America'],"['Action', 'Spy', 'Action Comedy', 'Action/Adventure', 'Comedy Thriller', 'Thriller', 'Comedy']",1980,6
462749,Hilary and Jackie,1999,['United Kingdom'],"['Film adaptation', 'Family Drama', 'Biography', 'Biographical film', 'Biopic [feature]', 'Drama', 'Medical fiction']",1990,9
3954720,Burnt Offerings,1976,['United States of America'],"['Film adaptation', 'Haunted House Film', 'Horror']",1970,6
2856978,Where the Heart Is,1990,['United States of America'],"['Romantic comedy', 'Comedy']",1990,0
2839572,Haiku Tunnel,2001,['United States of America'],"['Indie', 'Comedy', 'Satire', 'Black comedy', 'Workplace Comedy']",2000,1
2994941,Friend,2001,['South Korea'],"['Crime Fiction', 'Gangster Film', 'World cinema', 'Drama']",2000,1
24057003,Laughology,2009,['Canada'],"['Comedy', 'Documentary']",2000,9
2528901,Elevated,1997,['Canada'],"['Short Film', 'Thriller']",1990,7
75874,Z,1969,"['France', 'Greece', 'Algeria']","['Crime Fiction', 'Mystery', 'Thriller', 'World cinema', 'Drama', 'History', 'Political drama', 'Political thriller']",1960,9
1008762,La Peau douce,1964,"['Portugal', 'France']","['Black-and-white', 'Romantic drama', 'World cinema', 'Romance Film', 'Drama']",1960,4
26278883,Molester's Train: Nasty Behavior,1993,['Japan'],['Japanese Movies'],1990,3
5240530,The Hotel New Hampshire,1984,"['United Kingdom', 'United States of America', 'Canada']","['LGBT', 'Family Drama', 'Coming of age', 'Comedy', 'Black comedy', 'Comedy-drama']",1980,4
35319301,Ponvayal,1954,['India'],['Musical'],1950,4
10183625,The Adventures of Hajji Baba,1954,['United States of America'],"['Action', 'Film adaptation', 'Action/Adventure', 'Romance Film', 'Adventure', 'Drama']",1950,4
9749808,The One and Only,2002,['United Kingdom'],"['Romantic comedy', 'Comedy']",2000,2
1009560,Wicker Park,2004,['United States of America'],"['Psychological thriller', 'Mystery', 'Romantic drama', 'Thriller', 'Romance Film', 'Drama']",2000,4
24027382,Weapons,2007,[],"['Drama', 'Crime Fiction', 'Indie', 'Juvenile Delinquency Film']",2000,7
23984088,The Lady Says No,1952,['United States of America'],"['Black-and-white', 'Comedy', 'Romance Film', 'Romantic comedy']",1950,2
21543965,Ivan,2002,[],['Action'],2000,2
20267538,Our Feature Presentation,2008,['United States of America'],"['Indie', 'Comedy']",2000,8
14112883,The Taebaek Mountains,1994,['South Korea'],['Drama'],1990,4
24608768,The One and Only,1978,['United States of America'],"['Comedy', 'Romantic comedy', 'Romance Film', 'Sports']",1970,8
99545,This Is Spinal Tap,1984,['United States of America'],"['Musical', 'Indie', 'Parody', 'Satire', 'Comedy', 'Mockumentary', 'Cult']",1980,4
15907366,Sole Survivor,1970,['United States of America'],"['Drama', 'Fantasy']",1970,0
25924934,From Beginning to End,2009,['Brazil'],"['Gay Themed', 'LGBT', 'Drama']",2000,9
14729260,Manslaughter,1922,['United States of America'],"['Black-and-white', 'Drama', 'Indie', 'Silent film']",1920,2
25156889,Birdie & Bogey,2009,['United States of America'],"['Sports', 'Drama']",2000,9
6894813,Thilakkam,2003,['India'],['Comedy'],2000,3
29470561,The Devil and the Ten Commandments,1962,"['France', 'Italy']","['Drama', 'Comedy']",1960,2
1769207,Little Witches,1996,['United States of America'],"['Indie', 'Thriller', 'Horror', 'Teen', 'Supernatural']",1990,6
4440305,Highlander II: The Quickening,1991,"['Argentina', 'France', 'United Kingdom']","['Action', 'Fantasy Adventure', 'Sword and sorcery films', 'Science Fiction', 'Fantasy']",1990,1
24204980,(Untitled),2009,['United States of America'],"['Indie', 'Comedy', 'Satire', 'Romance Film', 'Romantic comedy']",2000,9
2643766,Crustacés et coquillages,2005,['France'],"['Musical', 'LGBT', 'Romantic drama', 'Comedy', 'World cinema', 'Romance Film', 'Drama', 'Romantic comedy']",2000,5
5334557,"I, Monster",1971,['United Kingdom'],"['Costume Horror', 'Science Fiction', 'Horror']",1970,1
591309,A Bronx Tale,1993,['United States of America'],"['Period piece', 'Drama', 'Crime Fiction', 'Gangster Film', 'Indie', 'Coming of age']",1990,3
5076193,On The Nameless Height,2004,['Russia'],['War film'],2000,4
61184,The Patriot,2000,"['Germany', 'United States of America']","['Action', 'Period piece', 'Drama', 'War film', 'Costume drama']",2000,0
8484229,Las Aguas Bajan Turbias,1952,['Argentina'],['Drama'],1950,2
13469795,The Bulldog Breed,1960,['United Kingdom'],"['Black-and-white', 'Screwball comedy', 'Comedy']",1960,0
10932535,"Fatal Needles, Fatal Fists",1978,['Hong Kong'],"['Action', 'Action/Adventure', 'World cinema', 'Chinese Movies', 'Martial Arts Film']",1970,8
6642278,The Life and Times of Judge Roy Bean,1972,['United States of America'],"['Action', 'Revisionist Western', 'Action/Adventure', 'Western', 'Comedy', 'Comedy film', 'Romance Film']",1970,2
25901276,Kariyilakkattu Pole,1986,['India'],"['Crime Fiction', 'Mystery', 'Thriller']",1980,6
1059716,Monsignor,1982,['United States of America'],"['Melodrama', 'Drama']",1980,2
19495315,The Cuckoos,1930,['United States of America'],"['Musical', 'Comedy']",1930,0
21858669,Winter in Wartime,2008,"['Netherlands', 'Belgium']","['Thriller', 'World cinema', 'Adventure', 'Drama', 'Period piece', 'History', 'Coming of age', 'War film']",2000,8
10593126,Naseeb,1981,['India'],"['Musical', 'Bollywood', 'World cinema', 'Drama']",1980,1
1412408,Slap Shot,1977,['United States of America'],"['Action', 'Action/Adventure', 'Comedy', 'Sports']",1970,7
9540203,Tujhe Meri Kasam,2003,['India'],['Romance Film'],2000,3
22370434,Wubb Idol,2009,"['Canada', 'United States of America']",['Animation'],2000,9
1594929,Demon Seed,1977,['United States of America'],"['Science Fiction', 'Sci-Fi Horror', 'Horror']",1970,7
27509330,Another Chance,1989,['United States of America'],['Comedy'],1980,9
9205739,Maw`ed Gharam,1956,['Egypt'],"['Musical', 'Romance Film', 'Drama']",1950,6
29539622,Viruthan Shanku,1968,[],['Comedy film'],1960,8
206879,Star Trek III: The Search for Spock,1984,['United States of America'],"['Science Fiction', 'Adventure', 'Family Film']",1980,4
15769804,Nenjathai Killadhe,2008,['India'],['Romance Film'],2000,8
171070,Nobody's Fool,1994,['United States of America'],"['Albino bias', 'Drama']",1990,4
671455,Infernal Affairs III,2003,['Hong Kong'],"['Crime Fiction', 'Action/Adventure', 'World cinema', 'Crime Thriller', 'Chinese Movies']",2000,3
230483,Commando,1985,['United States of America'],"['Action', 'Adventure']",1980,5
535335,War of the Worlds,2005,['United States of America'],"['Action', 'Thriller', 'Disaster', 'Adventure', 'Drama', 'Horror', 'Doomsday film', 'Alien Film', 'Science Fiction']",2000,5
133648,Scent of a Woman,1992,['United States of America'],"['Coming of age', 'Drama']",1990,2
2584970,Hercules vs. the Moon Men,1964,"['France', 'Italy']",['Fantasy'],1960,4
1367574,Ghosts of Mississippi,1996,['United States of America'],"['Crime Fiction', 'Historical fiction', 'Docudrama', 'Drama', 'Courtroom Drama']",1990,6
18732813,Illustrious Corpses,1976,"['France', 'Italy']","['Psychological thriller', 'Crime Fiction', 'Mystery', 'Thriller', 'World cinema', 'Crime Thriller', 'Suspense', 'Political thriller']",1970,6
12742325,Kamen Rider Ryuki: Episode Final,2002,[],['Science Fiction'],2000,2
14634101,The Puppetmaster,1993,"['China', 'Taiwan']","['Chinese Movies', 'Biography', 'Biographical film', 'World cinema', 'War film', 'Drama']",1990,3
5210202,Arinthum Ariyamalum,2005,['India'],"['Crime Fiction', 'Comedy film', 'Tamil cinema', 'Romance Film', 'Drama', 'Family Film']",2000,5
14440848,Reptilian,1999,['South Korea'],"['Action', 'Horror', 'World cinema', 'Science Fiction', 'Fantasy']",1990,9
4622516,Where the Boys Are '84,1984,['United States of America'],"['Coming of age', 'Comedy', 'Teen', 'Romance Film', 'Romantic comedy']",1980,4
33446753,Aham,1992,[],['Drama'],1990,2
12835282,Bombay to Goa,2007,['India'],['Comedy'],2000,7
2332610,Les Carabiniers,1963,"['France', 'Italy']","['Anti-war', 'Anti-war film', 'Satire', 'World cinema', 'War film', 'Drama']",1960,3
26367955,Ophelia,1963,['France'],"['Drama', 'World cinema']",1960,3
9650843,Nilaave Vaa,1998,['India'],['Romance Film'],1990,8
31383066,Varaphalam,1994,[],['Comedy film'],1990,4
35888695,Yaaran Naal Baharan,2005,['India'],"['Comedy', 'Comedy film', 'Romance Film', 'Drama']",2000,5
221968,Getting There,2002,['United States of America'],"['Family Film', 'Comedy', 'Teen']",2000,2
4977303,Voice of the City,1929,['United States of America'],"['Detective fiction', 'Black-and-white', 'Crime Fiction', 'Mystery', 'Pre-Code', 'Drama', 'Detective', 'Melodrama']",1920,9
1367453,En Route,2004,['Germany'],['Drama'],2000,4
1972231,Flipper,1963,['United States of America'],"['Adventure', 'Drama', 'Family Film']",1960,3
7486668,Little Criminals,1995,['Canada'],"['Music', 'Experimental film', 'Avant-garde']",1990,5
6012723,Baharen Phir Bhi Aayengi,1966,['India'],"['Drama', 'World cinema']",1960,6
6759112,Rock-A-Bye Baby,1958,['United States of America'],"['Musical', 'Comedy']",1950,8
18405650,John and Mary,1969,['United States of America'],"['Romance Film', 'Romantic drama', 'Drama']",1960,9
5177588,Sangam,1964,['India'],"['Romantic drama', 'Bollywood', 'World cinema', 'Romance Film', 'Drama']",1960,4
4357962,Failan,2001,['South Korea'],"['Romance Film', 'Drama', 'World cinema']",2000,1
3511710,The Eye,2002,"['Hong Kong', 'Singapore', 'England', 'Thailand']","['Psychological thriller', 'Chinese Movies', 'Thriller', 'Horror', 'World cinema', 'Drama']",2000,2
2167778,Loggerheads,2005,['United States of America'],"['LGBT', 'Indie', 'Family Drama', 'Drama']",2000,5
4302846,Superman and the Mole Men,1951,['United States of America'],"['Action', 'Fantasy Adventure', 'Superhero', 'Action/Adventure', 'Superhero movie', 'Adventure']",1950,1
2819346,A Man Escaped,1956,['France'],"['Prison', 'Art film', 'World cinema', 'Docudrama', 'Escape Film', 'Drama']",1950,6
25841110,Under Ten Flags,1960,"['Italy', 'United States of America']","['War film', 'Drama', 'World cinema']",1960,0
3624365,Tsotsi,2005,"['United Kingdom', 'South Africa']","['Crime Fiction', 'World cinema', 'Crime Drama', 'Drama']",2000,5
20818010,A Certain Smile,1958,['United States of America'],['Drama'],1950,8
13944412,Heartbeat Detector,2007,['France'],"['Psychological thriller', 'Thriller', 'World cinema', 'Drama']",2000,7
8223535,The Runaway Bus,1954,['United Kingdom'],"['Crime Fiction', 'Mystery', 'Caper story', 'Comedy']",1950,4
5671088,Lone Wolf and Cub: Baby Cart at the River Styx,1972,['Japan'],"['Action', 'Samurai cinema', 'Japanese Movies', 'Action/Adventure', 'World cinema']",1970,2
1016655,Nousukausi,2003,['Finland'],"['Comedy', 'Drama', 'Comedy of manners']",2000,3
4588632,Pajama Party,1964,['United States of America'],"['Science Fiction', 'Comedy']",1960,4
9588998,H-8,1958,"['Yugoslavia', 'Croatia']",['Drama'],1950,8
23011287,Following,1999,"['United Kingdom', 'England']","['Psychological thriller', 'Neo-noir', 'Black-and-white', 'Crime Fiction', 'Mystery', 'Indie', 'Thriller', 'Crime Thriller', 'Cult', 'Drama', 'Suspense']",1990,9
801064,Porky's Duck Hunt,1937,['United States of America'],"['Short Film', 'Black-and-white']",1930,7
2384098,American Shaolin,1991,"['Hong Kong', 'United States of America']","['Action', 'Chinese Movies', 'Martial Arts Film']",1990,1
19158255,Le Clan des Siciliens,1969,['France'],"['Crime Fiction', 'Gangster Film', 'Caper story', 'Crime Thriller', 'Drama']",1960,9
10732804,The Glamorous Life of Sachiko Hanai,2003,['Japan'],"['Political satire', 'Comedy', 'Thriller', 'World cinema', 'Drama', 'Political cinema', 'Japanese Movies', 'Pinku eiga', 'Erotica', 'Fantasy', 'Sex comedy']",2000,3
6427576,Tamara,2006,"['Canada', 'United States of America']","['Fantasy', 'Thriller', 'Horror']",2000,6
2189914,Roseland,1977,['United States of America'],"['Romance Film', 'Romantic drama', 'Drama']",1970,7
18895130,Arvind Desai Ki Ajeeb Dastaan,1978,['India'],['Drama'],1970,8
30780644,Boy Trouble,1939,['United States of America'],"['Melodrama', 'Comedy-drama']",1930,9
675878,The Great White Hype,1996,['United States of America'],"['Boxing', 'Parody', 'Satire', 'Comedy', 'Sports']",1990,6
4298666,The Man Who Fell to Earth,1976,"['United Kingdom', 'United States of America']","['Film adaptation', 'Science Fiction', 'Drama', 'Cult']",1970,6
15843010,The Other Boleyn Girl,2003,['United Kingdom'],"['Period piece', 'Romantic drama', 'Romance Film', 'Costume drama', 'Drama']",2000,3
19145638,Dougal and the Blue Cat,1970,['France'],"['Animation', 'Stop motion', 'Adventure', 'Fantasy']",1970,0
8347090,My Sweet Little Village,1985,"['Czech Republic', 'Czechoslovakia']","['Drama', 'Comedy']",1980,5
273593,Jedda,1955,['Australia'],"['Romantic drama', 'Family Drama', 'Drama']",1950,5
104916,Man on the Moon,1999,"['Japan', 'United Kingdom', 'Germany', 'United States of America']","['Period piece', 'Japanese Movies', 'Biography', 'Comedy', 'Biographical film', 'Drama']",1990,9
11339461,Pet Peeve,1954,['United States of America'],"['Comedy', ""Children's/Family""]",1950,4
11719444,Manuale d'amore,2005,['Italy'],"['Romantic drama', 'Comedy']",2000,5
16676489,Stranded: NxE1ufragos,2001,['Spain'],"['Thriller', 'World cinema', 'Adventure', 'Disaster', 'Science Fiction', 'Drama']",2000,1
22101232,What a Carve Up!,1962,['United Kingdom'],"['Mystery', 'Comedy', 'Thriller', 'Crime Thriller']",1960,2
31156887,Ponmudipuzhayorathu,2005,['India'],"['Drama', 'Crime Fiction']",2000,5
8252596,Chinnodu,2006,['India'],"['Action', 'Crime Fiction', 'Drama']",2000,6
8991445,La soupe aux choux,1981,['France'],['Comedy'],1980,1
2318313,The Perfect Man,2005,['United States of America'],"['Comedy', 'Romance Film', 'Romantic comedy', 'Family Film']",2000,5
2243660,D.C. Cab,1983,['United States of America'],"['Action', 'Action/Adventure', 'Comedy', 'Workplace Comedy']",1980,3
11545338,Bag Københavns kulisser,1935,['Denmark'],['Black-and-white'],1930,5
2351932,Friday the 13th Part VIII: Jason Takes Manhattan,1989,['United States of America'],"['Slasher', 'Teen', 'Horror', 'Cult']",1980,9
1364770,8mm,1999,"['Germany', 'United States of America']","['Mystery', 'Crime Thriller', 'Thriller']",1990,9
19417220,Lakeboat,2001,"['Canada', 'United States of America']","['Film adaptation', 'Drama', 'Indie', 'Comedy']",2000,1
9105282,Men with Guns,1997,['United States of America'],"['Indie', 'Action/Adventure', 'Adventure', 'Political drama', 'Drama']",1990,7
6631824,Aashiqui,1990,['India'],"['Musical', 'Romantic drama', 'Bollywood', 'World cinema', 'Romance Film', 'Drama']",1990,0
3524245,"Retreat, Hell!",1952,['United States of America'],"['Combat Films', 'Black-and-white', 'War film']",1950,2
35321421,Magic Flute Diaries,2008,['Canada'],"['Romance Film', 'Romantic drama', 'Drama']",2000,8
5377861,The Three Stooges Meet Hercules,1962,['United States of America'],"['Black-and-white', 'Time travel', 'Parody', 'Comedy', 'Slapstick', 'Fantasy']",1960,2
5123756,The Pelican Brief,1993,['United States of America'],"['Action', 'Film adaptation', 'Action Thrillers', 'Mystery', 'Action/Adventure', 'Thriller', 'Courtroom Drama', 'Suspense', 'Political thriller']",1990,3
22246659,O ziliarogatos,1956,['Greece'],['Comedy'],1950,6
3043729,The Man,1972,['United States of America'],"['Film adaptation', 'Television movie', 'Political drama', 'Drama']",1970,2
35448806,A Brokedown Melody,2004,['United States of America'],"['Sports', 'Documentary']",2000,4
19347806,Bouncing Babies,1929,['United States of America'],"['Black-and-white', 'Short Film', 'Comedy', 'Family Film']",1920,9
30485890,Modadha Mareyalli,1991,['India'],['Action'],1990,1
570231,Godzilla vs. Hedorah,1971,['Japan'],"['Creature Film', 'Monster', 'Japanese Movies', 'Horror', 'World cinema', 'Science Fiction', 'Cult']",1970,1
8256015,You're in the Navy Now,1951,['United States of America'],"['Black-and-white', 'Comedy', 'War film', 'Slapstick']",1950,1
15059457,Aag Aur Shola,1986,['India'],"['Romantic drama', 'World cinema', 'Romance Film', 'Drama']",1980,6
25868401,La Pointe Courte,1955,['France'],"['Art film', 'Romantic drama', 'Marriage Drama', 'World cinema', 'Romance Film', 'Comedy-drama', 'Drama']",1950,5
11508646,La Nuit porte-jarretelles,1985,['France'],['Romance Film'],1980,5
8743599,Baazi,1995,['India'],"['Musical', 'Bollywood', 'World cinema', 'Drama']",1990,5
30050789,Blue Tornado,1991,['Italy'],"['Action', 'Thriller']",1990,1
12794951,The Notorious Landlady,1962,['United States of America'],"['Mystery', 'Comedy', 'Thriller', 'Crime Comedy', 'Romance Film', 'Romantic comedy']",1960,2
7641358,Man in the Dark,1953,['United States of America'],"['Film noir', 'Crime Fiction']",1950,3
1643411,"Oh, Mr Porter!",1937,"['United Kingdom', 'England']","['Comedy', 'Black-and-white']",1930,7
27763708,They Came to Rob Las Vegas,1968,"['Spain', 'France', 'West Germany', 'Italy']","['Drama', 'Crime Fiction']",1960,8
25842111,ICarly: iGo to Japan,2008,"['Japan', 'United States of America']","['Japanese Movies', 'Comedy', 'Family Film']",2000,8
1822948,The Rachel Papers,1989,['United Kingdom'],"['Coming of age', 'Comedy', 'Teen', 'Romantic comedy', 'Romance Film', 'Drama', 'Sex comedy']",1980,9
10053468,La Anam,1958,['Egypt'],"['Romance Film', 'Drama']",1950,8
3180932,Thin Ice,1937,['United States of America'],"['Comedy', 'Black-and-white']",1930,7
8447225,The Barber of Siberia,1998,"['Russia', 'France', 'Czech Republic', 'Italy']","['Romance Film', 'Comedy', 'Drama']",1990,8
9072423,The Danish Poet,2006,"['Norway', 'Spain', 'Canada']","['Animated cartoon', 'Animation', 'Short Film', 'Romance Film']",2000,6
61522,The Awful Truth,1937,['United States of America'],"['Romance Film', 'Comedy']",1930,7
2016450,The Reaping,2007,['United States of America'],"['Thriller', 'Horror']",2000,7
13196764,Amnèsia,2002,"['Spain', 'Italy']",['Drama'],2000,2
17489405,1977,2008,['India'],"['Action', 'Drama']",2000,8
20581383,Gaon Hamara Shaher Tumhara,1972,['India'],"['Romance Film', 'Drama', 'Family Film']",1970,2
12151283,Tentacles,1977,"['Italy', 'United States of America']","['Horror', 'Natural horror films']",1970,7
1360465,Travellers and Magicians,2003,"['Bhutan', 'Australia']","['Art film', 'World cinema', 'Adventure', 'Drama']",2000,3
1487971,Balto,1995,['United States of America'],"['Animation', 'Animal Picture', 'Family-Oriented Adventure', ""Children's/Family"", 'Adventure', 'Family Film']",1990,5
2743228,Identity Crisis,1989,['United States of America'],"['Action', 'Indie', 'Comedy', 'Hip hop movies', 'Fantasy Comedy']",1980,9
1089233,Revenge of the Nerds IV: Nerds in Love,1994,['United States of America'],"['Romance Film', 'Comedy']",1990,4
1039414,Cecil B. Demented,2000,"['France', 'United States of America']","['Action', 'Crime Fiction', 'Indie', 'Satire', 'Thriller', 'Comedy', 'Media Satire', 'Black comedy', 'Cult']",2000,0
26197151,Dominique,1979,['United Kingdom'],"['Supernatural', 'Thriller', 'Horror']",1970,9
2891451,Love in Magic,2005,['South Korea'],"['Romance Film', 'Comedy']",2000,5
32665121,Bryan Loves You,2008,['United States of America'],"['Psychological thriller', 'Slasher', 'Horror', 'B-movie']",2000,8
26723880,Thavalam,2008,['India'],"['Musical', 'Bollywood', 'World cinema', 'Drama']",2000,8
32441728,Los tramposos,1959,[],['Comedy film'],1950,9
4034543,King of Sorrow,2006,['Canada'],"['Thriller', 'Drama']",2000,6
8574461,Silent Night,2002,['Canada'],"['Period piece', 'Television movie', 'War film', 'Drama']",2000,2
4573027,Border Patrol,1942,['United States of America'],"['Action', 'Black-and-white', 'Western', 'Adventure']",1940,2
10594693,Bobby Deerfield,1977,['United States of America'],"['Auto racing', 'Romantic drama', 'Romance Film', 'Melodrama', 'Sports', 'Drama']",1970,7
200626,Adaptation,2002,['United States of America'],"['Crime Fiction', 'Satire', 'Comedy', 'Black comedy', 'Comedy-drama', 'Drama', 'Cult']",2000,2
1252820,Cows,1992,['Spain'],"['Drama', 'World cinema']",1990,2
18578504,Table for Five,1983,['United States of America'],"['Indie', 'Family Drama', 'Drama']",1980,3
5028363,"Tom, Dick, and Harry",2006,['India'],['Comedy'],2000,6
15402213,Blast!,2004,"['Germany', 'South Africa', 'United States of America']","['Action', 'Thriller', 'Comedy film']",2000,4
11988,King Kong vs. Godzilla,1962,['Japan'],"['Creature Film', 'Monster movie', 'Japanese Movies', 'Monster', 'Science Fiction', 'Cult', 'Fantasy']",1960,2
22063038,Reunion,1989,"['United Kingdom', 'France', 'West Germany']",['Drama'],1980,9
670013,Final Fantasy VII: Advent Children,2005,['Japan'],"['Action', 'Computer Animation', 'Animation', 'Japanese Movies', 'Thriller', 'Anime', 'Science Fiction']",2000,5
28442568,Jaganmohini,1978,['India'],['Drama'],1970,8
96893,Blow,2001,['United States of America'],"['Period piece', 'Film adaptation', 'Crime Fiction', 'Biography', 'Biographical film', 'Drama']",2000,1
18307105,Worlds Apart,2008,['Denmark'],['Drama'],2000,8
613518,Win a Date with Tad Hamilton!,2004,['United States of America'],"['Romance Film', 'Romantic comedy', 'Comedy']",2000,4
1619872,Downhill,1927,['United Kingdom'],"['Black-and-white', 'Drama', 'Family Drama', 'Indie', 'Thriller', 'Silent film', 'Adventure']",1920,7
30080805,Ice Bound,2003,"['Canada', 'United States of America']",['Drama'],2000,3
5082748,Face,1997,['United Kingdom'],"['Crime Fiction', 'Thriller', 'Crime Thriller', 'Drama']",1990,7
1365621,"Murder, Inc.",1960,['United States of America'],"['Crime Fiction', 'Gangster Film', 'Thriller', 'Crime Drama', 'Crime Thriller', 'Drama']",1960,0
180606,The Animatrix,2003,"['Japan', 'United States of America']","['Action', 'Animation', 'Japanese Movies', 'Adventure', 'Anime', 'Science Fiction', 'Drama']",2000,3
226202,While You Were Sleeping,1995,['United States of America'],"['Romance Film', 'Romantic comedy', 'Comedy']",1990,5
7362462,The Power of Kangwon Province,1998,['South Korea'],"['Romantic drama', 'World cinema', 'Romance Film', 'Drama']",1990,8
1724301,Turner & Hooch,1989,['United States of America'],"['Action', 'Crime Fiction', 'Action/Adventure', 'Comedy', 'Family Film']",1980,9
5198820,This Property is Condemned,1966,['United States of America'],"['Romantic drama', 'Romance Film', 'Melodrama', 'Drama']",1960,6
1346910,The Kid,1999,['Hong Kong'],"['Chinese Movies', 'Drama']",1990,9
5638224,The Born Losers,1967,['United States of America'],"['Action', 'Crime Fiction', 'Action Thrillers', 'Indie', 'Action/Adventure', 'Thriller', 'Drama', 'Biker Film', 'Outlaw biker film']",1960,7
15155743,The Lazarus Project,2008,['United States of America'],"['Psychological thriller', 'Crime Fiction', 'Mystery', 'Thriller', 'Supernatural', 'Science Fiction']",2000,8
8509794,Meet the Deedles,1998,['United States of America'],"['Adventure Comedy', 'Buddy film', 'Comedy', 'Teen']",1990,8
6051512,A Feather in His Hare,1948,['United States of America'],"['Animation', 'Short Film', 'Family Film']",1940,8
6097521,Firelight,1997,"['United Kingdom', 'France', 'United States of America']","['Romantic drama', 'World cinema', 'Romance Film', 'Costume drama', 'Drama']",1990,7
90684,Inside Monkey Zetterland,1992,['United States of America'],"['Indie', 'Satire', 'Comedy', 'Domestic Comedy']",1990,2
14248418,Krishna,1996,['India'],['Action'],1990,6
16770876,Max Payne,2008,"['Canada', 'United States of America']","['Action', 'Crime Fiction', 'Action/Adventure', 'Thriller', 'Crime Thriller']",2000,8
23440490,Me Shivajiraje Bhosale Boltoy,2009,['India'],['Drama'],2000,9
3031997,Big Eden,2000,['United States of America'],"['LGBT', 'Indie', 'Romance Film', 'Drama', 'Gay Themed', 'Gay', 'Gay Interest', 'Romantic comedy', 'Comedy-drama']",2000,0
6305925,The Astronaut Farmer,2006,['United States of America'],"['Indie', 'Adventure', 'Americana', 'Science Fiction', 'Drama']",2000,6
689490,Birthday Girl,2002,"['United Kingdom', 'United States of America']","['Crime Fiction', 'Indie', 'Comedy', 'Thriller', 'Black comedy', 'Romance Film', 'Drama', 'Erotic thriller']",2000,2
8469182,Animal Farm,1999,"['United Kingdom', 'United States of America']","['Film adaptation', 'Comedy', 'Political drama', 'Drama']",1990,9
17778990,A Very Special Love,2008,['Philippines'],"['Romance Film', 'Comedy film']",2000,8
34206301,The Terrorist,1995,['South Korea'],['Action'],1990,5
1128240,Final Destination 2,2003,"['Canada', 'United States of America']","['Slasher', 'Thriller', 'Horror', 'Teen', 'Supernatural', 'Cult']",2000,3
7026014,Fools' Parade,1971,['United States of America'],"['Western', 'Comedy', 'Drama']",1970,1
36061953,The Substitute Wife,1994,['United States of America'],['Drama'],1990,4
4040311,Truck Turner,1974,['United States of America'],"['Action', 'Blaxploitation', 'Crime Fiction', 'Action Thrillers', 'Action/Adventure', 'Thriller']",1970,4
15708834,Under the Sand,2000,"['France', 'Japan']","['Mystery', 'Japanese Movies', 'World cinema', 'Drama']",2000,0
17444132,All-American Murder,1991,['United States of America'],"['Mystery', 'Thriller', 'Horror', 'Whodunit', 'Crime Thriller']",1990,1
18895319,Skullduggery,1970,['United States of America'],['Science Fiction'],1970,0
9881899,Elsa y Fred,2005,"['Argentina', 'Spain']","['Romantic drama', 'Comedy', 'World cinema', 'Romance Film', 'Romantic comedy', 'Drama']",2000,5
14346303,Daddy,1989,['India'],['Family Film'],1980,9
34825470,Listening,2003,['United Kingdom'],['Short Film'],2000,3
1380361,View from the Top,2003,['United States of America'],"['Romance Film', 'Romantic comedy', 'Comedy']",2000,3
4881898,Babylon A.D.,2008,"['United Kingdom', 'France', 'United States of America']","['Action', 'Thriller', 'Adventure', 'Science Fiction']",2000,8
6184646,The Life of the Party,1930,['United States of America'],"['Musical comedy', 'Pre-Code']",1930,0
14920398,The Wayward Bus,1957,['United States of America'],['Drama'],1950,7
13036480,Eight,1998,['United Kingdom'],"['Short Film', 'Drama']",1990,8
19400450,The Lucky Corner,1935,['United States of America'],"['Black-and-white', 'Short Film', 'Comedy', 'Family Film']",1930,5
2467561,"Play It Again, Sam",1972,['United States of America'],"['Film adaptation', 'Parody', 'Comedy', 'Romance Film', 'Romantic comedy', 'Drama']",1970,2
7212423,Trick or Treat,1986,['United States of America'],['Horror'],1980,6
7329566,Black Widow,1987,['United States of America'],"['Psychological thriller', 'Neo-noir', 'Mystery', 'Thriller', 'Crime Thriller']",1980,7
3546305,Dream a Little Dream 2,1995,['United States of America'],"['Drama', 'Indie', 'Comedy', 'Thriller', 'Fantasy Comedy', 'Sex comedy']",1990,5
18621136,Pandhayam,2008,['India'],"['Action', 'Romance Film']",2000,8
5257449,Joe,1970,['United States of America'],"['Crime Fiction', 'Indie', 'Drama']",1970,0
23691256,Colorado,1940,['United States of America'],"['Action/Adventure', 'Western']",1940,0
5464002,Putting Pants on Philip,1927,['United States of America'],"['Black-and-white', 'Indie', 'Short Film', 'Comedy', 'Silent film', 'Slapstick']",1920,7
1373876,My Family,1995,['United States of America'],"['Period piece', 'Indie', 'Drama']",1990,5
28256244,The Vengeance of She,1968,['United Kingdom'],"['Fantasy Adventure', 'Horror', 'Adventure', 'Fantasy']",1960,8
8784005,The Scarlet Flower,1952,['Soviet Union'],"['Fairy tale', ""Children's Fantasy"", ""Children's/Family"", 'Fantasy']",1950,2
2139989,The Junkman,1982,['United States of America'],"['Action', 'Chase Movie', 'Action Comedy', 'Action/Adventure', 'Comedy', 'Thriller', 'Crime Thriller']",1980,2
28214796,Mickey's Helping Hand,1931,['United States of America'],['Short Film'],1930,1
27656936,Thunderground,1989,"['Canada', 'United States of America']","['Action', 'Drama', 'Martial Arts Film']",1980,9
240363,Starting Over,1979,['United States of America'],"['Romance Film', 'Romantic comedy', 'Comedy']",1970,9
7362741,Woman is the Future of Man,2004,['South Korea'],"['Romantic drama', 'World cinema', 'Romance Film', 'Drama']",2000,4
3198884,The Devil's Playground,1976,"['New Zealand', 'Australia']","['Period piece', 'Indie', 'Biographical film', 'World cinema', 'Drama']",1970,6
343684,In the Mouth of Madness,1995,['United States of America'],"['Suspense', 'Psychological thriller', 'Mystery', 'Thriller', 'Horror', 'Supernatural']",1990,5
654530,Legends of the Fall,1994,['United States of America'],"['Film adaptation', 'Family Drama', 'Romantic drama', 'Romance Film', 'Drama', 'Period piece', 'Western', 'War film']",1990,4
5935181,Les Chevaliers du ciel,2005,['France'],"['Action', 'Action/Adventure', 'Thriller', 'World cinema', 'Adventure']",2000,5
13682670,Carved: The Slit Mouthed Woman,2007,['Japan'],"['Japanese Movies', 'Thriller', 'Horror', 'World cinema']",2000,7
707808,Snatch,2000,"['United Kingdom', 'United States of America']","['Action', 'Crime Fiction', 'Gangster Film', 'Action/Adventure', 'Comedy', 'Thriller', 'Black comedy', 'Crime Thriller', 'Heist']",2000,0
1367497,Running on Empty,1988,['United States of America'],"['Coming of age', 'Drama']",1980,8
12816415,On the Town,1949,['United States of America'],['Musical'],1940,9
2880294,Ruby in Paradise,1993,['United States of America'],"['Romantic drama', 'Indie', 'Romance Film', 'Drama', 'Feminist Film']",1990,3
8030277,Blonde Venus,1932,['United States of America'],"['Black-and-white', 'Romance Film', 'Melodrama', 'Pre-Code', 'Drama']",1930,2
271588,It,1927,['United States of America'],"['Black-and-white', 'Indie', 'Romantic drama', 'Comedy', 'Romance Film', 'Drama', 'Silent film', 'Romantic comedy']",1920,7
16682049,The Bandit,1946,['Italy'],"['Black-and-white', 'Crime Fiction', 'Road movie', 'Drama']",1940,6
4329971,Waterloo Bridge,1931,['United States of America'],"['Black-and-white', 'Romance Film', 'War film', 'Pre-Code', 'Drama']",1930,1
23150423,The Rack,1956,['United States of America'],"['War film', 'Drama']",1950,6
20848381,A Daughter of the Congo,1930,['United States of America'],['Adventure'],1930,0
21551575,Demonia,1990,['Italy'],"['World cinema', 'Horror']",1990,0
21440868,Bhageeratha,2005,['India'],"['Tollywood', 'Drama']",2000,5
1732917,The Gauntlet,1977,['United States of America'],"['Action', 'Crime Fiction', 'Action/Adventure', 'Thriller', 'Crime Thriller']",1970,7
1965350,Summer Lovers,1982,['United States of America'],"['Drama', 'Indie', 'Romantic drama', 'Comedy', 'Romance Film', 'Romantic comedy']",1980,2
12469751,Scorcher,2002,['United States of America'],"['Action', 'Action/Adventure', 'Science Fiction', 'Thriller', 'Disaster']",2000,2
157481,Diamonds Are Forever,1971,['United Kingdom'],"['Action', 'Spy', 'Action/Adventure', 'Science Fiction', 'Thriller', 'Glamorized Spy Film']",1970,1
2091487,Bangaaradha Manushya,1970,['India'],"['Musical', 'Bollywood', 'World cinema', 'Drama']",1970,0
5181141,Namak Haraam,1973,['India'],"['Drama', 'Bollywood', 'World cinema']",1970,3
8977977,County Hospital,1932,['United States of America'],"['Short Film', 'Black-and-white', 'Comedy']",1930,2
1915220,Land and Freedom,1995,"['Spain', 'United Kingdom', 'Germany', 'Italy']","['War film', 'Drama', 'Political drama']",1990,5
1506960,Get Over It,2001,['United States of America'],"['Musical', 'Comedy', 'Teen', 'Romance Film', 'Gay Themed', 'Gay', 'School story', 'Gay Interest', 'Romantic comedy', 'Sex comedy']",2000,1
2636543,Dad,1989,['United States of America'],"['Comedy-drama', 'Comedy', 'Drama']",1980,9
14247287,Mutts to You,1938,['United States of America'],"['Short Film', 'Black-and-white', 'Comedy']",1930,8
3817298,Chandni Bar,2001,['India'],"['Art film', 'Bollywood', 'World cinema', 'Drama']",2000,1
1241914,Erin Brockovich,2000,['United States of America'],"['Biographical film', 'Romance Film', 'Docudrama', 'Drama', 'Courtroom Drama', 'Feminist Film', 'Comedy-drama', 'Legal drama']",2000,0
1377382,Racing Stripes,2005,['United States of America'],"['Horse racing', 'Comedy', 'Animal Picture', ""Children's/Family"", 'Adventure', 'Drama', 'Family Film']",2000,5
27960737,Buzzy Boop,1938,['United States of America'],"['Animation', 'Short Film', 'Comedy', 'Family Film']",1930,8
1410384,Dragon Ball Z: The Tree of Might,1990,['Japan'],"['Action', 'Animated cartoon', 'Animation', 'Anime', ""Children's"", 'Japanese Movies', 'Science Fiction', 'Fantasy']",1990,0
4515932,Ghost in the Shell: Solid State Society,2006,['Japan'],"['Action', 'Animation', 'Action/Adventure', 'Thriller', 'World cinema', 'Japanese Movies', 'Anime', 'Science Fiction']",2000,6
11385169,Tom's Photo Finish,1957,['United States of America'],"['Comedy', ""Children's/Family""]",1950,7
3612393,Johnny Angel,1945,['United States of America'],"['Action', 'Black-and-white', 'Crime Fiction', 'Mystery', 'Thriller', 'Film noir', 'Drama']",1940,5
279813,Raising Arizona,1987,['United States of America'],"['Crime Fiction', 'Mystery', 'Comedy', 'Black comedy', 'Adventure', 'Crime Comedy', 'Domestic Comedy', 'Cult']",1980,7
6542034,The Queen,2006,"['United Kingdom', 'France', 'Italy']","['Biography', 'Biographical film', 'Political drama', 'Drama']",2000,6
3771009,The Captive City,1952,['United States of America'],"['Crime Fiction', 'Film noir', 'Crime Drama', 'Drama']",1950,2
1039551,Blankman,1994,['United States of America'],"['Action', 'Superhero', 'Action/Adventure', 'Buddy film', 'Comedy', 'Parody', 'Action Comedy', 'Superhero movie', 'Romantic comedy']",1990,4
286544,Deep Impact,1998,['United States of America'],"['Action', 'Action/Adventure', 'Thriller', 'Doomsday film', 'Disaster', 'Science Fiction', 'Drama']",1990,8
26838612,No Contest,1994,"['Canada', 'United States of America']","['Action', 'Crime Fiction', 'Action/Adventure', 'Thriller', 'Erotic thriller', 'Adult']",1990,4
3165521,Jolly Fellows,1934,['Soviet Union'],"['Musical', 'Comedy film']",1930,4
16619779,The Round-Up,1966,['Hungary'],"['Period piece', 'War film', 'Political drama', 'Drama']",1960,6
22536936,City Island,2009,['United States of America'],"['Comedy-drama', 'Indie', 'Comedy']",2000,9
24389074,The Beloved,1973,['United Kingdom'],['Drama'],1970,3
20518467,The Tree Medic,1955,['United States of America'],"['Animation', 'Short Film', 'Family Film']",1950,5
6169073,Wild Poses,1933,['United States of America'],"['Black-and-white', 'Short Film', 'Comedy', 'Family Film']",1930,3
22077582,The Courtesans of Bombay,1983,[],"['Drama', 'Documentary']",1980,3
26151559,Voice in the Wind,1944,['United States of America'],"['Action', 'Drama', 'Film noir', 'Romance Film', 'War film']",1940,4
19625929,Falling Down,1993,"['United Kingdom', 'France', 'United States of America']","['Action', 'Psychological thriller', 'Crime Fiction', 'Comedy', 'Thriller', 'Black comedy', 'Crime Thriller', 'Drama', 'Crime Drama']",1990,3
4278211,Die Screaming Marianne,1970,['United Kingdom'],"['Suspense', 'Thriller', 'Horror', 'Crime Thriller']",1970,0
26694308,Ishtam,2001,['India'],"['Comedy', 'Romance Film', 'Drama', 'Family Film']",2000,1
2028297,The Beast of Yucca Flats,1961,['United States of America'],"['Black-and-white', 'Indie', 'Sci-Fi Horror', 'Creature Film', 'Monster movie', 'Horror', 'B-movie', 'Science Fiction', 'Cult']",1960,1
13248717,Marathon,2005,['South Korea'],['Drama'],2000,5
8641043,Labou,2009,['United States of America'],"['Teen', 'Family-Oriented Adventure', ""Children's/Family"", ""Children's"", 'Adventure', ""Children's Fantasy"", 'Family Film', 'Fantasy']",2000,9
750694,Stuart Little 2,2002,['United States of America'],"['Fantasy Adventure', 'Comedy', 'Family-Oriented Adventure', ""Children's/Family"", 'Adventure', 'Computer Animation', 'Family Film', 'Fantasy']",2000,2
9170541,Thoroughbreds Don't Cry,1937,['United States of America'],"['Musical', 'Adventure', 'Drama']",1930,7
1238914,Easy Living,1937,['United States of America'],"['Black-and-white', 'Screwball comedy', 'Comedy']",1930,7
32107837,Music in the Air,1934,['United States of America'],['Musical'],1930,4
345105,D.C. Sniper: 23 Days of Fear,2003,['United States of America'],"['Thriller', 'Drama']",2000,3
7467056,Millionaire's Express,1986,['Hong Kong'],"['Action', 'Chinese Movies', 'Action/Adventure', 'Western', 'Comedy', 'World cinema', 'Martial Arts Film']",1980,6
31079,The Wedding Planner,2001,"['Germany', 'United States of America']","['Romantic drama', 'Comedy', 'Romance Film', 'Romantic comedy', 'Drama']",2000,1
4731866,Imitation of Life,1934,['United States of America'],"['Film adaptation', 'Black-and-white', 'Romance Film', 'Drama']",1930,4
61168,Flirtation Walk,1934,['United States of America'],"['Musical', 'Romance Film', 'Black-and-white']",1930,4
1781284,The Trouble with Girls,1969,['United States of America'],"['Musical', 'Comedy', 'Romance Film', 'Drama']",1960,9
15148739,One Terrible Day,1922,['United States of America'],"['Black-and-white', 'Indie', 'Short Film', 'Comedy', 'Silent film', 'Family Film']",1920,2
8851344,Premonition,2007,['United States of America'],"['Psychological thriller', 'Mystery', 'Thriller', 'Supernatural', 'Drama', 'Fantasy']",2000,7
19267191,Straight,2007,['Germany'],"['LGBT', 'Romantic drama', 'World cinema', 'Romance Film', 'Drama']",2000,7
30492267,Ottayal Pattalam,1995,['India'],['Comedy film'],1990,5
17578316,Gomorra,2008,['Italy'],"['Crime Fiction', 'Art film', 'Thriller', 'World cinema', 'Crime Thriller', 'Drama']",2000,8
5618260,Kill the Poor,2003,['United States of America'],"['Film adaptation', 'Drama', 'Indie', 'Comedy', 'Black comedy']",2000,3
15930359,Mission Istanbul,2008,['India'],"['Action', 'Musical', 'Action/Adventure', 'Bollywood', 'World cinema']",2000,8
14157327,Stand-In,1937,['United States of America'],"['Screwball comedy', 'Satire', 'Comedy']",1930,7
1357152,Houseguest,1995,['United States of America'],"['Comedy', 'Domestic Comedy', 'Family Film', 'Comedy of Errors']",1990,5
19101343,10 Rillington Place,1971,['United Kingdom'],"['Crime Fiction', 'Biography', 'Drama']",1970,1
1202005,Sallah,1965,['Israel'],"['Comedy', 'World cinema']",1960,5
10794581,Nightmare Detective,2007,['Japan'],"['Japanese Movies', 'Thriller', 'World cinema', 'Horror', 'Supernatural', 'Fantasy']",2000,7
18346225,The Crowd Roars,1932,['United States of America'],"['Black-and-white', 'Auto racing', 'Drama']",1930,2
16757667,The Hunter's Moon,1999,['United States of America'],"['Action', 'Drama', 'Chase Movie', 'Romance Film', 'Television movie']",1990,9
5696955,Kermit's Swamp Years,2002,['United States of America'],"['Comedy', 'Family Film', 'Adventure']",2000,2
26136240,Barda,2007,['Turkey'],['Horror'],2000,7
18454490,Escape to Witch Mountain,1975,['United States of America'],"['Mystery', 'Adventure', 'Science Fiction', 'Drama', 'Family Film', 'Fantasy']",1970,5
24160684,Tag: The Assassination Game,1982,['United States of America'],"['Action', 'Indie', 'Thriller']",1980,2
12005,The Return of Godzilla,1984,['Japan'],"['Monster', 'Science Fiction', 'Japanese Movies']",1980,4
23691025,Sheriff of Tombstone,1941,['United States of America'],"['Action', 'Western', 'Action/Adventure']",1940,1
31890421,Sex & Philosophy,2005,"['France', 'Iran']",['Drama'],2000,5
7837396,Becket,1964,"['United Kingdom', 'United States of America']","['Period piece', 'Biography', 'Biographical film', 'Costume drama', 'Drama']",1960,4
16148512,Voltaire,1933,['United States of America'],"['Period piece', 'Black-and-white', 'Biographical film', 'Biopic [feature]', 'Drama']",1930,3
20903266,Bundal Baaz,1976,['India'],"['Musical', 'Comedy', 'Bollywood', 'World cinema', 'Romance Film', 'Romantic comedy']",1970,6
3644779,Gertrud,1964,['Denmark'],"['Black-and-white', 'Art film', 'Romantic drama', 'Marriage Drama', 'World cinema', 'Romance Film', 'Drama']",1960,4
210216,The L-Shaped Room,1962,['United Kingdom'],"['Film adaptation', 'Kitchen sink realism', 'Drama', 'Ensemble Film']",1960,2
276070,Blood Simple,1984,['United States of America'],"['Neo-noir', 'Crime Fiction', 'Thriller', 'Crime Thriller', 'Drama']",1980,4
11757037,Abby Singer,2003,['United States of America'],"['Comedy-drama', 'Comedy', 'Drama']",2000,3
12386689,Miami Supercops,1985,['Italy'],"['Action', 'Comedy']",1980,5
7154010,Curse Of The Puppet Master,1998,['United States of America'],['Horror'],1990,8
3124974,Gambit,1966,['United States of America'],"['Crime Fiction', 'Thriller']",1960,6
1179278,The Dead Pool,1988,['United States of America'],"['Action', 'Crime Fiction', 'Action Thrillers', 'Action/Adventure', 'Thriller']",1980,8
26118288,A Gentleman After Dark,1942,['United States of America'],"['Drama', 'Crime Fiction']",1940,2
1676093,Strike It Rich,1990,['United Kingdom'],['Romantic comedy'],1990,0
8869015,Abschied,1930,"['Weimar Republic', 'Germany']","['Black-and-white', 'Comedy', 'Romance Film', 'Romantic comedy']",1930,0
25065935,The Christmas Wish,1998,['United States of America'],['Drama'],1990,8
25581548,Birdemic: Shock and Terror,2008,['United States of America'],"['Comedy', 'Thriller', 'Horror', 'Romance Film', 'B-movie', 'Natural disaster']",2000,8
6694508,The Wasp Woman,1959,['United States of America'],"['Black-and-white', 'Horror', 'B-movie', 'Science Fiction']",1950,9
9244646,Cape of Good Hope,2004,"['United States of America', 'South Africa']","['Romantic drama', 'Comedy', 'World cinema', 'Romance Film', 'Comedy-drama', 'Drama', 'Ensemble Film']",2000,4
320527,Pink Flamingos,1972,['United States of America'],"['Gross out', 'Crime Fiction', 'Gross-out film', 'Comedy', 'Black comedy', 'Drama', 'Gay Themed', 'Gay', 'Gay Interest', 'Horror', 'Cult']",1970,2
8447914,The Wild Dogs,2002,['Canada'],"['Social problem film', 'Indie', 'Drama']",2000,2
1176717,Gummo,1997,['United States of America'],"['Drama', 'Indie', 'Avant-garde', 'Teen', 'Experimental film', 'Ensemble Film']",1990,7
31149282,Jaisi Karni Waisi Bharni,1989,['India'],"['Drama', 'World cinema']",1980,9
8300166,Delhii Heights,2007,['India'],"['Musical', 'Romantic drama', 'Comedy', 'Bollywood', 'World cinema', 'Romance Film', 'Drama', 'Romantic comedy']",2000,7
887135,The Portrait of a Lady,1996,"['United Kingdom', 'United States of America']","['Period piece', 'Film adaptation', 'Feminist Film', 'Romantic drama', 'Romance Film', 'Drama']",1990,6
1631700,2009 Lost Memories,2002,['South Korea'],"['Action', 'Action/Adventure', 'Science Fiction', 'Thriller', 'World cinema']",2000,2
2037852,Stealing Harvard,2002,['United States of America'],"['Action', 'Crime Fiction', 'Action/Adventure', 'Slapstick', 'Comedy', 'Crime Comedy', 'Comedy of Errors']",2000,2
680006,The Jungle Book,1967,['United States of America'],"['Musical', 'Animation', 'Adventure', 'Drama', 'Family Film', 'Fantasy']",1960,7
583407,Return to Oz,1985,"['United Kingdom', 'United States of America']","['Steampunk', 'Adventure', 'Family Film', 'Fantasy']",1980,5
2987486,Proof,1991,"['New Zealand', 'Australia']","['Romantic drama', 'Comedy', 'World cinema', 'Black comedy', 'Romantic comedy', 'Romance Film', 'Drama']",1990,1
2949844,The Tillamook Treasure,2006,['United States of America'],['Family Film'],2000,6
17818658,God's Little Acre,1958,['United States of America'],"['Romance Film', 'Comedy', 'Drama']",1950,8
12139936,The Sea Hound,1947,['United States of America'],"['Action', 'Black-and-white', 'Adventure']",1940,7
21136555,Annie's Coming Out,1984,['Australia'],['Drama'],1980,4
540654,Body Heat,1981,['United States of America'],"['Neo-noir', 'Crime Fiction', 'Thriller', 'Erotic thriller', 'Romance Film', 'Crime Thriller', 'Drama']",1980,1
5706283,Legacy of Rage,1986,['Hong Kong'],"['Action', 'Thriller', 'World cinema', 'Chinese Movies', 'Martial Arts Film']",1980,6
6332837,Forty Guns,1957,['United States of America'],"['Action/Adventure', 'Western']",1950,7
12212206,The Surrogate Woman,1987,['South Korea'],['Drama'],1980,7
20889393,Ice Palace,1960,['United States of America'],"['Action', 'Adventure']",1960,0
3841831,The Darwin Awards,2006,['United States of America'],"['Indie', 'Comedy', 'Black comedy', 'Road movie']",2000,6
15759166,The Red Beret,1953,['United Kingdom'],"['War film', 'Drama']",1950,3
14538458,Gundaraj,1995,['India'],['Action'],1990,5
32361069,Cielito Lindo,2007,[],"['Thriller', 'Drama']",2000,7
3105804,The Secret of Convict Lake,1951,['United States of America'],"['Action', 'Western', 'Crime Drama', 'Adventure']",1950,1
2987094,Derailed,2005,"['United Kingdom', 'United States of America']","['Psychological thriller', 'Thriller', 'Crime Thriller', 'Drama']",2000,5
8401387,Black Shampoo,1976,['United States of America'],"['Action', 'Blaxploitation', 'Crime Fiction', 'Action Thrillers', 'Action/Adventure', 'Thriller', 'Drama']",1970,6
1348145,Emma,1932,['United States of America'],"['Black-and-white', 'Comedy-drama', 'Drama']",1930,2
73467,Five Easy Pieces,1970,['United States of America'],"['Family Drama', 'New Hollywood', 'Road movie', 'Drama']",1970,0
7222376,Le Grand Meaulnes,2006,['France'],['Drama'],2000,6
14580484,Dynamite,1929,['United States of America'],"['Black-and-white', 'Drama']",1920,9
13213647,Daffy Doodles,1946,['United States of America'],"['Animation', 'Short Film', 'Comedy', 'Family Film']",1940,6
225459,Lady Sings the Blues,1972,['United States of America'],"['Musical', 'Biography', 'Biographical film', 'Biopic [feature]', 'Musical Drama', 'Drama']",1970,2
29288654,The Silver King,1929,['United Kingdom'],['Silent film'],1920,9
14144087,Cody of the Pony Express,1950,['United States of America'],"['Adventure', 'Black-and-white']",1950,0
17452896,Pathram,1999,['India'],"['Action', 'Thriller', 'Bollywood']",1990,9
28746871,Drop Dead Darling,1966,['United Kingdom'],"['Comedy', 'Crime Fiction']",1960,6
6790169,The Boys Next Door,1985,['United States of America'],"['Crime Fiction', 'Indie', 'Thriller', 'Drama']",1980,5
3123636,The Spitfire Grill,1996,['United States of America'],"['Indie', 'Christian film', 'Melodrama', 'Drama']",1990,6
24328800,Poran Jaye Jolia Re,2009,['India'],"['Action', 'Drama', 'Romance Film', 'Adventure']",2000,9
28670668,Happiness Is,2009,[],['Documentary'],2000,9
8310271,Deadly Skies,2005,"['Canada', 'United States of America']","['LGBT', 'Thriller', 'Television movie', 'Science Fiction']",2000,5
24529619,Joey,1986,['United States of America'],['Drama'],1980,6
22724333,Iligos,1963,['Greece'],['Drama'],1960,3
32032279,My Man Adam,1985,[],['Comedy'],1980,5
1452866,Nothing Lasts Forever,1984,['United States of America'],"['Comedy', 'Science Fiction', 'Drama', 'Fantasy']",1980,4
22822894,Second Glance,1992,['United States of America'],"['Christian film', 'Drama']",1990,2
3027029,In This World,2002,['United Kingdom'],"['Documentary', 'Docudrama', 'Social problem film', 'Road movie', 'Political drama', 'Drama']",2000,2
8279668,"Federal Agents vs. Underworld, Inc",1949,['United States of America'],"['Action', 'Black-and-white', 'Drama', 'Crime Fiction', 'Adventure']",1940,9
12354998,Pyar Ki Jeet,1987,['India'],"['Musical', 'Comedy', 'Drama']",1980,7
19284029,Mon Amour: Shesher Kobita Revisited,2008,['India'],"['Musical', 'Bollywood', 'World cinema', 'Drama']",2000,8
20563678,Space Buddies,2009,"['Canada', 'United States of America']","['Animation', 'Family-Oriented Adventure', ""Children's/Family"", ""Children's"", 'Adventure', 'Animal Picture', 'Science Fiction', 'Family Film', 'Fantasy']",2000,9
12864134,Angel,2007,['Puerto Rico'],['Drama'],2000,7
35743450,Valerie,1957,['United States of America'],['Western'],1950,7
30846475,The Pit and the Pendulum,2009,['United States of America'],"['LGBT', 'Slasher', 'Horror', 'Erotic thriller']",2000,9
32559889,Gentille Alouette,1990,"['France', 'Chile']",[],1990,0
11845883,City of Ember,2008,['United States of America'],"['Fantasy Adventure', 'Film adaptation', 'Family Drama', ""Children's/Family"", 'Adventure', 'Drama', ""Children's Fantasy"", 'Dystopia', 'Science Fiction', 'Family Film', 'Fantasy']",2000,8
12204434,Target,2004,['United States of America'],"['Action', 'Suspense', 'Action/Adventure', 'Thriller']",2000,4
22835254,Deadly Strangers,1974,['United Kingdom'],"['Thriller', 'Horror']",1970,4
5657109,A.D.,1985,['United States of America'],"['Christian film', 'Costume drama']",1980,5
10270532,Shower,1999,['China'],"['Family Drama', 'Comedy', 'World cinema', 'Chinese Movies', 'Drama', 'Domestic Comedy', 'Comedy-drama', 'Ensemble Film']",1990,9
4913880,The Safety of Objects,2001,"['United Kingdom', 'United States of America']","['Drama', 'Indie', 'Romantic drama', 'Family Drama', 'Marriage Drama', 'Romance Film', 'Ensemble Film']",2000,1
6680122,Nijam,2003,['India'],['Action'],2000,3
600820,Caddyshack II,1988,['United States of America'],"['Sports', 'Slapstick', 'Comedy']",1980,8
1438595,Body Double,1984,['United States of America'],"['Psychological thriller', 'Thriller', 'Erotic thriller', 'Crime Thriller']",1980,4
28300499,Shatru,1986,['India'],"['Action', 'Drama', 'Adventure']",1980,6
32186653,A Few Days With Me,1988,['France'],"['Comedy', 'Comedy film', 'Romance Film', 'Drama']",1980,8
30048802,Eien no 1/2,1987,['Japan'],['Japanese Movies'],1980,7
16435377,Billu,2008,['India'],"['Musical', 'Bollywood', 'World cinema', 'Comedy-drama', 'Drama']",2000,8
20985242,Spectres,2005,['United States of America'],"['Thriller', 'Horror', 'Supernatural', 'Science Fiction']",2000,5
7724545,Charisma,1999,['Japan'],"['Japanese Movies', 'Thriller', 'World cinema', 'Drama']",1990,9
3296177,Virus,1999,['United States of America'],"['Horror', 'Science Fiction']",1990,9
2216322,Ready to Rumble,2000,['United States of America'],"['Gross out', 'Gross-out film', 'Comedy', 'Sports', 'Slapstick']",2000,0
735291,Dr. Dolittle 2,2001,['United States of America'],"['Comedy', 'Animal Picture', 'Fantasy Comedy', 'Family Film']",2000,1
2164242,The Flintstones Meet Rockula and Frankenstone,1980,['United States of America'],"[""Children's/Family""]",1980,0
7839959,Playing for Keeps,1986,['United States of America'],"['Comedy', 'Teen']",1980,6
26171505,Flying By,2008,['United States of America'],['Drama'],2000,8
12733257,Spitfire,1934,['United States of America'],"['Black-and-white', 'Drama']",1930,4
805120,Before Sunset,2004,['United States of America'],"['Romantic drama', 'Indie', 'Comedy', 'Romance Film', 'Drama']",2000,4
8094043,Exte,2007,['Japan'],"['Japanese Movies', 'Horror']",2000,7
16760642,The Dark Hour,2006,['Spain'],"['Thriller', 'Horror', 'World cinema', 'Science Fiction']",2000,6
5165771,You Must Be Scared,2006,['India'],"['Musical', 'Thriller', 'Bollywood', 'Horror', 'World cinema', 'Supernatural']",2000,6
17475150,Conduct Unbecoming,1975,['United Kingdom'],"['British Empire Film', 'Period piece', 'Crime Fiction', 'Crime Drama', 'Drama', 'Courtroom Drama']",1970,5
32639786,Dime to Retire,1955,['United States of America'],"['Animation', 'Short Film', 'Comedy film', 'Family Film']",1950,5
24657947,Rave,2000,['United States of America'],['Indie'],2000,0
13991161,The Boat,1921,['United States of America'],"['Black-and-white', 'Indie', 'Short Film', 'Silent film']",1920,1
10411269,"Ilsa, Harem Keeper of the Oil Sheiks",1976,"['Canada', 'United States of America']","['Action', 'Drama', 'Sexploitation', 'Indie', 'Action/Adventure', 'Adult']",1970,6
945305,Confessions of a Dangerous Mind,2002,"['United Kingdom', 'Germany', 'United States of America']","['Action', 'Film adaptation', 'Crime Fiction', 'Biography', 'Action/Adventure', 'Comedy', 'Thriller', 'Biographical film', 'Romance Film', 'Drama', 'Period piece', 'Biopic [feature]', 'Comedy film', 'Comedy-drama']",2000,2
7237349,Azhagi,2002,['India'],"['Musical', 'Romantic drama', 'Bollywood', 'World cinema', 'Romance Film', 'Drama']",2000,2
21900034,Red Psalm,1971,['Hungary'],"['Musical', 'War film', 'Drama']",1970,1
24378337,Fairy in a Cage,1977,['Japan'],"['Erotica', 'Japanese Movies', 'Pornographic movie']",1970,7
2967126,The Appaloosa,1966,['United States of America'],"['Action/Adventure', 'Western']",1960,6
20899724,Griffin and Phoenix,2006,['United States of America'],"['Romantic drama', 'Romance Film', 'Romantic comedy', 'Comedy-drama', 'Drama']",2000,6
21376937,The River,1997,"['China', 'Taiwan']","['World cinema', 'Romance Film', 'Chinese Movies', 'Drama']",1990,7
21757558,Paging Emma,1999,['Puerto Rico'],['Drama'],1990,9
10691130,Jar City,2006,"['Iceland', 'Germany']","['Crime Fiction', 'Mystery', 'Thriller', 'World cinema', 'Crime Thriller', 'Drama']",2000,6
516474,The Hobbit,1977,['United States of America'],"['Animation', 'Drama', 'Family Film', 'Fantasy']",1970,7
25080850,The Legend of Lylah Clare,1968,['United States of America'],"['Mystery', 'Melodrama']",1960,8
27767451,Operation Bullshine,1959,['United Kingdom'],"['Romance Film', 'War film', 'Comedy film']",1950,9
16166356,Vaanavil,2000,['India'],[],2000,0
7784737,The Daydreamer,1966,['United States of America'],"['Musical', 'Animation', 'Stop motion', ""Children's/Family"", 'Drama', 'Fairy tale', ""Children's Fantasy"", 'Family Film', 'Fantasy']",1960,6
9407480,The Flying Sorceress,1956,['United States of America'],"[""Children's/Family""]",1950,6
301798,Dirty Harry,1971,['United States of America'],"['Action', 'Crime Fiction', 'Action Thrillers', 'Mystery', 'Action/Adventure', 'Thriller']",1970,1
6715844,Kedi,2006,['India'],['Action'],2000,6
7305656,Nina's Heavenly Delights,2006,['United Kingdom'],"['LGBT', 'Romantic drama', 'Comedy', 'Romance Film', 'Drama', 'Gay Themed', 'Gay', 'Gay Interest', 'Romantic comedy', 'Feature film']",2000,6
8695943,Mauvais Sang,1986,['France'],"['Musical', 'Crime Fiction', 'Romantic drama', 'Thriller', 'World cinema', 'Romance Film', 'Drama', 'Crime Drama']",1980,6
3577967,Street of Chance,1942,['United States of America'],"['Film noir', 'Black-and-white']",1940,2
23430023,The Corn is Green,1979,['United States of America'],"['Film adaptation', 'Television movie', 'Drama']",1970,9
2021700,Mission: Impossible III,2006,"['Germany', 'China', 'United States of America']","['Action', 'Spy', 'Action Thrillers', 'Action/Adventure', 'Thriller', 'Glamorized Spy Film', 'Chinese Movies']",2000,6
6446062,Moonraker,1979,"['United Kingdom', 'France']","['Action', 'Action/Adventure', 'Thriller', 'Adventure', 'Glamorized Spy Film', 'Science Fiction']",1970,9
2188611,Played,2006,['United Kingdom'],"['Heist', 'Crime Fiction', 'Thriller', 'Crime Thriller']",2000,6
4058835,Boot Polish,1954,['India'],"['Musical', 'Bollywood', 'World cinema', 'Drama']",1950,4
686213,54,1998,['United States of America'],"['Period piece', 'LGBT', 'Drama', 'Ensemble Film']",1990,8
26692905,College Kumaran,2008,['India'],['Comedy'],2000,8
27482712,Abkari,1988,['India'],"['Action', 'Drama']",1980,8
8891457,Mame,1974,['United States of America'],"['Musical', 'Comedy', 'Musical comedy']",1970,4
25945345,The Art of Negative Thinking,2007,['Norway'],"['Comedy', 'World cinema', 'Black comedy', 'Drama']",2000,7
599963,Goodbye Pork Pie,1981,['New Zealand'],"['Action', 'Drama', 'Adventure']",1980,1
8594699,Return to Horror High,1987,['United States of America'],"['Comedy', 'Teen', 'Horror', 'Slasher', 'B-movie']",1980,7
10951762,If You Meet Sartana Pray for Your Death,1968,['Italy'],['Spaghetti Western'],1960,8
3873332,The Second Woman,1950,['United States of America'],"['Psychological thriller', 'Black-and-white', 'Thriller', 'Film noir', 'Drama']",1950,0
3189413,A-Haunting We Will Go,1942,['United States of America'],"['Black-and-white', 'Crime Fiction', 'Comedy']",1940,2
24962407,Project Shadowchaser II,1994,['United States of America'],"['Action', 'Science Fiction']",1990,4
5888145,Devadasu,2006,['India'],"['Tollywood', 'Romantic drama', 'World cinema', 'Romance Film', 'Drama']",2000,6
358688,Aladdin and the King of Thieves,1996,['United States of America'],"['Animation', 'Family-Oriented Adventure', ""Children's/Family"", 'Adventure', 'Family Film']",1990,6
5024913,Daft Punk's Electroma,2007,['France'],"['Indie', 'Avant-garde', 'World cinema', 'Drama', 'Experimental film', 'Silent film', 'Road movie', 'Science Fiction']",2000,7
21275560,The Telling,2009,['United States of America'],"['Mystery', 'Thriller', 'Horror']",2000,9
20053892,Victoria Day,2009,['Canada'],"['Period piece', 'Coming of age', 'Indie', 'Sports', 'Drama']",2000,9
31423765,Black Tights,1961,['France'],"['Music', 'Dance', 'World cinema']",1960,1
2296528,Whale Music,1994,['Canada'],"['Drama', 'Comedy']",1990,4
30959201,Khel,1991,['India'],"['Drama', 'Thriller', 'World cinema']",1990,1
9382558,To the Shores of Tripoli,1941,['United States of America'],"['Comedy', 'Romance Film', 'War film', 'Drama']",1940,1
16154245,Vampire Bats,2005,['United States of America'],"['Action', 'Thriller', 'Horror', 'Science Fiction']",2000,5
5269453,Dona Flor and Her Two Husbands,1976,['Brazil'],"['Romantic fantasy', 'Romantic drama', 'Comedy', 'World cinema', 'Romance Film', 'Drama', 'Romantic comedy', 'Fantasy']",1970,6
30250668,Poodle Springs,1998,['United States of America'],"['Drama', 'Crime Fiction']",1990,8
11353416,Charas,1976,['India'],"['Action', 'Thriller']",1970,6
24570525,Confessions of a Queen,1925,[],"['Silent film', 'Melodrama']",1920,5
25429292,Paithiyakaaran,1947,['India'],['Drama'],1940,7
27550497,Mandroid,1993,['United States of America'],"['Science Fiction', 'Thriller']",1990,3
2422360,Homicidal,1961,['United States of America'],"['Slasher', 'Horror']",1960,1
1462414,The Clan of the Cave Bear,1986,['United States of America'],"['Action', 'Costume drama', 'Adventure', 'Drama', 'Fantasy']",1980,6
20560403,Second Serve,1986,['United States of America'],"['Biography', 'Biopic [feature]', 'Docudrama', 'Drama']",1980,6
16263909,"Welcome, Reverend!",1950,['Italy'],"['Black-and-white', 'Crime Fiction', 'Comedy']",1950,0
6646087,Harper,1966,['United States of America'],"['Detective fiction', 'Mystery', 'Thriller', 'Detective', 'Crime Thriller', 'Drama']",1960,6
14570681,Far From Home,1989,['United States of America'],"['Psychological thriller', 'Suspense', 'Mystery', 'Indie', 'Thriller', 'Crime Thriller']",1980,9
503161,Sylvia,2003,['United Kingdom'],"['Period piece', 'Romantic drama', 'Biography', 'Biographical film', 'Romance Film', 'Drama']",2000,3
176489,Joe Versus the Volcano,1990,['United States of America'],"['Comedy', 'Black comedy', 'Romantic comedy', 'Romance Film', 'Fantasy Comedy', 'Fantasy']",1990,0
5905476,The OH in Ohio,2006,['United States of America'],"['Indie', 'Comedy', 'Romance Film', 'Romantic comedy', 'Sex comedy']",2000,6
13817550,Ashes of Paradise,2003,['Argentina'],"['Detective fiction', 'Drama', 'Family Drama', 'Indie', 'Thriller', 'Detective', 'World cinema']",2000,3
818002,Double Jeopardy,1999,"['Germany', 'United States of America', 'Canada']","['Action', 'Psychological thriller', 'Crime Fiction', 'Mystery', 'Thriller', 'Crime Thriller', 'Drama']",1990,9
22056282,Whispers in the Dark,1992,['United States of America'],"['Psychological thriller', 'Mystery', 'Thriller', 'Erotic thriller', 'Crime Thriller']",1990,2
2428970,Soldiers Of Salamina,2003,['Spain'],['Drama'],2000,3
9877310,The Jade Box,1930,['United States of America'],"['Action', 'Black-and-white', 'Mystery', 'Indie', 'Silent film', 'Adventure']",1930,0
8407529,14 Carrot Rabbit,1952,['United States of America'],"['Short Film', 'Comedy']",1950,2
35584608,Kismat,1995,['India'],"['Action', 'Musical', 'Drama', 'Family Film']",1990,5
26356319,Allemagne année 90 neuf zéro,1991,['France'],"['Essay Film', 'Avant-garde', 'Experimental film', 'Political drama', 'Drama']",1990,1
22113189,La Casa del Pelícano,1976,['Mexico'],['Drama'],1970,6
16686744,Rosencrantz and Guildenstern Are Undead,2009,['United States of America'],"['Indie', 'Comedy', 'Horror Comedy']",2000,9
1412382,At Long Last Love,1975,['United States of America'],"['Musical', 'Comedy', 'Romance Film', 'Romantic comedy', 'Jukebox musical']",1970,5
14577078,The Last Siege: Never Surrender,1999,['United States of America'],"['Action', 'Indie', 'Action/Adventure', 'Thriller']",1990,9
6714641,Deadly Intentions... Again?,1991,['United States of America'],"['Crime Fiction', 'Thriller', 'Crime Thriller', 'Docudrama', 'Drama']",1990,1
15445885,Time Without Pity,1957,['United Kingdom'],"['Suspense', 'Crime Fiction', 'Mystery', 'Family Drama', 'Thriller', 'Crime Thriller', 'Drama']",1950,7
5101743,Mr. Brooks,2007,['United States of America'],"['Psychological thriller', 'Crime Fiction', 'Mystery', 'Thriller', 'Crime Thriller', 'Drama']",2000,7
10851094,Captain America,1979,['United States of America'],"['Action', 'Drama']",1970,9
22094548,The Castle,1997,"['Austria', 'Germany']","['Mystery', 'Drama', 'World cinema']",1990,7
2839068,Nothing,2004,['Canada'],"['Indie', 'Comedy', 'Science Fiction', 'Drama']",2000,4
10943786,The Poughkeepsie Tapes,2007,['United States of America'],"['Crime Thriller', 'Slasher', 'Horror']",2000,7
2728419,Tatie Danielle,1990,['France'],"['Comedy', 'Satire', 'Comedy of manners', 'Black comedy', 'Domestic Comedy']",1990,0
17954693,Sytten,1965,['Denmark'],['Comedy'],1960,5
1044981,The Idiots,1998,"['Spain', 'Denmark', 'Netherlands']","['Dogme 95', 'Satire', 'Comedy', 'World cinema', 'Comedy-drama', 'Drama']",1990,8
1059630,Early Spring,1956,['Japan'],"['Art film', 'Japanese Movies', 'Romantic drama', 'World cinema', 'Romance Film', 'Drama']",1950,6
8380456,Movie Maniacs,1936,['United States of America'],"['Black-and-white', 'Short Film', 'Comedy', 'Slapstick']",1930,6
5511248,Holes,2003,['United States of America'],"['Mystery', 'Comedy', 'Teen', 'Romance Film', ""Children's/Family"", 'Escape Film', 'Adventure', 'Drama', 'Comedy-drama', 'Family Film']",2000,3
2810158,Barnyard,2006,"['Germany', 'United States of America']","['Animation', 'Comedy', ""Children's/Family"", 'Family Film', 'Computer Animation']",2000,6
3745444,Hellraiser: Inferno,2000,['United States of America'],"['Slasher', 'Horror', 'Supernatural', 'Cult']",2000,0
24811418,Dead Man Running,2009,['United Kingdom'],"['Action', 'Action/Adventure', 'Comedy', 'Thriller', 'Crime Thriller']",2000,9
2315614,Nikos,2003,['Germany'],['Horror'],2000,3
1852926,Gleaming the Cube,1989,['United States of America'],"['Detective fiction', 'Drama', 'Mystery', 'Indie', 'Detective', 'Teen']",1980,9
3137571,Harakiri,1962,['Japan'],"['Samurai cinema', 'Art film', 'Japanese Movies', 'World cinema', 'Drama']",1960,2
3770679,Framed,1947,['United States of America'],"['Black-and-white', 'Crime Fiction', 'Thriller', 'Film noir', 'Drama']",1940,7
18849345,Malaikkallan,1954,['India'],"['Action', 'Drama', 'Adventure']",1950,4
2574359,Everything Goes,2004,['Australia'],"['Short Film', 'Drama']",2000,4
26070363,The Scarlet Letter,1934,['United States of America'],"['Film adaptation', 'Drama']",1930,4
22561292,Black Bridge,2006,['Canada'],['Drama'],2000,6
145445,The Umbrellas of Cherbourg,1964,"['France', 'Germany', 'West Germany']","['Musical', 'Romantic drama', 'World cinema', 'Romance Film', 'Melodrama', 'Drama']",1960,4
684018,The Damned,1969,"['West Germany', 'Italy']","['Family Drama', 'Political drama', 'War film', 'Drama', 'Family Film']",1960,9
3069423,Corvette Summer,1978,['United States of America'],"['Screwball comedy', 'Comedy', 'Teen', 'Romantic comedy', 'Comedy-drama', 'Adventure', 'Cult']",1970,8
4393011,Komodo,1999,"['United States of America', 'Australia']","['Thriller', 'Horror', 'Science Fiction', 'Natural horror films']",1990,9
17030868,Mussanjemaatu,2008,['India'],['Romance Film'],2000,8
512235,Ninja Scroll,1993,['Japan'],"['Action', 'Animation', 'Japanese Movies', 'Anime', 'Martial Arts Film', 'Adventure', 'Fantasy']",1990,3
8868907,Born Reckless,1930,['United States of America'],"['Black-and-white', 'Crime Fiction', 'Comedy']",1930,0
6095024,Lijmen/Het Been,2002,"['Netherlands', 'Belgium']",['Drama'],2000,2
26051540,Mayak,2006,"['Russia', 'Armenia']",['Drama'],2000,6
8863185,The Actress,1953,['United States of America'],"['Comedy', 'Drama', 'Biographical film']",1950,3
781629,S.W.A.T.,2003,['United States of America'],"['Action', 'Crime Fiction', 'Action Thrillers', 'Action/Adventure', 'Thriller', 'Crime Thriller']",2000,3
13678738,Gunfight In Abilene,1967,['United States of America'],"['Western', 'Adventure']",1960,7
25418096,Le Donk & Scor-zay-zee,2009,['United Kingdom'],"['Mockumentary', 'Indie', 'Comedy']",2000,9
14771682,Footskating 101,2007,['South Africa'],"['Indie', 'Comedy', 'Adventure']",2000,7
8191093,Stiff Upper Lips,1998,['United Kingdom'],"['LGBT', 'Parody', 'Comedy', 'Comedy of manners']",1990,8
1596589,Encino Man,1992,['United States of America'],"['Science Fiction', 'Comedy', 'Teen']",1990,2
13735294,"Apat Dapat, Dapat Apat",2007,['Philippines'],"['Filipino Movies', 'Comedy', 'World cinema']",2000,7
4118248,Brother Bear 2,2006,['United States of America'],"['Animated cartoon', 'Animation', 'Adventure', 'Family Film', 'Fantasy']",2000,6
28062973,Kisses,2008,"['Ireland', 'United Kingdom']","['Coming of age', 'Indie', 'Drama']",2000,8
5698271,Spring Forward,2000,['United States of America'],"['Indie', 'Buddy film', 'Drama']",2000,0
3096943,Carrington,1995,"['United Kingdom', 'France', 'United States of America']","['LGBT', 'Biography', 'Indie', 'Romantic drama', 'Biographical film', 'Romance Film', 'Drama', 'Period piece', 'Biopic [feature]']",1990,5
1871602,The Lords of Flatbush,1974,['United States of America'],"['Period piece', 'Coming of age', 'Drama']",1970,4
12562361,Daman: A Victim of Marital Violence,2001,['India'],"['Art film', 'Drama', 'World cinema']",2000,1
27277176,Beastmaster III: The Eye of Braxus,1996,['United States of America'],"['Action', 'Adventure', 'Fantasy']",1990,6
683122,Bambi,1942,['United States of America'],"['Animation', 'Animated Musical', ""Children's/Family"", 'Adventure', 'Drama', ""Children's Fantasy"", 'Coming of age', 'Family Film', 'Fantasy']",1940,2
22448229,A Little Night Music,1978,"['Austria', 'West Germany', 'United States of America']","['Musical', 'Musical Drama', 'Comedy']",1970,8
26362054,Me and the Kid,1993,['United States of America'],"['Crime Fiction', 'Comedy', ""Children's/Family"", 'Adventure', 'Drama', 'Family Film']",1990,3
73475,Force of Evil,1948,['United States of America'],"['Black-and-white', 'Crime Fiction', 'Gangster Film', 'Thriller', 'Film noir', 'Drama']",1940,8
3288825,Strangers with Candy,2005,['United States of America'],"['LGBT', 'Parody', 'Indie', 'Comedy', 'Cult', 'Absurdism']",2000,5
2293029,Dobermann,1997,['France'],"['Action', 'Crime Fiction', 'Satire', 'Thriller', 'Crime Thriller', 'Master Criminal Films', 'Drama']",1990,7
68119,"America, America",1963,['United States of America'],"['Romance Film', 'Black-and-white', 'Drama']",1960,3
25974893,The Comeback Trail,1982,['United States of America'],['Comedy'],1980,2
4927911,Volver,2007,['Spain'],"['Crime Fiction', 'Mystery', 'Comedy', 'World cinema', 'Comedy-drama', 'Tragicomedy', 'Drama']",2000,7
24889160,Marquis,1989,"['France', 'Belgium']","['Comedy', 'Animation']",1980,9
61074,The Private Life of Henry VIII,1933,['United Kingdom'],"['Black-and-white', 'Biography', 'Biographical film', 'Romance Film', 'Costume drama', 'Drama', 'Marriage Drama', 'Biopic [feature]', 'Historical Epic', 'Historical fiction']",1930,3
18798887,The Family That Preys,2008,['United States of America'],"['Family Drama', 'Romantic drama', 'Comedy', 'Romance Film', 'Comedy-drama', 'Drama']",2000,8
3476119,Cigarettes & Coffee,1993,['United States of America'],"['Short Film', 'Drama']",1990,3
5060788,"Todesking, Der",1989,"['Germany', 'West Germany']","['Drama', 'Horror']",1980,9
1411169,Andrei Rublev,1969,"['Russia', 'Soviet Union']","['Art film', 'Biography', 'Historical drama', 'World cinema', 'Biographical film', 'Christian film', 'Costume drama', 'Drama', 'Period piece', 'History', 'Biopic [feature]', 'Historical Epic', 'Historical fiction', 'War film']",1960,9
23452645,Celebrity Pornhab with Dr. Screw,2009,[],['Pornographic movie'],2000,9
11600310,Buried Alive,1990,"['United States of America', 'South Africa']","['Indie', 'Horror']",1990,0
6099029,Thammudu,1999,['India'],"['Romance Film', 'Drama']",1990,9
2613497,Paycheck,2003,['United States of America'],"['Action', 'Future noir', 'Action/Adventure', 'Thriller', 'Martial Arts Film', 'Science Fiction']",2000,3
27160128,Kaiyethum Doorath,2002,['India'],"['Romance Film', 'Drama']",2000,2
26628464,Humans,2009,['France'],"['Action', 'Thriller', 'Horror', 'World cinema', 'Adventure']",2000,9
14788012,A Thousand and One Nights,1945,['United States of America'],"['Comedy', 'Adventure']",1940,5
17456689,Everglade Raid,1958,[],['Animation'],1950,8
31065652,Suicide Battalion,1958,['United States of America'],"['Adventure', 'War film']",1950,8
3600824,A Time to Kill,1996,['United States of America'],"['Drama', 'Crime Fiction', 'Thriller']",1990,6
18657094,Sembilu,1994,['Malaysia'],"['Action', 'Romance Film', 'Drama']",1990,4
32516277,Black Lightning,2009,"['Russia', 'United States of America']","['Action', 'Action/Adventure', 'World cinema', 'Adventure', 'Science Fiction', 'Family Film', 'Fantasy']",2000,9
18420153,Girl Scout,2008,['South Korea'],['Comedy'],2000,8
2685969,Three the Hard Way,1974,['United States of America'],['Blaxploitation'],1970,4
13987477,Headless Horseman,2007,['United States of America'],"['Slasher', 'Gothic Film', 'Horror']",2000,7
5812638,Midnight Run for Your Life,1994,['United States of America'],"['Action', 'Drama', 'Thriller', 'Comedy film']",1990,4
3153023,Beverly Hills Ninja,1997,['United States of America'],"['Action', 'Martial Arts Film', 'Action Comedy', 'Parody', 'Action/Adventure', 'Comedy', 'Slapstick']",1990,7
11517368,West Point,1928,['United States of America'],"['Silent film', 'Black-and-white', 'Drama']",1920,8
26205694,Meesa Madhavan,2002,['India'],"['Comedy', 'Family Film']",2000,2
7844547,Sleeping Beauties,1999,['United States of America'],"['LGBT', 'Indie', 'Short Film', 'Comedy']",1990,9
33267370,The Star of Africa,1957,[],"['War film', 'Drama']",1950,7
15861151,84 Charing Cross Road,1987,"['United Kingdom', 'United States of America']","['Period piece', 'Film adaptation', 'Romantic drama', 'Biography', 'Romance Film', 'Drama']",1980,7
4158045,Tourist Trap,1979,['United States of America'],"['Indie', 'Slasher', 'Teen', 'Horror', 'B-movie']",1970,9
1051653,Rollerball,1975,['United States of America'],"['Action', 'Dystopia', 'Science Fiction']",1970,5
3833665,Rodan,1956,['Japan'],"['Creature Film', 'Monster movie', 'Japanese Movies', 'Science Fiction', 'Horror', 'World cinema']",1950,6
1525944,Dancin' Thru the Dark,1990,"['United Kingdom', 'England']",['Comedy'],1990,0
3699869,Winnie the Pooh: Seasons of Giving,1999,['United States of America'],"[""Children's Fantasy"", ""Children's/Family"", 'Holiday Film']",1990,9
13261540,Jigyaasa,2006,['India'],"['Musical', 'Bollywood', 'World cinema', 'Drama']",2000,6
13299171,Pictures of Hollis Woods,2007,['United States of America'],"['Drama', 'Childhood Drama']",2000,7
19011948,Love at Large,1990,['United States of America'],"['Mystery', 'Comedy', 'Thriller', 'Romance Film', 'Romantic comedy', 'Crime Thriller']",1990,0
28951480,A House in the Hills,1995,"['Luxembourg', 'United States of America']","['Romance Film', 'Thriller']",1990,5
33051426,Sauna,2008,['Finland'],"['Historical fiction', 'World cinema', 'Horror']",2000,8
5215498,The Moderns,1988,['United States of America'],"['Indie', 'Romantic drama', 'Comedy', 'Romance Film', 'Drama', 'Period piece', 'Comedy-drama', 'Ensemble Film']",1980,8
9499569,Professori Uuno D.G. Turhapuro,1975,['Finland'],['Comedy'],1970,5
1635428,Dante's Inferno,1935,['United States of America'],"['Black-and-white', 'Drama']",1930,5
3879782,Best Laid Plans,1999,['United States of America'],"['Psychological thriller', 'Suspense', 'Crime Fiction', 'Thriller', 'Crime Thriller']",1990,9
13938940,Enchantment,1948,"['United Kingdom', 'United States of America']","['Romance Film', 'Romantic drama', 'Drama']",1940,8
549902,Possession,2002,"['United Kingdom', 'United States of America']","['Film adaptation', 'Mystery', 'Romantic drama', 'Thriller', 'Romance Film', 'Drama']",2000,2
7767292,Green Chair,2005,['South Korea'],"['Erotic Drama', 'Romantic drama', 'World cinema', 'Romance Film', 'Erotica', 'Drama']",2000,5
28424860,"Go, Yellow",2001,['Croatia'],"['Sports', 'Comedy film']",2000,1
175668,Get Carter,1971,['United Kingdom'],"['Crime Fiction', 'Gangster Film', 'Thriller', 'Crime Thriller']",1970,1
19036635,Is Your Honeymoon Really Necessary?,1953,['United Kingdom'],['Comedy'],1950,3
29586434,Mickey's Luck,1930,['United States of America'],['Short Film'],1930,0
4983711,The Amazing Dr. Clitterhouse,1938,['United States of America'],"['Heist', 'Black-and-white', 'Crime Fiction', 'Comedy', 'Crime Comedy', 'Comedy-drama', 'Drama']",1930,8
2401490,Samson and His Mighty Challenge,1964,"['France', 'Spain', 'Italy']",['Adventure'],1960,4
5115267,Which Is Witch,1949,['United States of America'],"['Animated cartoon', 'Short Film', 'Family Film']",1940,9
1832887,With Fire and Sword,1999,['Poland'],"['Crime Fiction', 'War film', 'Adventure', 'Drama']",1990,9
3185575,The Color Purple,1985,['United States of America'],"['Period piece', 'Film adaptation', 'LGBT', 'Feminist Film', 'Marriage Drama', 'Drama']",1980,5
20012069,Bibar,2006,['India'],"['Crime Fiction', 'Adventure', 'Drama']",2000,6
5836236,The Age of Innocence,1993,['United States of America'],"['Romance Film', 'Drama']",1990,3
6635718,Lakshmi Narasimha,2004,['India'],"['Musical', 'Bollywood', 'World cinema', 'Drama']",2000,4
5003046,Salome's Last Dance,1988,['United Kingdom'],"['Period piece', 'Film adaptation', 'Parody', 'Satire', 'Comedy', 'Black comedy', 'Drama']",1980,8
3132815,Bring It On Again,2004,['United States of America'],"['Sports', 'Comedy', 'Teen']",2000,4
31482004,Kottaram Veettile Apputtan,1998,[],"['Romance Film', 'Comedy-drama']",1990,8
936196,The Wizard,1989,['United States of America'],"['Coming of age', 'Comedy', 'Teen', 'Comedy-drama', 'Adventure', 'Drama', 'Family Film']",1980,9
26513602,Mooga Manasulu,1963,['India'],['Drama'],1960,3
4286886,Sleepwalkers,1992,['United States of America'],"['Film adaptation', 'Teen', 'Horror']",1990,2
5949759,Drug Wars: The Camarena Story,1990,"['Spain', 'United States of America']","['Action', 'Crime Fiction', 'Gangster Film', 'Action/Adventure', 'Thriller', 'Crime Thriller', 'Drama', 'Crime Drama', 'Television movie']",1990,0
23983874,Hyenas,1993,"['France', 'Switzerland', 'Senegal']","['Comedy', 'Drama', 'World cinema']",1990,3
5474642,Raid on Entebbe,1977,['United States of America'],"['Action', 'Action Thrillers', 'Action/Adventure', 'Thriller', 'Docudrama', 'Drama', 'Television movie', 'War film', 'Political thriller']",1970,7
22911386,Aval oru thodharkadai,1974,['India'],"['Romance Film', 'Drama']",1970,4
3567688,Pete 'n' Tillie,1972,['United States of America'],"['Film adaptation', 'Romantic drama', 'Romance Film', 'Drama']",1970,2
12234659,Zombie Island Massacre,1984,['United States of America'],"['Indie', 'Slasher', 'Thriller', 'Horror', 'B-movie', 'Zombie Film']",1980,4
1452377,Cry-Baby,1990,['United States of America'],"['Musical', 'Satire', 'Comedy', 'Musical comedy', 'Teen', 'Romance Film', 'Parody', 'Cult']",1990,0
29215735,Lawless Heart,2001,"['United Kingdom', 'France']","['LGBT', 'Drama', 'Indie', 'Romantic drama', 'Comedy', 'Romance Film']",2000,1
11223,Four Weddings and a Funeral,1994,['United Kingdom'],"['Comedy', 'Romance Film', 'Romantic comedy', 'Slice of life story']",1990,4
6697503,The Aqua Teen Hunger Force Movie Film for Theatres,2007,['United States of America'],"['Comedy', 'Animation']",2000,7
2735755,Watermelon Man,1970,['United States of America'],"['Blaxploitation', 'Parody', 'Satire', 'Comedy', 'Comedy-drama', 'Drama', 'Cult']",1970,0
31978798,Kisses for Breakfast,1941,['United States of America'],"['Slapstick', 'Comedy']",1940,1
4269125,Echoes of Innocence,2005,['United States of America'],"['Mystery', 'Thriller', 'Romance Film', 'Christian film', 'Supernatural', 'Drama']",2000,5
9811946,Dead Man's Eyes,1944,['United States of America'],"['Black-and-white', 'Crime Fiction', 'Mystery', 'Horror', 'Crime Thriller']",1940,4
5930384,Black Snake Moan,2006,['United States of America'],"['Music', 'Indie', 'Romance Film', 'Drama']",2000,6
24896183,Russel Fish: The Sausage and Eggs Incident,2009,['United States of America'],"['Coming of age', 'Short Film', 'Comedy', 'Black comedy', 'Cult']",2000,9
12285168,Bless the Beasts and Children,1971,['United States of America'],"['Animal Picture', 'Drama', 'Childhood Drama']",1970,1
2639712,Boudu Saved from Drowning,1932,['France'],"['Black-and-white', 'Satire', 'Comedy', 'World cinema', 'Comedy of manners']",1930,2
4246153,Palooka,1934,['United States of America'],"['Boxing', 'Black-and-white', 'Comedy', 'Superhero movie', 'Sports', 'Drama']",1930,4
871658,Drop Dead Gorgeous,1999,"['Germany', 'United States of America']",['Comedy'],1990,9
11247078,Lucid,2005,['Canada'],"['Psychological thriller', 'Indie', 'Drama']",2000,5
5257744,Some Kind of Hero,1982,['United States of America'],"['Comedy', 'Comedy-drama', 'Tragicomedy', 'War film', 'Drama']",1980,2
21375200,A Cat in the Brain,1990,['Italy'],"['Psychological thriller', 'Slasher', 'Horror', 'World cinema']",1990,0
25248296,A Dog Named Christmas,2009,['United States of America'],"['Film adaptation', 'Family Drama', 'Television movie', 'Family Film', 'Drama']",2000,9
30665001,Lucky Jordan,1942,['United States of America'],"['Crime Fiction', 'Comedy', 'Drama']",1940,2
11670299,Female on the Beach,1955,['United States of America'],"['Psychological thriller', 'Black-and-white', 'Thriller', 'Drama']",1950,5
25972529,Fun 2shh: Dudes In the 10th Century,2003,['India'],"['Comedy', 'World cinema', 'Fantasy Comedy', 'Fantasy']",2000,3
15281528,Man of the Moment,1935,['United Kingdom'],"['Romantic comedy', 'Black-and-white']",1930,5
22147898,Two People,1973,['United States of America'],"['Romance Film', 'Drama']",1970,3
15492185,Hex,1973,['United States of America'],"['Biker Film', 'Horror', 'Fantasy', 'Drama']",1970,3
11849222,Magnifico,2003,['Philippines'],"['Filipino Movies', 'Childhood Drama', 'World cinema', 'Drama']",2000,3
10699428,Dost,1974,['India'],['Bollywood'],1970,4
13956956,Twice-Told Tales,1963,['United States of America'],"['Horror', 'Science Fiction']",1960,3
8833565,The Snow Queen,1957,"['Russia', 'Soviet Union', 'United States of America']","['Animation', 'Drama', 'Family Film', 'Fantasy']",1950,7
1116298,G-SALE,2005,['United States of America'],"['Mockumentary', 'Comedy', 'Comedy of manners']",2000,5
2920790,Villain,1971,['United Kingdom'],"['Drama', 'Crime Fiction']",1970,1
4329444,Happy Endings,2005,['United States of America'],"['Music', 'LGBT', 'Indie', 'Romantic drama', 'Comedy', 'Thriller', 'Romance Film', 'Drama', 'Romantic comedy']",2000,5
1164551,Ginger Snaps 2: Unleashed,2004,['Canada'],"['Creature Film', 'Comedy', 'Thriller', 'Horror', 'Teen', 'Addiction Drama', 'Feminist Film']",2000,4
5827982,The Love of Sunya,1927,['United States of America'],"['Black-and-white', 'Drama', 'Romantic drama', 'Indie', 'Silent film', 'Romance Film']",1920,7
9647695,Arizona,1931,['United States of America'],['Drama'],1930,1
22799564,Ordinary People,2009,"['Switzerland', 'Serbia', 'France', 'Netherlands']","['Drama', 'World cinema']",2000,9
2294770,Ensign Pulver,1964,['United States of America'],"['War film', 'Drama', 'Comedy film']",1960,4
876872,Addams Family Values,1993,['United States of America'],"['Comedy', 'Black comedy', 'Domestic Comedy', 'Family Film', 'Fantasy']",1990,3
939670,The Hole,2001,['United Kingdom'],"['Psychological thriller', 'Mystery', 'Thriller', 'Horror', 'Drama']",2000,1
1970853,Exiled,2007,"['China', 'Hong Kong']","['Action', 'Crime Fiction', 'Action/Adventure', 'Thriller', 'World cinema', 'Chinese Movies']",2000,7
3034844,Dragons Forever,1988,['Hong Kong'],"['Action', 'Slapstick', 'Comedy', 'Chinese Movies', 'Martial Arts Film']",1980,8
32329400,Strawberry and Chocolate,1994,"['Spain', 'Cuba', 'Mexico']","['LGBT', 'Comedy', 'World cinema', 'Drama']",1990,4
2687974,The Legend of Drunken Master,1994,['Hong Kong'],"['Action', 'Martial Arts Film', 'Action Comedy', 'Action/Adventure', 'Comedy', 'World cinema', 'Chinese Movies']",1990,4
17388211,Adam and Eve,1953,['Denmark'],['Drama'],1950,3
34986758,One-Hand Clapping,2001,['Denmark'],['Comedy film'],2000,1
26114073,Logorama,2009,['France'],"['LGBT', 'Animation', 'Short Film']",2000,9
884742,An Affair to Remember,1957,['United States of America'],"['Romantic drama', 'Romance Film', 'Melodrama', 'Comedy-drama', 'Drama']",1950,7
5159792,The Caveman's Valentine,2001,['United States of America'],"['Psychological thriller', 'Film adaptation', 'Crime Fiction', 'Mystery', 'Thriller', 'Crime Thriller', 'Drama']",2000,1
25397747,David's Mother,1994,['United States of America'],"['Television movie', 'Family Drama', 'Drama']",1990,4
17442083,Hindi Pa Tapos Ang Labada Darling,1994,['Philippines'],['Filipino Movies'],1990,4
12017390,San Antonio,1945,['United States of America'],"['Action', 'Western', 'Action/Adventure']",1940,5
1858358,Death Dimension,1978,['United States of America'],"['Action', 'Spy', 'Blaxploitation', 'Action Thrillers', 'Action/Adventure', 'Thriller', 'Glamorized Spy Film', 'Martial Arts Film', 'Science Fiction']",1970,8
24417113,Ichijo's Wet Lust,1972,['Japan'],"['Japanese Movies', 'World cinema', 'Pornographic movie', 'Erotica', 'Drama']",1970,2
4709385,16 Vayathinile,1977,['India'],"['Melodrama', 'Drama', 'Tamil cinema']",1970,7
6661678,Carried Away,1996,['United States of America'],"['Film adaptation', 'Romantic drama', 'Romance Film', 'Drama']",1990,6
28757535,Crosstrap,1962,['United Kingdom'],['Crime Fiction'],1960,2
6735519,Rescue From Gilligan's Island,1978,['United States of America'],"['Slapstick', 'Comedy', 'Television movie', 'Comedy of Errors']",1970,8
1526741,Ánimas Trujano,1962,['Mexico'],['Drama'],1960,2
18418582,24: Redemption,2008,['South Africa'],"['Action', 'Action Thrillers']",2000,8
16198836,The Grissom Gang,1971,['United States of America'],"['Action', 'Psychological thriller', 'Crime Fiction', 'Gangster Film', 'Thriller', 'Black comedy', 'Crime Thriller', 'Drama', 'Period piece', 'Crime Drama']",1970,1
24658454,Madame Butterfly,1932,['United States of America'],['Drama'],1930,2
12746952,The Glass Key,1942,['United States of America'],"['Black-and-white', 'Crime Fiction', 'Thriller', 'Detective', 'Film noir', 'Drama']",1940,2
10915095,My Father the Hero,1994,"['France', 'United States of America']","['Comedy', 'Romance Film', 'Romantic comedy', 'Family Film']",1990,4
2361036,Conquest,1937,['United States of America'],"['Black-and-white', 'Costume drama', 'Drama']",1930,7
10202660,The Master Key,1945,['United States of America'],"['Action', 'Spy', 'Black-and-white', 'Adventure']",1940,5
28286964,Living in Bondage,1992,['Nigeria'],"['Thriller', 'Drama']",1990,2
13728669,Kaya Taran,2004,['India'],['Drama'],2000,4
24633376,The Effect of Gamma Rays on Man-in-the-Moon Marigolds,1972,['United States of America'],"['Film adaptation', 'Drama']",1970,2
27070483,The Paper Will Be Blue,2006,['Romania'],"['Action', 'Drama', 'Action/Adventure', 'Thriller', 'World cinema']",2000,6
1400465,Osama,2003,"['Afghanistan', 'Ireland', 'Japan']","['Art film', 'Japanese Movies', 'Childhood Drama', 'World cinema', 'War film', 'Drama']",2000,3
5823121,The Long Weekend,2006,"['Canada', 'United States of America']","['Coming of age', 'Comedy']",2000,6
8635248,Secrets of the Heart,1997,"['Portugal', 'France', 'Spain']","['Drama', 'World cinema']",1990,7
32884037,The Adventures of Algy,1925,[],"['Drama', 'Comedy film']",1920,5
32657739,Tall Timbers,1937,[],"['Romance Film', 'Adventure']",1930,7
20520639,Misguided Missile,1958,['United States of America'],"['Animation', 'Short Film', 'Comedy film', 'Family Film']",1950,8
4954616,Little Vera,1988,"['Russia', 'Soviet Union']","['Family Drama', 'Romantic drama', 'World cinema', 'Social problem film', 'Romance Film', 'Drama']",1980,8
3654603,Sword of the Beast,1965,['Japan'],"['Action', 'Black-and-white', 'Samurai cinema', 'Art film', 'Action/Adventure', 'World cinema', 'Martial Arts Film', 'Adventure', 'Drama', 'Japanese Movies']",1960,5
15282975,Descendents of Cain,1968,['South Korea'],['Historical drama'],1960,8
24872954,Gulumal,2009,['India'],"['Drama', 'Comedy', 'Thriller']",2000,9
24397761,Mahamantri Timmarusu,1962,['India'],"['Action', 'Musical', 'Drama', 'History']",1960,2
28785588,Face in the Night,1957,['United Kingdom'],"['Drama', 'Crime Fiction']",1950,7
33144614,La Boum 2,1982,['France'],"['Coming of age', 'Comedy', 'Teen', 'Romance Film', 'Romantic comedy']",1980,2
1059701,Superman III,1983,"['United Kingdom', 'United States of America']","['Action', 'Superhero', 'Action/Adventure', 'Comedy', 'Thriller', 'Adventure', 'Superhero movie', 'Science Fiction', 'Family Film', 'Fantasy']",1980,3
9232940,Sira` Fi al-Mina,1956,['Egypt'],"['Action', 'Drama', 'Crime Fiction', 'Romance Film']",1950,6
17968385,Lancashire Luck,1937,['United Kingdom'],"['Romance Film', 'Black-and-white', 'Comedy']",1930,7
10113483,The Birthday Party,1968,"['United Kingdom', 'United States of America']",['Comedy'],1960,8
23731502,Blame It on the Bellboy,1992,"['United Kingdom', 'United States of America']","['Comedy', 'Comedy of Errors']",1990,2
24611218,I Start Counting,1969,['United Kingdom'],"['Psychological thriller', 'Film adaptation', 'Mystery', 'Thriller', 'Crime Thriller', 'Drama']",1960,9
2711278,Howling III,1987,"['New Zealand', 'Australia']","['Indie', 'Comedy', 'Horror']",1980,7
19080681,Jigsaw,1962,['United Kingdom'],"['Drama', 'Crime Fiction']",1960,2
12781074,Stella,1990,['United States of America'],['Drama'],1990,0
24020423,Pokkisham,2009,['India'],['Romance Film'],2000,9
7902455,Hitman,2007,"['France', 'United States of America']","['Action', 'Drama', 'Crime Fiction', 'Action/Adventure', 'Thriller']",2000,7
27877174,Love In Japan,2006,['India'],"['Action', 'Crime Fiction', 'Comedy', 'Comedy film', 'Crime']",2000,6
2130880,Striking Distance,1993,['United States of America'],"['Action', 'Crime Fiction', 'Mystery', 'Action Thrillers', 'Thriller']",1990,3
19423428,Nishijapon,2005,['India'],['Drama'],2000,5
6298640,The North Star,1943,['United States of America'],"['Black-and-white', 'War film', 'Propaganda film']",1940,3
8614136,Harano Sur,1957,['India'],"['Drama', 'World cinema']",1950,7
25418242,My Big Father,2009,[],"['Drama', 'Comedy film']",2000,9
2060664,Cornered,1945,['United States of America'],"['Black-and-white', 'Mystery', 'Thriller', 'Film noir', 'War film']",1940,5
8964827,Running Time,1997,['United States of America'],"['Crime Fiction', 'Caper story', 'Thriller', 'Crime Thriller']",1990,7
10895145,Most,2003,"['Czech Republic', 'United States of America']","['Short Film', 'Drama']",2000,3
22507815,Lethal Vows,1999,['United States of America'],"['Crime Fiction', 'Indie', 'Thriller', 'Crime Thriller', 'Drama']",1990,9
25847126,Tora-san's Shattered Romance,1971,['Japan'],['Japanese Movies'],1970,1
22637361,Pippi on the Run,1970,"['Sweden', 'West Germany']","['Comedy', 'Adventure', 'Drama', 'Family Film']",1970,0
657797,I Still Know What You Did Last Summer,1998,['United States of America'],"['Slasher', 'Teen', 'Horror']",1990,8
142224,A.I. Artificial Intelligence,2001,['United States of America'],"['Future noir', 'Adventure', 'Science Fiction', 'Drama']",2000,1
3920769,Anamika,2008,['India'],"['Bollywood', 'Thriller', 'World cinema', 'Romance Film', 'Drama']",2000,8
8313888,Rogue Cop,1954,['United States of America'],"['Black-and-white', 'Crime Fiction', 'Mystery', 'Thriller', 'Film noir', 'Drama']",1950,4
23617806,Hare-Breadth Hurry,1963,['United States of America'],"['Animation', 'Short Film', 'Comedy', 'Family Film']",1960,3
12590208,Merrill's Marauders,1962,['United States of America'],"['Combat Films', 'War film', 'Drama']",1960,2
12752377,Cronicas,2004,['Mexico'],"['Psychological thriller', 'Crime Fiction', 'Thriller', 'World cinema', 'Crime Thriller', 'Drama']",2000,4
2177800,Hard Times,1975,['United States of America'],"['Crime Fiction', 'Sports', 'Drama']",1970,5
637256,Waterworld,1995,['United States of America'],"['Action', 'Thriller', 'Adventure', 'Apocalyptic and post-apocalyptic fiction', 'Doomsday film', 'Science Fiction']",1990,5
3258591,Kung Phooey!,2003,['United States of America'],"['Action', 'Martial Arts Film', 'Action Comedy', 'Parody', 'Action/Adventure', 'Comedy']",2000,3
18807836,The Big Bad Wolf,1934,['United States of America'],"['Musical', 'Animation', 'Short Film', 'Comedy', 'Family Film']",1930,4
5447784,The Stepfather,2009,['United States of America'],"['Psychological thriller', 'Suspense', 'Slasher', 'Thriller', 'Horror', 'Crime Thriller']",2000,9
164411,Absence of Malice,1981,['United States of America'],"['Crime Fiction', 'Mystery', 'Legal drama', 'Drama', 'Courtroom Drama']",1980,1
25527959,For Love and Honor,2007,['Turkey'],['Action'],2000,7
36244504,Tower of Love,1974,['United States of America'],"['Comedy', 'Adult']",1970,4
4657647,69,2004,['Japan'],"['Japanese Movies', 'Drama']",2000,4
16166591,Azhagana Naatkal,2001,['India'],['Comedy'],2000,1
30797258,Malaga,1960,"['United Kingdom', 'United States of America']","['Drama', 'Crime Fiction']",1960,0
4317070,The Kill-Off,1990,['United States of America'],"['Neo-noir', 'Indie', 'Thriller', 'Crime Drama', 'Drama']",1990,0
172534,Cobra,1986,['United States of America'],"['Action', 'Crime Fiction', 'Action/Adventure', 'Thriller']",1980,6
2421467,Radio Days,1987,['United States of America'],"['Period piece', 'Drama', 'Coming of age', 'Indie', 'Comedy', 'Domestic Comedy', 'Ensemble Film']",1980,7
23949922,Once Upon a Time,1944,['United States of America'],"['Black-and-white', 'Comedy', 'Family Film', 'Fantasy']",1940,4
8068230,That's Carry On!,1977,['United Kingdom'],['Comedy'],1970,7
24455599,Phobia 2,2009,['Thailand'],"['World cinema', 'Horror']",2000,9
4669663,A Room for Romeo Brass,1999,['United Kingdom'],"['Comedy', 'Teen', 'Comedy-drama', 'Drama']",1990,9
29200545,Strange Boarders,1938,[],['Mystery'],1930,8
27433395,Kathodu Kathoram,1985,['India'],"['Musical', 'Drama']",1980,5
3594430,Take Care of My Cat,2001,['South Korea'],"['Coming of age', 'World cinema', 'Drama', 'Ensemble Film']",2000,1
12731136,When I'm 64,2004,['United Kingdom'],"['Gay Themed', 'LGBT', 'Gay', 'Gay Interest', 'Drama']",2000,4
2640432,Born to Fight,2004,['Thailand'],"['Action', 'Action/Adventure', 'Thriller', 'World cinema', 'Martial Arts Film']",2000,4
3528415,Michael,1924,"['Weimar Republic', 'Germany']","['Film adaptation', 'Black-and-white', 'LGBT', 'Crime Fiction', 'Indie', 'World cinema', 'Romance Film', 'Drama', 'Silent film']",1920,4
3394852,Wanted: Dead or Alive,1987,['United States of America'],"['Action', 'Crime Fiction', 'Action Thrillers', 'Chase Movie', 'Action/Adventure', 'Thriller']",1980,7
1832025,Underworld,1927,['United States of America'],"['Black-and-white', 'Crime Fiction', 'Indie', 'Silent film', 'Drama']",1920,7
4277184,The Naked Truth,1992,['United States of America'],"['Parody', 'Comedy film']",1990,2
2883438,Grind,2003,['United States of America'],"['Action', 'Action/Adventure', 'Comedy', 'Teen', 'Adventure', 'Sports']",2000,3
754323,Josie and the Pussycats,2001,"['Canada', 'United States of America']","['Musical', 'Parody', 'Comedy', 'Teen']",2000,1
30738106,You Are Here,2007,['United States of America'],"['Crime Fiction', 'Comedy', 'Romantic comedy', 'Romance Film']",2000,7
2918585,Uncommon Valor,1983,['United States of America'],"['Action', 'Suspense', 'Action/Adventure', 'Thriller', 'Adventure', 'War film', 'Drama']",1980,3
7594242,Thumbsucker,2005,['United States of America'],"['Film adaptation', 'Drama', 'Family Drama', 'Indie', 'Coming of age', 'Comedy', 'Comedy-drama']",2000,5
20049035,Hammersmith is Out,1972,['United States of America'],"['Drama', 'Comedy film']",1970,2
1619604,Marooned,1969,['United States of America'],"['Science Fiction', 'Adventure', 'Thriller']",1960,9
6678455,Aishite Imasu 1941: Mahal Kita,2004,['Philippines'],"['Filipino Movies', 'World cinema', 'Romance Film', 'War film', 'Drama']",2000,4
9547922,Laughter and Grief by the White Sea,1987,['Soviet Union'],"['Animation', 'Comedy', 'Feature film', 'Drama']",1980,7
4613833,Skin and Bone,1996,['United States of America'],"['Gay Themed', 'LGBT', 'Gay', 'Gay Interest', 'Crime Drama', 'Drama']",1990,6
6320542,Invincible,2006,['United States of America'],"['Period piece', 'Biography', 'Sports', 'Drama']",2000,6
14021789,Sanders of the River,1935,['United Kingdom'],"['British Empire Film', 'Black-and-white', 'Adventure', 'Drama']",1930,5
11535233,Anne of the Indies,1951,['United States of America'],"['Action', 'Swashbuckler films', 'Adventure']",1950,1
26608090,Hotel Paradiso,1966,['United Kingdom'],['Comedy'],1960,6
32169124,Geetha,1980,['India'],['Romance Film'],1980,0
12120876,Sandesaya,1960,['Sri Lanka'],['War film'],1960,0
25215748,David and Goliath,1960,['Italy'],"['Action', 'Action/Adventure', 'World cinema', 'Epic', 'Adventure', 'Drama']",1960,0
916576,Children of Heaven,1997,['Iran'],"['Comedy', 'World cinema', 'Adventure', 'Drama', 'Family Film']",1990,7
2145301,Video Days,1991,['United States of America'],['Short Film'],1990,1
1629631,Karan Arjun,1995,['India'],"['Action', 'Comedy', 'Romance Film', 'Fantasy']",1990,5
1266575,The Nest,2002,['France'],"['Action', 'Crime Fiction', 'Action/Adventure', 'Thriller', 'World cinema']",2000,2
2642154,Kippur,2000,"['Israel', 'France']","['Biographical film', 'World cinema', 'War film', 'Drama']",2000,0
2920404,Beach Party,1963,['United States of America'],"['Musical', 'Comedy', 'Musical comedy', 'Beach Film']",1960,3
21236198,Thief of Damascus,1952,['United States of America'],"['Romance Film', 'Adventure', 'Fantasy']",1950,2
12576598,Crooks in Cloisters,1964,['United Kingdom'],"['Comedy', 'Crime Fiction']",1960,4
3959961,Atentat,1964,"['Czechoslovakia', 'Czech Republic']","['War film', 'Black-and-white']",1960,4
612052,Spider-Man 2,2004,['United States of America'],"['Action', 'Superhero', 'Action/Adventure', 'Thriller', 'Drama', 'Superhero movie', 'Science Fiction', 'Fantasy']",2000,4
13005395,South from Granada,2003,['Spain'],"['Romantic drama', 'Comedy', 'World cinema', 'Romance Film', 'Romantic comedy', 'Drama']",2000,3
11142691,Ek Nai Paheli,1984,['India'],"['Romantic drama', 'World cinema', 'Romance Film', 'Drama']",1980,4
24491136,Dance Madness,1926,[],['Silent film'],1920,6
9782939,Bombers B-52,1957,['United States of America'],"['Family Drama', 'Romance Film', 'Melodrama', 'War film', 'Drama']",1950,7
24199899,The Big Bluff,1955,['United States of America'],"['Crime Fiction', 'Thriller', 'Film noir', 'Drama']",1950,5
3171944,Disappearing Acts,2000,['United States of America'],"['Film adaptation', 'Romantic drama', 'Romance Film', 'Television movie', 'Comedy-drama', 'Drama']",2000,0
19740679,Defying Gravity,2008,['United States of America'],"['Indie', 'Drama', 'Comedy film']",2000,8
3513144,Room 6,2006,['United States of America'],['Horror'],2000,6
21380202,Tower of Evil,1972,"['United Kingdom', 'United States of America']","['Slasher', 'Horror']",1970,2
7406163,My Scary Girl,2006,['South Korea'],"['Crime Fiction', 'Comedy', 'Romance Film', 'Drama']",2000,6
15867408,Monte Carlo,1930,['United States of America'],"['Musical', 'Black-and-white', 'Comedy', 'Romance Film', 'Romantic comedy']",1930,0
2055701,Three Seasons,1999,"['Vietnam', 'United States of America']","['Romantic drama', 'Indie', 'Romance Film', 'Drama', 'Ensemble Film']",1990,9
3496672,The Jackie Robinson Story,1950,['United States of America'],"['Sports', 'Family Drama', 'Biography', 'Biographical film', 'Biopic [feature]', 'Drama', 'Family Film']",1950,0
20624798,$9.99,2008,"['Israel', 'Australia']","['Drama', 'Animation', 'Indie', 'World cinema', 'Stop motion']",2000,8
142822,The Green Goddess,1930,['United States of America'],"['Black-and-white', 'Drama', 'Indie', 'Goat gland']",1930,0
28581444,Because of the Cats,1973,"['United States of America', 'Netherlands', 'Belgium']","['Drama', 'Crime Fiction', 'Thriller']",1970,3
5837972,Hellboy: Sword of Storms,2006,['United States of America'],"['Action', 'Animation', 'Superhero', 'Action/Adventure', 'Thriller', 'Creature Film', 'Horror', 'Superhero movie', 'Anime', 'Fantasy']",2000,6
10430845,Almost an Angel,1990,['United States of America'],"['Heaven-Can-Wait Fantasies', 'Heavenly Comedy', 'Comedy', 'Fantasy Comedy', 'Fantasy']",1990,0
667368,Harry Potter and the Chamber of Secrets,2002,"['United Kingdom', 'Germany', 'United States of America']","['Fantasy Adventure', ""Children's Fantasy"", 'Mystery', ""Children's/Family"", 'Adventure', 'Family Film', 'Fantasy']",2000,2
6981645,Shatruvu,1991,['India'],"['Drama', 'Crime Fiction']",1990,1
25871694,Passage,2009,"['Switzerland', 'United States of America']","['Short Film', 'Drama']",2000,9
27504596,White Night,2009,['South Korea'],"['Romance Film', 'Mystery', 'Thriller']",2000,9
18520248,Box Head Revolution,2002,['United States of America'],['Science Fiction'],2000,2
3963744,Daybreak,1939,['France'],"['Black-and-white', 'Crime Fiction', 'Thriller', 'World cinema', 'Romance Film', 'Drama']",1930,9
13455499,Run of the Arrow,1957,['United States of America'],"['Revisionist Western', 'Western', 'Indian Western']",1950,7
1605227,Silver Bullet,1985,['United States of America'],"['Creature Film', 'Psychological thriller', 'Film adaptation', 'Teen', 'Horror']",1980,5
3689613,A Better Place,1997,['United States of America'],"['Drama', 'Crime Fiction', 'Indie', 'Crime Drama', 'Juvenile Delinquency Film']",1990,7
905188,The Hitcher,1986,['United States of America'],"['Action', 'Psychological thriller', 'Suspense', 'Slasher', 'Thriller', 'Horror', 'Crime Thriller']",1980,6
21471797,Shadows in the Storm,1988,['United States of America'],"['Thriller', 'Drama']",1980,8
949958,Come Drink with Me,1966,['Hong Kong'],"['Action', 'Fantasy Adventure', 'Action/Adventure', 'World cinema', 'Wuxia', 'Chinese Movies', 'Martial Arts Film']",1960,6
3835200,Without Honor,1949,['United States of America'],['Film noir'],1940,9
675213,Young Guns II,1990,['United States of America'],"['Action', 'Action/Adventure', 'Western', 'Comedy']",1990,0
11072916,Thou Shalt Honor Thy Wife,1925,['Denmark'],"['Black-and-white', 'Drama', 'Indie', 'Comedy', 'Silent film']",1920,5
201448,The Rescuers,1977,['United States of America'],"['Crime Fiction', 'Animation', 'Mystery', 'Animated Musical', 'Film noir', ""Children's/Family"", 'Adventure', 'Drama', 'Family Film', 'Fantasy']",1970,7
214783,The Red Violin,1998,"['United Kingdom', 'Canada', 'Italy']","['Indie', 'Mystery', 'Romantic drama', 'Musical Drama', 'Thriller', 'Romance Film', 'Costume drama', 'Drama', 'Period piece']",1990,8
7235116,Someone to Watch Over Me,1987,['United States of America'],"['Suspense', 'Crime Fiction', 'Mystery', 'Romantic drama', 'Thriller', 'Crime Thriller', 'Drama']",1980,7
2166828,Nine Queens,2000,['Argentina'],"['Crime Fiction', 'Mystery', 'Indie', 'Thriller', 'World cinema', 'Crime Thriller', 'Drama', 'Caper story']",2000,0
1708039,Bulldog Drummond's Revenge,1937,['United States of America'],"['Action', 'Detective fiction', 'Crime Fiction', 'Mystery', 'Thriller', 'Detective', 'Crime Thriller']",1930,7
13377058,2 Become 1,2006,['Hong Kong'],"['Comedy', 'World cinema', 'Romance Film', 'Comedy-drama', 'Chinese Movies', 'Drama']",2000,6
9489056,Nagin,1954,['India'],"['Musical', 'Thriller', 'Romance Film', 'Drama']",1950,4
31981616,Hoodwink,1981,['Australia'],"['Romance Film', 'Crime Fiction', 'Drama']",1980,1
274097,Faces,1968,['United States of America'],"['Indie', 'Drama']",1960,8
17739132,Merci la vie,1991,['France'],"['Comedy', 'Black comedy', 'Road movie', 'Absurdism']",1990,1
19549905,Little Zizou,2009,['India'],"['Comedy', 'World cinema', 'Romance Film', 'Romantic comedy']",2000,9
24634376,Chalisuva Modagalu,1982,['India'],['Musical'],1980,2
7850702,The Prisoner of Zenda,1979,['United States of America'],"['Action', 'Action/Adventure', 'Comedy', 'Slapstick', 'Swashbuckler films']",1970,9
18529816,Sydney: A Story of a City,1999,"['New Zealand', 'Australia', 'United States of America']","['Romantic drama', 'World cinema', 'Romance Film', 'Drama']",1990,9
2991978,The Ringer,2005,['United States of America'],"['Sports', 'Comedy']",2000,5
19875689,The Island of Dr. Moreau,1996,['United States of America'],"['Action', 'Thriller', 'Horror', 'Science Fiction']",1990,6
1470810,Man of the House,2005,['United States of America'],"['Action', 'Action/Adventure', 'Comedy', 'Sports']",2000,5
27737554,Uninvited Guest,1999,['United States of America'],"['Psychological thriller', 'Suspense', 'Thriller', 'Drama']",1990,9
21070824,Samson vs. the Vampire Women,1962,['Mexico'],"['Superhero movie', 'Black-and-white', 'Horror']",1960,2
6795090,Nee Varuvai Ena,1999,['India'],"['Romantic drama', 'World cinema', 'Romance Film', 'Drama']",1990,9
28618942,McLeod's Daughters,1996,"['New Zealand', 'Australia']","['Drama', 'Indie', 'Western', 'Television movie']",1990,6
11219515,Mahasamudram,2006,['India'],"['Action', 'Drama']",2000,6
10882693,Déficit,2007,['Mexico'],"['Drama', 'World cinema']",2000,7
11287808,Aachi & Ssipak,2006,['South Korea'],"['Action', 'Animation', 'Dystopia', 'Comedy', 'Anime', 'Science Fiction', 'Fantasy']",2000,6
3660668,"Black Mama, White Mama",1972,['United States of America'],"['Action', 'Blaxploitation', 'Prison', 'Crime Fiction', 'Indie', 'Action/Adventure', 'Women in prison films', 'Sexploitation']",1970,2
19420139,Meet Me Tonight,1952,['United Kingdom'],"['Film adaptation', 'Comedy', 'Drama']",1950,2
23621133,Freedom Machines,2004,['United States of America'],"['Inventions & Innovations', 'Social issues', 'Documentary', 'Illnesses & Disabilities', 'Culture & Society']",2000,4
1136163,Elvis Meets Nixon,1997,['United States of America'],"['Mockumentary', 'Comedy']",1990,7
2476100,An American Tail: The Treasure of Manhattan Island,1998,['United States of America'],"['Music', 'Animation', 'Animated Musical', 'Family-Oriented Adventure', ""Children's/Family"", ""Children's"", 'Adventure', 'Family Film']",1990,8
7941624,Camping Cosmos,1996,['Belgium'],"['Surrealism', 'LGBT', 'Crime Fiction', 'Indie', 'Satire', 'Comedy', 'Black comedy', 'Sex comedy']",1990,6
11320510,Giri,2004,['India'],"['Drama', 'World cinema']",2000,4
10836632,Dasepo Naughty Girls,2006,['South Korea'],"['Musical', 'LGBT', 'Satire', 'Comedy', 'World cinema', 'Teen', 'Sex comedy']",2000,6
35736458,La otra alcoba,1976,['Spain'],"['Drama', 'Comedy film']",1970,6
1663422,Screaming Mimi,1958,['United States of America'],"['Psychological thriller', 'Black-and-white', 'Mystery', 'Thriller', 'Film noir', 'Drama']",1950,8
19081582,The Uninhibited,1965,"['Spain', 'France', 'West Germany', 'Italy']",['Drama'],1960,5
24478633,Gudia,1997,['India'],['Drama'],1990,7
33808833,Aces Go Places 5: The Terracotta Hit,1989,['Hong Kong'],"['Action', 'Crime Fiction', 'Comedy film', 'Chinese Movies']",1980,9
14147634,The Vertical Ray of the Sun,2000,"['France', 'Germany', 'Vietnam']","['Romantic drama', 'Family Drama', 'World cinema', 'Romance Film', 'Drama']",2000,0
2748374,My Heart Is Yours,2002,['India'],"['Musical', 'Romantic drama', 'Bollywood', 'World cinema', 'Romance Film', 'Drama', 'Family Film']",2000,2
3782101,Pushover,1954,['United States of America'],"['Suspense', 'Black-and-white', 'Crime Fiction', 'Thriller', 'Film noir', 'Drama']",1950,4
9595260,The King of the Kongo,1929,['United States of America'],"['Action', 'Black-and-white', 'Indie', 'Silent film', 'Adventure']",1920,9
17941890,The Dead Are Alive,1972,"['Italy', 'West Germany', 'Yugoslavia']",['Horror'],1970,2
4248608,The Land Before Time X: The Great Longneck Migration,2003,['United States of America'],"['Animated cartoon', 'Animation', 'Adventure', 'Family Film']",2000,3
11413995,In Caliente,1935,['United States of America'],"['Musical', 'Black-and-white', 'Comedy', 'Romantic comedy']",1930,5
31591508,Star Runners,2009,['United States of America'],"['Science Fiction', 'Thriller', 'Horror']",2000,9
8425973,Slipstream,1989,['United Kingdom'],"['Time travel', 'Science Fiction', 'Adventure']",1980,9
481293,Beauty and the Beast: The Enchanted Christmas,1997,"['Canada', 'United States of America']","[""Children's Fantasy"", 'Animation', 'Animated Musical', ""Children's/Family"", 'Christmas movie', 'Fantasy']",1990,7
16687535,The Trojan Horse,2008,['Canada'],"['Television movie', 'Political drama', 'Drama']",2000,8
25933772,Who is Thanassis,1969,['Greece'],['Comedy'],1960,9
30882696,Stolen Heaven,1931,['United States of America'],['Drama'],1930,1
4956438,Sorority Babes in the Slimeball Bowl-O-Rama,1988,['United States of America'],"['Horror Comedy', 'Teen', 'Horror', 'Comedy', 'B-movie', 'Cult']",1980,8
10621212,Madam Satan,1930,['United States of America'],"['Musical', 'Pre-Code', 'Drama']",1930,0
1607895,Kung Fu Hustle,2004,"['China', 'Hong Kong']","['Action', 'Crime Fiction', 'Action/Adventure', 'Satire', 'Comedy', 'World cinema', 'Chinese Movies', 'Martial Arts Film', 'Period piece', 'Parody', 'Action Comedy', 'Wuxia']",2000,4
8621468,Planet of Dinosaurs,1978,['United States of America'],"['Comedy', 'Thriller', 'Adventure', 'Parody', 'Stop motion', 'Science Fiction', 'Cult', 'Fantasy']",1970,8
13893715,Prey for Rock & Roll,2003,['United States of America'],"['Musical', 'LGBT', 'Indie', 'Drama']",2000,3
5083422,Battle in Outer Space,1959,['Japan'],"['Action', 'Japanese Movies', 'World cinema', 'Adventure', 'Science Fiction', 'Fantasy']",1950,9
24870003,Cracks,2009,"['United Kingdom', 'Spain', 'Ireland']","['Psychological thriller', 'LGBT', 'Crime Fiction', 'Mystery', 'Indie', 'Thriller', 'Crime Thriller', 'Drama', 'Period piece', 'Suspense']",2000,9
31176,The Parent Trap,1961,['United States of America'],"['Romantic comedy', 'Comedy']",1960,1
19234425,Life for Ruth,1962,['United Kingdom'],['Drama'],1960,2
22162507,Slayer,2006,['United States of America'],"['Action', 'Indie', 'Horror', 'Television movie']",2000,6
1005660,Mambo Italiano,2003,"['Canada', 'United States of America']","['LGBT', 'Comedy', 'Romance Film', 'Gay Themed', 'Gay', 'Gay Interest', 'Domestic Comedy', 'Romantic comedy', 'Comedy-drama']",2000,3
35194737,9 Nelalu,2001,['India'],['Drama'],2000,1
18198534,The Boys,1962,['United States of America'],"['Drama', 'Crime Fiction']",1960,2
1259785,Rebecca,1940,['United States of America'],"['Mystery', 'Thriller', 'Romance Film', 'Drama']",1940,0
30330044,Return of the Sentimental Swordsman,1981,['Hong Kong'],['Wuxia'],1980,1
4091030,Without Evidence,1995,['United States of America'],"['Psychological thriller', 'Crime Fiction', 'Thriller', 'Crime Thriller', 'Docudrama', 'Drama', 'Courtroom Drama']",1990,5
33355587,Murder in a Blue World,1973,['Spain'],['Science Fiction'],1970,3
23737134,Lonesome Dove,1989,['United States of America'],"['Western', 'Adventure', 'Drama']",1980,9
7987214,Muscle Up a Little Closer,1957,['United States of America'],"['Short Film', 'Black-and-white', 'Comedy']",1950,7
5042887,Pandavar Bhoomi,2001,['India'],[],2000,1
5579794,Bad Company,1986,['Argentina'],['Drama'],1980,6
8587833,Bava Nachadu,2001,['India'],"['Romance Film', 'Comedy', 'Drama']",2000,1
43307,K-19: The Widowmaker,2002,"['Canada', 'United Kingdom', 'Germany', 'United States of America']","['Action', 'Action Thrillers', 'Action/Adventure', 'Thriller', 'War film', 'Drama', 'Suspense', 'Period piece', 'History', 'Political drama']",2000,2
21689945,Wheels of Terror,1990,['United States of America'],"['Action Thrillers', 'Thriller', 'Horror']",1990,0
12813606,Double Agent 73,1974,['United States of America'],"['Action', 'Sexploitation', 'Action/Adventure', 'Comedy', 'Adult']",1970,4
1952159,The Spanish Prisoner,1997,['United States of America'],"['Heist', 'Crime Fiction', 'Mystery', 'Indie', 'Thriller', 'Crime Thriller']",1990,7
24489244,Bahurani,1963,['India'],['Bollywood'],1960,3
1571951,Mangal Pandey: The Rising,2005,['India'],"['Biographical film', 'Bollywood', 'World cinema', 'Drama']",2000,5
27580012,Mondo Bobo,1997,['Croatia'],"['Drama', 'Crime Fiction']",1990,7
3371111,Girl Shy,1924,['United States of America'],"['Black-and-white', 'Indie', 'Chase Movie', 'Comedy', 'Silent film', 'Romance Film', 'Romantic comedy']",1920,4
2259669,Prom Queen: The Marc Hall Story,2004,['Canada'],"['LGBT', 'Comedy', 'Drama', 'Gay Themed', 'Gay', 'Coming of age', 'Gay Interest', 'Television movie']",2000,4
6301209,Humko Tumse Pyaar Hai,2006,['India'],"['Musical', 'Romantic drama', 'World cinema', 'Romance Film', 'Drama']",2000,6
9280011,Tracks,1976,['United States of America'],['Drama'],1970,6
8511958,The Brotherhood II,2001,['United States of America'],['Horror'],2000,1
29471533,Flickan från tredje raden,1949,['Sweden'],['Drama'],1940,9
25112884,Palaivana Solai,2009,['India'],"['Romance Film', 'Drama']",2000,9
4114160,Watch Out for the Automobile,1966,['Soviet Union'],"['Comedy', 'Crime Fiction']",1960,6
21794578,Marvelous,2006,['United States of America'],"['Drama', 'Comedy']",2000,6
7693761,It's Always Fair Weather,1955,['United States of America'],"['Musical', 'Musical comedy']",1950,5
105406,Tromeo & Juliet,1997,['United States of America'],"['Parody', 'Comedy', 'Cult']",1990,7
396282,Beat Street,1984,['United States of America'],"['Musical', 'Drama', 'Teen', 'Dance', 'Hip hop movies', 'Breakdance']",1980,4
3405396,Uuno Turhapuro armeijan leivissä,1984,['Finland'],['Comedy'],1980,4
12450050,"Dance, Girl, Dance",1940,['United States of America'],"['Musical', 'Black-and-white', 'Romantic drama', 'Comedy', 'Romance Film', 'Drama']",1940,0
24605417,Navagraha,2008,[],['Thriller'],2000,8
25859284,The Tale of Zatoichi Continues,1962,['Japan'],"['Japanese Movies', 'Action/Adventure', 'World cinema', 'Martial Arts Film', 'Drama']",1960,2
15438705,Striker,2009,['India'],"['Action', 'Musical', 'Drama', 'Bollywood', 'World cinema']",2000,9
4235653,Lucky Number Slevin,2006,"['Germany', 'United States of America']","['Crime Fiction', 'Mystery', 'Comedy Thriller', 'Thriller', 'Crime Thriller', 'Drama']",2000,6
35740068,Girl of the Rio,1932,['United States of America'],"['Musical', 'Comedy film', 'Romance Film', 'Drama']",1930,2
26069176,Ride a Wild Pony,1975,"['United States of America', 'Australia']","['Adventure', 'Family Film']",1970,5
2856257,Hungama,2003,['India'],"['Comedy', 'Bollywood', 'Romance Film', 'Drama']",2000,3
8332992,Billa,2007,['India'],['Action'],2000,7
20524492,No Regret,2006,"['Korea', 'South Korea']","['LGBT', 'Romantic drama', 'World cinema', 'Romance Film', 'Drama', 'Gay Themed', 'Gay', 'Gay Interest']",2000,6
1625009,The Five Heartbeats,1991,['United States of America'],"['Musical', 'Film à clef', 'Family Drama', 'Musical Drama', 'Drama']",1990,1
21757059,Dive Bomber,1941,['United States of America'],"['War film', 'Drama']",1940,1
10393294,Three-Cornered Moon,1933,['United States of America'],"['Black-and-white', 'Comedy', 'Comedy of manners']",1930,3
1192675,Odd Man Out,1947,['United Kingdom'],"['Suspense', 'Crime Fiction', 'Chase Movie', 'Thriller', 'Crime Drama', 'Film noir', 'Drama']",1940,7
32329697,Nana,1985,[],['Drama'],1980,5
15550664,The Challengers,1990,"['Canada', 'United States of America']","['Drama', ""Children's"", 'Family Film']",1990,0
19877803,Real Time,2008,['Canada'],"['Indie', 'Comedy', 'Comedy-drama', 'Drama']",2000,8
23817664,Moment of Truth: Cradle of Conspiracy,1994,['United States of America'],['Drama'],1990,4
11357774,Little Golden Book Land,1989,['United States of America'],"['Short Film', 'Animation']",1980,9
1583660,El espíritu de la colmena,1973,['Spain'],"['Art film', 'World cinema', 'War film', 'Drama']",1970,3
9222319,Something Of Value,1957,['United States of America'],"['Black-and-white', 'Historical fiction', 'War film', 'Political drama', 'Drama']",1950,7
23605553,Demonic Toys: Personal Demons,2009,['United States of America'],"['Monster movie', 'Cult', 'Horror']",2000,9
17226530,Crossfire,1997,['India'],['Drama'],1990,7
8695018,Vigilante Force,1976,['United States of America'],"['Action', 'Drama', 'Action Thrillers', 'Action/Adventure', 'Thriller']",1970,6
24147198,In Our Time,1944,['United States of America'],"['Black-and-white', 'Drama']",1940,4
32191033,Maa Kasam,1985,['India'],"['Musical', 'Bollywood', 'World cinema', 'Drama']",1980,5
17365387,A Perfect Getaway,2009,['United States of America'],"['Action', 'Psychological thriller', 'Mystery', 'Action/Adventure', 'Slasher', 'Thriller', 'Crime Thriller']",2000,9
1769928,"Paradise, Hawaiian Style",1966,['United States of America'],"['Musical', 'Romance Film', 'Comedy']",1960,6
35784845,A Stranger In My Arms,1959,['United States of America'],['Drama'],1950,9
5644502,Pink Cadillac,1989,['United States of America'],"['Action', 'Action Comedy', 'Chase Movie', 'Action/Adventure', 'Comedy', 'Drama']",1980,9
6833084,The Good Night,2007,"['United Kingdom', 'Germany', 'United States of America']","['Drama', 'Indie', 'Comedy', 'Romance Film', 'Romantic comedy', 'Fantasy']",2000,7
1592906,Way Out West,1937,['United States of America'],"['Comedy', 'Black-and-white']",1930,7
34866660,Be Sure to Share,2009,['Japan'],"['Japanese Movies', 'Drama', 'World cinema']",2000,9
11692389,The Snow Queen,2005,"['Canada', 'United Kingdom']","['Adventure', 'Family Film', 'Fantasy']",2000,5
4015205,Rubberface,1983,['Canada'],"['Slapstick', 'Comedy']",1980,3
935847,Urban Legend,1998,"['United States of America', 'France']","['Slasher', 'Teen', 'Horror']",1990,8
7761830,Spaced Invaders,1990,['United States of America'],"['Comedy', 'Adventure', 'Alien Film', 'Science Fiction', 'Family Film']",1990,0
14473137,Pretty Bird,2008,['United States of America'],"['Black comedy', 'Indie', 'Comedy']",2000,8
1821202,Barabbas,1962,['Italy'],"['Period piece', 'Christian film', 'Epic', 'Costume drama', 'Drama', 'Movies About Gladiators']",1960,2
25846391,Tora-san's Grand Scheme,1970,['Japan'],"['Japanese Movies', 'Comedy', 'World cinema']",1970,0
14117382,The Rainbow Warrior,1992,"['New Zealand', 'United States of America']",['Drama'],1990,2
25011340,Dot.Kill,2005,['United States of America'],"['Action', 'Psychological thriller', 'Action/Adventure', 'Thriller', 'Crime Thriller']",2000,5
12430435,"Love, So Divine",2004,['South Korea'],['Romantic comedy'],2000,4
21699468,Ragazzi fuori,1990,['Italy'],['Drama'],1990,0
54999,Forbidden Planet,1956,['United States of America'],"['Science Fiction', 'Adventure']",1950,6
65436,Dawn of the Dead,1978,"['Italy', 'United States of America']","['Indie', 'Splatter film', 'Horror', 'Zombie Film', 'Doomsday film', 'Cult']",1970,8
26092506,Okul,2004,['Turkey'],"['Horror', 'Comedy film']",2000,4
7421383,Dixieland Droopy,1954,['United States of America'],"['Music', 'Animation', 'Short Film', 'Comedy', 'Family Film']",1950,4
20284620,I theia ap' ton Chicago,1957,['Greece'],['Comedy'],1950,7
13138495,A Knight in Camelot,1998,['United States of America'],"['Comedy', 'Adventure', 'Costume drama', 'Science Fiction', 'Fantasy Comedy', 'Family Film', 'Fantasy']",1990,8
6994182,Johnny Appleseed,1948,['United States of America'],"['Short Film', 'Biographical film']",1940,8
10088120,The Seven Little Foys,1955,['United States of America'],"['Musical', 'Comedy', 'Biopic [feature]', 'Biographical film', 'Drama', 'Family Film']",1950,5
26318071,His Royal Highness,1932,['Australia'],"['Musical', 'Comedy']",1930,2
11698816,Falling Sky,1998,['United States of America'],"['Indie', 'Family Drama', 'Drama']",1990,8
27170576,The Long Road Home,1999,['United States of America'],"['Family Drama', 'Adventure', 'Drama', 'Family Film']",1990,9
32871914,Three in One,1957,['Australia'],['Drama'],1950,7
18541564,The Great Man's Lady,1942,['United States of America'],"['Period piece', 'Black-and-white', 'Western', 'Historical fiction', 'Melodrama', 'Drama']",1940,2
15809123,Blue Smoke,2007,['United States of America'],"['Action', 'Psychological thriller', 'Film adaptation', 'Crime Fiction', 'Action/Adventure', 'Thriller', 'Romance Film', 'Drama', 'Suspense', 'Television movie']",2000,7
417744,Sexmission,1984,['Poland'],"['Comedy', 'Adventure', 'Science Fiction', 'Sex comedy']",1980,4
16158652,La hora de los valientes,1998,['Spain'],"['Period piece', 'Romantic drama', 'Thriller', 'World cinema', 'Romance Film', 'War film', 'Drama']",1990,8
25932547,Stranger Than Fiction,2001,['United States of America'],"['Comedy', 'Thriller']",2000,1
12054679,The Tournament,2009,['United Kingdom'],"['Action', 'Action/Adventure', 'Thriller', 'Crime Thriller']",2000,9
5351389,Marmoulak,2004,['Iran'],['Comedy'],2000,4
1829909,Kisna: The Warrior Poet,2005,"['United Kingdom', 'India']","['Musical', 'Romantic drama', 'World cinema', 'Romance Film', 'Drama']",2000,5
12275048,Ek Din Achanak,1989,['India'],"['Art film', 'Family Drama', 'Drama']",1980,9
2260022,Maniac Cop 3,1993,['United States of America'],"['Action', 'Slasher', 'Thriller', 'Horror', 'B-movie', 'Zombie Film']",1990,3
243064,Halloween III: Season of the Witch,1982,['United States of America'],"['Sci-Fi Horror', 'Mystery', 'Slasher', 'Horror', 'Supernatural', 'Science Fiction']",1980,2
22983782,The Wedding Tackle,2000,['United Kingdom'],['Comedy'],2000,0
2391447,One of Our Dinosaurs is Missing,1975,"['United Kingdom', 'United States of America']","['Spy', 'Mystery', 'Comedy', 'Thriller', 'Slapstick', 'Adventure', 'Science Fiction', 'Family Film']",1970,5
17366863,Raptor,2001,['United States of America'],"['Creature Film', 'Monster', 'Horror', 'B-movie', 'Sci-Fi Horror', 'Natural horror films']",2000,1
10791989,Netri Kann,1981,['India'],['Drama'],1980,1
10193,Enter the Dragon,1973,"['Hong Kong', 'United States of America']","['Action', 'Drama', 'Crime Fiction', 'Thriller']",1970,3
9913770,Daddy's Dyin': Who's Got the Will?,1990,['United States of America'],"['Black comedy', 'Comedy', 'Drama']",1990,0
13527119,Joy Division,2006,"['United Kingdom', 'Germany', 'Hungary']","['War film', 'Drama']",2000,6
6202854,Die Mommie Die!,2003,['United States of America'],"['LGBT', 'Parody', 'Indie', 'Comedy', 'Black comedy', 'Cult']",2000,3
3659506,It Came From the Sky,1999,"['Canada', 'United States of America']","['Family Drama', 'Fantasy Drama', 'Comedy', 'Comedy-drama']",1990,9
10318067,The Good Mother,1988,['United States of America'],"['Romantic drama', 'Romance Film', 'Drama', 'Courtroom Drama']",1980,8
13457412,Mandi,1983,['India'],"['Art film', 'Comedy', 'Bollywood', 'Drama']",1980,3
4155619,Something the Lord Made,2004,['United States of America'],"['Biopic [feature]', 'Television movie', 'Docudrama', 'Drama', 'Medical fiction']",2000,4
24700816,Un amour à taire,2005,['France'],"['LGBT', 'Drama', 'World cinema']",2000,5
3951878,The Aggressives,2005,['South Korea'],"['Gender Issues', 'LGBT', 'Biography', 'Documentary', 'Drama', 'Culture & Society']",2000,5
2219632,Heavens Above!,1963,['United Kingdom'],"['Parody', 'Satire', 'Comedy']",1960,3
16993468,On Trial,1928,[],"['Silent film', 'Black-and-white', 'Drama']",1920,8
10581336,Rough Romance,1930,['United States of America'],"['Black-and-white', 'Western', 'Adventure']",1930,0
21856079,Lost Stallions: The Journey Home,2008,['United States of America'],['Family Film'],2000,8
29251729,The Perfect Circle,1997,"['Bosnia and Herzegovina', 'France']","['War film', 'Drama']",1990,7
20927886,Alien Cargo,1999,['United States of America'],"['Creature Film', 'Science Fiction']",1990,9
8624023,Sakhiya,2004,['India'],[],2000,4
10691372,"Sizzle Beach, U.S.A.",1974,['United States of America'],"['Indie', 'Comedy', 'Romance Film', 'Romantic comedy']",1970,4
532618,Scary Movie 2,2001,"['Canada', 'United States of America']","['Gross out', 'Gross-out film', 'Horror Comedy', 'Comedy', 'Teen', 'Haunted House Film', 'Parody', 'Horror']",2000,1
19208267,Estômago,2007,"['Brazil', 'Italy']","['Drama', 'World cinema']",2000,7
4048011,Can't Buy Me Love,1987,['United States of America'],"['Coming of age', 'Comedy', 'Teen', 'Romantic comedy', 'Romance Film', 'Sex comedy']",1980,7
1582661,The Musketeer,2001,"['Luxembourg', 'United Kingdom', 'Germany', 'United States of America']","['Action', 'Film adaptation', 'Costume Adventure', 'Action/Adventure', 'Costume drama', 'Adventure', 'Drama', 'Swashbuckler films', 'Period piece', 'Historical fiction']",2000,1
31569602,Current,2009,['India'],"['Romance Film', 'Romantic comedy', 'Drama']",2000,9
3834043,Daddy Long-legs,2005,['South Korea'],['Romantic comedy'],2000,5
8119617,The Tiger Woman,1944,['United States of America'],"['Action', 'Black-and-white', 'Action/Adventure', 'Adventure']",1940,4
5777938,Stoogemania,1986,['United States of America'],"['Slapstick', 'Comedy']",1980,6
1415904,What's New Pussycat?,1965,"['United Kingdom', 'France', 'United States of America']","['Comedy', 'Romance Film', 'Romantic comedy', 'Sex comedy']",1960,5
14068889,The Chemist,1936,['United States of America'],"['Short Film', 'Black-and-white', 'Comedy']",1930,6
3938481,Let Me Die a Woman,1978,['United States of America'],"['LGBT', 'Sexploitation', 'Indie', 'Documentary', 'Adult']",1970,8
19299698,"Jubilo, Jr.",1924,['United States of America'],"['Black-and-white', 'Short Film', 'Comedy', 'Silent film']",1920,4
31968558,Whispers and Moans,2007,['Hong Kong'],"['Erotic Drama', 'World cinema', 'Chinese Movies', 'Drama']",2000,7
15877215,Mumbai Matinee,2003,['India'],"['Romantic drama', 'Comedy', 'World cinema', 'Romance Film', 'Romantic comedy', 'Drama']",2000,3
16675752,She's No Angel,2001,['United States of America'],"['Television movie', 'Drama', 'Thriller']",2000,1
5028092,Murder on the Orient Express,1974,['United Kingdom'],"['Film adaptation', 'Crime Fiction', 'Mystery', 'Thriller', 'Crime Thriller', 'Drama', 'Period piece', 'Detective']",1970,4
5886750,The Wind in the Willows,1983,['United Kingdom'],"['Animation', 'Stop motion', 'Television movie', 'Family Film', 'Fantasy']",1980,3
15462344,Moordwijven,2007,['Netherlands'],"['Action Comedy', 'Comedy', 'Crime Comedy', 'Black comedy']",2000,7
6503634,The Deadly Companions,1961,['United States of America'],"['Action', 'Revisionist Western', 'Action/Adventure', 'Western']",1960,1
3511104,Care Bears Nutcracker Suite,1988,['Canada'],"['Animation', 'Comedy', ""Children's"", 'Family Film', 'Fantasy']",1980,8
14603523,Nijinsky,1980,['United States of America'],"['LGBT', 'Biographical film', 'Biopic [feature]', 'Drama']",1980,0
33052656,Kailangan Ko'y Ikaw,2000,['Philippines'],['Filipino Movies'],2000,0
2973132,The Namesake,2006,"['India', 'United States of America']","['Film adaptation', 'Drama', 'Family Drama', 'Indie']",2000,6
25396255,Accident on Hill Road,2009,['India'],"['Musical', 'Thriller', 'Bollywood', 'World cinema']",2000,9
7999199,Desire,1936,['United States of America'],"['Black-and-white', 'Drama']",1930,6
667371,Harry Potter and the Prisoner of Azkaban,2004,"['United Kingdom', 'United States of America']","['Fantasy Adventure', ""Children's Fantasy"", 'Mystery', ""Children's/Family"", 'Adventure', 'Family Film', 'Fantasy']",2000,4
1550562,The Cars that Ate Paris,1974,"['New Zealand', 'Australia']","['Action', 'Mystery', 'Action/Adventure', 'Comedy', 'Horror Comedy', 'World cinema', 'Black comedy', 'Adventure', 'Horror', 'Science Fiction']",1970,4
7277391,La Maldicion de la Bestia,1975,['Spain'],['Horror'],1970,5
13346488,Twenty Million Sweethearts,1934,['United States of America'],"['Musical', 'Black-and-white', 'Satire', 'Comedy']",1930,4
21199699,The Inhabited Island,2008,['Russia'],"['Action', 'Science Fiction', 'Adventure']",2000,8
2460646,The Maze,1953,['United States of America'],"['Film adaptation', 'Horror', 'Science Fiction', 'Drama']",1950,3
27253597,Speed Track,2007,['India'],"['Action', 'Romantic comedy']",2000,7
18785623,Another Shore,1948,['United Kingdom'],['Comedy'],1940,8
3142178,The Blue Kite,1993,['China'],"['Family Drama', 'World cinema', 'Chinese Movies', 'Political drama', 'Drama']",1990,3
25074145,Dr. Alien,1989,['United States of America'],"['Science Fiction', 'Comedy']",1980,9
26180347,Sangre de Mayo,2008,['Spain'],"['Period piece', 'History', 'Historical fiction', 'Epic']",2000,8
19408520,Second Childhood,1936,['United States of America'],"['Black-and-white', 'Short Film', 'Comedy', 'Family Film']",1930,6
1234079,A Night in Casablanca,1946,['United States of America'],"['Crime Fiction', 'Satire', 'Comedy', 'Slapstick']",1940,6
6585829,Unlikely Angel,1996,['United States of America'],"['Heavenly Comedy', 'Comedy', 'Religious Film', 'Fantasy Comedy', 'Drama', 'Fantasy']",1990,6
711102,Lucas,1986,['United States of America'],"['Romantic drama', 'Comedy', 'Teen', 'Romance Film', 'Drama', 'Coming of age', 'Comedy-drama', 'Sports']",1980,6
14436334,Flagpole Jitters,1956,['United States of America'],"['Short Film', 'Black-and-white', 'Comedy']",1950,6
27376044,Restraining Order,1999,"['Germany', 'United States of America']","['Action', 'Thriller']",1990,9
20699587,Pope Joan,2009,['Germany'],"['Drama', 'World cinema']",2000,9
4995737,Yam Yasothon,2005,['Thailand'],"['Musical', 'Romantic comedy', 'Comedy']",2000,5
17212834,Prison-A-Go-Go!,2003,['United States of America'],"['Action', 'Crime Fiction', 'Parody', 'Indie', 'Comedy', 'B-movie', 'Women in prison films']",2000,3
957792,Cats & Dogs,2001,"['United States of America', 'Australia']","['Action', 'Fantasy Adventure', 'Comedy', ""Children's/Family"", 'Adventure', 'Fantasy Comedy', 'Family Film']",2000,1
30859718,The Flipside of Dominick Hide,1980,['United Kingdom'],['Drama'],1980,0
1972230,"Hold the Lion, Please",1942,['United States of America'],"['Animation', 'Short Film', 'Family Film']",1940,2
5589674,Western Union,1941,['United States of America'],['Western'],1940,1
14866242,Romola,1924,['United States of America'],"['Black-and-white', 'Romantic drama', 'Indie', 'Silent film', 'Drama']",1920,4
2937356,To the Limit,1995,['United States of America'],"['Action', 'Crime Fiction', 'Thriller']",1990,5
5019937,Geronimo: An American Legend,1993,['United States of America'],"['Revisionist Western', 'Action/Adventure', 'Drama', 'Period piece', 'Epic Western', 'Western', 'Biopic [feature]', 'Indian Western']",1990,3
2706065,Red Sun,1971,"['Spain', 'France', 'Italy', 'United States of America']","['Western', 'Hybrid Western', 'Action/Adventure']",1970,1
5064339,Terror-Creatures from the Grave,1965,['Italy'],"['Horror', 'B-movie', 'Zombie Film', 'Supernatural']",1960,5
21781488,Boy A,2008,['United Kingdom'],"['Crime Fiction', 'Indie', 'Romance Film', 'Drama']",2000,8
17702782,Saturday Night,2002,['Pakistan'],['Thriller'],2000,2
2435343,Five Deadly Venoms,1978,['Hong Kong'],"['Action', 'Action/Adventure', 'World cinema', 'Chinese Movies', 'Martial Arts Film', 'Drama']",1970,8
23891073,Les Bronzés 3 : Amis pour la vie,2006,['France'],['Comedy film'],2000,6
27232037,Come Out of the Pantry,1935,['United States of America'],['Musical'],1930,5
9170426,Pigskin Parade,1936,['United States of America'],"['Musical', 'Black-and-white', 'Comedy', 'Sports']",1930,6
20345291,Cautiva,2005,['Argentina'],"['Drama', 'Indie', 'World cinema', 'Political drama']",2000,5
30789590,Parameshi Prema Prasanga,1985,['India'],['Drama'],1980,5
10792059,Priya,1978,['India'],"['Musical', 'Romantic drama', 'Bollywood', 'World cinema', 'Romance Film', 'Drama']",1970,8
666935,"A Cool, Dry Place",1999,['United States of America'],"['Film adaptation', 'Romantic drama', 'Family Drama', 'Romance Film', 'Drama']",1990,9
10604153,Flag of Iron,1980,['Hong Kong'],"['Action/Adventure', 'World cinema', 'Chinese Movies', 'Martial Arts Film']",1980,0
2793610,The Holiday,2006,['United States of America'],"['Comedy', 'Romance Film', 'Romantic comedy', 'Comedy-drama']",2000,6
4562945,Postal,2007,"['Germany', 'United States of America', 'Canada']","['Action', 'Parody', 'Action Comedy', 'Action/Adventure', 'Comedy', 'Horror', 'Black comedy']",2000,7
3978358,The Medusa Touch,1978,['United Kingdom'],"['Psychological thriller', 'Mystery', 'Thriller', 'Horror']",1970,8
702506,White Palace,1990,['United States of America'],"['Film adaptation', 'Romantic drama', 'Romance Film', 'Erotica', 'Drama']",1990,0
3907857,Six Shooter,2005,"['Ireland', 'United Kingdom']","['Short Film', 'Comedy', 'Black comedy', 'Comedy-drama']",2000,5
20693171,These Thousand Hills,1959,['United States of America'],"['Action/Adventure', 'Western']",1950,9
9340076,Adrenalin: Fear the Rush,1996,['United States of America'],"['Action', 'Action/Adventure', 'Thriller', 'Disaster', 'Science Fiction']",1990,6
12733053,The Gay Bride,1934,['United States of America'],"['Black-and-white', 'Crime Fiction', 'Comedy']",1930,4
12491178,A Broken Life,2007,['Canada'],"['Indie', 'Drama']",2000,7
7906552,From A to Z-Z-Z-Z,1954,[],[],1950,4
5480364,Island of Lost Souls,1932,['United States of America'],"['Black-and-white', 'Horror', 'Pre-Code', 'Science Fiction']",1930,2
8671919,Nahwa al-Majd,1949,['Egypt'],['Romance Film'],1940,9
2547451,Animal Factory,2000,['United States of America'],"['Prison', 'Crime Fiction', 'Drama']",2000,0
13468494,The Stranger Within,1971,['United States of America'],"['Mystery', 'Science Fiction']",1970,1
7818947,Father,1990,['Australia'],['Drama'],1990,0
1393739,The Brothers Grimm,2005,"['United Kingdom', 'Czech Republic', 'United States of America']","['Action/Adventure', 'Comedy', 'Thriller', 'Buddy film', 'Black comedy', 'War film', 'Costume drama', 'Adventure', 'Steampunk', 'Fantasy']",2000,5
1933671,Breaking Glass,1980,"['United Kingdom', 'England']","['Musical', 'Musical Drama', 'Punk rock', 'Drama']",1980,0
1145800,"Me, Myself & Irene",2000,['United States of America'],"['Gross out', 'Gross-out film', 'Comedy', 'Slapstick']",2000,0
32151409,Assa,1987,['Soviet Union'],"['Music', 'Crime Fiction', 'Historical drama', 'Romance Film']",1980,7
4760936,Insomnia,2002,"['Canada', 'United States of America']","['Psychological thriller', 'Crime Fiction', 'Mystery', 'Thriller', 'Remake', 'Crime Thriller', 'Drama', 'Suspense']",2000,2
3021304,The Little Colonel,1935,['United States of America'],"['Black-and-white', 'Family Drama', 'Musical Drama', 'Drama', 'Family Film']",1930,5
15720590,Gift Horse,1952,['United Kingdom'],"['War film', 'Black-and-white']",1950,2
14763504,My Dog Vincent,1998,['Canada'],"['Indie', 'Comedy']",1990,8
1968110,How to Get Ahead in Advertising,1989,"['United Kingdom', 'England']","['Indie', 'Parody', 'Satire', 'Comedy', 'Black comedy', 'Workplace Comedy', 'Fantasy']",1980,9
2860057,Crackerjack,2002,['Australia'],['Comedy'],2000,2
2244939,Clean and Sober,1988,['United States of America'],"['Addiction Drama', 'Drama']",1980,8
9246776,"Edison, the Man",1940,"['United Kingdom', 'United States of America']","['Period piece', 'Black-and-white', 'Biographical film', 'Biopic [feature]', 'Drama']",1940,0
31097343,The Jeweller's Shop,1988,"['Austria', 'Canada', 'Germany', 'Italy']","['Film adaptation', 'Romantic drama', 'World cinema', 'Romance Film', 'Drama']",1980,8
561315,The Wizard of Oz,1939,['United States of America'],"['Musical', 'Black-and-white', 'Star vehicle', 'Adventure', 'Drama', 'Coming of age', 'Family Film', 'Fantasy']",1930,9
19389089,Astrópía,2007,['Iceland'],"['Comedy', 'World cinema', 'Romantic comedy', 'Slice of life story', 'Fantasy Comedy', 'Fantasy']",2000,7
4944673,Lock Up,1989,['United States of America'],"['Action', 'Prison', 'Crime Fiction', 'Action/Adventure', 'Thriller', 'Crime Thriller', 'Drama', 'Prison film']",1980,9
23653214,The General in Red Robes,1973,['South Korea'],"['Historical drama', 'War film']",1970,3
22217327,Janbaaz,1986,['India'],"['Action/Adventure', 'Thriller', 'World cinema', 'Drama']",1980,6
10386925,Remember the Day,1941,['United States of America'],"['Black-and-white', 'Drama']",1940,1
6299060,Lorna,1964,['United States of America'],"['Sexploitation', 'Indie', 'Adult']",1960,4
5801352,Exterminator 2,1984,['United States of America'],"['Action', 'Thriller']",1980,4
1609729,Never Die Alone,2004,['United States of America'],"['Action', 'Crime Fiction', 'Mystery', 'Action/Adventure', 'Thriller', 'Crime Thriller']",2000,4
955409,The Taking of Pelham One Two Three,1974,['United States of America'],"['Action', 'Crime Fiction', 'Mystery', 'Action/Adventure', 'Thriller', 'Crime Thriller', 'Suspense', 'Heist']",1970,4
2350185,Teknolust,2002,"['United Kingdom', 'Germany', 'United States of America']","['Indie', 'Romantic drama', 'Comedy', 'Romance Film', 'Black comedy', 'Drama', 'Parody', 'Romantic comedy', 'Science Fiction', 'Sex comedy']",2000,2
19552121,Barbie Presents: Thumbelina,2009,"['Canada', 'United States of America']","['Fairy tale', 'Computer Animation', 'Animation', ""Children's/Family"", 'Family Film', 'Fantasy']",2000,9
20580702,Spread,2009,['United States of America'],"['Comedy', 'Romance Film', 'Romantic comedy', 'Drama', 'Sex comedy']",2000,9
15525072,"Oh, God! You Devil",1984,['United States of America'],"['Heavenly Comedy', 'Comedy', 'Religious Film', 'Fantasy Comedy']",1980,4
8574921,Yogi's First Christmas,1980,['United States of America'],"[""Children's/Family"", 'Animation']",1980,0
129619,Ghost,1990,['United States of America'],"['Mystery', 'Romantic drama', 'Comedy', 'Thriller', 'Romance Film', 'Drama', 'Supernatural', 'Fantasy']",1990,0
16262723,The Last of Mrs. Cheyney,1937,['United States of America'],"['Black-and-white', 'Drama']",1930,7
5350092,Aaru,2005,['India'],"['Action', 'Musical', 'Drama', 'Tamil cinema', 'World cinema']",2000,5
18089720,Duska,2007,"['Russia', 'Netherlands', 'Ukraine']","['Drama', 'Comedy']",2000,7
11388323,Pretty Ladies,1925,['United States of America'],"['Black-and-white', 'Drama', 'Romantic drama', 'Indie', 'Silent film', 'Romance Film']",1920,5
22637647,Fear Island,2009,['Canada'],"['Mystery', 'Thriller', 'Horror']",2000,9
14418816,Madame Sin,1972,"['United Kingdom', 'United States of America']","['Action', 'Spy', 'Drama', 'Action Thrillers', 'Thriller']",1970,2
3356058,Negadon: The Monster from Mars,2005,['Japan'],"['Action', 'Animation', 'Short Film', 'Anime', 'Science Fiction']",2000,5
3017440,Radioland Murders,1994,['United States of America'],"['Musical', 'Crime Fiction', 'Screwball comedy', 'Mystery', 'Comedy', 'Thriller', 'Black comedy', 'Whodunit', 'Crime Thriller', 'Comedy Thriller']",1990,4
26726831,Run for Cover,1955,['United States of America'],"['Action', 'Western', 'Action/Adventure']",1950,5
25747499,Cover Up,1991,"['Israel', 'United States of America']","['Action', 'Indie', 'Action/Adventure', 'Thriller']",1990,1
3476903,Little Nemo: Adventures in Slumberland,1989,"['Japan', 'United States of America']","['Fantasy Adventure', 'Animation', ""Children's/Family"", 'Adventure', ""Children's Fantasy"", 'Japanese Movies', 'Anime', 'Family Film', 'Fantasy']",1980,9
1353062,The Saint Strikes Back,1939,['United States of America'],"['Detective fiction', 'Black-and-white', 'Crime Fiction', 'Mystery', 'Detective']",1930,9
1429988,JCVD,2008,"['France', 'Luxembourg', 'Belgium']","['Action', 'Crime Fiction', 'Indie', 'Action/Adventure', 'Comedy', 'World cinema', 'Drama', 'Parody', 'Crime Comedy']",2000,8
18620635,The Impatient Patient,1942,[],"['Animation', 'Short Film', 'Comedy', 'Family Film']",1940,2
7048628,"Long Life, Happiness & Prosperity",2002,['Canada'],"['Drama', 'Indie', 'Family Drama', 'Comedy', 'Romance Film', 'Romantic comedy', 'Family Film']",2000,2
25625802,Escaping Tel Aviv,2009,['Egypt'],"['Action', 'Thriller', 'Drama']",2000,9
2477367,Pride,2004,['United Kingdom'],"['Family Drama', 'Comedy', 'Television movie', 'Adventure', 'Drama', 'Family Film']",2000,4
4273140,Avatar,2009,"['United Kingdom', 'United States of America']","['Action', 'Thriller', 'Adventure', 'Computer Animation', 'Epic', 'Fantasy', 'Science Fiction', 'Nature']",2000,9
68485,Jurassic Park,1993,['United States of America'],"['Action', 'Film adaptation', 'Monster', 'Action/Adventure', 'Thriller', 'Adventure', 'Horror', 'Science Fiction', 'Natural horror films']",1990,3
5697939,Dao,1995,['Hong Kong'],"['Drama', 'Chinese Movies', 'Martial Arts Film']",1990,5
24224913,The Phantom Express,1932,['United States of America'],"['Psychological thriller', 'Mystery', 'Thriller']",1930,2
36003936,Bommai Kalyanam,1958,[],[],1950,8
4870829,VeggieTales: A Snoodles Tale,2004,['United States of America'],"['Musical', 'Animation', 'Short Film', 'Comedy', ""Children's""]",2000,4
20203012,Disturbance in Her Barroom,2008,['South Korea'],['Gangster Film'],2000,8
5318353,Curse of the Golden Flower,2006,"['China', 'Hong Kong']","['Romantic drama', 'Action/Adventure', 'World cinema', 'Romance Film', 'Chinese Movies', 'Martial Arts Film', 'Drama', 'Period piece', 'Wuxia']",2000,6
11217759,Kudrat,1981,['India'],"['Romantic drama', 'World cinema', 'Romance Film', 'Drama']",1980,1
14069401,Jail Bait,1937,['United States of America'],"['Short Film', 'Black-and-white', 'Comedy']",1930,7
14737005,Three Loan Wolves,1946,['United States of America'],"['Short Film', 'Black-and-white', 'Comedy']",1940,6
24322105,Playing House,2006,['Canada'],['Comedy'],2000,6
9630679,The Sick House,2007,['United Kingdom'],"['Teen', 'Horror']",2000,7
25724666,A Child's Wish,1997,['United States of America'],"['Sports', 'Drama']",1990,7
19661752,The Guy with the Secret Kung Fu,1981,['Hong Kong'],"['Action', 'Chinese Movies', 'Martial Arts Film', 'Adventure']",1980,1
4446490,It Takes Two,1995,['United States of America'],"['Comedy', 'Family Film']",1990,5
13617056,Horror House on Highway Five,1985,['United States of America'],"['Indie', 'Slasher', 'Horror', 'B-movie']",1980,5
6196919,Captain Kidd,1945,['United States of America'],"['Action', 'Action/Adventure', 'Adventure', 'Swashbuckler films']",1940,5
7818764,Mrs. Wiggs of the Cabbage Patch,1934,['United States of America'],"['Comedy', 'Black-and-white']",1930,4
6097745,The Legacy,1978,"['United Kingdom', 'United States of America']","['Supernatural', 'Cult', 'Horror']",1970,8
2910952,The Seventh Victim,1943,['United States of America'],"['Black-and-white', 'Gothic Film', 'Horror', 'Film noir', 'Supernatural']",1940,3
4873690,The Giant of Marathon,1959,"['France', 'Italy']","['Costume Adventure', 'Action/Adventure', 'World cinema', 'Sword and Sandal', 'Adventure', 'Drama', 'Period piece', 'Historical fiction']",1950,9
33509284,I Live on Danger,1942,['United States of America'],"['Mystery', 'Thriller']",1940,2
2276474,Humongous,1982,['Canada'],"['Creature Film', 'Indie', 'Slasher', 'Horror']",1980,2
2866335,Oberst Redl,1985,"['Austria', 'Germany', 'Hungary', 'West Germany']","['Period piece', 'LGBT', 'World cinema', 'Drama']",1980,5
5254729,I Could Never Be Your Woman,2007,['United States of America'],"['Comedy', 'Romance Film', 'Romantic comedy', 'Drama']",2000,7
4885828,Smile For The Camera.,2005,['United States of America'],"['Indie', 'Short Film', 'Thriller', 'Horror']",2000,5
23691144,Bells of San Angelo,1947,['United States of America'],"['Action', 'Western', 'Action/Adventure']",1940,7
5273390,Man's Best Friend,1993,['United States of America'],"['Horror', 'Science Fiction']",1990,3
12112395,Cherry Crush,2007,['United States of America'],"['Psychological thriller', 'Crime Fiction', 'Mystery', 'Thriller', 'Teen', 'Crime Thriller', 'Drama']",2000,7
7425934,Life Express,2003,"['Hong Kong', 'Taiwan', 'China']","['Action', 'Action/Adventure', 'Thriller', 'World cinema', 'Bollywood', 'Chinese Movies', 'Drama']",2000,3
5353344,Matrubhoomi: A Nation Without Women,2005,"['India', 'France']","['Bollywood', 'World cinema', 'Science Fiction', 'Drama']",2000,5
9908588,Balkan Express,1983,['Yugoslavia'],"['War film', 'Comedy']",1980,3
30676896,Dr. Kildare Goes Home,1940,['United States of America'],"['Drama', 'Medical fiction']",1940,0
45488,The Last Laugh,1924,"['Weimar Republic', 'Germany']","['Black-and-white', 'Indie', 'World cinema', 'Silent film', 'Drama']",1920,4
9378574,The Ipcress File,1965,['United Kingdom'],"['Spy', 'Crime Fiction', 'Mystery', 'Thriller', 'Drama', 'Political thriller']",1960,5
26188630,Ma and Pa Kettle at the Fair,1952,['United States of America'],['Comedy'],1950,2
3248338,The Masked Marvel,1943,['United States of America'],"['Action', 'Spy', 'Black-and-white', 'Superhero movie', 'Adventure']",1940,3
29672995,Battle of Moscow,1985,['Soviet Union'],"['War film', 'Drama']",1980,5
600807,Mazes and Monsters,1982,['United States of America'],"['Psychological thriller', 'Thriller', 'Teen', 'Television movie', 'Drama', 'Fantasy']",1980,2
6456053,The Yellow Rolls-Royce,1964,['United Kingdom'],"['Comedy', 'Comedy-drama', 'Comedy of manners', 'Drama']",1960,4
26358383,Mambo,1954,"['Italy', 'United States of America']","['Romance Film', 'Black-and-white', 'Drama']",1950,4
20195915,But Not for Me,1959,['United States of America'],"['Romance Film', 'Romantic comedy', 'Comedy']",1950,9
7541099,Mayura,1975,['India'],['Historical drama'],1970,5
35790656,Tata Birla,1996,['India'],['Comedy film'],1990,6
6789650,Moolaadé,2004,"['Tunisia', 'Burkina Faso', 'Morocco', 'France', 'Cameroon', 'Senegal']",['Drama'],2000,4
4163253,Bangkok Dangerous,1999,['Thailand'],"['Action', 'Crime Fiction', 'Thriller', 'World cinema', 'Crime Thriller', 'Drama']",1990,9
3375353,The Man Who Loved Women,1977,['France'],"['Comedy', 'Romance Film', 'Drama', 'Sex comedy']",1970,7
31935306,The Man of the Year,2003,"['Brazil', 'United States of America']","['Action', 'Drama', 'Crime Fiction', 'Action/Adventure', 'Comedy film', 'World cinema', 'Slice of life story']",2000,3
5427514,"Boy, Did I Get a Wrong Number!",1966,['United States of America'],"['Screwball comedy', 'Comedy', 'Romance Film', 'Romantic comedy', 'Slapstick']",1960,6
25886080,Totally Spies! The Movie,2009,['France'],"['Crime Fiction', 'Animation', 'Mystery', 'Comedy', 'Adventure', 'Family Film']",2000,9
444267,Legally Blonde,2001,['United States of America'],"['Political cinema', 'Courtroom Comedy', 'Comedy', 'Comedy of manners', 'Romance Film', 'Romantic comedy']",2000,1
36036213,Buried Alive,1990,['United States of America'],"['Thriller', 'Horror']",1990,0
31076868,The Courage of Kavik the Wolf Dog,1980,"['Canada', 'United States of America']",['Action/Adventure'],1980,0
22729991,Mitrudu,2009,['India'],['Drama'],2000,9
1367539,Longtime Companion,1989,['United States of America'],"['Gay Themed', 'LGBT', 'Gay', 'Gay Interest', 'Drama', 'Medical fiction']",1980,9
21787356,Premi No.1,2009,['India'],"['Romance Film', 'Comedy', 'Drama']",2000,9
1397120,The Great Lie,1941,['United States of America'],"['Black-and-white', 'Romantic drama', 'Romance Film', 'Melodrama', 'Drama']",1940,1
3876620,All the President's Men,1976,['United States of America'],"['History', 'Thriller', 'Docudrama', 'Political drama', 'Drama']",1970,6
5982397,I Can Hardly Wait,1943,['United States of America'],"['Short Film', 'Black-and-white', 'Comedy']",1940,3
27261334,Diary of a Cannibal,2007,['United States of America'],"['Slasher', 'Horror']",2000,7
1654450,Dil To Pagal Hai,1997,['India'],"['Musical', 'Comedy', 'Bollywood', 'Romance Film', 'Comedy-drama', 'Drama']",1990,7
760738,Camille Claudel,1988,['France'],"['Art film', 'Romantic drama', 'Biographical film', 'Historical drama', 'World cinema', 'Romance Film', 'Drama', 'Period piece', 'Biopic [feature]']",1980,8
1997332,The Prince and the Showgirl,1957,"['United Kingdom', 'United States of America']","['Romantic drama', 'Comedy', 'Romance Film', 'Drama', 'Period piece', 'Political cinema', 'Romantic comedy', 'Political drama']",1950,7
9435892,The Mark Unleashed,2004,['United States of America'],"['Action', 'Action/Adventure', 'Thriller', 'Christian film', 'Science Fiction', 'Drama']",2000,4
76389,To Be or Not to Be,1942,['United States of America'],"['Black-and-white', 'Screwball comedy', 'Parody', 'Comedy', 'War film', 'Drama']",1940,2
8817989,Ardh Satya,1982,['India'],"['Drama', 'Art film', 'Bollywood']",1980,2
23691846,Under Your Spell,1936,['United States of America'],"['Musical', 'Romantic comedy']",1930,6
3645450,My Life as a Dog,1985,['Sweden'],"['Coming of age', 'Comedy', 'Childhood Drama', 'World cinema', 'Comedy-drama', 'Drama']",1980,5
8443094,One Stone Two Birds,2005,"['Hong Kong', 'Taiwan']","['Action/Adventure', 'Comedy', 'World cinema', 'Chinese Movies', 'Martial Arts Film', 'Drama']",2000,5
23780420,Killer Instinct,1988,['United States of America'],['Drama'],1980,8
21581927,The Steel Bayonet,1957,['United Kingdom'],"['War film', 'Drama']",1950,7
30488499,Kiler-ów 2-óch,1999,['Poland'],"['Comedy film', 'Crime Fiction']",1990,9
228519,Voices of a Distant Star,2003,['Japan'],"['Animation', 'Japanese Movies', 'Short Film', 'World cinema', 'Romance Film', 'Anime', 'Science Fiction']",2000,3
24955248,O periergos,1982,['Greece'],['Comedy'],1980,2
61664,All About My Mother,1999,"['France', 'Spain']","['LGBT', 'Feminist Film', 'Comedy', 'World cinema', 'Comedy-drama', 'Drama', 'Ensemble Film']",1990,9
3190223,Extreme Measures,1996,['United States of America'],"['Suspense', 'Drama', 'Thriller']",1990,6
7100124,Daffy Duck Slept Here,1948,['United States of America'],"['Animation', 'Short Film', 'Comedy', 'Family Film']",1940,8
906737,Circus,2000,"['United Kingdom', 'United States of America']","['Crime Fiction', 'Crime Thriller', 'Thriller']",2000,0
26187961,Susan Slade,1961,['United States of America'],"['Romance Film', 'Romantic drama', 'Drama']",1960,1
2666222,Lying Lips,1939,['United States of America'],"['Black-and-white', 'Drama']",1930,9
10050502,The Milpitas Monster,1975,['United States of America'],"['Science Fiction', 'Thriller', 'Horror']",1970,5
14143498,The Iron Claw,1941,['United States of America'],"['Adventure', 'Black-and-white']",1940,1
9609271,The Phantom of the West,1931,['United States of America'],"['Action', 'Black-and-white', 'Western', 'Action/Adventure', 'Adventure']",1930,1
11379588,Mademoiselle,1967,"['United Kingdom', 'France']","['Drama', 'Crime Fiction', 'Indie', 'World cinema']",1960,7
13579288,Aamdani Atthani Kharcha Rupaiyaa,2001,['India'],['Comedy'],2000,1
25830343,I Want You,1951,['United States of America'],['War film'],1950,1
8170692,Bringing Rain,2003,['United States of America'],"['Mystery', 'Indie', 'Coming of age', 'Teen', 'Drama']",2000,3
24479826,Full Blast,1999,['Canada'],"['Music', 'Drama']",1990,9
9083492,Lies My Father Told Me,1975,['Canada'],"['Period piece', 'Drama']",1970,5
789903,Catwoman,2004,"['United States of America', 'Australia']","['Action', 'Crime Fiction', 'Superhero', 'Action/Adventure', 'Thriller', 'Superhero movie', 'Fantasy']",2000,4
14143328,The Shadow,1940,['United States of America'],"['Adventure', 'Black-and-white']",1940,0
28611312,Dead Man's Treasure,1959,['Greece'],['Comedy'],1950,9
12585204,Just Between Friends,1986,['United States of America'],"['Romantic drama', 'Romance Film', 'Melodrama', 'Drama']",1980,6
10513897,Ouija,2007,['Philippines'],"['Filipino Movies', 'Mystery', 'Horror', 'Drama']",2000,7
20926377,Hancock,2008,['United States of America'],"['Action', 'Crime Fiction', 'Superhero', 'Comedy', 'Action Comedy', 'Superhero movie', 'Science Fiction', 'Fantasy']",2000,8
4765472,Do Detectives Think,1927,['United States of America'],"['Black-and-white', 'Indie', 'Short Film', 'Comedy', 'Silent film']",1920,7
7577684,Extreme Limits,2001,['United States of America'],"['Action', 'Action Thrillers', 'Action/Adventure', 'Thriller', 'Adventure']",2000,1
26624119,Beyond the Time Barrier,1960,['United States of America'],"['Science Fiction', 'Time travel']",1960,0
9271112,The Temptress,1926,['United States of America'],"['Black-and-white', 'Drama', 'Indie', 'Silent film']",1920,6
29346238,Neither Seen Nor Recognized,1958,['France'],"['Comedy', 'Comedy film', 'Crime Comedy', 'Comedy of manners']",1950,8
586023,Those Magnificent Men in Their Flying Machines,1965,['United Kingdom'],"['Adventure Comedy', 'Action', 'Costume Adventure', 'Action/Adventure', 'Comedy', 'Adventure', 'Ensemble Film']",1960,5
11194174,Get Set Goal,2007,"['United Kingdom', 'India']","['Musical', 'World cinema', 'Sports', 'Drama']",2000,7
11160859,Night Tide,1963,['United States of America'],"['Psychological thriller', 'Black-and-white', 'Thriller']",1960,3
10249232,Sit Tight,1931,['United States of America'],['Comedy'],1930,1
33025390,Open Fire,1994,[],['Thriller'],1990,4
16487646,Alice in Wonderland,1988,['Australia'],"['Animation', 'Adventure', 'Family Film', 'Fantasy']",1980,8
217835,Buffalo '66,1998,['United States of America'],"['Crime Fiction', 'Indie', 'Comedy', 'Romance Film', 'Black comedy', 'Drama', 'Crime Drama', 'Comedy-drama', 'Road movie', 'Cult']",1990,8
6098808,Dead Silence,2007,['United States of America'],"['Mystery', 'Thriller', 'Horror', 'Supernatural', 'Cult']",2000,7
3223514,Evil Alien Conquerors,2002,['United States of America'],"['Parody', 'Comedy', 'Adventure', 'Science Fiction']",2000,2
24518351,Lolly-Madonna XXX,1973,['United States of America'],['Drama'],1970,3
11094192,Black Cadillac,2003,['United States of America'],"['Psychological thriller', 'Crime Fiction', 'Thriller', 'Crime Thriller', 'Drama']",2000,3
144415,The Santa Clause,1994,['United States of America'],"['Comedy', 'Holiday Film', 'Christmas movie', 'Fantasy Comedy', 'Family Film', 'Fantasy']",1990,4
2532751,Legend of the Lost,1957,"['Italy', 'United States of America']","['Western', 'Action/Adventure', 'Adventure']",1950,7
9574476,Our House,2006,['United States of America'],['Drama'],2000,6
1194084,Chicken Little,2005,['United States of America'],"['Computer Animation', 'Animation', 'Comedy', 'Adventure', 'Science Fiction', 'Family Film']",2000,5
13386113,Panchathantiram,2002,['India'],"['Musical', 'Romantic drama', 'Bollywood', 'World cinema', 'Romance Film', 'Drama']",2000,2
33435278,Rukhsat,1988,[],['Romance Film'],1980,8
3654271,Fantastic Four: Rise of the Silver Surfer,2007,"['Canada', 'United Kingdom', 'Germany', 'United States of America']","['Action', 'Superhero', 'Action/Adventure', 'Thriller', 'Superhero movie', 'Doomsday film', 'Science Fiction', 'Fantasy']",2000,7
6076402,Robot Jox,1990,['United States of America'],"['Action', 'Dystopia', 'Indie', 'Stop motion', 'Science Fiction', 'Cult']",1990,0
11788641,Just the Way You Are,1984,['United States of America'],"['Romantic drama', 'Comedy', 'Comedy-drama', 'Drama']",1980,4
25157043,Poomagal Oorvalam,1999,['India'],"['Romantic drama', 'World cinema', 'Romance Film', 'Drama']",1990,9
23229518,The Unnamable II: The Statement of Randolph Carter,1993,['United States of America'],['Horror'],1990,3
25146239,Picking Up & Dropping Off,2003,['Canada'],"['Romance Film', 'Comedy', 'Drama']",2000,3
8526754,Carrie,2002,"['Canada', 'United States of America']","['Thriller', 'Teen', 'Horror', 'Television movie']",2000,2
12272453,Honky Tonk,1941,['United States of America'],"['Western', 'Black-and-white']",1940,1
3189853,The Black Rose,1950,"['United Kingdom', 'United States of America']","['Action', 'Action/Adventure', 'Adventure', 'Costume drama']",1950,0
10791992,Ranuva Veeran,1981,['India'],['Action'],1980,1
27735073,The Sharkfighters,1956,['United States of America'],['Drama'],1950,6
33725922,Uttarayan,2005,['India'],"['Musical', 'Bollywood', 'World cinema', 'Drama']",2000,5
4436565,The Crazy Stranger,1997,"['Romania', 'France']","['Music', 'Musical', 'Romantic drama', 'Comedy', 'World cinema', 'Romance Film', 'Drama']",1990,7
12049835,Just Add Water,2008,['United States of America'],"['Indie', 'Comedy']",2000,8
3700174,Jumanji,1995,"['Japan', 'United States of America']","['Fantasy Adventure', 'Thriller', ""Children's/Family"", 'Adventure', ""Children's Fantasy"", 'Japanese Movies', 'Family Film', 'Fantasy']",1990,5
20837938,Wide Awake,2007,['South Korea'],"['Crime Fiction', 'Mystery', 'Thriller', 'Horror', 'World cinema', 'Drama']",2000,7
20536322,Woodchipper Massacre,1988,['United States of America'],"['Slasher', 'B-movie', 'Horror']",1980,8
129444,Driving Miss Daisy,1989,['United States of America'],"['Period piece', 'Film adaptation', 'Buddy film', 'Comedy', 'Comedy-drama', 'Drama']",1980,9
1632580,Stepmom,1998,['United States of America'],"['Family Drama', 'Romantic drama', 'Romance Film', 'Domestic Comedy', 'Comedy-drama', 'Drama', 'Medical fiction']",1990,8
9334416,West of Zanzibar,1928,['United States of America'],"['Black-and-white', 'Drama', 'Horror']",1920,8
22713372,The Skeptic,2009,['United States of America'],"['Suspense', 'Thriller', 'Horror', 'Supernatural']",2000,9
24490517,Man and Maid,1925,[],"['Romantic drama', 'Silent film', 'Romance Film', 'Drama']",1920,5
4121272,The Dentist 2,1998,['United States of America'],"['Slasher', 'B-movie', 'Horror']",1990,8
32493869,Usha Parinayam,1961,['India'],"['Musical', 'Drama']",1960,1
5746900,Style,2006,['India'],['Sports'],2000,6
26391644,Une Partie de Plaisir,1975,['France'],"['Drama', 'World cinema']",1970,5
3556701,Grizzly,1976,['United States of America'],"['B-movie', 'Natural horror films', 'Horror']",1970,6
15895549,Two Mafiamen in the Far West,1964,['Italy'],['Comedy'],1960,4
1979586,Missamma,1955,['India'],"['Comedy', 'Drama', 'Family Film']",1950,5
9531428,Aero NT-54,1925,['Soviet Union'],"['Silent film', 'Black-and-white']",1920,5
11639973,Wonder Bar,1934,['United States of America'],"['Musical', 'Black-and-white', 'Backstage Musical', 'Musical Drama', 'Musical comedy', 'Romance Film', 'Pre-Code', 'Drama']",1930,4
11452604,Confessions of a Sorority Girl,1994,['United States of America'],"['Drama', 'Comedy']",1990,4
803786,Total Eclipse,1995,"['United Kingdom', 'France', 'Belgium']","['LGBT', 'Erotic Drama', 'Biography', 'Indie', 'Biographical film', 'Romance Film', 'Drama', 'Period piece', 'Gay Themed', 'Gay', 'Gay Interest', 'Biopic [feature]']",1990,5
13239722,Sex and the City: The Movie,2008,['United States of America'],"['Comedy', 'Romance Film', 'Romantic comedy', 'Drama']",2000,8
10617974,Mr. Natwarlal,1979,['India'],"['Musical', 'Romantic drama', 'Action/Adventure', 'Bollywood', 'World cinema', 'Romance Film', 'Drama']",1970,9
1376794,Romper Stomper,1992,"['New Zealand', 'Australia']","['Action', 'Psychological thriller', 'Crime Fiction', 'Teen', 'World cinema', 'Drama']",1990,2
909940,"Happy Birthday, Wanda June",1971,['United States of America'],"['Drama', 'Comedy']",1970,1
14503554,Three Smart Saps,1942,['United States of America'],"['Prison', 'Black-and-white', 'Short Film', 'Comedy', 'Slapstick']",1940,2
5478827,Lost and Found,1979,['United Kingdom'],['Comedy'],1970,9
16166225,Kunguma Pottu Gounder,2001,['India'],['Comedy film'],2000,1
3028833,The Last Ride,2004,['United States of America'],"['Action', 'Drama', 'Action/Adventure', 'Thriller', 'Television movie', 'Crime Thriller']",2000,4
7147117,The Incredible Journey of Mary Bryant,2005,['Australia'],"['Period piece', 'History', 'Television movie', 'Costume drama', 'Adventure', 'Drama']",2000,5
15408925,The Private Life of Don Juan,1934,['United Kingdom'],"['Black-and-white', 'Romantic drama', 'Romance Film', 'Comedy-drama', 'Drama']",1930,4
33437103,The Picture Show Man,1977,['Australia'],"['Comedy', 'Drama', 'Comedy film']",1970,7
1129009,Re-Animator,1985,['United States of America'],"['Comedy', 'Horror Comedy', 'Horror', 'Zombie Film', 'Sci-Fi Horror', 'Science Fiction', 'Cult']",1980,5
16987257,The Last Dinosaur,1977,['Japan'],"['Japanese Movies', 'Science Fiction', 'Fantasy']",1970,7
4679340,The Airzone Solution,1993,['United Kingdom'],"['Science Fiction', 'Dystopia']",1990,3
11077335,Doctor Zhivago,2002,[],['Costume drama'],2000,2
26458693,Space Master X-7,1958,['United States of America'],['Science Fiction'],1950,8
6954370,The Other Sister,1999,['United States of America'],"['Family Drama', 'Romantic drama', 'Comedy', 'Romance Film', 'Romantic comedy', 'Drama']",1990,9
1055633,Latter Days,2003,['United States of America'],"['Comedy', 'Romance Film', 'Drama', 'Gay Themed', 'Gay', 'Gay Interest', 'Romantic comedy', 'Comedy-drama']",2000,3
28785017,The Black Torment,1964,['United Kingdom'],['Horror'],1960,4
97732,Tom Jones,1963,"['United Kingdom', 'United States of America']","['Action/Adventure', 'Comedy', 'Romance Film', 'Romantic comedy', 'British New Wave', 'Costume drama', 'Adventure']",1960,3
9265338,Neel Kamal,1968,['India'],"['Romantic drama', 'Bollywood', 'World cinema', 'Romance Film', 'Drama']",1960,8
5320667,The Prince of Tennis,2006,['Japan'],['Japanese Movies'],2000,6
21663542,La Maison en Petits Cubes,2008,['Japan'],"['Japanese Movies', 'Animation', 'Short Film', 'Anime', 'Drama', 'Family Film']",2000,8
23370311,The Gun That Won the West,1955,['United States of America'],"['Action', 'Western']",1950,5
14500944,Special Agent,1935,['United States of America'],"['Black-and-white', 'Crime Fiction', 'Drama']",1930,5
26198042,The Men's Club,1986,['United States of America'],"['Film adaptation', 'Drama']",1980,6
1622296,Scared Stiff,1953,['United States of America'],"['Musical', 'Comedy']",1950,3
2784636,PANICS,2005,['United States of America'],"['Parody', 'Science Fiction', 'Animation']",2000,5
449731,Bright Future,2003,['Japan'],"['Japanese Movies', 'Drama', 'World cinema']",2000,3
4059223,88 Minutes,2007,"['Germany', 'United States of America', 'Canada']","['Psychological thriller', 'Suspense', 'Crime Fiction', 'Mystery', 'Thriller', 'Crime Thriller', 'Drama']",2000,7
2819995,Nobel Son,2007,['United States of America'],"['Suspense', 'Drama', 'Indie', 'Thriller', 'Black comedy', 'Crime Thriller']",2000,7
18793990,The Base 2: Guilty as Charged,2000,['United States of America'],"['Action', 'Action/Adventure', 'Thriller']",2000,0
2323824,God of Gamblers,1989,['Hong Kong'],"['Action', 'Action Comedy', 'Action/Adventure', 'Comedy', 'World cinema', 'Chinese Movies']",1980,9
11440374,Dance 'Til Dawn,1988,['United States of America'],"['Comedy', 'Teen', 'Romantic comedy', 'Family Film']",1980,8
23731682,Edge of Honor,1991,['United States of America'],"['Action', 'Addiction Drama', 'Adventure']",1990,1
12932741,The Young Victoria,2009,"['United Kingdom', 'United States of America']","['History', 'Romantic drama', 'Biography', 'Docudrama', 'Romance Film', 'Drama']",2000,9
25185963,The Break-Up Artist,2009,['United States of America'],"['Romance Film', 'Romantic comedy', 'Comedy']",2000,9
3117366,The ChubbChubbs!,2002,"['United Kingdom', 'United States of America']","['Animation', ""Children's Fantasy"", 'Short Film', 'Comedy', ""Children's/Family"", 'Computer Animation']",2000,2
24165554,Classic Dance of Love,2005,['India'],['World cinema'],2000,5
10501623,American Pie Presents: Beta House,2007,"['Canada', 'United States of America']","['Gross out', 'Gross-out film', 'Comedy', 'Teen', 'Sex comedy']",2000,7
3204413,"I Want a Dog for Christmas, Charlie Brown",2003,['United States of America'],"[""Children's/Family"", 'Animation', 'Holiday Film']",2000,3
25091060,The Fourth War,1990,['United States of America'],"['Action', 'Spy', 'Thriller', 'Adventure']",1990,0
165106,Desk Set,1957,['United States of America'],"['Workplace Comedy', 'Libraries and librarians', 'Comedy', 'Romance Film', 'Romantic comedy']",1950,7
14734277,Hot Stuff,1956,['United States of America'],"['Short Film', 'Black-and-white', 'Comedy']",1950,6
382387,Gremlins,1984,['United States of America'],"['Creature Film', 'Comedy', 'Horror Comedy', 'Horror', 'Black comedy', 'Cult', 'Fantasy']",1980,4
6090730,Burnt Money,2000,"['Argentina', 'Spain', 'Uruguay']","['Crime Fiction', 'Thriller', 'Romance Film', 'Drama']",2000,0
7264941,Unpublished Story,1942,['United Kingdom'],"['Black-and-white', 'Thriller', 'War film', 'Drama']",1940,2
442647,Young Frankenstein,1974,['United States of America'],"['Black-and-white', 'Parody', 'Horror Comedy', 'Comedy', 'Horror', 'Slapstick', 'Science Fiction']",1970,4
36245129,Monique,1970,['United Kingdom'],"['LGBT', 'Comedy film', 'Romance Film', 'Drama', 'Cult']",1970,0
9430272,The Monster and the Girl,1941,['United States of America'],"['Creature Film', 'Black-and-white', 'Horror', 'Film noir', 'Science Fiction']",1940,1
18118843,The 7 th Day,2004,['Spain'],['Drama'],2000,4
879006,Missile to the Moon,1958,['United States of America'],"['Black-and-white', 'Remake', 'Adventure', 'Science Fiction']",1950,8
610832,Hard Core Logo,1996,['Canada'],"['Music', 'Musical', 'Indie', 'Comedy', 'Satire', 'Punk rock', 'Mockumentary', 'Drama', 'Parody', 'Comedy-drama', 'Road movie', 'Ensemble Film']",1990,6
11380361,Secret Sunshine,2007,['South Korea'],"['Art film', 'Family Drama', 'Comedy', 'World cinema', 'Romance Film', 'Drama', 'Slice of life story']",2000,7
1362026,The Smallest Show on Earth,1957,['United Kingdom'],"['Comedy', 'Workplace Comedy']",1950,7
34814175,Ningen,1962,['Japan'],['Drama'],1960,2
24089186,The Possibility of Hope,2007,['United Kingdom'],"['Short Film', 'Documentary']",2000,7
13681543,A Loving Father,2002,"['Canada', 'Switzerland', 'United Kingdom', 'France']","['Family Drama', 'Drama', 'World cinema']",2000,2
26319701,Ammakilikkoodu,2003,['India'],"['Drama', 'Comedy']",2000,3
21395172,Taking Sides,2001,"['Austria', 'United Kingdom', 'France', 'Germany']","['Music', 'Musical', 'Historical fiction', 'War film', 'Drama']",2000,1
2510385,Jarhead,2005,"['Germany', 'United States of America']","['Film adaptation', 'Biography', 'Gulf War', 'War film', 'Drama']",2000,5
1834015,Quick Change,1990,['United States of America'],"['Heist', 'Crime Fiction', 'Comedy']",1990,0
15547337,Fix,2009,['United States of America'],"['Crime Fiction', 'Indie', 'Drama']",2000,9
18192574,Copperhead,2008,['United States of America'],"['Action', 'Western', 'Horror']",2000,8
3254412,The Vivero Letter,1998,['United States of America'],"['Mystery', 'Thriller']",1990,8
21182881,Murder-Set-Pieces,2004,['United States of America'],['Horror'],2000,4
15856289,The Master of Ballantrae,1953,['United States of America'],"['Action', 'Action/Adventure', 'Epic', 'Swashbuckler films', 'Adventure', 'Drama']",1950,3
1641890,Walk the Line,2005,"['Germany', 'United States of America']","['Musical', 'Biography', 'Romantic drama', 'Musical Drama', 'Romance Film', 'Drama', 'Period piece', 'Biopic [feature]']",2000,5
2932836,Above the Rim,1994,['United States of America'],"['Crime Fiction', 'Melodrama', 'Sports', 'Drama']",1990,4
5071341,Air Buddies,2006,['United States of America'],"['Comedy', 'Animal Picture', 'Family-Oriented Adventure', ""Children's/Family"", ""Children's"", 'Family Film']",2000,6
33643112,My Memories of Old Beijing,1983,['China'],['Drama'],1980,3
1894535,Sleeping Dogs,1977,"['New Zealand', 'Australia']","['Action', 'Action/Adventure', 'Thriller', 'World cinema', 'Political thriller']",1970,7
29008008,Zamindar,1965,['India'],['Thriller'],1960,5
5192298,Who Killed Who?,1943,['United States of America'],['Short Film'],1940,3
13391536,Haunted Spooks,1920,['United States of America'],"['Black-and-white', 'Indie', 'Short Film', 'Comedy', 'Comedy film', 'Silent film', 'Slapstick']",1920,0
8995918,Ladybug Ladybug,1963,['United States of America'],"['Black-and-white', 'Drama', 'Thriller']",1960,3
13621743,Skinner,1990,['United States of America'],"['Psychological thriller', 'Indie', 'Slasher', 'Horror']",1990,0
1915087,Supersonic Man,1979,['Spain'],"['Action', 'Fantasy Adventure', 'Adventure', 'Science Fiction']",1970,9
15132280,After Shave,2005,"['France', 'Lebanon']","['Short Film', 'Comedy', 'Drama']",2000,5
561350,Children on Their Birthdays,2002,['United States of America'],"['Film adaptation', 'Family Drama', 'Americana', 'Drama', 'Period piece', 'Coming of age', 'Comedy-drama', 'Family Film']",2000,2
8982712,Ana al-Madi,1951,['Egypt'],['Crime Fiction'],1950,1
18906833,John and Julie,1955,['United Kingdom'],"['Family-Oriented Adventure', 'Comedy-drama', ""Children's/Family""]",1950,5
34592130,Justine,1977,['United Kingdom'],"['Erotic thriller', 'Romance Film', 'Drama']",1970,7
22321588,Minnesota Cuke and The Search For Noah's Umbrella,2009,['United States of America'],"['Musical', 'Animation', 'Short Film', ""Children's""]",2000,9
33374163,Pyaar Ke do Pal,1986,['India'],"['Drama', 'Family Film']",1980,6
8202728,The World According to Garp,1982,['United States of America'],"['Coming of age', 'Comedy', 'Romantic comedy', 'Comedy-drama', 'Tragicomedy', 'Drama']",1980,2
15263353,To the Starry Island,1993,['South Korea'],"['Drama', 'Fantasy']",1990,3
12165318,The Rutles 2: Can't Buy Me Lunch,2005,['United Kingdom'],"['Mockumentary', 'Parody', 'Comedy']",2000,5
14922755,Tell It to the Marines,1927,['United States of America'],"['Silent film', 'Black-and-white', 'War film']",1920,7
187095,The Blue Veil,1951,['United States of America'],['Drama'],1950,1
7011080,Rage,1972,['United States of America'],['Drama'],1970,2
6791799,The 11th Day: Crete 1941,2005,['United States of America'],"['War film', 'Documentary']",2000,5
12139125,Red,2008,['United States of America'],"['Indie', 'Thriller', 'Horror', 'Drama']",2000,8
3131514,Leningrad Cowboys Go America,1989,"['Finland', 'Sweden']","['Indie', 'Comedy', 'Road movie', 'Americana']",1980,9
8111774,Deadline: Sirf 24 Ghante,2006,['India'],"['Drama', 'World cinema']",2000,6
42093,Gentleman's Agreement,1947,['United States of America'],"['Romance Film', 'Black-and-white', 'Drama']",1940,7
23856529,The Wild and the Innocent,1959,['United States of America'],"['Western', 'Comedy']",1950,9
477099,50 First Dates,2004,['United States of America'],"['Romance Film', 'Romantic comedy', 'Comedy']",2000,4
31050313,The Circuit 3: Street Monk,2006,[],"['Action', 'Sports', 'Drama']",2000,6
27730947,Counterblast,1948,['United Kingdom'],"['Science Fiction', 'Thriller', 'Political thriller']",1940,8
11915869,The Hours and Times,1992,['United States of America'],"['Gay Themed', 'LGBT', 'Gay', 'Black-and-white', 'Indie', 'Gay Interest', 'Drama']",1990,2
9998295,The Black Bird,1975,['United States of America'],['Comedy'],1970,5
19165692,The Man Who Wouldn't Talk,1958,['United Kingdom'],"['Drama', 'Crime Fiction']",1950,8
1159454,Conspiracy,2001,"['United Kingdom', 'United States of America']","['Period piece', 'History', 'War film', 'Political drama', 'Drama']",2000,1
12613761,Arizona,1940,['United States of America'],"['Black-and-white', 'Romantic drama', 'Action/Adventure', 'Western', 'Romance Film', 'Drama']",1940,0
24885724,Right Yaaa Wrong,2009,['India'],"['Thriller', 'World cinema']",2000,9
13206489,Sorry Safari,1962,[],"['Animation', 'Short Film', 'Comedy', 'Family Film']",1960,2
9123604,The End of the Affair,1955,['United Kingdom'],"['Film adaptation', 'Black-and-white', 'Romantic drama', 'Romance Film', 'Drama']",1950,5
1042090,Madhouse,1990,['United States of America'],['Comedy'],1990,0
24884138,Gauri: The Unborn,2007,['India'],"['Musical', 'Thriller', 'Bollywood', 'Horror', 'World cinema', 'Drama']",2000,7
157239,Star Trek: Insurrection,1998,['United States of America'],"['Action', 'Thriller', 'Adventure', 'Romance Film', 'Science Fiction', 'Drama']",1990,8
7286784,Postmen in the Mountains,1999,['China'],"['Drama', 'Chinese Movies', 'World cinema']",1990,9
32873180,Typhoon Treasure,1938,['Australia'],"['Action', 'Adventure']",1930,8
5766046,Shade,2003,['United States of America'],"['Action', 'Crime Fiction', 'Gangster Film', 'Action/Adventure', 'Thriller', 'Crime Thriller', 'Drama']",2000,3
11353896,Zindagi,1976,['India'],['Bollywood'],1970,6
29460128,Prime Risk,1985,['United States of America'],['Drama'],1980,5
418110,Amistad,1997,['United States of America'],"['Period piece', 'History', 'Mystery', 'Historical fiction', 'Costume drama', 'Drama', 'Courtroom Drama']",1990,7
1392052,Wannabe,2005,['United States of America'],['Comedy'],2000,5
92706,Heaven's Gate,1980,['United States of America'],"['Period piece', 'History', 'Action/Adventure', 'Western', 'Drama']",1980,0
4555159,Kaadhal Kavithai,1999,['India'],"['Romantic drama', 'World cinema', 'Romance Film', 'Drama']",1990,9
1471306,Crime Spree,2003,"['Canada', 'United Kingdom', 'France', 'United States of America']","['Action', 'Heist', 'Crime Fiction', 'Action/Adventure', 'Comedy', 'Crime Comedy', 'Comedy of Errors']",2000,3
12611336,Mujrim,1989,['India'],"['Action', 'Crime Fiction']",1980,9
24889161,Riff Raffy Daffy,1948,[],"['Animation', 'Short Film', 'Comedy film', 'Family Film']",1940,8
29732423,Marshal,2002,['India'],"['Action/Adventure', 'Drama', 'World cinema']",2000,2
28964840,Inakkilly,1984,"['India', 'Malayalam Language']",['Romantic drama'],1980,4
3477744,¡Vampiros en La Habana!,1985,"['Spain', 'Cuba', 'Germany', 'West Germany']","['Animation', 'Comedy', 'Horror', 'World cinema', 'Fantasy']",1980,5
2641235,Modern Problems,1981,['United States of America'],"['Screwball comedy', 'Comedy', 'Fantasy Comedy']",1980,1
10017331,My Suicidal Sweetheart,2005,['United States of America'],"['Indie', 'Comedy-drama']",2000,5
26772297,Bangaru Papa,1954,['India'],['Drama'],1950,4
2155510,John Carpenter presents Body Bags,1993,['United States of America'],"['Slasher', 'Comedy', 'Thriller', 'Horror', 'Science Fiction']",1990,3
21997968,Red Swastik,2007,['India'],['Bollywood'],2000,7
21291315,Comanche Station,1960,['United States of America'],"['Action', 'Drama', 'Action/Adventure', 'Western']",1960,0
12747734,Dead Like Me: Life After Death,2009,['United States of America'],"['Black comedy', 'Comedy']",2000,9
7353661,Golgo 13: Kûron no kubi,1977,['Japan'],"['Action', 'Japanese Movies', 'Action/Adventure', 'World cinema']",1970,7
15707290,Dead Leaves,2004,['Japan'],"['Action', 'Animation', 'Japanese Movies', 'Anime', 'Science Fiction']",2000,4
5676495,7 Seconds,2005,"['United Kingdom', 'Switzerland', 'Romania']","['Action', 'Crime Fiction', 'Gangster Film', 'Action Thrillers', 'Action/Adventure', 'Thriller', 'Crime Thriller']",2000,5
2226221,The King of the Kickboxers,1990,"['Hong Kong', 'United States of America']","['Action', 'Crime Fiction', 'Sports', 'Martial Arts Film']",1990,0
13252507,La Dernière femme,1976,"['France', 'Italy']",['Drama'],1970,6
2143256,Pat Garrett and Billy the Kid,1973,['United States of America'],"['History', 'Action/Adventure', 'Western', 'Drama']",1970,3
13455991,Dog Days of Summer,2007,['United States of America'],"['Mystery', 'Indie', 'Thriller', 'Drama']",2000,7
2380086,Don't Tempt Me,2001,"['Spain', 'Mexico', 'France', 'Italy']","['Comedy', 'World cinema', 'Religious Film', 'Fantasy']",2000,1
32238844,Van de koele meren des doods,1982,['Netherlands'],"['Melodrama', 'Costume drama', 'Tragedy']",1980,2
855797,A Walk to Remember,2002,['United States of America'],"['Film adaptation', 'Romantic drama', 'Coming of age', 'Teen', 'Romance Film', 'Melodrama', 'Drama']",2000,2
30854893,Return of the Living Dead 3,1993,['United States of America'],"['Horror Comedy', 'Teen', 'Horror', 'B-movie', 'Zombie Film', 'Cult']",1990,3
5547391,Aakhree Raasta,1986,['India'],"['Action', 'Bollywood']",1980,6
36290263,Raa,2001,['India'],[],2000,1
9058143,Top Dog,1995,['United States of America'],"['Action', 'Crime Fiction', 'Action/Adventure', 'Comedy', 'Thriller']",1990,5
27763343,Kona Coast,1968,['United States of America'],['Drama'],1960,8
17884583,The President Is Coming,2009,['India'],"['Mockumentary', 'Comedy', 'World cinema']",2000,9
9667576,Kadhal Sadugudu,2003,['India'],"['Romance Film', 'Comedy']",2000,3
6767366,Untitled Rajasekhar/Vishal Project,2008,['India'],['Action'],2000,8
1667811,Embrace of the Vampire,1995,['United States of America'],"['Indie', 'Horror', 'Erotic thriller', 'Erotica', 'Cult']",1990,5
193854,I Want to Live!,1958,['United States of America'],"['Prison', 'Black-and-white', 'Crime Fiction', 'Film noir', 'Drama', 'Courtroom Drama', 'Biopic [feature]', 'Crime Drama']",1950,8
1194208,A Hill in Korea,1956,['United Kingdom'],['War film'],1950,6
24409284,Janakan,2009,['India'],"['Thriller', 'Crime Fiction']",2000,9
12527169,The Foghorn Leghorn,1948,['United States of America'],"['Animation', 'Comedy', 'Family Film']",1940,8
2326317,Kevin & Perry Go Large,2000,['United Kingdom'],"['Musical', 'Comedy', 'Teen', 'Sex comedy']",2000,0
25564184,Decalogue V,1988,['Poland'],['Drama'],1980,8
9347344,Deadly Outlaw: Rekka,2002,['Japan'],"['Action', 'Crime Fiction', 'Gangster Film', 'Action/Adventure', 'World cinema', 'Crime Thriller', 'Drama', 'Japanese Movies']",2000,2
6768793,Suyamvaram,1999,['India'],['Comedy-drama'],1990,9
4584210,Main Aisa Hi Hoon,2005,['India'],"['Musical', 'Drama', 'World cinema']",2000,5
9719246,Beyond Paradise,1998,['United States of America'],"['Indie', 'Drama']",1990,8
11094934,The Robot vs. The Aztec Mummy,1958,['Mexico'],"['Monster movie', 'Horror', 'World cinema', 'Science Fiction']",1950,8
547378,Along Came Polly,2004,['United States of America'],"['Gross out', 'Gross-out film', 'Comedy', 'Romance Film', 'Romantic comedy']",2000,4
3946045,The Big Knife,1955,['United States of America'],"['Film adaptation', 'Black-and-white', 'Film noir', 'Drama']",1950,5
1246394,Mary Shelley's Frankenstein,1994,"['Japan', 'United States of America']","['Gothic Film', 'Thriller', 'Romance Film', 'Costume Horror', 'Drama', 'Creature Film', 'Japanese Movies', 'Horror', 'Science Fiction']",1990,4
33146132,Revenge of the Musketeers,1994,['France'],"['Action', 'Action/Adventure', 'Comedy', 'World cinema', 'Adventure']",1990,4
1544670,Vera Cruz,1954,['United States of America'],"['Western', 'Action/Adventure', 'War film']",1950,4
2019025,Desperately Seeking Susan,1985,['United States of America'],"['Screwball comedy', 'Mystery', 'Comedy', 'Romance Film', 'Romantic comedy', 'Drama', 'Feminist Film']",1980,5
14185043,Power,1986,['United States of America'],"['Drama', 'Political drama']",1980,6
5916161,Amrutham,2004,['India'],"['Drama', 'Malayalam Cinema']",2000,4
6821714,Jee Aayan Nu,2003,['India'],"['Romance Film', 'Drama']",2000,3
25583720,Saboot,1980,['India'],['Thriller'],1980,0
708479,Blue Streak,1999,"['Germany', 'United States of America']","['Action', 'Crime Fiction', 'Action/Adventure', 'Comedy']",1990,9
12210337,Butterfly Man,2002,"['United Kingdom', 'Thailand']","['Romantic drama', 'Action/Adventure', 'Adventure', 'Romance Film', 'Drama']",2000,2
10142639,Tito and Me,1992,"['Yugoslavia', 'France']","['Music', 'Political cinema', 'Political satire', 'Satire', 'Comedy', 'World cinema', 'Drama']",1990,2
11688451,4,2005,['Russia'],"['Surrealism', 'Art film', 'World cinema', 'Drama']",2000,5
17147883,Pest of the West,2008,"['Canada', 'United States of America']",['Short Film'],2000,8
32227193,Main Balwaan,1986,[],['Action'],1980,6
13396282,I Still Dream of Jeannie,1991,['United States of America'],"['Comedy', 'Fantasy Comedy']",1990,1
24517581,The Naked Face,1984,['United States of America'],"['Action', 'Mystery', 'Thriller']",1980,4
23755411,The Reception,2005,['United States of America'],"['Indie', 'Drama']",2000,5
9893687,O Drakos,1956,['Greece'],"['Film noir', 'Drama', 'Thriller']",1950,6
29443815,Earthbound,1981,['United States of America'],"['Family Film', 'Science Fiction', 'Comedy film']",1980,1
4041420,Shall We Dance,1937,['United States of America'],"['Musical', 'Black-and-white', 'Comedy', 'Romance Film', 'Romantic comedy']",1930,7
31530052,Infested,1994,[],['Horror'],1990,4
24333629,Ganesh,2009,['India'],['Romance Film'],2000,9
3182907,The Basketball Diaries,1995,['United States of America'],"['Film adaptation', 'Crime Fiction', 'Biography', 'Indie', 'Teen', 'Addiction Drama', 'Drama', 'Coming of age', 'Biopic [feature]', 'Sports']",1990,5
33192771,Private Master,1967,['India'],['Musical'],1960,7
6320176,The Trench,1999,"['Ireland', 'United Kingdom']","['Period piece', 'Drama', 'Indie', 'War film']",1990,9
215738,Orpheus,1949,['France'],"['Surrealism', 'Black-and-white', 'Drama', 'Fantasy']",1940,9
26737511,T.N.T. Jackson,1974,"['Philippines', 'United States of America']","['Action', 'Filipino Movies', 'Blaxploitation', 'Drama']",1970,4
30889053,Fireball,2009,['Thailand'],"['Action', 'Drama', 'Action/Adventure', 'World cinema', 'Martial Arts Film']",2000,9
9555242,The Cheetah Girls: One World,2008,['United States of America'],"['Comedy', 'Drama', 'Family Film']",2000,8
349005,Jetsons: The Movie,1990,['United States of America'],"['Musical', 'Animated cartoon', 'Animation', 'Comedy', ""Children's/Family"", ""Children's"", 'Science Fiction', 'Family Film']",1990,0
14411333,Who Killed Dr Bogle and Mrs Chandler?,2006,['Australia'],"['Indie', 'Documentary']",2000,6
1867173,The Naked Gun 33⅓: The Final Insult,1994,['United States of America'],"['Parody', 'Comedy']",1990,4
3252667,Dangerous Child,2001,['United States of America'],"['Psychological thriller', 'Crime Fiction', 'Family Drama', 'Television movie', 'Drama']",2000,1
4163034,Maximum Risk,1996,['United States of America'],"['Action', 'Action Thrillers', 'Action/Adventure', 'Thriller', 'Crime Thriller', 'Martial Arts Film']",1990,6
18803923,Flash Gordon: The Greatest Adventure of All,1982,['United States of America'],"['Action', 'Superhero', 'Adventure', 'Superhero movie', 'Science Fiction']",1980,2
682280,Consenting Adults,1992,['United States of America'],"['Psychological thriller', 'Thriller', 'Erotic thriller', 'Crime Thriller']",1990,2
9147232,Once Upon a Time in China V,1995,"['China', 'Hong Kong']","['Chinese Movies', 'Martial Arts Film']",1990,5
22960044,Afsana Pyaar Ka,1991,['India'],"['Romantic drama', 'World cinema', 'Romance Film', 'Drama']",1990,1
4362261,Monster Night,2006,['United States of America'],"['Comedy', 'Family Film', 'Adventure']",2000,6
36341206,Cela s'appelle l'aurore,1956,"['France', 'Italy']",['Drama'],1950,6
25228092,Chosen Survivors,1974,"['Mexico', 'United States of America']",['Horror'],1970,4
19820048,Creation,2009,['United Kingdom'],"['Period piece', 'Biographical film', 'Drama']",2000,9
25239147,Sathi Leelavathi,1936,['India'],['Drama'],1930,6
19034709,Perfect Understanding,1933,['United Kingdom'],['Comedy-drama'],1930,3
2262603,Mera Naam Joker,1970,['India'],"['Romantic drama', 'Bollywood', 'World cinema', 'Romance Film', 'Drama']",1970,0
17582439,One Dark Night,1983,['United States of America'],"['Indie', 'Teen', 'Horror']",1980,3
1875065,Daffy Duck's Quackbusters,1988,['United States of America'],"['Animation', 'Family Film', 'Fantasy']",1980,8
5089524,Muqaddar Ka Sikandar,1978,['India'],"['Musical', 'Romantic drama', 'Bollywood', 'World cinema', 'Romance Film', 'Drama']",1970,8
17142267,West of Shanghai,1937,['United States of America'],"['Black-and-white', 'War film', 'Adventure', 'Drama']",1930,7
8511986,The Brotherhood IV: The Complex,2005,['Canada'],"['Teen', 'Horror']",2000,5
20928397,Señorella and the Glass Huarache,1964,['United States of America'],"['Animation', 'Short Film', 'Comedy']",1960,4
9628048,The Wolf Dog,1933,['United States of America'],"['Action', 'Black-and-white', 'Adventure']",1930,3
3178080,Du er ikke alene,1978,['Denmark'],"['LGBT', 'Coming of age', 'Romantic drama', 'World cinema', 'Romance Film', 'Drama']",1970,8
6499613,Bring Me the Head of Mavis Davis,1997,['United Kingdom'],"['Black comedy', 'Comedy', 'Crime Comedy']",1990,7
4951456,Kinjite: Forbidden Subjects,1989,['United States of America'],"['Action', 'Crime Fiction', 'Action/Adventure', 'Thriller']",1980,9
3150536,High Diving Hare,1949,['United States of America'],"['Animation', 'Short Film', 'Comedy', 'Family Film']",1940,9
24582227,Altars of Desire,1927,['United States of America'],"['Silent film', 'Drama']",1920,7
675947,Hamburger Hill,1987,['United States of America'],"['Action', 'Combat Films', 'Indie', 'Action/Adventure', 'Drama', 'Anti-war', 'Anti-war film', 'War film']",1980,7
26085510,One Piece Film: Strong World,2009,['Japan'],['Japanese Movies'],2000,9
6566456,The Family Jewels,1965,['United States of America'],"['Slapstick', 'Comedy']",1960,5
30241871,Dead Men Tell,1941,['United States of America'],"['Detective fiction', 'Mystery', 'Comedy', 'Detective']",1940,1
23454846,Is This Love?,2002,['India'],"['Musical', 'Romantic drama', 'Bollywood', 'World cinema', 'Romance Film', 'Drama']",2000,2
25812350,An Officer and a Car Salesman,1988,['United Kingdom'],"['Comedy', 'Thriller']",1980,8
1401046,The Keep,1983,"['United Kingdom', 'United States of America']","['War film', 'Supernatural', 'Horror']",1980,3
3227819,Maybe Baby,2000,['United Kingdom'],"['Indie', 'Comedy', 'Romance Film', 'Romantic comedy', 'Drama']",2000,0
4625875,Seeta Aur Geeta,1972,['India'],"['Musical', 'Comedy', 'Bollywood', 'World cinema', 'Romance Film']",1970,2
6197489,The Importance of Being Earnest,2002,"['United Kingdom', 'United States of America']","['Period piece', 'Romantic drama', 'Comedy', 'Romance Film', 'Romantic comedy', 'Costume drama', 'Drama']",2000,2
6157905,Murari,2001,['India'],"['Romance Film', 'Comedy', 'Drama']",2000,1
8309714,State's Evidence,2006,['United States of America'],"['Psychological thriller', 'Indie', 'Thriller']",2000,6
2444093,Æon Flux,2005,['United States of America'],"['Action', 'Dystopia', 'Thriller', 'Adventure', 'Science Fiction']",2000,5
12596771,Kyun Tum Say Itna Pyar Hai,2005,['Pakistan'],['Action'],2000,5
21121530,Troubled Waters,2006,['Canada'],"['Suspense', 'Mystery', 'Thriller', 'Crime Thriller', 'Supernatural']",2000,6
25502856,Don't Open Till Christmas,1984,"['United Kingdom', 'United States of America']","['Slasher', 'Horror', 'B-movie', 'Holiday Film']",1980,4
19620290,Ninaithale Inikkum,2009,['India'],"['Mystery', 'Drama']",2000,9
27855544,A West Lake Moment,2005,['China'],"['Romantic drama', 'World cinema', 'Romance Film', 'Chinese Movies', 'Drama']",2000,5
9067968,Dayavan,1988,['India'],"['Action/Adventure', 'World cinema']",1980,8
16780427,The Unholy Three,1930,['United States of America'],"['Black-and-white', 'Thriller']",1930,0
1623051,Cypher,2002,"['Canada', 'United States of America']","['Psychological thriller', 'Science Fiction', 'Thriller']",2000,2
3717574,Night Editor,1946,['United States of America'],"['Black-and-white', 'Crime Fiction', 'Thriller', 'Crime Drama', 'Film noir', 'Drama']",1940,6
18011991,Vacancy 2: The First Cut,2009,['United States of America'],"['Psychological thriller', 'Slasher', 'Horror']",2000,9
7156316,Who Done It?,1942,['United States of America'],"['Spy', 'Black-and-white', 'Mystery', 'Comedy', 'Thriller', 'Family Film']",1940,2
4238834,Breast Men,1997,['United States of America'],"['Comedy', 'Biopic [feature]', 'Comedy-drama', 'Docudrama', 'Drama', 'Medical fiction']",1990,7
1682418,102 Dalmatians,2000,"['United Kingdom', 'France', 'United States of America']","[""Children's"", 'Comedy', 'Animal Picture', 'Family-Oriented Adventure', ""Children's/Family"", 'Adventure', 'Family Film']",2000,0
46505,Airplane!,1980,['United States of America'],"['Satire', 'Comedy', 'Romance Film', 'Disaster', 'Absurdism', 'Airplanes and airports', 'Parody', 'Cult', 'Ensemble Film']",1980,0
4729,Batman & Robin,1997,"['United Kingdom', 'United States of America']","['Action', 'Crime Fiction', 'Superhero', 'Action/Adventure', 'Buddy film', 'Thriller', 'Master Criminal Films', 'Superhero movie', 'Science Fiction', 'Fantasy']",1990,7
25998588,Superstar,2008,['India'],"['Musical', 'Bollywood', 'World cinema', 'Drama']",2000,8
12182097,Cycle Psycho,1973,['United States of America'],"['Action', 'Psychological thriller', 'Mystery', 'Indie', 'Thriller', 'Horror', 'B-movie']",1970,3
6231868,Bloodline,1979,"['West Germany', 'United States of America']","['Crime Fiction', 'Mystery', 'Thriller', 'Romance Film', 'Drama']",1970,9
13402244,Yeh Lamhe Judaai Ke,2004,['India'],['Drama'],2000,4
3755662,The Bachelor,1999,['United States of America'],"['Romance Film', 'Romantic comedy', 'Comedy']",1990,9
2401502,Omen IV: The Awakening,1991,['United States of America'],"['Demonic child', 'Horror', 'Television movie', 'Cult']",1990,1
9049483,44 Minutes: The North Hollywood Shoot-Out,2003,['United States of America'],"['Action', 'Drama', 'Crime Fiction', 'Action/Adventure']",2000,3
9467480,King Solomon's Mines,1950,['United States of America'],"['Action', 'Action/Adventure', 'Adventure', 'Romance Film']",1950,0
2046284,She's Too Young,2004,"['Canada', 'United States of America']","['Family Drama', 'Social problem film', 'Melodrama', 'Television movie', 'Drama']",2000,4
431251,Immortal Beloved,1994,"['United Kingdom', 'United States of America']","['Musical', 'Romantic drama', 'Musical Drama', 'Romance Film', 'Costume drama', 'Drama', 'Period piece', 'Biopic [feature]', 'Epic']",1990,4
18700650,"Hard, Fast and Beautiful",1951,['United States of America'],"['Film adaptation', 'Black-and-white', 'Family Drama', 'Romance Film', 'Sports', 'Drama']",1950,1
1394167,100 Girls,2001,['United States of America'],"['Indie', 'Comedy', 'Teen', 'Romance Film', 'Romantic comedy']",2000,1
11871813,"Ready When You Are, Mr McGill",1976,['United Kingdom'],['Comedy'],1970,6
34358984,God's Country,1946,['United States of America'],"['Western', 'Comedy film']",1940,6
29187590,The Ugly Duckling,1959,[],"['Comedy film', 'Crime Fiction']",1950,9
15401848,Le Grand Chef,2007,['South Korea'],['World cinema'],2000,7
7182036,Mrigaraju,2001,['India'],"['Action', 'Adventure']",2000,1
17029551,On the Avenue,1937,['United States of America'],"['Musical', 'Black-and-white', 'Backstage Musical', 'Comedy', 'Musical comedy', 'Romance Film', 'Romantic comedy']",1930,7
1239956,I'm All Right Jack,1959,['United Kingdom'],"['Parody', 'Satire', 'Comedy', 'Black comedy', 'Workplace Comedy']",1950,9
21951886,The Apocalypse,2007,['United States of America'],"['Drama', 'Indie', 'Action/Adventure', 'Christian film', 'Disaster', 'Science Fiction']",2000,7
13886616,Coast to Coast,2003,"['Canada', 'United States of America']","['Film adaptation', 'Romantic drama', 'Comedy', 'Romance Film', 'Television movie', 'Drama']",2000,3
14870122,"Cheese It, the Cat!",1957,['United States of America'],"['Animation', 'Short Film', 'Comedy', 'Family Film']",1950,7
42159,The Best Years of Our Lives,1946,['United States of America'],"['Black-and-white', 'Family Drama', 'Epic', 'Americana', 'War film', 'Drama', 'Ensemble Film']",1940,6
26652800,Katha Parayum Theruvoram,2009,['India'],['Drama'],2000,9
21331491,Escápate Conmigo,1987,['Mexico'],"['Musical', 'Comedy']",1980,7
30809909,The Murder Men,1961,['United States of America'],"['Drama', 'Crime Fiction']",1960,1
15279295,Slumber Party Massacre 3,1990,['United States of America'],"['Indie', 'Slasher', 'Teen', 'Horror']",1990,0
3098409,Spring Snow,2005,['Japan'],"['History', 'Japanese Movies', 'Romantic drama']",2000,5
17922358,Labor Pains,2009,['United States of America'],"['Romance Film', 'Romantic comedy', 'Comedy']",2000,9
28363568,The White Game,1968,['Sweden'],"['Sports', 'Documentary']",1960,8
936651,The Mask of Fu Manchu,1932,['United States of America'],"['Black-and-white', 'Crime Fiction', 'Adventure', 'Master Criminal Films', 'Pre-Code']",1930,2
14657242,For Love or Money,1963,['United States of America'],['Romantic comedy'],1960,3
15591569,Liquidation,2007,[],"['Action', 'Thriller']",2000,7
1887575,The Klansman,1974,['United States of America'],"['Crime Fiction', 'Thriller', 'Social problem film', 'Melodrama', 'Crime Thriller', 'Drama']",1970,4
15561808,"My Boss, My Hero",2001,['South Korea'],"['Action', 'Crime Fiction', 'Comedy']",2000,1
26553464,While the Sun Shines,1947,['United Kingdom'],"['Romantic comedy', 'Comedy']",1940,7
19203216,Scream and Scream Again,1970,['United Kingdom'],"['Crime Fiction', 'Mystery', 'Thriller', 'Horror', 'Science Fiction']",1970,0
1640125,Used Cars,1980,['United States of America'],"['Action', 'Parody', 'Action/Adventure', 'Satire', 'Comedy', 'Americana']",1980,0
10766020,Bring It On: In It to Win It,2007,['United States of America'],"['Sports', 'Comedy', 'Teen']",2000,7
36745171,Frank's Cock,1993,['Canada'],"['Experimental film', 'Short Film', 'Drama']",1990,3
82423,Nosferatu,1922,['Germany'],"['Expressionism', 'Mystery', 'Indie', 'Gothic Film', 'World cinema', 'Romance Film', 'Costume Horror', 'Horror', 'Silent film', 'Fantasy']",1920,2
8531960,The Half Life of Timofey Berezin,2006,"['United Kingdom', 'United States of America']","['Crime Fiction', 'Thriller', 'Television movie', 'Crime Thriller', 'Political drama', 'Drama']",2000,6
18513660,Egon Schiele Exzess und Bestrafung,1980,"['France', 'Germany', 'Croatia']","['Drama', 'Biographical film']",1980,0
15562419,Swanee River,1939,['United States of America'],['Drama'],1930,9
284619,To Die For,1995,"['United Kingdom', 'United States of America']","['Crime Fiction', 'Parody', 'Satire', 'Comedy', 'Black comedy', 'Drama']",1990,5
9358839,Heidi's Song,1982,['United States of America'],"['Musical', 'Animation', ""Children's"", 'Drama']",1980,2
5906140,The Last Warning,1929,['United States of America'],"['Mystery', 'Crime Fiction']",1920,9
2564119,Krush Groove,1985,['United States of America'],"['Drama', 'Hip hop movies', 'Comedy film']",1980,5
24485169,The President's Mystery,1936,['United States of America'],"['Mystery', 'Thriller', 'Romance Film', 'Drama']",1930,6
9333163,Ashik Kerib,1988,"['Russia', 'Soviet Union', 'Georgian SSR', 'Georgia']","['Romantic drama', 'World cinema', 'Adventure', 'Romance Film', 'Drama']",1980,8
31513157,Vazhkai / Jeevitham,1949,['India'],['Drama'],1940,9
36208116,Showdown,1993,['United States of America'],['Action'],1990,3
11635128,The Ice Follies of 1939,1939,['United States of America'],"['Musical', 'Black-and-white', 'Drama']",1930,9
18622484,The Daffy Duckaroo,1942,['United States of America'],"['Animation', 'Short Film', 'Comedy', 'Family Film']",1940,2
9022488,The Boss of it All,2006,"['Denmark', 'Sweden', 'France', 'Italy']","['Art film', 'Comedy', 'World cinema', 'Workplace Comedy', 'Drama']",2000,6
34083061,One of Our Spies Is Missing,1966,['United States of America'],"['Action', 'Spy', 'Crime Fiction', 'Mystery', 'Comedy', 'Glamorized Spy Film', 'Adventure', 'Comedy film']",1960,6
3473999,Swordsman II,1991,['Hong Kong'],"['Action', 'Action/Adventure', 'World cinema', 'Chinese Movies', 'Martial Arts Film', 'Adventure', 'Wuxia', 'Fantasy']",1990,1
12145557,"Scream, Baby, Scream",1969,['United States of America'],"['Indie', 'Horror']",1960,9
22415023,El Peñon de las Animas,1943,['Mexico'],"['Romance Film', 'Drama']",1940,3
10540943,Spring Silkworms,1933,['China'],"['Black-and-white', 'Drama', 'Indie', 'Silent film', 'Chinese Movies']",1930,3
21036698,Amara Deepam,1956,['India'],['Romance Film'],1950,6
3053795,The Suburbans,1999,['United States of America'],"['Parody', 'Comedy', 'Comedy-drama', 'Drama', 'Ensemble Film']",1990,9
19878320,BASEketball,1998,['United States of America'],"['Gross out', 'Gross-out film', 'Parody', 'Comedy', 'Sports', 'Slapstick', 'Absurdism']",1990,8
29556828,Mermaid,2007,['Russia'],"['Romantic drama', 'Comedy', 'World cinema', 'Romance Film', 'Drama', 'Fantasy']",2000,7
3820793,He Ran All the Way,1951,['United States of America'],"['Crime Fiction', 'Thriller', 'Film noir', 'Crime Thriller', 'Drama']",1950,1
543517,Fear and Desire,1953,['United States of America'],"['Black-and-white', 'War film', 'Drama']",1950,3
4607239,Having A Wild Weekend,1965,['United Kingdom'],"['Drama', 'Comedy']",1960,5
21859783,Shangani Patrol,1970,['South Africa'],"['Action', 'Drama', 'War film']",1970,0
28236143,No Place to Hide,1981,['United States of America'],"['Psychological thriller', 'Mystery', 'Thriller', 'Drama']",1980,1
80510,The Bishop's Wife,1947,['United States of America'],"['Romantic fantasy', 'Heavenly Comedy', 'Comedy', 'Romantic comedy', 'Romance Film', 'Christmas movie', 'Fantasy']",1940,7
23946168,Captain Khorshid,1987,['Iran'],"['Action', 'Drama']",1980,7
7421446,Far From Home: The Adventures of Yellow Dog,1995,['United States of America'],"[""Children's"", 'Animal Picture', 'Family-Oriented Adventure', ""Children's/Family"", 'Adventure', 'Family Film']",1990,5
24426458,Apollo 11,1996,['United States of America'],['Drama'],1990,6
14148627,D'Lucky Ones,2006,['Philippines'],"['Filipino Movies', 'Romantic drama', 'Comedy', 'World cinema', 'Romance Film', 'Romantic comedy', 'Drama']",2000,6
2631788,Arabesque,1966,['United States of America'],"['Spy', 'Suspense', 'Thriller']",1960,6
10406957,Al-Zawjah al-Azra',1958,['Egypt'],"['Mystery', 'Crime Fiction']",1950,8
3746294,Night Shift,1944,"['France', 'Italy']","['Comedy', 'Black-and-white']",1940,4
5238193,These Girls,2006,['Canada'],"['Drama', 'Indie', 'Comedy', 'Romance Film', 'Romantic comedy', 'Comedy-drama']",2000,6
24984104,Lourdes,2009,"['France', 'Germany', 'Austria']","['Drama', 'World cinema']",2000,9
36089665,Men Don't Tell,1993,['United States of America'],['Drama'],1990,3
3497365,Stay Hungry,1976,['United States of America'],"['Sports', 'Comedy', 'Drama']",1970,6
4205606,About a Boy,2002,"['United Kingdom', 'France', 'United States of America']","['Coming of age', 'Comedy', 'Romantic comedy', 'Romance Film', 'Comedy-drama', 'Drama', 'Slice of life story']",2000,2
17249372,Wild West Comedy Show: 30 Days & 30 Nights - Hollywood to the Heartland,2006,['United States of America'],"['Stand-up comedy', 'Comedy']",2000,6
3159121,Confidence,2003,"['Germany', 'United States of America', 'Canada']","['Suspense', 'Heist', 'Crime Fiction', 'Gangster Film', 'Thriller', 'Crime Thriller', 'Drama']",2000,3
13532982,The Legend of Suram Fortress,1984,"['Russia', 'Soviet Union', 'Georgian SSR']","['Action/Adventure', 'Drama', 'World cinema']",1980,4
5693657,The Jock Club and the Mellon Collie Death of Eugene Nerdlinger,1999,[],"['Short Film', 'Comedy']",1990,9
26719982,Parunthu,2008,['India'],"['Action', 'Thriller', 'Family Film']",2000,8
1412856,Lamerica,1994,['Italy'],"['Art film', 'World cinema', 'Political drama', 'Adventure', 'Drama']",1990,4
3449617,Udayon,2005,['India'],['Action'],2000,5
24035981,Doll Face,1946,['United States of America'],"['Musical', 'Black-and-white', 'Comedy', 'Romance Film', 'Drama']",1940,6
1624928,Nightwatch,1997,['United States of America'],"['Action', 'Psychological thriller', 'Crime Fiction', 'Mystery', 'Indie', 'Thriller', 'Crime Thriller', 'Drama', 'Suspense', 'Slasher', 'Horror']",1990,7
3112223,Cosmos: War of the Planets,1977,['Italy'],['Science Fiction'],1970,7
23290396,"Elmer, the Great",1933,['United States of America'],['Drama'],1930,3
6425519,Where Angels Fear to Tread,1991,['United Kingdom'],"['Period piece', 'Film adaptation', 'Romantic drama', 'Romance Film', 'Drama']",1990,1
12743934,Hot Stuff,1979,['United States of America'],['Comedy'],1970,9
9690225,The Strongest Man in the World,1975,['United States of America'],"['Comedy', 'Science Fiction', 'Drama', 'Family Film']",1970,5
29536949,Melodies of Vera Quarter,1973,[],"['Musical', 'Drama', 'Comedy film']",1970,3
3597370,Dillinger,1991,['United States of America'],"['Action', 'Drama', 'Crime Fiction', 'Historical drama', 'Biographical film']",1990,1
35226792,Kanni Rasi,1985,['India'],['Romance Film'],1980,5
5939732,Pass the Ammo,1988,['United States of America'],"['Parody', 'Satire', 'Comedy']",1980,8
10552268,Valkyrie,2008,"['Germany', 'United States of America']","['Period piece', 'History', 'Thriller', 'Political drama', 'War film', 'Drama', 'Political thriller']",2000,8
168602,Flashdance,1983,['United States of America'],"['Musical', 'Romantic drama', 'Musical Drama', 'Dance', 'Romance Film', 'Drama']",1980,3
4343468,To Sleep With Anger,1990,['United States of America'],"['Indie', 'Family Drama', 'Drama']",1990,0
9928554,Blind Dating,2006,['United States of America'],"['Romance Film', 'Romantic comedy', 'Comedy']",2000,6
15899775,Diverted,2009,"['Canada', 'United Kingdom']",['Drama'],2000,9
3303622,Father of the Bride Part II,1995,['United States of America'],"['Screwball comedy', 'Comedy', 'Romance Film', 'Family Film']",1990,5
99123,Speed,1994,['United States of America'],"['Action', 'Crime Fiction', 'Action/Adventure', 'Thriller', 'Adventure']",1990,4
24402395,The Cemetery Club,1993,['United States of America'],['Comedy'],1990,3
25469888,Utharam,1989,['India'],"['Mystery', 'Thriller']",1980,9
461353,House of Sand and Fog,2003,['United States of America'],"['Psychological thriller', 'Film adaptation', 'Drama', 'Tragedy']",2000,3
18622071,Sabaidee Luang Prabang,2008,['Thailand'],['Romance Film'],2000,8
5888613,Venky,2004,['India'],"['Mystery', 'Romance Film']",2000,4
6417754,This Boy's Life,1993,['United States of America'],"['Period piece', 'Film adaptation', 'Coming of age', 'Family Drama', 'Biographical film', 'Drama']",1990,3
1319356,Godzilla: Final Wars,2004,['Japan'],"['Creature Film', 'Japanese Movies', 'Monster', 'World cinema', 'Science Fiction', 'Cult', 'Fantasy']",2000,4
2721832,Night and the City,1992,['United States of America'],"['Neo-noir', 'Crime Fiction', 'Remake', 'Drama']",1990,2
18868736,Göta kanal,1981,['Sweden'],['Comedy'],1980,1
18768247,Doctor in Trouble,1970,['United Kingdom'],"['Romance Film', 'Romantic comedy', 'Comedy']",1970,0
5023723,Fando & Lis,1970,['Mexico'],"['Surrealism', 'Fantasy', 'Adventure']",1970,0
2295405,Little Children,2006,['United States of America'],"['Romance Film', 'Marriage Drama', 'Drama']",2000,6
2476317,French Connection II,1975,['United States of America'],"['Action', 'Suspense', 'Crime Fiction', 'Gangster Film', 'Action/Adventure', 'Thriller', 'Crime Thriller']",1970,5
3999301,Phenomena,1985,['Italy'],"['Indie', 'Slasher', 'Teen', 'Horror', 'Cult', 'Natural horror films', 'Fantasy']",1980,5
10527038,Private Property,2007,"['France', 'Luxembourg', 'Belgium']","['Art film', 'Drama', 'World cinema']",2000,7
6716962,After the Rain,1999,['Japan'],"['Japanese Movies', 'Martial Arts Film', 'Drama']",1990,9
35025516,Borrowing Matchsticks,1980,"['Finland', 'Soviet Union']",['Comedy film'],1980,0
6822553,Dice,2001,"['Canada', 'United Kingdom']","['Drama', 'Television movie']",2000,1
33577260,Jonathan: The Boy Nobody Wanted,1992,[],['Drama'],1990,2
10319907,Mehman-e Maman,2004,['Iran'],"['Drama', 'Comedy']",2000,4
3965064,Catchfire,1990,['United States of America'],['Drama'],1990,0
2271177,Resident Evil: Extinction,2007,"['Australia', 'United Kingdom', 'France', 'Germany', 'United States of America']","['Action', 'Thriller', 'Horror', 'Zombie Film', 'Sci-Fi Horror', 'Science Fiction']",2000,7
17169953,Ultraman Tiga & Ultraman Dyna: Warriors of the Star of Light,1998,['Japan'],"['Monster movie', 'Japanese Movies', 'Action/Adventure', 'World cinema', 'Superhero movie']",1990,8
18554876,The Human Contract,2009,['United States of America'],"['Erotic thriller', 'Drama', 'Thriller']",2000,9
6761901,Riffraff,1947,['United States of America'],['Film noir'],1940,7
878892,Escaflowne,2000,['Japan'],"['Fantasy Adventure', 'Animation', 'World cinema', 'Adventure', 'Japanese Movies', 'Coming of age', 'Anime', 'Science Fiction', 'Fantasy']",2000,0
22348404,The Cell 2,2009,['United States of America'],"['Sci-Fi Horror', 'Suspense', 'Psychological thriller', 'Thriller', 'Crime Thriller', 'Supernatural', 'Science Fiction']",2000,9
2188459,The Stalking of Laurie Show,2000,"['Canada', 'United States of America']",['Thriller'],2000,0
2701438,Look Both Ways,2005,"['New Zealand', 'Australia']","['Drama', 'Mystery', 'Indie', 'Romantic drama', 'World cinema', 'Romance Film']",2000,5
11590938,Case Closed: Strategy Above the Depths,2005,['Japan'],['Japanese Movies'],2000,5
27730209,Adam's Woman,1972,"['United States of America', 'Australia']","['Crime Drama', 'Drama']",1970,2
544413,Speak,2004,['United States of America'],"['Indie', 'Drama', 'Teen']",2000,4
5001692,Golmaal: Fun Unlimited,2006,['India'],"['Musical', 'Comedy', 'Bollywood', 'World cinema']",2000,6
238906,Blues Brothers 2000,1998,['United States of America'],"['Adventure Comedy', 'Action', 'Musical', 'Action/Adventure', 'Buddy film', 'Comedy', 'Chase Movie', 'Road movie']",1990,8
1406799,Schultze Gets the Blues,2003,['Germany'],"['Musical', 'Comedy', 'Comedy of manners', 'World cinema', 'Comedy-drama', 'Drama']",2000,3
17972410,The Red Horses,1950,['Denmark'],['Family Film'],1950,0
9474548,Shalako,1968,"['United Kingdom', 'Germany']","['Action', 'Western', 'Action/Adventure']",1960,8
6758985,Bon Voyage,2003,['France'],"['Comedy', 'World cinema', 'Black comedy', 'War film', 'Drama']",2000,3
421305,The Blue Lamp,1950,['United Kingdom'],"['Crime Fiction', 'Crime Thriller', 'Thriller']",1950,0
5590439,Carry On Henry,1971,['United Kingdom'],"['Parody', 'Comedy', 'Sex comedy']",1970,1
24829091,White Shadows in the South Seas,1928,['United States of America'],"['Crime Fiction', 'Silent film', 'Adventure', 'Drama']",1920,8
3242846,Gulliver's Travels,1996,"['United Kingdom', 'United States of America']","['Adventure', 'Family Film', 'Fantasy']",1990,6
18547154,Jonny Vang,2002,['Norway'],"['Mystery', 'Comedy', 'Romantic comedy', 'Drama']",2000,2
1969089,Rollercoaster,1977,['United States of America'],"['Action', 'Crime Fiction', 'Mystery', 'Action/Adventure', 'Thriller', 'Crime Thriller', 'Disaster', 'Suspense']",1970,7
13269855,Close to You,2006,['Philippines'],"['Filipino Movies', 'Romantic drama', 'World cinema', 'Romance Film', 'Drama']",2000,6
9055835,Designing Woman,1957,['United States of America'],"['Romance Film', 'Romantic comedy', 'Comedy']",1950,7
405669,Quintet,1979,['United States of America'],"['Dystopia', 'Science Fiction', 'Drama']",1970,9
354061,Red Heat,1988,['United States of America'],"['Action', 'Crime Fiction', 'Action/Adventure', 'Buddy film', 'Thriller', 'Comedy']",1980,8
14683918,Look,2007,['United States of America'],"['Crime Fiction', 'Indie', 'Drama']",2000,7
33383055,Weasel Stop,1956,[],"['Animation', 'Short Film', 'Comedy film', 'Family Film']",1950,6
21858274,"Hello, That's Me!",1966,['Armenia'],"['Black-and-white', 'Drama']",1960,6
10996671,Zeppelin,1971,['United Kingdom'],"['War film', 'Adventure', 'Drama']",1970,1
11079489,Sex & Fury,1973,['Japan'],"['Action', 'Crime Fiction', 'Gangster Film', 'Action/Adventure', 'World cinema', 'Japanese Movies', 'Pinku eiga', 'Erotica']",1970,3
489800,Rush Hour,1998,['United States of America'],"['Action', 'Crime Fiction', 'Comedy', 'Thriller']",1990,8
16309183,No Way to Treat a Lady,1968,['United States of America'],"['Comedy film', 'Thriller']",1960,8
4606109,I Bury the Living,1958,['United States of America'],"['Horror', 'Gothic Film']",1950,8
15893927,Island of Mutations,1979,['Italy'],"['Science Fiction', 'World cinema', 'Horror']",1970,9
34269763,Thousand Pieces of Gold,1990,"['United Kingdom', 'United States of America']","['Period piece', 'Romantic drama', 'Western', 'Romance Film', 'Drama']",1990,0
2675881,Black Friday,1940,['United States of America'],"['Black-and-white', 'Science Fiction', 'Horror']",1940,0
4510764,Gokulamlo Seetha,1997,['India'],"['Romance Film', 'Family Film']",1990,7
22291285,The Miracle of the Bells,1948,['United States of America'],"['Film adaptation', 'Melodrama', 'Drama']",1940,8
3459253,Secret of the Telegian,1960,['Japan'],"['Mystery', 'Japanese Movies', 'Horror', 'Science Fiction']",1960,0
1636672,The Two Jakes,1990,['United States of America'],"['Period piece', 'Neo-noir', 'Crime Fiction', 'Mystery', 'Thriller', 'Crime Thriller', 'Drama']",1990,0
172666,The Big Red One,1980,['United States of America'],"['Combat Films', 'Action', 'Drama', 'War film']",1980,0
9948127,Dr. Chopper,2005,['United States of America'],"['Indie', 'Slasher', 'Teen', 'Horror', 'B-movie']",2000,5
13832511,Dark Night of the Scarecrow,1981,['United States of America'],"['Monster movie', 'Horror', 'Television movie', 'Supernatural']",1980,1
2338797,Three Men and a Cradle,1985,['France'],"['Comedy', 'Comedy of manners', 'World cinema', 'Domestic Comedy']",1980,5
7635980,Biwi Ho To Aisi,1988,['India'],"['Drama', 'Comedy']",1980,8
71415,Dune,1984,['United States of America'],"['Action', 'Film adaptation', 'LGBT', 'Thriller', 'Adventure', 'Drama', 'Science Fiction', 'Cult']",1980,4
21427707,One Is a Lonely Number,1972,['United States of America'],"['Melodrama', 'Drama']",1970,2
3698195,City by the Sea,2002,['United States of America'],"['Crime Fiction', 'Mystery', 'Family Drama', 'Thriller', 'Crime Thriller', 'Drama']",2000,2
60155,She Done Him Wrong,1933,['United States of America'],"['Black-and-white', 'Screwball comedy', 'Comedy', 'Crime Comedy', 'Romantic comedy', 'Pre-Code']",1930,3
5708633,The Great New Wonderful,2006,['United States of America'],"['Indie', 'Comedy-drama', 'Drama', 'Ensemble Film']",2000,6
1853148,Torque,2004,['United States of America'],"['Action', 'Action/Adventure', 'Thriller', 'Sports']",2000,4
2757780,Nathalie...,2004,"['France', 'Spain']","['Erotic Drama', 'Romantic drama', 'World cinema', 'Romance Film', 'Drama']",2000,4
163459,Serpico,1973,"['Italy', 'United States of America']","['Crime Fiction', 'Biography', 'Thriller', 'Social problem film', 'Crime Thriller', 'Docudrama', 'Drama', 'New Hollywood']",1970,3
577618,Hard Boiled,1992,['Hong Kong'],"['Action', 'Action/Adventure', 'Thriller', 'World cinema', 'Chinese Movies', 'Martial Arts Film']",1990,2
3827670,Dracula A.D.1972,1972,['United Kingdom'],['Horror'],1970,2
13069334,Hotel Chevalier,2007,['United States of America'],"['Romantic drama', 'Short Film', 'Drama']",2000,7
19432732,Nagabonar,1987,['Indonesia'],"['War film', 'Comedy']",1980,7
50744,Star Wars Episode VI: Return of the Jedi,1983,['United States of America'],"['Action', 'Adventure', 'Space opera', 'Science Fiction', 'Family Film', 'Fantasy']",1980,3
19112117,"You Shoot, I Shoot",2001,['Hong Kong'],"['Action/Adventure', 'Comedy', 'World cinema', 'Chinese Movies']",2000,1
29027165,Amalfi: Rewards of the Goddess,2009,['Japan'],"['Mystery', 'Japanese Movies', 'Thriller', 'Drama']",2000,9
17308230,Blood on the Highway,2008,['United States of America'],"['Creature Film', 'Indie', 'Comedy', 'Horror', 'Black comedy']",2000,8
11380132,Summer Interlude,1951,['Sweden'],"['Black-and-white', 'Drama']",1950,1
2439489,The City of No Limits,2002,"['Argentina', 'Spain']","['Family Drama', 'Thriller', 'World cinema', 'Drama']",2000,2
19425978,Guns of Darkness,1962,['United Kingdom'],"['Adventure', 'Drama']",1960,2
242525,Victor/Victoria,1982,"['United Kingdom', 'United States of America']","['Musical', 'LGBT', 'Comedy', 'Remake', 'Romantic comedy', 'Sex comedy']",1980,2
18640305,The House Bunny,2008,['United States of America'],"['Comedy', 'Comedy of manners', 'Romance Film', 'Romantic comedy']",2000,8
14820202,Hansel and Gretel,2007,['South Korea'],"['Fantasy Drama', 'Horror', 'World cinema', 'Drama']",2000,7
17727825,Life Partner,2009,['India'],"['Musical', 'Romantic drama', 'Bollywood', 'World cinema', 'Romance Film', 'Drama']",2000,9
10848177,Azhagiya Tamil Magan,2007,['India'],"['Action', 'Comedy']",2000,7
26705987,Advaitham,1992,['India'],"['Action', 'Crime Fiction', 'Drama']",1990,2
25176887,A Summer in La Goulette,1996,"['France', 'Tunisia', 'Belgium']","['Coming of age', 'Teen', 'World cinema', 'Drama']",1990,6
11815820,Anne B. Real,2003,['United States of America'],"['Hip hop movies', 'Drama']",2000,3
14899649,Kushikushigaa,2004,['India'],['Romance Film'],2000,4
21705368,Les Abysses,1963,['France'],"['Crime Fiction', 'Docudrama', 'Drama']",1960,3
5420601,Ram Balram,1980,['India'],['World cinema'],1980,0
8666659,Da Hip Hop Witch,2004,['United States of America'],"['Parody', 'Comedy', 'Horror Comedy', 'Horror', 'Hip hop movies']",2000,4
12044905,Sinners,2007,['United States of America'],"['Drama', 'Crime Fiction']",2000,7
8614238,Dena Paona,1931,['India'],['Drama'],1930,1
957871,Destination Tokyo,1943,['United States of America'],"['Combat Films', 'Black-and-white', 'War film', 'Drama']",1940,3
4894733,The Fourth Protocol,1987,['United Kingdom'],"['Action', 'Spy', 'Film adaptation', 'Action Thrillers', 'Mystery', 'Thriller', 'Glamorized Spy Film']",1980,7
25849164,Thuruppu Gulan,2006,['India'],"['Action', 'Comedy']",2000,6
3746749,Cow Belles,2006,['United States of America'],"['Comedy', 'Teen', 'Romantic comedy', 'Television movie', ""Children's"", 'Family Film']",2000,6
22643321,Hidden Lives,1920,"['United Kingdom', 'Netherlands']",['Silent film'],1920,0
23485396,Star of Midnight,1935,['United States of America'],"['Detective fiction', 'Mystery', 'Detective', 'Crime Thriller']",1930,5
10867838,"Paris, France",1994,['Canada'],"['LGBT', 'Erotic Drama', 'Indie', 'Comedy', 'Romance Film', 'Drama', 'Gay Themed', 'Softcore Porn', 'Gay', 'Gay Interest', 'Comedy-drama', 'Ensemble Film']",1990,4
26063887,Troublesome Night 18,2003,['Hong Kong'],"['Chinese Movies', 'Horror']",2000,3
14205956,Zindagi Ek Jua,1992,['India'],"['Drama', 'World cinema']",1990,2
6835148,Walky Talky Hawky,1946,['United States of America'],"['Comedy', 'Family Film']",1940,6
7969860,Jailbait,2004,['United States of America'],"['LGBT', 'Crime Fiction', 'Drama']",2000,4
6805865,"Sorry, Haters",2005,['United States of America'],"['Thriller', 'Indie', 'Drama']",2000,5
25862293,La Totale !,1991,['France'],"['Adventure', 'Comedy film']",1990,1
12794804,Zombie Holocaust,1980,['Italy'],"['Creature Film', 'Horror', 'World cinema', 'Zombie Film']",1980,0
31076473,So Ends Our Night,1941,['United States of America'],"['War film', 'Drama']",1940,1
14737481,Drive a Crooked Road,1954,['United States of America'],"['Black-and-white', 'Crime Fiction', 'Thriller', 'Film noir', 'Crime Drama']",1950,4
19166020,The Moonraker,1958,['United Kingdom'],"['Historical fiction', 'Adventure', 'Drama']",1950,8
25975737,Kandu Kandarinju,1985,['India'],"['Action', 'Drama', 'Comedy']",1980,5
2898154,Ghost Lake,2005,['United States of America'],"['Horror', 'Zombie Film']",2000,5
24980367,Daffy's Southern Exposure,1942,['United States of America'],"['Animation', 'Short Film', 'Comedy', 'Family Film']",1940,2
6288907,The Ballad of Little Jo,1993,['United States of America'],"['Revisionist Western', 'Indie', 'Biography', 'Action/Adventure', 'Drama', 'Feminist Film', 'Period piece', 'Western']",1990,3
24741887,Hot Blood,1956,['United States of America'],"['Musical', 'Drama']",1950,6
6435577,Uncivil Warriors,1935,['United States of America'],"['Short Film', 'Black-and-white', 'Comedy']",1930,5
2380059,The Mary Kay Letourneau Story: All-American Girl,2000,['United States of America'],"['Crime Fiction', 'Biographical film', 'Docudrama', 'Drama']",2000,0
5098248,Prince Vladimir,2006,['Russia'],"['Christian film', 'Animation', 'Drama']",2000,6
6446995,The Whole Nine Yards,2000,"['Canada', 'United States of America']","['Action', 'Crime Fiction', 'Gangster Film', 'Action/Adventure', 'Comedy', 'Black comedy', 'Adventure', 'Drama', 'Crime Comedy']",2000,0
2100492,Medicine Man,1992,['United States of America'],"['Romantic drama', 'Action/Adventure', 'Jungle Film', 'Romance Film', 'Adventure', 'Drama']",1990,2
3100741,Abraham,1994,"['France', 'Germany', 'Czech Republic', 'Italy', 'United States of America']","['Biography', 'Christian film', 'Television movie', 'Epic', 'Drama']",1990,4
21751791,Red Sands,2009,['United States of America'],"['Action', 'War film', 'Horror']",2000,9
13049227,Hello Friend,2003,['United Kingdom'],"['Short Film', 'Comedy', 'Horror']",2000,3
21950055,A Bunch of Amateurs,2008,['United Kingdom'],['Comedy'],2000,8
213471,Chungking Express,1994,['Hong Kong'],"['Art film', 'Romantic drama', 'World cinema', 'Romance Film', 'Chinese Movies', 'Drama']",1990,4
11217536,Aasha,1980,['India'],"['Musical', 'Bollywood', 'World cinema', 'Drama']",1980,0
21650397,Doomsday Gun,1994,"['United Kingdom', 'United States of America']","['Biography', 'Biopic [feature]', 'Docudrama', 'Television movie', 'Political drama', 'Drama']",1990,4
33002479,Hukumat,1987,['India'],['Action'],1980,7
17244218,Cozy Dens,1999,['Czech Republic'],"['Period piece', 'Family Drama', 'Coming of age', 'Comedy', 'Comedy-drama', 'Drama']",1990,9
2199162,Nosferatu: Phantom der Nacht,1979,"['France', 'Germany', 'West Germany']","['World cinema', 'Remake', 'Horror']",1970,9
1056905,Bombay,1995,['India'],"['Romantic drama', 'Bollywood', 'World cinema', 'Political drama', 'Drama']",1990,5
11441643,Stand Up for Justice: The Ralph Lazo Story,2004,['United States of America'],"['History', 'Short Film', 'Biographical film']",2000,4
27744297,Al-Ra'i wal Nisaa,1991,['Egypt'],"['Romance Film', 'Drama']",1990,1
7101944,Gamebox 1.0,2004,['United States of America'],"['Science Fiction', 'Thriller', 'Horror']",2000,4
8425494,Dharma Chakram,1994,['India'],['Drama'],1990,4
972816,Clockwatchers,1997,"['United Kingdom', 'United States of America']","['Indie', 'Comedy', 'Workplace Comedy', 'Cult', 'Ensemble Film']",1990,7
21334426,Love Matters,2009,['Singapore'],"['Romance Film', 'Drama']",2000,9
3490448,Boa vs. Python,2004,['United States of America'],"['Creature Film', 'Monster', 'Horror', 'Science Fiction', 'Natural horror films']",2000,4
7666236,Arunachalam,1999,['India'],"['Comedy', 'World cinema']",1990,9
7285884,Anji,2004,['India'],"['Action', 'Drama', 'Thriller', 'Adventure', 'Science Fiction']",2000,4
13578694,Marte Dam Tak,1987,['India'],"['Action', 'Drama', 'World cinema']",1980,7
656608,What's Eating Gilbert Grape,1993,['United States of America'],"['Film adaptation', 'Indie', 'Romantic drama', 'Comedy', 'Romance Film', 'Americana', 'Drama', 'Slice of life story', 'Coming of age']",1990,3
6032729,Death Trance,2005,['Japan'],"['Action', 'Action Thrillers', 'Action/Adventure', 'Thriller', 'World cinema', 'Martial Arts Film', 'Japanese Movies', 'Fantasy']",2000,5
1511805,Robot Stories,2003,['United States of America'],"['Drama', 'Indie', 'Romantic drama', 'Comedy', 'Romance Film', 'Comedy-drama', 'Science Fiction']",2000,3
2316562,Summer Camp Nightmare,1987,['United States of America'],"['Drama', 'Horror']",1980,7
285559,Feeling Minnesota,1996,['United States of America'],"['Action', 'Crime Fiction', 'Action/Adventure', 'Comedy', 'Black comedy', 'Romance Film', 'Action Comedy', 'Road movie']",1990,6
4901314,Cloaca,2003,['Netherlands'],"['Drama', 'Comedy']",2000,3
5812844,Der Tiger von Eschnapur,1959,"['France', 'Germany', 'Italy']","['Romantic drama', 'Adventure', 'Romance Film', 'Drama']",1950,9
1208768,Someone Like You,2001,['United States of America'],"['Romance Film', 'Comedy']",2000,1
35226968,Murai Maman,1995,['India'],['Comedy film'],1990,5
28866199,Kallu Kondoru Pennu,1998,['India'],['Musical'],1990,8
18890766,Unruled Paper,2002,['Iran'],['Drama'],2000,2
12653392,Welcome to Hard Times,1967,['United States of America'],"['Revisionist Western', 'Western', 'Adventure']",1960,7
11476109,Cabin by the Lake,2000,['United States of America'],"['Psychological thriller', 'Comedy', 'Thriller', 'Horror', 'Black comedy']",2000,0
17903453,City of Men,2008,['Brazil'],"['Art film', 'Coming of age', 'World cinema', 'Crime Drama', 'Social problem film', 'Drama']",2000,8
28525363,Delayed Action,1954,['United Kingdom'],['Mystery'],1950,4
14336079,The Hot Scots,1948,['United States of America'],"['Short Film', 'Black-and-white', 'Comedy']",1940,8
993791,Der Untergang,2004,"['Germany', 'Austria', 'Italy']","['History', 'Biography', 'Biographical film', 'World cinema', 'War film', 'Drama']",2000,4
2994151,Bhoot,2003,['India'],"['Thriller', 'Bollywood', 'Horror']",2000,3
14053389,Madame X,1981,['United States of America'],['Drama'],1980,1
3343617,A Little Princess,1995,['United States of America'],"['Family Drama', 'Drama', 'Family Film', 'Fantasy']",1990,5
163440,The Ruling Class,1972,['United Kingdom'],"['Film adaptation', 'Parody', 'Satire', 'Comedy', 'Black comedy', 'Comedy-drama', 'Drama']",1970,2
2724834,"Pretty Village, Pretty Flame",1996,"['Serbia', 'Serbia and Montenegro', 'Federal Republic of Yugoslavia']","['Political satire', 'Comedy', 'World cinema', 'Black comedy', 'War film', 'Drama', 'Anti-war', 'Anti-war film', 'Political drama']",1990,6
3262502,Pinocchio and the Emperor of the Night,1987,['United States of America'],"['Fairy tale', ""Children's Fantasy"", 'Animation', ""Children's/Family"", 'Adventure', 'Fantasy']",1980,7
24461873,The Snob,1924,['United States of America'],"['Silent film', 'Melodrama', 'Drama']",1920,4
14719302,Man Ki Aankhen,1970,['India'],"['Drama', 'Family Film']",1970,0
25532672,The Stranger Beside Me,1995,['United States of America'],"['Suspense', 'Crime Fiction', 'Mystery', 'Thriller', 'Television movie', 'Crime Thriller', 'Drama']",1990,5
2777047,Objection/Hatred,2004,['India'],"['Bollywood', 'World cinema', 'Drama', 'Courtroom Drama']",2000,4
24092656,Skyrunners,2009,['United States of America'],['Science Fiction'],2000,9
2002258,Halloween 4: The Return of Michael Myers,1988,['United States of America'],"['Indie', 'Slasher', 'Teen', 'Horror', 'Cult']",1980,8
10667973,Christiane F. - Wir Kinder vom Bahnhof Zoo,1981,"['Germany', 'West Germany']","['Drama', 'Indie', 'Biographical film', 'World cinema']",1980,1
2186181,Juvenile,2000,['Japan'],['Japanese Movies'],2000,0
29381822,Dada,2000,['India'],['Action'],2000,0
8947775,The Bride Came C.O.D.,1941,['United States of America'],"['Black-and-white', 'Screwball comedy', 'Comedy', 'Romance Film', 'Romantic comedy', 'Slapstick']",1940,1
2029825,X-Men: The Last Stand,2006,"['United Kingdom', 'United States of America', 'Canada']","['Action', 'Superhero', 'Action/Adventure', 'Thriller', 'Sci-Fi Adventure', 'Superhero movie', 'Science Fiction', 'Fantasy']",2000,6
1122387,Gold Diggers of '49,1935,['United States of America'],"['Animated cartoon', 'Short Film', 'Family Film']",1930,5
7558804,Kuch Khatti Kuch Meethi,2001,['India'],"['Drama', 'World cinema']",2000,1
18777132,Maan Gaye Mughal-e-Azam,2008,['India'],"['Musical', 'Comedy', 'Bollywood', 'World cinema']",2000,8
4579403,Acción mutante,1993,"['France', 'Spain']","['Science Fiction', 'Comedy', 'World cinema']",1990,3
22422444,There Was a Little Girl,1981,"['Italy', 'United States of America']","['Slasher', 'B-movie', 'Horror']",1980,1
5204875,Gadar: Ek Prem Katha,2001,['India'],"['Action', 'Drama', 'Romantic drama', 'Bollywood', 'Romance Film']",2000,1
11279445,Only Human,2004,"['Portugal', 'Spain', 'Argentina', 'United Kingdom']","['Crime Fiction', 'Indie', 'Romantic drama', 'Comedy', 'World cinema', 'Romance Film', 'Drama', 'Comedy of Errors', 'Domestic Comedy', 'Romantic comedy']",2000,4
33912411,Tokusou Sentai Dekaranger The Movie: Full Blast Action,2004,[],['Short Film'],2000,4
17764048,Born to Be Bad,1950,['United States of America'],"['Black-and-white', 'Drama']",1950,0
887457,40 Days and 40 Nights,2002,"['United Kingdom', 'France', 'United States of America']","['Comedy', 'Romance Film', 'Romantic comedy', 'Drama', 'Sex comedy']",2000,2
27445422,Mr. Vampire V,1992,['Hong Kong'],"['Chinese Movies', 'Horror']",1990,2
931949,Cocoon,1985,['United States of America'],"['Film adaptation', 'Science Fiction', 'Drama']",1980,5
10746939,I Walk the Line,1970,['United States of America'],"['Crime Drama', 'Drama']",1970,0
422428,Johnson Family Vacation,2004,['United States of America'],"['Comedy', 'Domestic Comedy', 'Road movie', 'Family Film']",2000,4
26268645,Children of Montmartre,1933,['France'],['Drama'],1930,3
14171052,Nadia,1984,"['Yugoslavia', 'United States of America']","['Television movie', 'Sports', 'Drama']",1980,4
1506297,The Man Who Cried,2000,"['United Kingdom', 'France']","['Period piece', 'Romantic drama', 'Romance Film', 'Melodrama', 'Epic', 'Drama']",2000,0
31025129,La Selva de Fuego,1945,['Mexico'],"['Adventure', 'Drama']",1940,5
7351292,Straight Edge,2007,"['Canada', 'United States of America']","['Psychological thriller', 'Indie', 'Thriller', 'Horror', 'Teen']",2000,7
6554432,Yellow Sky,1948,['United States of America'],"['Action/Adventure', 'Western']",1940,8
7120714,Abbott and Costello Meet Dr. Jekyll and Mr. Hyde,1953,['United States of America'],"['Black-and-white', 'Parody', 'Comedy', 'Horror', 'Slapstick', 'Science Fiction']",1950,3
392998,The Hire: The Follow,2001,['United States of America'],"['Action', 'Mystery', 'Short Film']",2000,1
7283462,Subhalekha,1982,['India'],"['Musical', 'Drama', 'Family Film']",1980,2
27634879,Jesse Stone: Thin Ice,2009,['United States of America'],"['Film adaptation', 'Crime Fiction', 'Thriller', 'Television movie', 'Crime Thriller', 'Drama']",2000,9
559847,Con Air,1997,['United States of America'],"['Action', 'Crime Fiction', 'Action Thrillers', 'Action/Adventure', 'Thriller']",1990,7
3811057,Late Night Shopping,2001,"['United Kingdom', 'Germany', 'Scotland']","['Indie', 'Comedy', 'Romance Film', 'Romantic comedy', 'Ensemble Film']",2000,1
8351476,Breach,2007,['United States of America'],"['Spy', 'Crime Fiction', 'Thriller', 'Crime Thriller', 'Docudrama', 'Drama']",2000,7
32191720,Nee Manasu Naaku Telusu,2003,[],['Romance Film'],2000,3
2187884,Gone in 60 Seconds,1974,['United States of America'],"['Action', 'Heist', 'Crime Fiction', 'Action/Adventure', 'Thriller', 'Crime Thriller']",1970,4
34393185,The No Mercy Man,1973,['United States of America'],"['Action', 'Drama']",1970,3
856733,A Shot in the Dark,1964,"['United Kingdom', 'United States of America']","['Parody', 'Slapstick', 'Comedy', 'Family Film']",1960,4
30805709,Ina,1982,['India'],"['Teen', 'Drama']",1980,2
30553937,Confessions of a Sexist Pig,1998,['United States of America'],"['Romantic comedy', 'Comedy']",1990,8
31684269,Phantom of the Mall: Eric's Revenge,1989,['United States of America'],['Horror'],1980,9
309159,Teheran 43,1981,"['Spain', 'Switzerland', 'Soviet Union', 'France']","['Action', 'Crime Fiction', 'Thriller', 'Romance Film', 'War film', 'Drama']",1980,1
9719009,Sasquatch Mountain,2006,['United States of America'],"['Creature Film', 'Monster movie', 'Horror', 'B-movie', 'Science Fiction']",2000,6
4167640,Wanpaku Ouji no Orochi Taiji,1963,['Japan'],"['Japanese Movies', 'Anime', 'Adventure']",1960,3
2452459,New Police Story,2004,['Hong Kong'],"['Action', 'Action Thrillers', 'Action/Adventure', 'Thriller', 'World cinema', 'Chinese Movies', 'Martial Arts Film']",2000,4
28171015,Lease of Life,1954,['United Kingdom'],['Drama'],1950,4
7211913,"Morning, Noon and Night",1933,['United States of America'],['Adult'],1930,3
24112022,Battle of the V-1,1958,['United Kingdom'],['War film'],1950,8
24507227,Diwana,1968,['India'],"['Musical', 'Romance Film', 'Bollywood']",1960,8
14439599,Witness to the Mob,1998,['United States of America'],"['Crime Fiction', 'Gangster Film', 'Biopic [feature]', 'Crime Drama']",1990,8
24160453,Cannibal Campout,1988,['United States of America'],"['Slasher', 'B-movie', 'Horror']",1980,8
20838015,Say Yes,2001,['South Korea'],"['Crime Fiction', 'Thriller', 'Horror', 'Romance Film', 'Drama']",2000,1
15883386,Parugu,2008,['India'],"['Action', 'Romance Film']",2000,8
14240828,Made for Each Other,1939,['United States of America'],"['Black-and-white', 'Romantic drama', 'Comedy', 'Romance Film', 'Drama']",1930,9
12867186,Von Richthofen and Brown,1971,['United States of America'],"['Action', 'Combat Films', 'Biography', 'Action/Adventure', 'Drama', 'Biopic [feature]', 'Historical fiction', 'War film']",1970,1
11374179,Aadmi,1968,['India'],"['Drama', 'Bollywood', 'World cinema']",1960,8
2276238,Nightmares,1983,['United States of America'],"['Science Fiction', 'Thriller', 'Horror']",1980,3
3494143,The Black Sheep of Whitehall,1942,['United Kingdom'],"['Action', 'Black-and-white', 'Spy', 'Slapstick', 'Comedy', 'War film']",1940,2
33774989,Cold Heaven,1991,['United States of America'],"['Film adaptation', 'Drama', 'Mystery', 'Indie', 'Thriller', 'Supernatural']",1990,1
1765996,Josh,2000,['India'],['Bollywood'],2000,0
1271237,The Front,1976,['United States of America'],"['Period piece', 'Political cinema', 'Parody', 'Comedy', 'Political drama', 'Drama']",1970,6
16143971,Draw!,1984,['Canada'],"['Western', 'Comedy']",1980,4
471755,Doctor Who,1996,"['United Kingdom', 'United States of America', 'Canada']","['Science Fiction', 'Sci-Fi Adventure']",1990,6
5002289,We're Back! A Dinosaur's Story,1993,['United States of America'],"['Animation', 'Comedy', 'Family Film', 'Fantasy']",1990,3
21565137,Crazy Girls Undercover,2008,['United States of America'],"['Action', 'Crime Fiction', 'Action Thrillers', 'Action/Adventure', 'Thriller', 'Erotic thriller', 'Crime Thriller']",2000,8
6446036,The Spy Who Loved Me,1977,['United Kingdom'],"['Action', 'Spy', 'Action Thrillers', 'Action/Adventure', 'Thriller', 'Glamorized Spy Film']",1970,7
10757522,Possessed,2006,['Malaysia'],['Horror'],2000,6
8099185,Daredevils of the Red Circle,1939,['United States of America'],"['Action', 'Black-and-white', 'Movie serial', 'Adventure']",1930,9
16167785,Julie Ganapathi,2003,['India'],"['Drama', 'Family Film']",2000,3
2214634,Porgy and Bess,1959,['United States of America'],"['Musical', 'Roadshow theatrical release']",1950,9
11938659,The Christmas List,1997,['United States of America'],['Drama'],1990,7
8323564,The Asphyx,1973,['United Kingdom'],"['Horror', 'Costume Horror', 'Supernatural', 'Fantasy']",1970,3
16490762,Anthony Yaar?,2009,['India'],['Action'],2000,9
22904509,Paternity,1981,['United States of America'],"['Romance Film', 'Comedy film']",1980,1
17529919,Tarzan and the Valley of Gold,1966,"['Switzerland', 'United States of America']","['Adventure', 'Jungle Film']",1960,6
15890610,The Song of Sparrows,2008,['Iran'],"['Family Drama', 'World cinema', 'Tragicomedy', 'Drama']",2000,8
655335,My Name is Ivan,1963,"['Russia', 'Soviet Union']","['Art film', 'World cinema', 'War film', 'Drama']",1960,3
23320544,Cold Souls,2009,['United States of America'],"['Drama', 'Indie', 'Comedy', 'Comedy-drama', 'Fantasy Comedy', 'Fantasy']",2000,9
11158587,Russkies,1987,['United States of America'],"['Family Drama', 'Comedy', 'Political drama', 'Drama', 'Family Film']",1980,7
11640332,The Green Man,1956,['United Kingdom'],['Comedy'],1950,6
2506456,Parichay,1972,['India'],"['Family Drama', 'Romantic drama', 'Comedy', 'Bollywood', 'World cinema', 'Drama', 'Melodrama', 'Family Film']",1970,2
3176657,You're Darn Tootin,1928,['United States of America'],"['Black-and-white', 'Indie', 'Short Film', 'Comedy', 'Silent film']",1920,8
5493777,Nate and the Colonel,2003,['United States of America'],"['Period piece', 'Indie', 'Action/Adventure', 'Western', 'Drama']",2000,3
652255,Mr. Nanny,1993,['United States of America'],"['Domestic Comedy', 'Comedy', 'Family Film']",1990,3
14774463,Cheetah,1989,['United States of America'],"['Family Drama', 'Adventure', 'Drama', 'Family Film']",1980,9
31305787,The Red Queen Kills Seven Times,1972,['Italy'],"['World cinema', 'Horror']",1970,2
1671520,School's Out! The Musical,2005,['United States of America'],['Musical'],2000,5
21183787,Murder by Television,1935,['United States of America'],"['Suspense', 'Crime Thriller', 'Thriller']",1930,5
22680425,On the Count of Zero,2007,['Turkey'],"['Mystery', 'Thriller', 'Drama', 'Fantasy']",2000,7
2525251,Coonskin,1975,['United States of America'],"['Blaxploitation', 'Drama', 'Animation', 'Indie', 'Satire', 'Cult']",1970,5
11490409,Common Bonds,1997,['United States of America'],"['Prison', 'Indie', 'Drama']",1990,7
442675,High Anxiety,1977,['United States of America'],"['Mystery', 'Parody', 'Comedy', 'Thriller', 'Slapstick', 'Absurdism']",1970,7
30104052,Something Short of Paradise,1979,['United States of America'],"['Comedy', 'Comedy film', 'Romance Film', 'Romantic comedy', 'Drama']",1970,9
9652359,Let's Make It Legal,1951,['United States of America'],"['Black-and-white', 'Comedy', 'Romance Film', 'Romantic comedy', 'Drama']",1950,1
20089961,Holding Trevor,2007,['United States of America'],"['LGBT', 'Indie', 'Romance Film', 'Drama', 'Gay Themed', 'Gay', 'Gay Interest', 'Comedy-drama']",2000,7
74381,The Hospital,1971,['United States of America'],"['Parody', 'Satire', 'Comedy', 'Black comedy', 'Medical fiction']",1970,1
2509635,Mahanagar,1963,['India'],"['Art film', 'Drama', 'World cinema']",1960,3
2217144,Princess Caraboo,1994,"['United Kingdom', 'United States of America']","['Period piece', 'Mystery', 'Comedy', 'Romantic comedy', 'Comedy-drama', 'Costume drama', 'Drama']",1990,4
11142074,Mice Follies,1960,['United States of America'],"['Short Film', 'Comedy', 'Family Film']",1960,0
18078685,They Just Had to Get Married,1933,['United States of America'],"['Comedy', 'Black-and-white']",1930,3
14068757,Blue Blazes,1936,['United States of America'],"['Short Film', 'Black-and-white', 'Comedy']",1930,6
817516,Tommy Boy,1995,['United States of America'],"['Comedy', 'Buddy film', 'Slapstick', 'Adventure']",1990,5
15233369,Slumdog Millionaire,2008,['United Kingdom'],"['Film adaptation', 'Crime Fiction', 'Indie', 'Inspirational Drama', 'Romantic drama', 'Thriller', 'Romance Film', 'Drama', 'Coming of age']",2000,8
80523,Miracle on 34th Street,1947,['United States of America'],"['Christmas movie', 'Fantasy']",1940,7
13748529,Zero Focus,1961,['Japan'],"['Black-and-white', 'Mystery', 'Japanese Movies', 'Thriller', 'World cinema']",1960,1
36114256,Saravarsham,1982,['India'],"['Drama', 'Crime Fiction', 'Thriller']",1980,2
9210027,Case Closed: Crossroad in the Ancient Capital,2003,['Japan'],['Japanese Movies'],2000,3
6309072,Robin Hood,1991,['United Kingdom'],"['Action/Adventure', 'Adventure', 'Television movie', 'Costume drama', 'Swashbuckler films']",1990,1
15646516,Dumb Bell of the Yukon,1946,['United States of America'],"['Short Film', 'Comedy', 'Family Film']",1940,6
1216495,The One That Got Away,1957,['United Kingdom'],"['War film', 'Drama']",1950,7
22672266,The Mysterious Lady,1928,['United States of America'],"['Action', 'Spy', 'Black-and-white', 'Romantic drama', 'Silent film', 'Romance Film', 'Drama']",1920,8
21671305,Yeh Zindagi Ka Safar,2001,['India'],"['Musical', 'Romantic drama', 'Bollywood', 'World cinema', 'Romance Film', 'Drama']",2000,1
32562762,Leikkikalugangsteri,1969,[],"['Comedy film', 'Crime Fiction']",1960,9
21246543,Quisiera Ser Hombre,1988,['Mexico'],"['Action', 'Crime Fiction', 'Comedy']",1980,8
1489050,Pokémon Heroes,2003,"['Japan', 'United States of America']","['Fantasy Adventure', 'Animated cartoon', 'Animation', 'Action/Adventure', 'World cinema', ""Children's/Family"", ""Children's"", ""Children's Fantasy"", 'Japanese Movies', 'Anime', 'Family Film', 'Fantasy']",2000,3
13580398,Jaan Se Pyaara,1992,['India'],"['Drama', 'Crime Fiction']",1990,2
1331395,The Adventures of Pluto Nash,2002,"['United States of America', 'Australia']","['Action', 'Gangster Film', 'Action/Adventure', 'Comedy', 'Adventure', 'Science Fiction']",2000,2
13104745,Yugant,1995,['India'],['Drama'],1990,5
24844004,Every Home Should Have One,1970,['United Kingdom'],['Comedy'],1970,0
17918771,Sangama,2008,['India'],['Romance Film'],2000,8
22114856,"Chung Kuo, Cina",1972,['Italy'],['Documentary'],1970,2
624505,The Bridges at Toko-Ri,1954,['United States of America'],"['Action', 'Combat Films', 'Romantic drama', 'Action/Adventure', 'Romance Film', 'War film', 'Drama']",1950,4
3082268,Pickpocket,1959,['France'],"['Crime Fiction', 'Art film', 'Thriller', 'World cinema', 'Drama']",1950,9
19933654,Lover of the Monster,1974,['Italy'],['Horror'],1970,4
18715808,Shark City,2009,['United States of America'],"['Indie', 'Comedy Thriller', 'Thriller', 'Comedy']",2000,9
2363625,Der Tunnel,2001,['Germany'],"['Thriller', 'World cinema', 'Political drama', 'Drama', 'Political thriller']",2000,1
9782726,The Octagon,1980,['United States of America'],"['Action', 'Action Thrillers', 'Action/Adventure', 'Thriller', 'Martial Arts Film']",1980,0
22815373,Rumpelstiltskin,1995,['United States of America'],"['Supernatural', 'B-movie', 'Horror']",1990,5
3368653,Pokémon Ranger and the Prince of the Sea: Manaphy,2006,"['Japan', 'United States of America']","['Action', 'Animated cartoon', 'Animation', 'Action/Adventure', ""Children's"", 'Japanese Movies', 'Anime', 'Family Film']",2000,6
673903,The Devil's Own,1997,['United States of America'],"['Action', 'Drama', 'Crime Fiction', 'Thriller']",1990,7
12288251,Birth of a Notion,1947,['United States of America'],"['Short Film', 'Animation']",1940,7
11818376,Andy Hardy Meets Debutante,1940,['United States of America'],"['Romantic comedy', 'Comedy', 'Family Film']",1940,0
170139,Old Enough,1984,['United States of America'],"['Family Drama', 'Coming of age', 'Childhood Drama', 'Teen', 'Comedy-drama', 'Drama', 'Family Film']",1980,4
1823034,Kvinnorna på taket,1989,['Sweden'],"['Period piece', 'Coming of age', 'Drama']",1980,9
161190,Star Trek VI: The Undiscovered Country,1991,['United States of America'],"['Thriller', 'Adventure', 'Science Fiction', 'Family Film']",1990,1
6018723,Barstool Words,2007,['Canada'],"['Thriller', 'Crime Thriller']",2000,7
14851425,Samay: When Time Strikes,2003,['India'],"['Action', 'Thriller']",2000,3
28137110,Painted Boats,1945,['United Kingdom'],['Drama'],1940,5
1273501,Forty-Ninth Parallel,1941,"['United Kingdom', 'United States of America']","['Black-and-white', 'War film', 'Drama']",1940,1
19094116,O.k.,1970,"['Germany', 'West Germany']","['War film', 'Drama']",1970,0
5669049,Dogtown,1997,['United States of America'],"['Romantic drama', 'Indie', 'Romance Film', 'Melodrama', 'Drama']",1990,7
13379536,The Jane Austen Book Club,2007,['United States of America'],"['Film adaptation', 'Romantic drama', 'Romance Film', 'Romantic comedy', 'Comedy-drama', 'Drama', 'Ensemble Film']",2000,7
29885579,Swarg Yahan Narak Yahan,1991,['India'],"['Action', 'Drama', 'Crime Fiction', 'Comedy film']",1990,1
31315244,A Vacation In Hell,1979,[],"['Action', 'Adventure', 'Thriller']",1970,9
3814210,Duet for One,1986,['United States of America'],"['Drama', 'Indie', 'Musical Drama', 'Marriage Drama', 'Medical fiction']",1980,6
18716405,Shelter,2009,['United States of America'],"['Mystery', 'Thriller', 'Horror', 'Crime Thriller', 'Supernatural']",2000,9
35825867,Log Kya Kahenge,1982,['India'],['Family Film'],1980,2
22778879,The Desert Song,1953,['United States of America'],"['Musical', 'Romance Film']",1950,3
1937542,Living in Oblivion,1995,['United States of America'],"['Drama', 'Indie', 'Satire', 'Comedy', 'Black comedy', 'Ensemble Film']",1990,5
31555231,A Fitting Tribute,2007,['United Kingdom'],"['Short Film', 'Comedy', 'Drama']",2000,7
384141,Do Bigha Zameen,1953,['India'],"['Musical', 'Black-and-white', 'Bollywood', 'World cinema', 'Drama']",1950,3
1730420,Breakdown,1997,['United States of America'],"['Action', 'Psychological thriller', 'Suspense', 'Crime Fiction', 'Action/Adventure', 'Thriller']",1990,7
9024870,Ad-lib Night,2006,['South Korea'],"['Drama', 'World cinema']",2000,6
12064359,Cloverfield,2008,['United States of America'],"['Action', 'Monster', 'Mystery', 'Action/Adventure', 'Thriller', 'Archives and records', 'Disaster', 'Sci-Fi Horror', 'Creature Film', 'Monster movie', 'Horror', 'Doomsday film', 'Science Fiction']",2000,8
19278838,Emmanuelle 2,1975,['France'],"['Romantic drama', 'World cinema', 'Romance Film', 'Drama', 'Softcore Porn', 'Sexploitation', 'Pornographic movie', 'Erotica', 'Adult']",1970,5
4186717,Love Is All There Is,1996,['United States of America'],"['Indie', 'Comedy', 'Romance Film', 'Romantic comedy']",1990,6
384990,"Sex, Lies, and Videotape",1989,['United States of America'],['Drama'],1980,9
1430058,My Name Is Joe,1998,"['Spain', 'United Kingdom', 'France', 'Germany', 'Italy']","['Crime Fiction', 'Romantic drama', 'Romance Film', 'Sports', 'Drama']",1990,8
6189444,Afonya,1975,['Soviet Union'],"['Satire', 'Comedy', 'Romance Film', 'Romantic comedy', 'Comedy-drama', 'Drama']",1970,5
11372753,Uran Khatola,1955,['India'],"['Musical', 'Romance Film']",1950,5
12479905,Phar Lap,1983,['Australia'],"['Biographical film', 'Docudrama', 'Sports', 'Drama', 'Family Film']",1980,3
22542726,99,2009,['India'],"['Musical', 'Comedy', 'Bollywood', 'World cinema']",2000,9
6241237,Lunch Wagon,1981,['United States of America'],"['Action', 'Crime Fiction', 'Comedy']",1980,1
13348042,Hotel,2001,"['United Kingdom', 'Italy']","['Crime Fiction', 'Comedy', 'Thriller', 'Crime Thriller', 'Drama']",2000,1
12710799,Nosotros los pobres,1948,['Mexico'],"['Drama', 'World cinema']",1940,8
35986595,Nalaya Manithan,1989,[],[],1980,9
5082034,The Sad Sack,1957,['United States of America'],"['Slapstick', 'Comedy']",1950,7
3848688,Saamy,2003,['India'],"['Action', 'Musical', 'Drama']",2000,3
23951630,Silver Blaze,1937,['United Kingdom'],"['Black-and-white', 'Crime Fiction', 'Mystery']",1930,7
16648125,Carlton-Browne of the F.O.,1959,['United Kingdom'],"['Political cinema', 'Black-and-white', 'Political satire', 'Parody', 'Comedy', 'Absurdism']",1950,9
924835,Airheads,1994,['United States of America'],"['Crime Fiction', 'Comedy', 'Teen', 'Crime Comedy']",1990,4
15722751,The Proper Time,1960,['United States of America'],"['Black-and-white', 'Drama']",1960,0
5181423,Aar-Paar,1954,['India'],"['Musical', 'Romantic drama', 'Bollywood', 'World cinema', 'Romance Film', 'Drama']",1950,4
2939386,Max Hell Frog Warrior,2002,['United States of America'],"['Action', 'Science Fiction']",2000,2
29009455,Cool School,2007,['Turkey'],['Comedy film'],2000,7
5565527,Freiheit,1965,['United States of America'],"['Short Film', 'Thriller']",1960,5
33784082,Mexican Boarders,1962,[],"['Animation', 'Short Film', 'Comedy film', 'Family Film']",1960,2
16358705,Bye Bye Birdie,1963,['United States of America'],"['Musical', 'Comedy', 'Musical comedy', 'Family Film']",1960,3
10502224,The Monster of Piedras Blancas,1959,['United States of America'],"['Creature Film', 'Black-and-white', 'Horror', 'Science Fiction']",1950,9
21066411,Man of Flowers,1983,['Australia'],"['Romantic drama', 'World cinema', 'Romance Film', 'Drama']",1980,3
5316938,Supernova,2005,"['United States of America', 'South Africa']","['Disaster', 'Thriller']",2000,5
4655863,Strike,1924,"['Russia', 'Soviet Union']","['Black-and-white', 'Drama', 'Indie', 'World cinema', 'Silent film', 'Political drama']",1920,4
538995,Shaolin Soccer,2001,"['China', 'Hong Kong']","['Action', 'Chinese Movies', 'Action/Adventure', 'Comedy', 'World cinema', 'Sports', 'Martial Arts Film']",2000,1
14427075,Loin,2001,"['France', 'Spain']","['Romantic drama', 'Drama']",2000,1
25432148,Treasure Raiders,2007,"['Russia', 'United States of America']","['Action', 'Auto racing', 'Action/Adventure', 'Thriller', 'World cinema', 'Sports']",2000,7
26278717,40 Guns to Apache Pass,1967,['United States of America'],"['Romance Film', 'Western', 'Adventure']",1960,7
10475102,Tosun Paşa,1976,['Turkey'],['Comedy'],1970,6
2259324,The Party Animal,1984,['United States of America'],"['Indie', 'Comedy', 'Sex comedy']",1980,4
12102068,El baile,1959,['Spain'],"['Drama', 'Comedy']",1950,9
23183761,Hare-Less Wolf,1958,[],"['Animation', 'Short Film', 'Family Film']",1950,8
5558022,Keeping Up with the Steins,2006,['United States of America'],"['Coming of age', 'Parody', 'Indie', 'Comedy', 'Domestic Comedy']",2000,6
5513513,Bingo,1991,['United States of America'],"['Action', 'Action/Adventure', 'Comedy', 'Family Film']",1990,1
5892072,Beijing Bicycle,2002,"['France', 'Taiwan', 'China']","['Drama', 'Chinese Movies', 'World cinema']",2000,2
28958625,Shock 'Em Dead,1990,[],"['Music', 'Thriller', 'Horror']",1990,0
28147421,Glowing Stars,2009,['Sweden'],['Drama'],2000,9
4655520,12B,2001,['India'],"['Comedy', 'Tamil cinema', 'Romance Film', 'Drama']",2000,1
7691695,There’s Something Out There,2004,['United States of America'],"['Short Film', 'Horror']",2000,4
11553516,St. Jorgens's Day,1930,['Soviet Union'],"['Black-and-white', 'Indie', 'Satire', 'Comedy', 'Silent film']",1930,0
15384415,Christmas Is Here Again,2007,['United States of America'],"['Musical', 'Animation', ""Children's/Family"", 'Holiday Film', ""Children's"", 'Family Film']",2000,7
3859182,Bandolero!,1968,['United States of America'],"['Action', 'Revisionist Western', 'Action/Adventure', 'Western']",1960,8
26730794,Mangalam Veettil Manaseswari Gupta,1995,['India'],"['Romance Film', 'Comedy', 'Drama']",1990,5
3539982,Zombies of the Stratosphere,1952,['United States of America'],"['Action', 'Black-and-white', 'Adventure', 'Science Fiction']",1950,2
33914576,Tokusou Sentai Dekaranger vs. Abaranger,2005,[],"['Action', 'Science Fiction']",2000,5
21001056,The Last House on the Left,2009,['United States of America'],"['Drama', 'Thriller', 'Horror']",2000,9
194249,Shanghai Knights,2003,"['United Kingdom', 'Hong Kong', 'United States of America']","['Action', 'Action/Adventure', 'Comedy', 'Thriller', 'Buddy film', 'Chinese Movies', 'Martial Arts Film', 'Costume drama', 'Adventure', 'Action Comedy', 'Western']",2000,3
7926725,Stone,1974,"['New Zealand', 'Australia']","['Action', 'Crime Fiction', 'Mystery', 'Indie', 'Action/Adventure', 'Thriller', 'World cinema', 'Adventure', 'Drama']",1970,4
878670,First Men in the Moon,1964,['United Kingdom'],['Science Fiction'],1960,4
13257893,The Legend of Sasquatch,2006,['United States of America'],"['Fairy tale', 'Animation', 'Family-Oriented Adventure', ""Children's/Family"", 'Family Film']",2000,6
7810685,Helen the Baby Fox,2006,['Japan'],['Japanese Movies'],2000,6
24172982,Ashes and Embers,1982,['United States of America'],"['Melodrama', 'Drama']",1980,2
10988036,Ambitious Kung Fu Girl,1981,['Hong Kong'],"['Action', 'Martial Arts Film', 'Adventure']",1980,1
11715286,Witless Protection,2008,['United States of America'],"['Action', 'Action/Adventure', 'Comedy']",2000,8
3824857,Ghost House,2004,['South Korea'],"['Comedy', 'Horror']",2000,4
12823099,Annie,1982,['United States of America'],"['Music', 'Musical', 'Comedy', ""Children's"", 'Drama', 'Family Film']",1980,2
2017072,Evangelion: Death and Rebirth,1997,['Japan'],"['Animation', 'Japanese Movies', 'Anime', 'Science Fiction', 'Drama', 'Fantasy']",1990,7
25434824,Italians and Other Strangers,2008,['Italy'],['Gay pornography'],2000,8
32012994,Chak De Phatte,2008,['India'],"['Drama', 'Comedy']",2000,8
6674887,Going Back,2001,['United States of America'],"['Coming of age', 'War film', 'Drama']",2000,1
1708667,Fear in the Night,1947,['United States of America'],"['Film adaptation', 'Crime Fiction', 'Mystery', 'Thriller', 'Film noir', 'Crime Thriller', 'Drama']",1940,7
3196327,Goya's Ghosts,2006,"['United Kingdom', 'Spain', 'United States of America']","['Period piece', 'Biography', 'Biopic [feature]', 'World cinema', 'Drama']",2000,6
9889964,Baaghi: A Rebel for Love,1990,['India'],"['Action', 'Romance Film']",1990,0
3584576,Ride a Crooked Trail,1958,['United States of America'],"['Action/Adventure', 'Western']",1950,8
9019720,Shutter,2008,['United States of America'],"['Mystery', 'Thriller', 'Remake', 'Horror']",2000,8
8323362,The Rats,2002,['United States of America'],"['Natural horror films', 'Horror', 'Television movie', 'Drama']",2000,2
25901386,Peruvannapurathe Visheshangal,1989,['India'],"['Drama', 'Comedy']",1980,9
1728156,The Crime of Father Amaro,2002,"['Spain', 'Mexico', 'Argentina', 'France']","['Romance Film', 'Drama', 'World cinema']",2000,2
17378447,The Girl in a Swing,1988,['United States of America'],"['Action', 'Spy', 'Thriller']",1980,8
4848029,The Bank,2001,"['New Zealand', 'Italy', 'Australia']","['Suspense', 'Crime Fiction', 'World cinema', 'Crime Thriller', 'Drama']",2000,1
6201527,Intern Academy,2004,['Canada'],"['Parody', 'Comedy']",2000,4
26546695,Fortune is a Woman,1957,['United Kingdom'],['Crime Fiction'],1950,7
1228937,Lemony Snicket's A Series of Unfortunate Events,2004,"['Germany', 'United States of America']","['Gothic Film', 'Comedy', 'Black comedy', ""Children's/Family"", 'Adventure', 'Drama', 'Steampunk', 'Family Film', 'Fantasy']",2000,4
21618909,Barah Aana,2009,['India'],"['Crime Fiction', 'Comedy', 'Drama']",2000,9
4728208,After Sex,2007,['United States of America'],"['Indie', 'Comedy', 'Romance Film', 'Romantic comedy']",2000,7
17889548,Thazhvaram,1990,['India'],['Thriller'],1990,0
35771658,Fantasia 3,1966,['Spain'],['Fantasy'],1960,6
3673691,Swing Hostess,1944,['United States of America'],"['Music', 'Musical', 'Comedy film', 'Romance Film', 'Drama']",1940,4
25063718,Before I Self Destruct,2009,[],"['Action', 'Crime Fiction', 'Drama']",2000,9
35969179,Kutumba,2003,['India'],[],2000,3
8121583,Houdini,1953,['United States of America'],"['Period piece', 'Biography', 'Biographical film', 'Drama']",1950,3
2909975,Aflatoon,1997,['India'],"['Action', 'Musical', 'Crime Fiction', 'Bollywood', 'World cinema', 'Drama']",1990,7
7626909,Kidnapped,1960,['United States of America'],"['Costume drama', 'Adventure', 'Drama', 'Family Film']",1960,0
584713,Showdown in Little Tokyo,1991,"['Japan', 'United States of America']","['Action', 'Detective fiction', 'Crime Fiction', 'Action Thrillers', 'Action/Adventure', 'Comedy', 'Thriller', 'Martial Arts Film', 'Drama', 'Japanese Movies', 'Detective']",1990,1
3361015,Veronika Voss,1982,"['Germany', 'West Germany']","['Art film', 'Drama', 'World cinema']",1980,2
14700922,Niagara Motel,2006,['Canada'],"['Drama', 'Indie', 'Comedy', 'Black comedy', 'Comedy-drama', 'Ensemble Film']",2000,6
13163680,The Way I Spent the End of the World,2006,"['Romania', 'France']","['Period piece', 'Coming of age', 'World cinema', 'Drama']",2000,6
25831476,Son of India,1931,['United States of America'],['Romance Film'],1930,1
2501435,An Autumn Afternoon,1962,['Japan'],"['Art film', 'Japanese Movies', 'Family Drama', 'Romantic drama', 'World cinema', 'Comedy-drama', 'Drama']",1960,2
18498357,The Attic Expeditions,2001,['United States of America'],"['Psychological thriller', 'Slasher', 'Horror', 'Erotic thriller']",2000,1
26839391,Cock-A-Doodle Deux Deux,1966,['United States of America'],"['Short Film', 'Animation']",1960,6
8382058,Musang Berjanggut,1959,"['Singapore', 'Malaysia']","['Musical', 'Drama']",1950,9
2572864,Don't Bother to Knock,1952,['United States of America'],"['Psychological thriller', 'Suspense', 'Black-and-white', 'Mystery', 'Thriller', 'Film noir', 'Drama']",1950,2
3611352,The Quiet Family,1998,['South Korea'],"['Crime Fiction', 'Family Drama', 'Comedy', 'Thriller', 'World cinema', 'Black comedy', 'Horror', 'Comedy-drama']",1990,8
27766591,Ride or Die,2004,['United States of America'],"['Action', 'Crime Fiction', 'Action/Adventure', 'Comedy', 'Thriller', 'Crime Thriller']",2000,4
2572301,"You're Not Elected, Charlie Brown",1972,['United States of America'],"['Animation', 'Short Film', 'Drama', 'Family Film']",1970,2
23672917,Formosa Betrayed,2009,['Taiwan'],"['Crime Fiction', 'Mystery', 'Thriller', 'Crime Thriller', 'Drama', 'Period piece', 'Political drama', 'Political thriller']",2000,9
31983570,Glue,2006,"['Argentina', 'United Kingdom']","['Gay Themed', 'LGBT', 'Gay', 'Coming of age', 'Gay Interest', 'World cinema', 'Drama']",2000,6
16682699,Impulse,1990,['United States of America'],['Thriller'],1990,0
22395733,Malpertuis,1971,"['West Germany', 'France', 'Belgium']","['Science Fiction', 'Drama', 'Horror']",1970,1
11227773,Wisdom of the Pretzel,2002,['Israel'],"['Romantic comedy', 'Comedy-drama', 'Comedy']",2000,2
11907590,Mr. 3 Minutes,2006,['Hong Kong'],['Chinese Movies'],2000,6
28463749,Take Care of My Little Girl,1952,['United States of America'],['Drama'],1950,2
9056492,The Naked Brothers Band: The Movie,2007,['United States of America'],"['Musical', 'Indie', 'Parody', 'Documentary', 'Mockumentary']",2000,7
6021658,Mudra,2007,['India'],"['Action', 'Musical', 'Comedy', 'Thriller', 'Bollywood', 'World cinema', 'Romance Film', 'Fantasy']",2000,7
5174460,High Freakquency,1998,['United States of America'],"['Media Satire', 'Comedy']",1990,8
14090644,Eagle Eye,2008,"['Germany', 'United States of America']","['Action', 'Mystery', 'Chase Movie', 'Thriller']",2000,8
26364529,EMI - Liya Hai Toh Chukana Parega,2008,['India'],"['Drama', 'Comedy']",2000,8
12698715,Big School-Break,1972,['Soviet Union'],"['Romance Film', 'Romantic comedy', 'Comedy film']",1970,2
30519399,Circle of Violence: A Family Drama,1986,['United States of America'],['Drama'],1980,6
183061,Earth Girls Are Easy,1988,"['United Kingdom', 'United States of America']","['Music', 'Musical', 'Indie', 'Comedy', 'Musical comedy', 'Romance Film', 'Parody', 'Romantic comedy', 'Science Fiction', 'Cult']",1980,8
17839852,Truant Officer Donald,1941,['United States of America'],"['Animation', 'Short Film', 'Comedy']",1940,1
3995423,The Lake House,2006,"['United States of America', 'Australia']","['Romantic fantasy', 'Romantic drama', 'Romance Film', 'Drama', 'Fantasy']",2000,6
14883772,Loyalties,1986,"['Canada', 'United Kingdom']",['Drama'],1980,6
5542682,Possession,1981,"['France', 'West Germany']","['Surrealism', 'Psychological thriller', 'Thriller', 'Horror', 'Erotic thriller', 'Supernatural', 'Drama']",1980,1
4152420,Suzie Gold,2004,['United Kingdom'],"['Comedy', 'Romance Film', 'Romantic comedy', 'Domestic Comedy', 'Comedy-drama', 'Drama']",2000,4
5467578,With Love and Hisses,1927,['United States of America'],"['Black-and-white', 'Indie', 'Short Film', 'Comedy', 'Silent film', 'Slapstick']",1920,7
5143892,Mere Jeevan Saathi,2006,['India'],"['Musical', 'Romance Film']",2000,6
1742101,Titanic,1996,"['Canada', 'United States of America']","['Action', 'Drama', 'Disaster', 'Costume drama']",1990,6
18216602,Mataharis,2007,['Spain'],"['Detective fiction', 'Ensemble Film', 'Detective', 'Drama', 'Slice of life story']",2000,7
15916538,Mumbai Se Aaya Mera Dost,2003,['India'],"['Action', 'Romance Film', 'Adventure']",2000,3
18941522,The Locked Door,1929,['United States of America'],"['Black-and-white', 'Drama']",1920,9
29536294,Don't Tell Her It's Me,1990,['United States of America'],"['Romance Film', 'Romantic comedy', 'Comedy']",1990,0
24582482,Lovey Mary,1926,[],['Silent film'],1920,6
8623363,"Live Once, Die Twice",2006,['Canada'],"['Suspense', 'Mystery', 'Thriller', 'Television movie', 'Drama']",2000,6
9016038,Curly Top,1935,['United States of America'],"['Musical', 'Black-and-white', 'Musical Drama', 'Romantic drama', 'Romance Film', ""Children's"", 'Drama', 'Family Film']",1930,5
9894564,Murder Unveiled,2006,['Canada'],"['Television movie', 'Crime Fiction', 'Drama']",2000,6
10844908,Curtin,2007,['Australia'],"['Biography', 'War film', 'Drama']",2000,7
9016016,Sabu,2002,['Japan'],"['Period piece', 'Prison', 'Japanese Movies', 'Action/Adventure', 'World cinema', 'Drama']",2000,2
1001142,Repulsion,1965,['United Kingdom'],"['Psychological thriller', 'Black-and-white', 'Thriller']",1960,5
164359,The Buddy Holly Story,1978,['United States of America'],"['Musical', 'Period piece', 'Biography', 'Biographical film', 'Biopic [feature]', 'Musical Drama', 'Drama']",1970,8
1679809,Hum Tum,2004,['India'],"['Musical', 'Romantic drama', 'Comedy', 'Bollywood', 'World cinema', 'Romance Film', 'Drama', 'Romantic comedy', 'Comedy-drama']",2000,4
18579324,The Monster X Strikes Back/Attack the G8 Summit,2008,['Japan'],"['Japanese Movies', 'World cinema']",2000,8
10195064,The Bridge,1992,['United Kingdom'],"['Indie', 'Drama']",1990,2
24192275,Between the Lines,1977,['United States of America'],"['Romance Film', 'Comedy', 'Drama']",1970,7
18802880,The Big Cube,1969,"['Mexico', 'United States of America']","['Mystery', 'Thriller', 'Melodrama', 'Drama']",1960,9
14876301,Romance on the High Seas,1948,['United States of America'],"['Musical', 'Comedy', 'Musical comedy', 'Romance Film', 'Romantic comedy']",1940,8
24490740,Loaded Pistols,1948,['United States of America'],"['Action/Adventure', 'Western']",1940,8
27689143,Paris Playboys,1954,['United States of America'],['Comedy'],1950,4
1045457,Finding Neverland,2004,"['United Kingdom', 'United States of America']","['Period piece', 'Biography', 'Biopic [feature]', 'Costume drama', 'Drama', 'Family Film']",2000,4
8379216,Ali Baba Bujang Lapok,1960,"['Singapore', 'Malaysia']","['Musical', 'Black-and-white', 'Comedy']",1960,0
18987350,Greetings from the Shore,2007,['United States of America'],"['Romantic drama', 'Comedy', 'Romance Film', 'Romantic comedy', 'Drama']",2000,7
6028449,Caught,1949,['United States of America'],"['Film noir', 'Drama', 'Thriller']",1940,9
22861853,Restless,1998,"['China', 'United States of America']","['Chinese Movies', 'Comedy', 'World cinema']",1990,8
13201569,The Great Adventures of Wild Bill Hickok,1938,['United States of America'],"['Black-and-white', 'Western', 'Adventure']",1930,8
2493454,Flesh Gordon,1974,['United States of America'],"['Gross out', 'Gross-out film', 'Comedy', 'Adventure', 'Softcore Porn', 'Parody', 'Pornographic movie', 'Stop motion', 'Science Fiction', 'Adult', 'Sex comedy']",1970,4
4321709,Rope of Sand,1948,['United States of America'],"['Action', 'Crime Fiction', 'Action/Adventure', 'Thriller', 'Film noir', 'Crime Thriller', 'Adventure', 'Drama']",1940,8
27359996,Santee,1973,['United States of America'],"['Crime Fiction', 'Western', 'Action/Adventure', 'Drama']",1970,3
885776,The Cable Guy,1996,['United States of America'],"['Satire', 'Thriller', 'Comedy', 'Media Satire', 'Black comedy', 'Drama', 'Comedy-drama', 'Cult']",1990,6
6543887,Dinner for Adele,1977,"['Czechoslovakia', 'Czech Republic']","['Black comedy', 'Crime Fiction', 'Comedy']",1970,7
22419306,Hasenjagd - Vor lauter Feigheit gibt es kein Erbarmen,1994,"['Austria', 'Germany']",['Drama'],1990,4
6616047,Gang,2000,['India'],"['Action', 'Drama']",2000,0
1939585,Drowning Mona,2000,['United States of America'],"['Crime Fiction', 'Mystery', 'Comedy', 'Crime Comedy', 'Black comedy', 'Whodunit']",2000,0
15283053,Son of Man,1980,['South Korea'],['Drama'],1980,0
23481438,Dream with the Fishes,1997,['United States of America'],"['Drama', 'Indie', 'Comedy', 'Black comedy']",1990,7
32760587,Flight Angels,1940,[],"['Romance Film', 'Drama', 'Comedy film']",1940,0
19231529,Davitelj protiv davitelja,1984,['Yugoslavia'],"['Comedy', 'Thriller', 'Comedy Thriller', 'Horror', 'Black comedy']",1980,4
3917900,The Contract,2006,"['Germany', 'United States of America']","['Action', 'Suspense', 'Crime Fiction', 'Action/Adventure', 'Thriller', 'Crime Thriller', 'Drama']",2000,6
15274957,Kuselan,2008,['India'],"['Comedy', 'Drama', 'Family Film']",2000,8
9662019,The Bengali Night,1988,"['United Kingdom', 'France', 'Switzerland']","['Drama', 'Indie', 'Romantic drama', 'Biographical film', 'World cinema', 'Romance Film']",1980,8
55325,Total Recall,1990,['United States of America'],"['Action', 'Dystopia', 'Future noir', 'Action/Adventure', 'Thriller', 'Adventure', 'Science Fiction']",1990,0
2381862,Night of the Comet,1984,['United States of America'],"['Indie', 'Action/Adventure', 'Comedy', 'Zombie Film', 'Apocalyptic and post-apocalyptic fiction', 'Disaster', 'Horror', 'B-movie', 'Doomsday film', 'Science Fiction', 'Cult']",1980,4
187603,Rashomon,1950,['Japan'],"['Black-and-white', 'Samurai cinema', 'Crime Fiction', 'Mystery', 'World cinema', 'Drama', 'Period piece', 'Japanese Movies', 'Crime Drama']",1950,0
26486347,What Is a Man Without a Moustache?,2005,['Croatia'],"['Romance Film', 'Drama', 'Comedy film']",2000,5
106117,Thelma & Louise,1991,"['United States of America', 'France']","['Outlaw', 'Crime Fiction', 'Comedy', 'Buddy film', 'Drama', 'Feminist Film', 'Female buddy film', 'Chase Movie', 'Comedy-drama', 'Road movie']",1990,1
4492078,How to Eat Fried Worms,2006,['United States of America'],"['Film adaptation', 'Comedy', 'Drama', 'Family Film']",2000,6
32766082,The Bridesmaid,2004,"['France', 'Germany']","['Thriller', 'World cinema', 'Romance Film', 'Drama']",2000,4
9833036,Rekava,1956,['Sri Lanka'],['Drama'],1950,6
6521562,Island of Doomed Men,1940,['United States of America'],"['Black-and-white', 'Mystery', 'Thriller', 'Melodrama', 'Drama']",1940,0
24199883,Meera,1992,['India'],"['Musical', 'Romance Film']",1990,2
16815927,His Last Gift,2008,['South Korea'],"['Melodrama', 'Drama', 'Family Film']",2000,8
14093598,"Good-bye, My Lady",1956,['United States of America'],['Drama'],1950,6
18832483,Quo Vadis,2001,"['Poland', 'United States of America']","['Period piece', 'Romantic drama', 'World cinema', 'Romance Film', 'Drama']",2000,1
27750227,Attack on Leningrad,2009,"['Russia', 'United Kingdom']","['War film', 'Drama']",2000,9
10070959,Chokher Bali,2003,['India'],"['Period piece', 'Art film', 'Romantic drama', 'World cinema', 'Romance Film', 'Melodrama', 'Drama']",2000,3
2654186,Zodiac,2007,['United States of America'],"['Crime Fiction', 'History', 'Mystery', 'Thriller', 'Docudrama', 'Drama']",2000,7
6533560,Saajan,1991,['India'],"['Romantic drama', 'Bollywood', 'World cinema', 'Romance Film', 'Drama']",1990,1
25836577,Nallathambi,1949,['India'],"['Romance Film', 'Drama']",1940,9
3509990,Gung Ho,1986,['United States of America'],"['Workplace Comedy', 'Sports', 'Comedy']",1980,6
20312589,Tomorrow at Ten,1964,[],"['Crime Fiction', 'Thriller', 'Crime Thriller', 'Drama']",1960,4
1232088,Project X,1987,['United States of America'],"['Action/Adventure', 'Comedy', 'Thriller', 'Adventure', 'Science Fiction', 'Drama']",1980,7
27387205,Gen 13,2000,['United States of America'],"['Action', 'Animation', 'Science Fiction']",2000,0
24258284,Vishwa Mohini,1940,['India'],"['Musical', 'Drama', 'Fantasy']",1940,0
3153784,Piranha,1978,['United States of America'],"['Indie', 'Comedy', 'Natural horror films', 'Parody', 'Horror', 'B-movie', 'Stop motion', 'Cult']",1970,8
12074729,Storm Over Asia,1928,"['Russia', 'Soviet Union']","['Black-and-white', 'World cinema', 'War film', 'Drama', 'History', 'Silent film', 'Political drama', 'Propaganda film']",1920,8
7323666,Gift Wrapped,1952,['United States of America'],['Short Film'],1950,2
4845241,The Music Man,1962,['United States of America'],"['Musical', 'Comedy', 'Romance Film', 'Family Film']",1960,2
25462251,Las Pirañas aman en Cuaresma,1969,['Mexico'],"['Action', 'Adventure']",1960,9
11474887,Dubai Seenu,2007,['India'],"['Action', 'Action Comedy', 'Comedy', 'Tollywood']",2000,7
1939966,Café Lumière,2003,"['Japan', 'Taiwan']","['Japanese Movies', 'Family Drama', 'World cinema', 'Drama']",2000,3
18778495,Omega Cop,1990,['United States of America'],"['Action', 'Martial Arts Film', 'Science Fiction']",1990,0
2175063,Hardware,1990,"['United Kingdom', 'United States of America']","['Dystopia', 'Indie', 'Thriller', 'Horror', 'Science Fiction']",1990,0
30753524,Give Us Wings,1940,['United States of America'],"['Comedy', 'Adventure']",1940,0
23998788,Quiet Wedding,1941,['United Kingdom'],['Comedy'],1940,1
9252228,Aag,1948,['India'],"['Musical', 'Romantic drama', 'Bollywood', 'World cinema', 'Romance Film', 'Drama']",1940,8
20694440,Great Catherine,1968,['United Kingdom'],"['Period piece', 'Romantic comedy', 'Comedy']",1960,8
2245922,The Paleface,1948,['United States of America'],"['Screwball comedy', 'Action/Adventure', 'Western', 'Comedy']",1940,8
22302577,"Main, Meri Patni Aur Woh",2005,['India'],"['Romantic drama', 'Comedy', 'World cinema', 'Romance Film', 'Romantic comedy', 'Drama']",2000,5
2938431,The Car,1977,['United States of America'],"['Thriller', 'Horror', 'Supernatural', 'Cult']",1970,7
6372126,"The Class of Nuke 'Em High 3: The Good, the Bad and the Subhumanoid",1994,['United States of America'],"['Parody', 'Comedy', 'Horror', 'Black comedy', 'Science Fiction']",1990,4
2337131,Split Second,1992,['United Kingdom'],"['Monster movie', 'Indie', 'Science Fiction']",1990,2
22550712,Nightwing,1979,['United States of America'],"['Horror', 'Natural horror films']",1970,9
11827356,The Mummy Strikes,1943,['United States of America'],"['Animation', 'Superhero', 'Short Film', 'Superhero movie']",1940,3
19988478,J'ai quelque chose à vous dire,1931,['France'],"['Short Film', 'Black-and-white']",1930,1
13901961,Mulberry,1986,['South Korea'],['Erotica'],1980,6
17746685,Anubhav,1971,['India'],"['Black-and-white', 'Bollywood', 'World cinema']",1970,1
2096585,The Adventures of Mark Twain,1944,['United States of America'],"['Black-and-white', 'Biographical film']",1940,4
12217443,Damn Yankees,1958,['United States of America'],"['Musical', 'Comedy', 'Sports', 'Fantasy']",1950,8
19571819,Ex Drummer,2007,"['Netherlands', 'Belgium', 'France', 'Italy']","['Musical', 'Crime Fiction', 'Comedy', 'Thriller', 'Biographical film', 'World cinema', 'Black comedy', 'Punk rock', 'Drama']",2000,7
3215125,Hobgoblins,1988,['United States of America'],"['Action', 'Action Thrillers', 'Action/Adventure', 'Comedy', 'Thriller', 'Horror', 'Science Fiction']",1980,8
970386,The SpongeBob SquarePants Movie,2004,['United States of America'],"['Animation', 'Comedy', ""Children's/Family"", 'Adventure', 'Family Film', 'Absurdism']",2000,4
631251,Scum,1979,"['United Kingdom', 'England']","['Crime Fiction', 'Crime Thriller', 'Juvenile Delinquency Film', 'Drama']",1970,9
1711622,Wild in the Country,1961,['United States of America'],"['Musical', 'Romantic drama', 'Romance Film', 'Drama']",1960,1
19347508,Boxing Gloves,1929,['United States of America'],"['Black-and-white', 'Short Film', 'Comedy', 'Family Film']",1920,9
11047370,Kachche Dhaage,1999,['India'],"['Action', 'Drama', 'Bollywood', 'World cinema', 'Romance Film']",1990,9
28564638,La vacanza,1972,['Italy'],['Drama'],1970,2
15662719,Mirugam,2007,['India'],['Drama'],2000,7
31443320,Body of Evidence,1988,[],"['Thriller', 'Drama']",1980,8
1706423,Naruto the Movie 2: Great Clash! The Illusionary Ruins at the Depths of the Earth,2005,['Japan'],"['Animation', 'Japanese Movies', 'Comedy', 'Anime', 'Adventure', 'Drama', 'Fantasy']",2000,5
26083926,Devil's Den,2006,['United States of America'],"['Action', 'Action/Adventure', 'Thriller', 'Comedy film', 'Horror', 'B-movie']",2000,6
25608525,Heroes of the Alamo,1937,['United States of America'],"['Action', 'Action/Adventure', 'Western', 'Epic', 'War film', 'Drama']",1930,7
1618469,Cromwell,1970,['United Kingdom'],"['Biography', 'Biographical film', 'War film', 'Costume drama', 'Drama', 'Period piece', 'Biopic [feature]', 'Historical Epic', 'Epic', 'Political drama']",1970,0
10417568,Let's Get Harry,1986,['United States of America'],"['Action', 'Adventure']",1980,6
9878827,None But the Brave,1965,"['Japan', 'United States of America']","['Japanese Movies', 'War film', 'Drama']",1960,5
27363241,Akasa Kusum,2008,['Sri Lanka'],['Drama'],2000,8
2253183,Gold,1974,['United Kingdom'],"['Action', 'Indie', 'Action/Adventure', 'Thriller']",1970,4
27125366,Palunku,2006,['India'],['Drama'],2000,6
885824,Scrooged,1988,['United States of America'],"['Satire', 'Comedy', 'Black comedy', 'Christmas movie', 'Fantasy Comedy', 'Fantasy']",1980,8
4790234,Minnesota Clay,1965,['Italy'],"['Action', 'Spaghetti Western', 'Western']",1960,5
498181,The Order,2003,"['Germany', 'United States of America']","['Psychological thriller', 'Mystery', 'Thriller', 'Horror', 'Crime Thriller', 'Supernatural']",2000,3
3497214,Fast Getaway,1991,['United States of America'],"['Action', 'Crime Fiction', 'Chase Movie', 'Action Comedy', 'Comedy', 'Adventure']",1990,1
5871901,Creator,1985,['United States of America'],"['Comedy', 'Romance Film', 'Romantic comedy', 'Comedy-drama', 'Science Fiction']",1980,5
17329040,Extreme Justice,1993,['United States of America'],"['Action', 'Crime Fiction', 'Action/Adventure', 'Thriller', 'Adventure']",1990,3
14489554,Too Many Crooks,1959,['United Kingdom'],"['Black-and-white', 'Crime Fiction', 'Comedy']",1950,9
1295310,Into the West,1992,"['Ireland', 'United Kingdom']","['Adventure', 'Family Film', 'Fantasy']",1990,2
30448587,Otto – Der Film,1985,[],"['Romance Film', 'Comedy film']",1980,5
770242,Flash Gordon Conquers the Universe,1940,['United States of America'],"['Action', 'Black-and-white', 'Adventure', 'Movie serial', 'Superhero movie', 'Science Fiction']",1940,0
6828146,The Water Babies,1978,"['United Kingdom', 'Poland']","[""Children's Fantasy"", 'Animation', ""Children's/Family"", 'Family Film', 'Fantasy']",1970,8
2688309,Poseidon,2006,['United States of America'],"['Action', 'Action/Adventure', 'Thriller', 'Adventure', 'Disaster']",2000,6
5170537,Ayee Milan Ki Bela,1964,['India'],"['Drama', 'Bollywood', 'World cinema']",1960,4
2631894,The Pearl of Death,1944,['United States of America'],"['Suspense', 'Detective fiction', 'Black-and-white', 'Mystery', 'Thriller', 'Detective', 'Crime Thriller']",1940,4
1781048,Charro!,1969,['United States of America'],"['Western', 'Action/Adventure', 'Drama']",1960,9
3223765,Joni's Promise,2005,['Indonesia'],"['Romantic comedy', 'Comedy']",2000,5
4680482,Come Fly with Me,1963,['United Kingdom'],['Comedy'],1960,3
1524739,Lianna,1983,['United States of America'],"['LGBT', 'Erotic Drama', 'Indie', 'Romantic drama', 'Romance Film', 'Drama', 'Feminist Film', 'Gay Themed', 'Gay', 'Gay Interest']",1980,3
4087825,American Outlaws,2001,['United States of America'],"['Action', 'Revisionist Western', 'Action/Adventure', 'Western', 'Comedy', 'Costume drama']",2000,1
11143116,Kaakki Sattai,1985,['India'],['Action'],1980,5
4013476,3 Dev Adam,1973,['Turkey'],['Superhero movie'],1970,3
26613939,In Darkness,2009,['Turkey'],"['Thriller', 'Drama']",2000,9
26565512,Berlin 36,2009,['Germany'],['Drama'],2000,9
7948938,Prodigal Son,1982,['Hong Kong'],"['Action', 'Action/Adventure', 'World cinema', 'Chinese Movies', 'Martial Arts Film']",1980,2
16490980,Modhi Vilayadu,2008,['India'],[],2000,8
24592644,Out of the Blue,1947,['United States of America'],['Comedy'],1940,7
1654151,A Generation,1955,['Poland'],"['Art film', 'World cinema', 'War film', 'Drama']",1950,5
2193494,Little Voice,1998,['United Kingdom'],"['Musical', 'Film adaptation', 'Drama', 'Family Drama', 'Indie', 'Comedy']",1990,8
7876902,Abhilasha,1983,['India'],['Horror'],1980,3
3675194,Omkara,2006,['India'],"['Art film', 'Bollywood', 'World cinema', 'Drama']",2000,6
5605332,Slipping Wives,1927,['United States of America'],"['Black-and-white', 'Indie', 'Short Film', 'Comedy', 'Silent film', 'Comedy of Errors', 'Sex comedy']",1920,7
23292052,"The Goods: Live Hard, Sell Hard",2009,['United States of America'],['Comedy'],2000,9
18013931,The Good Fairy,1935,['United States of America'],"['Romance Film', 'Romantic comedy', 'Comedy film']",1930,5
2249993,Nora Prentiss,1947,['United States of America'],"['Film noir', 'Melodrama', 'Drama']",1940,7
10327683,Ananthabhadram,2005,['India'],"['Horror', 'Romance Film', 'Drama', 'Fantasy']",2000,5
3792976,The Ballad of Andy Crocker,1969,['United States of America'],"['War film', 'Drama']",1960,9
14291388,The Limits of Control,2009,"['Spain', 'Japan', 'United States of America']","['Crime Fiction', 'Japanese Movies', 'Indie', 'Mystery', 'Thriller', 'Crime Drama', 'Crime Thriller']",2000,9
12260258,The King of Kong: A Fistful of Quarters,2007,['United States of America'],"['Biography', 'Documentary', 'Sports', 'Culture & Society']",2000,7
34219152,Pallandu Vazhga,1975,['India'],['Musical'],1970,5
6899017,Funny Farm,1988,['United States of America'],"['Domestic Comedy', 'Americana', 'Comedy']",1980,8
2238130,Crack-Up,1946,['United States of America'],"['Psychological thriller', 'Black-and-white', 'Mystery', 'Thriller', 'Film noir', 'Drama']",1940,6
4087068,Shadowless Sword,2005,['South Korea'],"['Action', 'Period piece', 'Action/Adventure', 'World cinema', 'Martial Arts Film']",2000,5
3170260,Waking the Dead,2000,['United States of America'],"['Period piece', 'Drama', 'Indie', 'Romantic drama', 'Thriller', 'Romance Film', 'Political drama']",2000,0
5419425,Daddy's Little Girls,2007,['United States of America'],"['Romantic drama', 'Comedy', 'Romance Film', 'Romantic comedy', 'Comedy-drama', 'Drama']",2000,7
11199922,A Bedtime Story,1933,['United States of America'],"['Musical', 'Romance Film', 'Comedy']",1930,3
26728732,Funeral for an Assassin,1977,"['United States of America', 'South Africa']","['Drama', 'Crime Fiction']",1970,7
34155440,Oru Oorla oru Rajakumari,1995,[],[],1990,5
21339766,Det brenner i natt!,1956,['Norway'],"['Thriller', 'Drama']",1950,6
31860041,This Week of Grace,1933,[],['Comedy film'],1930,3
18079673,Alien Agent,2007,"['Canada', 'United States of America']","['Action', 'Drama', 'Crime Fiction', 'Alien Film', 'Science Fiction']",2000,7
5961506,The Forsaken,2001,['United States of America'],"['Teen', 'Thriller', 'Horror', 'Road movie']",2000,1
5461234,The Apple,1980,['United States of America'],"['Musical', 'Parody', 'Science Fiction', 'Drama', 'Fantasy']",1980,0
15757337,Ready,2008,['India'],"['Action', 'Drama', 'Romantic drama', 'World cinema', 'Romance Film']",2000,8
14025685,Every Girl Should Be Married,1948,['United States of America'],"['Black-and-white', 'Comedy', 'Romance Film', 'Romantic comedy']",1940,8
19315787,Slow Burn,1986,['United States of America'],"['Film noir', 'Drama']",1980,6
4750927,Dan in Real Life,2007,['United States of America'],"['Comedy', 'Romance Film', 'Romantic comedy', 'Domestic Comedy', 'Comedy-drama', 'Drama']",2000,7
9226602,Cannibal Rollerbabes,1997,['Canada'],"['Slasher', 'Horror Comedy', 'Horror', 'Black comedy', 'B-movie']",1990,7
9650293,Endrendrum Kadhal,1999,['India'],"['Romantic drama', 'World cinema', 'Romance Film', 'Drama']",1990,9
29111124,Artworks,2002,[],"['Crime Fiction', 'Romantic drama', 'Caper story', 'Crime Drama', 'Romance Film', 'Drama']",2000,2
517376,The Boondock Saints,1999,"['Canada', 'United States of America']","['Action', 'LGBT', 'Crime Fiction', 'Gangster Film', 'Indie', 'Buddy film', 'Thriller', 'Drama']",1990,9
19451320,The Snake King's Wife,1970,['Cambodia'],"['Drama', 'Horror']",1970,0
58147,The Manchurian Candidate,1962,['United States of America'],"['Cold War', 'Psychological thriller', 'Film adaptation', 'Black-and-white', 'Spy', 'Mystery', 'Thriller', 'Film noir', 'War film', 'Drama', 'Political drama', 'Political thriller']",1960,2
25120274,To Live and Die in Mongkok,2009,['Hong Kong'],"['Crime Fiction', 'Thriller', 'World cinema', 'Crime Drama', 'Chinese Movies']",2000,9
615418,Kids,1995,['United States of America'],"['Crime Fiction', 'Coming of age', 'Indie', 'Teen', 'Drama']",1990,5
6223567,The Man with the Golden Gun,1974,"['Kingdom of Great Britain', 'United Kingdom']","['Action', 'Action Thrillers', 'Thriller', 'Glamorized Spy Film', 'Adventure']",1970,4
11825941,The Last Hurrah,1977,['United States of America'],['Drama'],1970,7
28483774,Presença de Anita,2003,['Brazil'],[],2000,3
10596382,Do Aur Do Paanch,1980,['India'],"['Action', 'Musical', 'Drama', 'Comedy', 'Romance Film']",1980,0
12495707,Weeds,1987,['United States of America'],"['Prison', 'Crime Fiction', 'Biopic [feature]', 'Drama']",1980,7
2623723,Panic in Year Zero!,1962,['United States of America'],"['Thriller', 'Doomsday film', 'Disaster', 'Science Fiction', 'Drama']",1960,2
183358,SLC Punk!,1998,['United States of America'],"['Music', 'Drama', 'Indie', 'Comedy']",1990,8
15887664,Born to Win,1971,['United States of America'],"['Crime Fiction', 'Comedy', 'Comedy film', 'Black comedy', 'Comedy-drama', 'Addiction Drama', 'Drama']",1970,1
19828673,Tale of a Dog,1944,['United States of America'],"['Black-and-white', 'Short Film', 'Comedy', 'Family Film']",1940,4
13154,Glen or Glenda?,1953,['United States of America'],"['LGBT', 'Indie', 'Sexploitation', 'Drama', 'Comedy', 'Docudrama', 'Cult']",1950,3
29173696,Hindle Wakes,1952,['United Kingdom'],"['Romance Film', 'Drama']",1950,2
21586321,Trial by Jury,1994,['United States of America'],"['Suspense', 'Crime Fiction', 'Gangster Film', 'Thriller', 'Crime Thriller', 'Drama', 'Courtroom Drama']",1990,4
1230920,"New York, New York",1977,['United States of America'],"['Musical', 'Period piece', 'Romantic drama', 'New Hollywood', 'Romance Film', 'Drama']",1970,7
651322,Days of Thunder,1990,['United States of America'],"['Action', 'Auto racing', 'Romantic drama', 'Romance Film', 'Sports', 'Drama']",1990,0
18793987,The Midnight Story,1957,['United States of America'],"['Detective fiction', 'Crime Fiction', 'Mystery', 'Detective', 'Film noir']",1950,7
30888121,Shubhayathra,1990,[],['Drama'],1990,0
20619519,After Sex,2000,['United States of America'],"['Drama', 'Indie', 'Romantic drama', 'Comedy', 'Romance Film', 'Romantic comedy']",2000,0
25281265,Lisa,1990,['United States of America'],"['Psychological thriller', 'Suspense', 'Thriller', 'Horror', 'Romance Film', 'Crime Thriller', 'Drama']",1990,0
4760947,Insomnia,1997,['Norway'],"['Psychological thriller', 'Crime Fiction', 'Mystery', 'Thriller', 'World cinema', 'Crime Thriller', 'Drama']",1990,7
181340,Love Letters,1945,['United States of America'],"['Black-and-white', 'Drama']",1940,5
20713272,7 Years,2006,"['France', 'Netherlands']","['LGBT', 'Drama']",2000,6
1083768,Mindhunters,2004,"['United Kingdom', 'Netherlands', 'United States of America']","['Action', 'Psychological thriller', 'Mystery', 'Action/Adventure', 'Thriller', 'Whodunit', 'Crime Thriller', 'Slasher']",2000,4
2291800,Good Neighbor Sam,1964,['United States of America'],"['Screwball comedy', 'Comedy', 'Domestic Comedy', 'Comedy of Errors']",1960,4
17925163,Flying Dagger,1993,['Hong Kong'],"['Action/Adventure', 'Comedy', 'World cinema', 'Chinese Movies', 'Martial Arts Film', 'Comedy film', 'Wuxia', 'Fantasy']",1990,3
5602177,Lower City,2005,['Brazil'],"['Erotic Drama', 'Romantic drama', 'World cinema', 'Romance Film', 'Drama']",2000,5
62121,Of Mice and Men,1939,['United States of America'],"['Film adaptation', 'Black-and-white', 'Drama']",1930,9
9457115,"Hello Sister, Goodbye Life",2006,['United States of America'],"['Drama', 'Comedy-drama']",2000,6
2783476,The Last American Virgin,1982,['United States of America'],"['Drama', 'Indie', 'Coming of age', 'Comedy', 'Comedy-drama', 'Sex comedy']",1980,2
26652107,Parayan Marannathu,2009,['India'],['Drama'],2000,9
1308799,Repossessed,1990,['United States of America'],"['Parody', 'Satire', 'Comedy', 'Horror Comedy', 'Horror']",1990,0
3904503,Sun Valley Serenade,1941,['United States of America'],"['Musical', 'Black-and-white', 'Comedy', 'Musical comedy', 'Romantic comedy']",1940,1
7758260,Outlander,2008,['United States of America'],"['Action', 'Science Fiction']",2000,8
7651220,Jesus Christ Superstar,1973,['United States of America'],"['Musical', 'Historical drama', 'Christian film', 'Drama']",1970,3
23851782,The Ghost Train,1941,['United Kingdom'],"['Crime Fiction', 'Comedy', 'Thriller', 'Supernatural']",1940,1
8433769,Kamome Shokudo,2006,['Japan'],"['Comedy', 'Japanese Movies']",2000,6
25446095,Manchi Donga,1988,['India'],"['Action', 'Family Film']",1980,8
449790,Better Than Chocolate,1999,['Canada'],"['Gay Themed', 'LGBT', 'Gay', 'Gay Interest', 'Comedy', 'Romance Film', 'Romantic comedy']",1990,9
6589296,Prom Night IV: Deliver Us from Evil,1992,['Canada'],['Horror'],1990,2
5222578,A Ring of Endless Light,2002,['United States of America'],"['Drama', 'Television movie']",2000,2
6084956,Exit to Eden,1994,['United States of America'],"['Detective fiction', 'Indie', 'Satire', 'Thriller', 'Comedy', 'Black comedy', 'Comedy Thriller', 'Detective', 'Sex comedy']",1990,4
19888701,Longitude,2000,"['United Kingdom', 'United States of America']","['History', 'Drama']",2000,0
4673167,Barbie and the Magic of Pegasus,2005,['United States of America'],"['Fantasy Adventure', 'Animation', ""Children's/Family"", ""Children's"", 'Adventure', 'Computer Animation', ""Children's Fantasy"", 'Family Film', 'Fantasy']",2000,5
32772643,Out of the Dark 1995 film,1995,['Hong Kong'],['Chinese Movies'],1990,5
16856054,Operation Amsterdam,1959,['United Kingdom'],"['Action', 'Heist', 'Caper story', 'Thriller', 'Docudrama', 'War film', 'Drama']",1950,9
29616923,Thinkalazhcha Nalla Divasam,1985,['India'],['Drama'],1980,5
11643011,Madeline,1998,"['France', 'United States of America']","['Comedy', 'Adventure', ""Children's"", 'Family Film']",1990,8
12982230,The Ugly Swans,2006,['Russia'],['Science Fiction'],2000,6
33867837,Chatrapathy,2004,['India'],['Action'],2000,4
7497695,The Intelligence Men,1965,['United Kingdom'],"['Action', 'Mystery', 'Parody', 'Action/Adventure', 'Comedy']",1960,5
25367068,Sweet Dreams,1996,['United States of America'],"['Mystery', 'Drama']",1990,6
21412109,My Past is My Own,1989,['United States of America'],"['Romance Film', 'Family Drama', 'Drama']",1980,9
24491418,Double Bang,2001,['United States of America'],"['Action', 'Crime Fiction', 'Gangster Film', 'Action/Adventure', 'Thriller', 'Crime Thriller']",2000,1
3198687,Fast and Furry-ous,1948,['United States of America'],"['Chase Movie', 'Adventure']",1940,8
21088389,Departures,2008,['Japan'],"['Music', 'Japanese Movies', 'World cinema', 'Drama', 'Slice of life story']",2000,8
73439,Duck Amuck,1953,['United States of America'],"['Family Film', ""Children's/Family""]",1950,3
709419,Dodgeball: A True Underdog Story,2004,"['Germany', 'United States of America']","['Sports', 'Comedy', 'Ensemble Film']",2000,4
31165215,Beyond Mombasa,1956,"['United Kingdom', 'United States of America']","['Action', 'Adventure']",1950,6
16904577,Herb Alpert: Music for Your Eyes,2003,['United States of America'],"['Music', 'Short Film', 'Documentary']",2000,3
14355866,Mr. Peabody and the Mermaid,1948,['United States of America'],"['Romantic fantasy', 'Film adaptation', 'Black-and-white', 'Comedy', 'Romance Film', 'Drama', 'Romantic comedy', 'Fantasy']",1940,8
61484,The Lives of a Bengal Lancer,1935,['United States of America'],"['British Empire Film', 'Action', 'Black-and-white', 'Action/Adventure', 'War film', 'Adventure', 'Drama']",1930,5
18650739,29th Street,1991,"['Japan', 'United States of America']","['Indie', 'Japanese Movies', 'Biographical film', 'Comedy', 'Comedy-drama']",1990,1
829780,Millennium Actress,2002,['Japan'],"['Animation', 'Japanese Movies', 'Anime', 'Drama']",2000,2
10778999,Fakira,1976,['India'],"['Musical', 'Bollywood', 'World cinema', 'Drama', 'Family Film']",1970,6
10436005,Mr. Medhavi,2008,['India'],"['Romance Film', 'Drama']",2000,8
5585815,Mili,1975,['India'],"['Drama', 'Bollywood', 'World cinema']",1970,5
4627521,Jogi,2005,['India'],[],2000,5
3302699,The Ghost of Frankenstein,1942,['United States of America'],"['Creature Film', 'Black-and-white', 'Gothic Film', 'Horror', 'Costume Horror']",1940,2
105397,The Toxic Avenger,1985,['United States of America'],"['Superhero', 'Indie', 'Action/Adventure', 'Comedy', 'Horror Comedy', 'Monster movie', 'Parody', 'Horror', 'Superhero movie', 'B-movie', 'Cult']",1980,5
19555878,Sasirekha Parinayam,2009,['India'],['Romance Film'],2000,9
5109579,Best Defense,1984,['United States of America'],"['Action', 'Spy', 'Action/Adventure', 'Comedy']",1980,4
1188832,Ring 2,1999,['Japan'],"['Japanese Movies', 'Horror', 'World cinema', 'Supernatural']",1990,9
11065720,Strawberry Shortcakes,2006,['Japan'],"['Japanese Movies', 'Drama']",2000,6
14994126,The Man with Three Coffins,1987,['South Korea'],['Drama'],1980,7
3319694,Leap of Faith,1992,['United States of America'],"['Comedy', 'Romance Film', 'Romantic comedy', 'Religious Film', 'Comedy-drama', 'Drama']",1990,2
25326438,Graveyard Disturbance,1987,['Italy'],"['Creature Film', 'Gothic Film', 'Thriller', 'Horror', 'World cinema', 'Supernatural']",1980,7
25212812,Gumnaam – The Mystery,2008,['India'],"['Musical', 'Romantic drama', 'Bollywood', 'World cinema', 'Romance Film', 'Drama']",2000,8
24771643,We Think the World of You,1988,['United Kingdom'],"['Period piece', 'Film adaptation', 'LGBT', 'Drama', 'Indie', 'Comedy']",1980,8
882119,Napoleon Dynamite,2004,['United States of America'],"['Indie', 'Comedy', 'Teen', 'Romance Film', 'Drama', 'Absurdism', 'Coming of age', 'Cult']",2000,4
18525087,Passion Flower Hotel,1978,['Germany'],"['Comedy', 'World cinema']",1970,8
2581392,The Pink Panther,2006,"['France', 'Czech Republic', 'United States of America']","['Action', 'Crime Fiction', 'Mystery', 'Action/Adventure', 'Comedy', 'Slapstick', 'Reboot', 'Family Film']",2000,6
14737096,Three Little Pirates,1946,['United States of America'],"['Black-and-white', 'Short Film', 'Comedy', 'Slapstick']",1940,6
17974588,Crows ZERO,2007,['Japan'],"['Action', 'Japanese Movies', 'Action/Adventure', 'Thriller', 'World cinema']",2000,7
2421352,The Questor Tapes,1974,['United States of America'],['Science Fiction'],1970,4
22189918,Devil and the Deep,1932,"['Belgium', 'United States of America']",['Drama'],1930,2
7017644,Still Life,2006,"['China', 'Hong Kong']","['Romantic drama', 'World cinema', 'Romance Film', 'Chinese Movies', 'Drama']",2000,6
26391493,Chemistry,2009,[],['Horror'],2000,9
35485634,Veettoda Mappillai,2001,['India'],['Drama'],2000,1
16056291,Third Man Out,2005,"['Canada', 'United States of America']","['Film adaptation', 'Detective fiction', 'LGBT', 'Mystery', 'Thriller', 'Crime Thriller', 'Drama', 'Gay Themed', 'Gay', 'Gay Interest', 'Detective']",2000,5
13285237,Pearblossom,2009,['United States of America'],"['Horror', 'Science Fiction']",2000,9
4799510,Down Will Come Baby,1999,['United States of America'],['Thriller'],1990,9
26277570,Jinx Money,1948,['United States of America'],"['Crime Fiction', 'Comedy', 'Crime Comedy']",1940,8
92688,Room at the Top,1959,['United Kingdom'],"['Black-and-white', 'Melodrama', 'British New Wave', 'Kitchen sink realism', 'Drama']",1950,9
31425064,Half a Sinner,1940,['United States of America'],"['Comedy', 'Thriller']",1940,0
3247979,The Great Waldo Pepper,1975,['United States of America'],"['Action', 'Period piece', 'Airplanes and airports', 'Action/Adventure', 'Adventure', 'Americana', 'Drama']",1970,5
29329868,Third Party Risk,1954,[],"['Drama', 'Crime Fiction']",1950,4
17181372,The Bride from Hell,1972,[],"['Mystery', 'Chinese Movies', 'Horror']",1970,2
3434085,Sorority Boys,2002,['United States of America'],"['Gross out', 'LGBT', 'Gross-out film', 'Comedy', 'Teen', 'Slapstick', 'Comedy of Errors', 'Sex comedy']",2000,2
11467610,Paranoid,2000,['United Kingdom'],"['Psychological thriller', 'Crime Thriller', 'Thriller']",2000,0
18855750,"Ride Him, Bosko!",1932,[],"['Animation', 'Short Film', 'Western', 'Comedy film', 'Family Film']",1930,2
1255024,The Hebrew Hammer,2003,['United States of America'],"['Action', 'Indie', 'Parody', 'Action/Adventure', 'Comedy', 'Superhero movie', 'Holiday Film']",2000,3
7021576,8 guys,2003,['United States of America'],"['Indie', 'Short Film']",2000,3
491323,The Limey,1999,['United States of America'],"['Action', 'Drama', 'Crime Fiction', 'Indie', 'Thriller', 'Crime Drama', 'Crime Thriller']",1990,9
8917795,Shake It All About,2001,"['Germany', 'Denmark']","['LGBT', 'Romantic drama', 'Comedy', 'World cinema', 'Romance Film', 'Drama', 'Gay Themed', 'Gay', 'Gay Interest', 'Romantic comedy', 'Comedy-drama']",2000,1
25012140,A Global Affair,1964,['United States of America'],['Comedy'],1960,4
35473056,Imtihan,1974,['India'],"['Drama', 'Family Film']",1970,4
11567328,"Good Morning, Night",2003,['Italy'],"['History', 'Thriller', 'World cinema', 'Political drama', 'Drama', 'Political thriller']",2000,3
18487940,Homecoming,1948,['United States of America'],"['Romance Film', 'Black-and-white', 'Drama']",1940,8
9937072,Under the Lighthouse Dancing,1997,"['New Zealand', 'Australia']","['Romantic drama', 'World cinema', 'Romance Film', 'Drama']",1990,7
15228213,Who Shot Patakango?,1990,['United States of America'],"['Period piece', 'Coming of age', 'Drama']",1990,0
11496156,The Aerial,2007,['Argentina'],"['Surrealism', 'Black-and-white', 'Drama', 'Indie', 'World cinema', 'Fantasy']",2000,7
5630975,F/X2,1991,['United States of America'],"['Action', 'Thriller']",1990,1
4195173,Vishwa Thulasi,2004,['India'],['Romance Film'],2000,4
722551,Fire in the Sky,1993,['United States of America'],"['Film adaptation', 'Mystery', 'Thriller', 'Docudrama', 'Alien Film', 'Science Fiction', 'Drama']",1990,3
26180499,Dead Cert,1974,['United Kingdom'],"['Sports', 'Film adaptation', 'Mystery', 'Thriller', 'Horse racing', 'Drama']",1970,4
9544391,Evening,2007,"['Germany', 'United States of America']","['Film adaptation', 'Romantic drama', 'Romance Film', 'Drama']",2000,7
21186590,Arundhati,2009,['India'],"['Thriller', 'Horror']",2000,9
31799966,Étoile,1988,['Italy'],['Horror'],1980,8
21327515,The Union: The Business Behind Getting High,2007,['Canada'],"['Social issues', 'Political cinema', 'Documentary', 'Culture & Society']",2000,7
25305145,Love Affair,1932,['United States of America'],"['Romance Film', 'Drama']",1930,2
17853154,Tarzan and the Huntress,1947,['United States of America'],"['Adventure', 'Jungle Film']",1940,7
584014,Steamboat Bill Jr.,1928,['United States of America'],"['Black-and-white', 'Indie', 'Comedy', 'Silent film', 'Adventure', 'Drama']",1920,8
7966219,Scooby-Doo and the Loch Ness Monster,2004,['United States of America'],"['Family-Oriented Adventure', ""Children's/Family"", 'Animation']",2000,4
28744569,The Golden Link,1954,['United Kingdom'],['Crime Fiction'],1950,4
8938294,Ay Juancito,2004,['Argentina'],"['Indie', 'Biographical film', 'Drama']",2000,4
11545308,Khuda Gawah,1992,"['India', 'Afghanistan']","['Musical', 'Romantic drama', 'Action/Adventure', 'Bollywood', 'World cinema', 'Romance Film', 'Drama', 'Epic']",1990,2
2093587,Desperate Measures,1998,['United States of America'],"['Action', 'Crime Fiction', 'Action/Adventure', 'Thriller']",1990,8
8261602,Nuvve Nuvve,2002,['India'],"['Romantic drama', 'World cinema', 'Romance Film', 'Drama']",2000,2
10343102,Bandhan,1998,['India'],"['Drama', 'World cinema']",1990,8
16645800,Steamboat Round the Bend,1935,['United States of America'],"['Black-and-white', 'Comedy', 'Americana', 'Drama']",1930,5
3287436,Coraline,2009,['United States of America'],"['Animation', 'Thriller', ""Children's"", 'Adventure', ""Children's Fantasy"", 'Stop motion', 'Family Film', 'Fantasy']",2000,9
143812,Three to Tango,1999,"['United States of America', 'Australia']","['LGBT', 'Comedy', 'Romance Film', 'Romantic comedy', 'Comedy of Errors']",1990,9
167857,The Usual Suspects,1994,"['Germany', 'United States of America']","['Neo-noir', 'Crime Fiction', 'Mystery', 'Thriller', 'Crime Thriller', 'Ensemble Film']",1990,4
24487714,L'affaire Farewell,2009,['France'],"['Drama', 'Thriller', 'World cinema']",2000,9
17806585,Tarzan's Revenge,1938,['United States of America'],"['Action', 'Action/Adventure', 'Jungle Film', 'Adventure']",1930,8
9162690,Port of Seven Seas,1938,['United States of America'],"['Melodrama', 'Romantic drama', 'Drama']",1930,8
21707436,The New Daughter,2009,['United States of America'],"['Creature Film', 'Thriller', 'Horror', 'Supernatural', 'Haunted House Film']",2000,9
33343765,Dear Sarah,1990,[],['Drama'],1990,0
25644474,Luna Caliente,2009,['Spain'],"['Erotic Drama', 'Thriller', 'World cinema', 'Drama']",2000,9
311445,Prince of Darkness,1987,['United States of America'],"['Horror', 'Zombie Film', 'Supernatural', 'Cult']",1980,7
5676165,The Devil's Brother,1933,['United States of America'],"['Comedy', 'Black-and-white']",1930,3
25496071,Maa Inti Premayanam,1983,['India'],['Drama'],1980,3
13402594,The Last Lieutenant,1993,['Norway'],"['Action/Adventure', 'World cinema', 'War film', 'Drama']",1990,3
11669568,Reunion in France,1942,['United States of America'],"['Black-and-white', 'Romantic drama', 'Romance Film', 'Melodrama', 'War film', 'Drama']",1940,2
24460184,The Great Divide,1925,['United States of America'],['Silent film'],1920,5
19141442,The Way We Are,2008,['Hong Kong'],"['Drama', 'Chinese Movies', 'World cinema']",2000,8
17102529,Mr.Garagasa,2008,['India'],['Comedy'],2000,8
20452234,Server Sundaram,1964,['India'],"['Musical', 'Bollywood', 'World cinema', 'Drama']",1960,4
24788378,Buy & Cell,1987,['United States of America'],['Comedy'],1980,7
25546093,Diario de una Ninfómana,2008,['Spain'],"['LGBT', 'Romantic drama', 'World cinema', 'Romance Film', 'Erotica', 'Drama']",2000,8
6299822,American Hardcore,2006,['United States of America'],"['Music', 'Rockumentary', 'Biography', 'Documentary', 'Punk rock']",2000,6
20699252,Newcastle,2008,"['New Zealand', 'Australia']","['LGBT', 'Drama', 'Indie']",2000,8
832222,A Thin Line Between Love and Hate,1996,['United States of America'],"['Comedy', 'Romance Film', 'Romantic comedy', 'Comedy-drama', 'Drama', 'Sex comedy']",1990,6
28456956,The Black Widow,1951,['United Kingdom'],['Crime Fiction'],1950,1
29170556,Avenging Force,1986,['United States of America'],"['Spy', 'Action', 'Political thriller']",1980,6
1024501,Conan the Destroyer,1984,['United States of America'],"['Action', 'Fantasy Adventure', 'Action/Adventure', 'Costume drama', 'Adventure', 'Sword and sorcery films', 'Sword and sorcery', 'Fantasy']",1980,4
23127876,The Blood of Fu Manchu,1968,"['Spain', 'United Kingdom', 'West Germany', 'United States of America']","['Crime Fiction', 'Thriller', 'Horror', 'Adventure', 'Crime Thriller', 'Master Criminal Films', 'Science Fiction']",1960,8
14589005,Little Miss Broadway,1938,['United States of America'],"['Musical', 'Black-and-white', 'Family Drama', 'Drama', 'Family Film']",1930,8
11432032,Come Sweet Death,2000,['Austria'],['Black comedy'],2000,0
7866939,Hugo the Hippo,1975,"['Hungary', 'United States of America']","['Animation', ""Children's/Family"", 'Drama']",1970,5
1906931,The Monolith Monsters,1957,['United States of America'],"['Horror', 'Science Fiction']",1950,7
11960457,Paid,2006,['Netherlands'],"['Action', 'Crime Fiction', 'Action/Adventure', 'Thriller', 'World cinema', 'Romance Film', 'Crime Thriller']",2000,6
500622,Mystic Pizza,1988,['United States of America'],"['Indie', 'Romantic drama', 'Comedy', 'Romance Film', 'Drama', 'Coming of age', 'Romantic comedy', 'Comedy-drama', 'Ensemble Film']",1980,8
13903487,All About Steve,2009,['United States of America'],['Comedy'],2000,9
3619421,Winnie the Pooh and a Day for Eeyore,1983,['United States of America'],"[""Children's Fantasy"", 'Animation', 'Short Film', 'Comedy', ""Children's/Family""]",1980,3
11723307,My Brother the Pig,1999,['United States of America'],"[""Children's Fantasy"", 'Comedy', 'Adventure', 'Fantasy Comedy', 'Family Film', 'Fantasy']",1990,9
17995745,Smithereens,1982,['United States of America'],"['Indie', 'Drama']",1980,2
25012105,The Tattered Dress,1957,['United States of America'],['Film noir'],1950,7
19270406,Eti,2008,['India'],['Romance Film'],2000,8
26107863,Commissar Shakespeare,2001,['Turkey'],"['Drama', 'Comedy film']",2000,1
8119585,The Possession of Joel Delaney,1972,['United States of America'],"['Drama', 'Thriller', 'Horror']",1970,2
20621597,Cass,2008,['United Kingdom'],"['Crime Fiction', 'Indie', 'Drama']",2000,8
22248107,Color Me Olsen,2007,['United States of America'],"['LGBT', 'Indie', 'Short Film', 'Comedy-drama']",2000,7
31499731,Sesham,2002,[],['Drama'],2000,2
16166370,Alli Thandha Vaanam,2001,['India'],['Drama'],2000,1
11517706,Tweek City,2006,['United States of America'],"['LGBT', 'Indie', 'Thriller', 'Drama']",2000,6
26219770,Swapna Sundari,1950,['India'],"['Musical', 'Drama', 'Fantasy']",1950,0
19081261,The Extra Day,1956,['United Kingdom'],"['Drama', 'Comedy']",1950,6
360138,24 Hour Party People,2002,['United Kingdom'],"['Biography', 'Comedy', 'Biographical film', 'Punk rock', 'Drama', 'Period piece', 'Biopic [feature]', 'Comedy-drama']",2000,2
4632411,Ping Pong,2002,['Japan'],"['Japanese Movies', 'Comedy', 'World cinema', 'Sports', 'Drama']",2000,2
797349,The Bay Boy,1984,"['Canada', 'France']","['Period piece', 'Coming of age', 'Drama']",1980,4
14852313,Empties,2007,"['United Kingdom', 'Denmark', 'Czech Republic']","['Comedy', 'Comedy-drama', 'Drama', 'Slice of life story']",2000,7
11551728,Four Walls,1928,['United States of America'],"['Black-and-white', 'Drama', 'Indie', 'Silent film']",1920,8
29680525,He Died With A Felafel In His Hand,2001,"['New Zealand', 'Italy', 'Australia']","['Indie', 'Comedy', 'World cinema', 'Black comedy']",2000,1
19281170,Mr. Moto's Last Warning,1939,['United States of America'],"['Detective fiction', 'Black-and-white', 'Crime Fiction', 'Mystery', 'Thriller', 'Detective', 'Crime Thriller']",1930,9
12347192,Hollywood Zap!,1986,['United States of America'],"['Indie', 'Comedy']",1980,6
3871584,Humanoids from the Deep,1980,['United States of America'],"['Monster movie', 'Horror', 'B-movie', 'Science Fiction']",1980,0
19755662,Woman's World,1954,['United States of America'],['Drama'],1950,4
14631619,Aap To Aise Na The,1980,['India'],"['Romance Film', 'Drama', 'Family Film']",1980,0
4232773,The Mechanik,2005,"['Germany', 'United States of America']","['Action', 'Drama', 'Action/Adventure', 'Thriller']",2000,5
3277444,Le Radeau de la Méduse,1998,['France'],"['History', 'Adventure', 'Drama']",1990,8
3163760,A Boy Named Charlie Brown,1969,['United States of America'],"['Animation', 'Drama', 'Family Film']",1960,9
21494032,An American Affair,2009,['United States of America'],"['Period piece', 'Indie', 'Drama']",2000,9
8367375,Street Scene,1931,['United States of America'],"['Black-and-white', 'Drama']",1930,1
62095,Four Daughters,1938,['United States of America'],"['Musical', 'Black-and-white', 'Melodrama', 'Drama']",1930,8
9652081,Mickey's Gala Premier,1933,['United States of America'],"['Musical', 'Black-and-white', 'Animation', 'Short Film', 'Comedy', 'Family Film']",1930,3
6203032,Case Closed: Magician of the Silver Sky,2004,['Japan'],"['Anime', 'Japanese Movies']",2000,4
5162174,Night of the Seagulls,1976,['Spain'],"['Horror', 'World cinema', 'Zombie Film', 'Supernatural']",1970,6
434816,The Seduction of Mimi,1972,['Italy'],"['Political satire', 'Satire', 'Comedy', 'World cinema', 'Black comedy', 'Political cinema', 'Comedy-drama', 'Sex comedy']",1970,2
24744150,We're Here To Help,2007,['New Zealand'],['Comedy'],2000,7
9562999,The Man in the Iron Mask,1939,['United States of America'],"['Black-and-white', 'Costume drama', 'Swashbuckler films']",1930,9
18892307,Vote for Huggett,1949,['United Kingdom'],['Comedy'],1940,9
31205088,Mela,1980,[],['Drama'],1980,0
25145488,Snow 2: Brain Freeze,2008,[],"['Comedy', 'Family Film']",2000,8
2454014,Angel Puss,1944,['United States of America'],"['Short Film', 'Comedy', 'Anime', 'Family Film']",1940,4
9192572,Chiquititas: Rincón de luz,2001,['Argentina'],"['Adventure', 'Family Film']",2000,1
33716930,Always Goodbye,1938,['United States of America'],['Drama'],1930,8
26583800,The Seven-Per-Cent Solution,1976,"['United Kingdom', 'United States of America']","['Crime Fiction', 'Mystery', 'Thriller', 'Comedy film', 'Costume drama', 'Adventure', 'Drama']",1970,6
537416,Ace Ventura: When Nature Calls,1995,['United States of America'],"['Action', 'Detective fiction', 'Gross out', 'Gross-out film', 'Mystery', 'Comedy', 'Slapstick', 'Adventure', 'Detective']",1990,5
21423623,Glorious 39,2009,['United Kingdom'],"['Crime Fiction', 'Indie', 'Family Drama', 'Romantic drama', 'Thriller', 'Romance Film', 'Drama', 'Period piece', 'Political drama']",2000,9
5049873,Mediterraneo,1991,['Italy'],"['Comedy', 'World cinema', 'Romance Film', 'Romantic comedy', 'War film', 'Drama']",1990,1
14144009,Son of the Guardsman,1946,['United States of America'],"['Adventure', 'Black-and-white']",1940,6
1919203,The Lady from Shanghai,1947,['United States of America'],"['Surrealism', 'Film adaptation', 'Crime Fiction', 'Mystery', 'Thriller', 'Film noir', 'Crime Thriller', 'Drama', 'Suspense']",1940,7
2517072,Na Tum Jaano Na Hum,2002,['India'],"['Musical', 'Romantic drama', 'World cinema', 'Romance Film', 'Romantic comedy', 'Drama']",2000,2
6723478,Evil Ed,1997,['Sweden'],"['Slasher', 'Horror Comedy', 'Horror', 'Comedy', 'B-movie']",1990,7
8188696,Dek hor,2006,['Thailand'],"['Thriller', 'Horror', 'World cinema', 'Supernatural', 'Drama']",2000,6
26024282,Black Belt,2007,['Japan'],['Japanese Movies'],2000,7
28145596,Never Take Sweets from a Stranger,1960,['United Kingdom'],"['Drama', 'Mystery', 'Thriller']",1960,0
2316181,El derecho de nacer,1951,['Mexico'],"['Drama', 'World cinema']",1950,1
6535047,Rage at Dawn,1955,['United States of America'],"['Action/Adventure', 'Western']",1950,5
3059032,Noah,1998,['United States of America'],"['Heavenly Comedy', 'Comedy', 'Romance Film', 'Fantasy Comedy', 'Fantasy']",1990,8
4894261,Ue wo Muite Arukou,2005,['Japan'],"['Japanese Movies', 'Biography', 'Drama']",2000,5
18737307,In the Flesh,1998,['United States of America'],"['LGBT', 'Indie', 'Romance Film', 'Drama']",1990,8
25565399,Easy to Wed,1946,['United States of America'],"['Musical', 'Comedy', 'Romance Film', 'Romantic comedy']",1940,6
1202035,The Phantom Lover,1995,['Hong Kong'],"['Period piece', 'Romantic drama', 'World cinema', 'Romance Film', 'Melodrama', 'Chinese Movies', 'Drama']",1990,5
17168374,Sight,2008,['United States of America'],"['Suspense', 'Psychological thriller', 'Mystery', 'Thriller', 'Horror', 'Supernatural']",2000,8
12550288,Khiladi,1992,['India'],"['Action/Adventure', 'World cinema']",1990,2
5819636,The Adventures of Marco Polo,1938,['United States of America'],"['Period piece', 'Black-and-white', 'Costume drama', 'Adventure', 'Drama']",1930,8
26334071,S.N.U.B.,2008,['United Kingdom'],"['Thriller', 'Horror']",2000,8
8863206,Dracula III Legacy,2005,['United States of America'],['Horror'],2000,5
31773414,Sharada,1973,['India'],['Drama'],1970,3
23410377,Enigma,2009,['United States of America'],"['Short Film', 'Science Fiction']",2000,9
20688153,Astérix at the Olympic Games,2008,"['Spain', 'Belgium', 'France', 'Germany', 'Italy']","['Period piece', 'Comedy', 'Family-Oriented Adventure', ""Children's/Family"", 'Family Film']",2000,8
5330369,Ten Canoes,2006,"['New Zealand', 'Australia']","['Drama', 'Family Drama', 'Indie', 'Comedy', 'World cinema', 'Adventure']",2000,6
296377,Haunted Castle,2001,"['Belgium', 'United States of America']","['Animation', 'Short Film', 'Thriller', 'Horror']",2000,1
35882350,Al moraheqat,1961,['Egypt'],[],1960,1
15958674,The Amateur,1982,['Canada'],"['Action', 'Spy', 'Suspense', 'Crime Fiction', 'Action/Adventure', 'Thriller', 'Political thriller']",1980,2
9955403,Jigri Dost,1969,['India'],"['Musical', 'Bollywood', 'World cinema', 'Drama']",1960,9
26138037,Echo Park,1986,"['Austria', 'United States of America']","['Drama', 'Indie', 'Romantic drama', 'Comedy', 'Romance Film', 'Romantic comedy']",1980,6
1329088,1941,1979,['United States of America'],"['Action', 'Screwball comedy', 'Action/Adventure', 'Satire', 'Comedy', 'War film', 'Airplanes and airports', 'Period piece', 'Parody', 'Action Comedy']",1970,9
936759,Double Teamed,2002,['United States of America'],"['Family Drama', 'Biographical film', ""Children's/Family"", 'Sports', 'Family Film']",2000,2
29320113,Event Horizon,1997,"['United Kingdom', 'United States of America']","['Sci-Fi Horror', 'Mystery', 'Thriller', 'Horror', 'Adventure', 'Supernatural', 'Science Fiction']",1990,7
13505007,My Brother Is an Only Child,2006,"['France', 'Italy']","['Crime Fiction', 'Art film', 'Comedy', 'World cinema', 'Drama']",2000,6
23330124,Offset,2006,"['Switzerland', 'France', 'Germany', 'Romania']",['Drama'],2000,6
5836246,Fade to Black,1980,['United States of America'],"['Indie', 'Slasher', 'Thriller', 'Horror', 'Teen', 'B-movie']",1980,0
11140664,Singaravelan,1992,['India'],['Comedy'],1990,2
7010904,Pusong Mamon,1998,['Philippines'],"['Filipino Movies', 'LGBT', 'Comedy', 'World cinema', 'Romantic comedy']",1990,8
2069318,"Bon Voyage, Charlie Brown",1980,['United States of America'],"['Animation', ""Children's"", 'Family Film']",1980,0
1367554,Mr. Saturday Night,1992,['United States of America'],"['Comedy-drama', 'Comedy', 'Drama']",1990,2
2337008,Walkout,2006,['United States of America'],"['Social problem film', 'Television movie', 'Docudrama', 'Drama']",2000,6
31953707,American Strays,1996,['United States of America'],"['Action', 'Crime Fiction', 'Indie', 'Action/Adventure', 'Comedy', 'Black comedy', 'Drama', 'Crime Comedy']",1990,6
6117093,Mad About Mambo,2000,"['United Kingdom', 'Ireland', 'United States of America']","['Comedy', 'Teen', 'Romantic comedy', 'Romance Film', 'Comedy-drama', 'Sports']",2000,0
28304392,It Started in Paradise,1952,['United Kingdom'],['Drama'],1950,2
29699054,Nirbhay,1996,['India'],['Action'],1990,6
4514440,Carry On Up the Jungle,1970,['United Kingdom'],"['Adventure Comedy', 'Parody', 'Comedy']",1970,0
24813200,Kisses and Caroms,2006,['United States of America'],"['Indie', 'Comedy', 'Romance Film', 'Romantic comedy']",2000,6
14738118,Crime on Their Hands,1948,['United States of America'],"['Short Film', 'Black-and-white', 'Comedy']",1940,8
9424050,The Day the Fish Came Out,1967,"['United Kingdom', 'Greece', 'United States of America']","['Comedy-drama', 'Science Fiction', 'Comedy']",1960,7
4558559,Miracles,1989,"['China', 'Hong Kong']","['Crime Fiction', 'Action/Adventure', 'Comedy', 'World cinema', 'Chinese Movies', 'Martial Arts Film', 'Drama']",1980,9
6795099,Thodarum,1999,['India'],['Comedy-drama'],1990,9
10433895,21,2008,['United States of America'],"['Film adaptation', 'Crime Fiction', 'Action/Adventure', 'Drama']",2000,8
5733528,City of Industry,1997,['United States of America'],"['Neo-noir', 'Crime Fiction', 'Indie', 'Thriller', 'Crime Thriller', 'Drama', 'Suspense', 'Heist', 'Chase Movie']",1990,7
15789864,Streets of Laredo,1949,['United States of America'],"['Western', 'Black-and-white']",1940,9
7363069,The Loves of Hercules,1960,"['France', 'Italy']",['Adventure'],1960,0
598397,Shaun of the Dead,2004,['United Kingdom'],"['Comedy', 'Horror Comedy', 'Black comedy', 'Zombie Film', 'Parody', 'Horror', 'Romantic comedy', 'Doomsday film', 'Cult']",2000,4
443972,Hook,1991,['United States of America'],"['Fantasy Adventure', 'Comedy', ""Children's/Family"", 'War film', 'Adventure', ""Children's Fantasy"", 'Family Film', 'Fantasy']",1990,1
28149658,Shameless,2008,['Czech Republic'],"['Romantic drama', 'Comedy', 'World cinema', 'Romance Film', 'Romantic comedy', 'Drama']",2000,8
31371,Seven Samurai,1954,['Japan'],"['Black-and-white', 'Samurai cinema', 'Art film', 'Action/Adventure', 'Historical drama', 'World cinema', 'Drama', 'Period piece', 'Japanese Movies', 'Existentialism', 'Ensemble Film']",1950,4
12763158,Resistance,2003,"['Netherlands', 'United States of America']","['Action', 'Film adaptation', 'Romantic drama', 'Romance Film', 'Epic', 'War film', 'Drama']",2000,3
14576560,Dodsworth,1936,['United States of America'],"['Black-and-white', 'Romantic drama', 'Romance Film', 'Drama']",1930,6
6258260,Diep,2005,['Netherlands'],['Drama'],2000,5
5576945,Devil In The Flesh,1998,['United States of America'],"['Psychological thriller', 'Crime Fiction', 'Indie', 'Comedy', 'Thriller', 'Black comedy', 'Crime Thriller', 'Erotic thriller']",1990,8
1698283,Out of Bounds,1986,['United States of America'],"['Action', 'Drama', 'Crime Fiction', 'Thriller']",1980,6
19662200,Day of the Wolves,1971,['United States of America'],"['Drama', 'Crime Fiction', 'Thriller']",1970,1
4454250,Kokoda,2006,['Australia'],"['Action', 'Drama', 'War film']",2000,6
10132275,Love,1928,['United States of America'],"['Black-and-white', 'Indie', 'Silent film', 'Romance Film', 'Drama']",1920,8
19787401,Money,1928,['France'],"['Black-and-white', 'Silent film', 'Romance Film', 'Drama']",1920,8
6852813,They Were Not Divided,1949,['United Kingdom'],['War film'],1940,9
76371,Sweet Smell of Success,1957,['United States of America'],"['Film à clef', 'Black-and-white', 'Film noir', 'Media Satire', 'Drama']",1950,7
1659186,The Pompatus of Love,1996,"['France', 'United States of America']","['Indie', 'Comedy', 'Romance Film', 'Romantic comedy', 'Comedy-drama', 'Ensemble Film']",1990,6
6529207,Fragile,2006,"['United Kingdom', 'Spain']","['Suspense', 'Psychological thriller', 'Thriller', 'Horror', 'World cinema', 'Supernatural']",2000,6
18549292,Raintree County,1957,['United States of America'],"['Film adaptation', 'Romance Film', 'War film', 'Drama']",1950,7
1482800,The Great Waltz,1938,['United States of America'],"['Musical', 'Black-and-white', 'Biography', 'Romantic drama', 'Biographical film', 'Romance Film', 'Drama', 'Period piece']",1930,8
1814192,Chopin: Desire for Love,2002,['Poland'],"['Biography', 'Romantic drama', 'Biographical film', 'World cinema', 'Romance Film', 'Drama', 'Period piece', 'Biopic [feature]']",2000,2
25072014,Destiny's Son,1962,[],['Drama'],1960,2
11141594,Unnal Mudiyum Thambi,1988,['India'],['Musical'],1980,8
3186031,Kyon Ki,2005,['India'],"['Romantic drama', 'World cinema', 'Romance Film', 'Drama']",2000,5
27617955,Smith!,1969,['United States of America'],['Drama'],1960,9
765519,L'Appartement,1996,"['France', 'Spain', 'Italy']","['Romantic drama', 'Thriller', 'World cinema', 'Romance Film', 'Drama']",1990,6
8374281,The Final Sanction,1990,['United States of America'],"['Action', 'Adventure', 'War film', 'Science Fiction']",1990,0
19033808,Pan Tadeusz,1999,"['France', 'Poland']","['Family Drama', 'Romantic drama', 'World cinema', 'Romance Film', 'Drama', 'Period piece', 'History', 'War film']",1990,9
27757207,The Last Escape,1970,['United States of America'],"['Action', 'Action/Adventure', 'War film']",1970,0
13961279,The Sin of Harold Diddlebock,1947,['United States of America'],"['Black-and-white', 'Screwball comedy', 'Comedy', 'Slapstick']",1940,7
17841580,'Til There Was You,1997,['United States of America'],"['Romance Film', 'Romantic comedy', 'Comedy']",1990,7
9542797,Kyaa Kool Hai Hum,2005,['India'],"['Romantic drama', 'Comedy', 'Thriller', 'World cinema', 'Romance Film', 'Romantic comedy', 'Drama']",2000,5
3093642,The Shaggy D.A.,1976,['United States of America'],"['Drama', 'Slapstick', 'Comedy', 'Fantasy Comedy', 'Family Film']",1970,6
16168084,Engal Anna,2004,['India'],"['Romantic drama', 'Action/Adventure', 'World cinema', 'Romance Film', 'Drama']",2000,4
14969710,The Spider's Stratagem,1970,['Italy'],"['Mystery', 'Indie', 'Drama']",1970,0
11975441,Two-Fisted Law,1932,['United States of America'],"['Action', 'Black-and-white', 'Western']",1930,2
22811616,Lootere,1993,['India'],"['Action', 'Musical', 'Drama']",1990,3
695283,Lethal Weapon 4,1998,['United States of America'],"['Action', 'Crime Fiction', 'Action Thrillers', 'Action/Adventure', 'Comedy', 'Thriller', 'Buddy film', 'Martial Arts Film', 'Buddy cop', 'Action Comedy']",1990,8
3770927,The Promise,2005,"['Hong Kong', 'South Korea', 'China', 'United States of America']","['Action', 'Romantic drama', 'World cinema', 'Romance Film', 'Chinese Movies', 'Adventure', 'Drama', 'Wuxia', 'Fantasy']",2000,5
8062885,Case Closed: The Private Eyes' Requiem,2006,['Japan'],['Japanese Movies'],2000,6
4132529,Boys and Girls,2000,['United States of America'],"['Comedy', 'Teen', 'Romance Film', 'Romantic comedy']",2000,0
1702672,My Life in Pink,1997,"['United Kingdom', 'France', 'Belgium']","['LGBT', 'Family Drama', 'Comedy', 'Childhood Drama', 'World cinema', 'Drama', 'Gay Themed', 'Gay', 'Gay Interest', 'Domestic Comedy', 'Comedy-drama']",1990,7
1371014,À ton image,2004,['France'],"['Science Fiction', 'Thriller']",2000,4
22124142,Kattathe Kilikkoodu,1983,['India'],"['Romance Film', 'Comedy', 'Drama']",1980,3
31568206,Poor Pretty Eddie,1975,[],"['Slasher', 'Horror', 'Escape Film', 'Drama']",1970,5
27156371,Daddy Longlegs,2009,"['United States of America', 'France']","['Mumblecore', 'Drama', 'Indie', 'Comedy', 'Childhood Drama', 'Comedy-drama']",2000,9
21962416,Messenger of Death,1988,['United States of America'],"['Action', 'Action Thrillers', 'Mystery', 'Action/Adventure', 'Thriller']",1980,8
5843617,The Scarlet Blade,1963,['United Kingdom'],"['Romance Film', 'Costume drama', 'Adventure', 'Drama']",1960,3
36097069,Gun for a Coward,1957,['United States of America'],['Western'],1950,7
27956166,Revolver,1973,"['France', 'West Germany', 'Italy']","['Action', 'Crime Fiction', 'Action/Adventure', 'Thriller', 'World cinema', 'Crime Thriller']",1970,3
5118109,Vivacious Lady,1938,['United States of America'],"['Black-and-white', 'Comedy', 'Romance Film', 'Romantic comedy']",1930,8
4340073,The Strawberry Blonde,1941,['United States of America'],"['Black-and-white', 'Comedy', 'Romance Film', 'Romantic comedy']",1940,1
12528152,White Wedding,1989,['France'],"['Romantic drama', 'Romance Film', 'Melodrama', 'Drama']",1980,9
17602253,The Stalking Moon,1968,['United States of America'],"['Action', 'Action/Adventure', 'Western', 'Indian Western']",1960,8
1482779,These Three,1936,['United States of America'],"['Black-and-white', 'Melodrama', 'Drama']",1930,6
6565119,The Path to 9/11,2006,[],"['Docudrama', 'War film', 'Drama']",2000,6
8946174,The Crooked Eye,2009,['United States of America'],"['Short Film', 'Drama', 'Animation']",2000,9
18855599,The Crime of the Century,1933,['United States of America'],"['Detective fiction', 'Crime Fiction', 'Mystery', 'Thriller', 'Detective', 'Crime Thriller']",1930,3
22363271,Mike's Murder,1984,['United States of America'],"['Crime Drama', 'Drama']",1980,4
5341795,Chup Chup Ke,2006,['India'],"['Musical', 'Comedy', 'Bollywood', 'World cinema', 'Romantic comedy', 'Comedy of Errors']",2000,6
7148350,Opal Dream,2006,"['United Kingdom', 'New Zealand', 'Australia']","['Film adaptation', 'Family Drama', 'Indie', 'Childhood Drama', 'World cinema', ""Children's/Family"", 'Drama', 'Family Film']",2000,6
2245035,Brainstorm,1965,['United States of America'],"['Film noir', 'Drama', 'Thriller']",1960,5
823939,Twilight,1998,['United States of America'],"['Neo-noir', 'Crime Fiction', 'Mystery', 'Thriller', 'Detective', 'Crime Thriller', 'Drama']",1990,8
14144193,Mysterious Island,1951,['United States of America'],"['Black-and-white', 'Science Fiction', 'Adventure']",1950,1
6715920,Vattaram,2006,['India'],[],2000,6
1666550,Only the Strong,1993,['United States of America'],"['Action', 'Crime Fiction', 'Action/Adventure', 'Martial Arts Film']",1990,3
1256990,Candyman,1992,['United States of America'],"['Psychological thriller', 'Film adaptation', 'Slasher', 'Thriller', 'Horror', 'Supernatural', 'Cult']",1990,2
19840982,The Black Cat,1981,['Italy'],"['World cinema', 'Horror']",1980,1
1348590,The Protector,1985,"['Hong Kong', 'United States of America']","['Action', 'Crime Fiction', 'Action/Adventure', 'Chinese Movies', 'Martial Arts Film', 'Drama']",1980,5
17159479,Imaginary Playmate,2006,['Canada'],['Thriller'],2000,6
3357705,FairyTale: A True Story,1997,"['United Kingdom', 'United States of America']","['Period piece', 'Family Drama', 'Drama', 'Family Film', 'Fantasy']",1990,7
23893107,Eyes of Fire,1983,['United States of America'],['Horror'],1980,3
22465833,The White Ribbon,2009,"['Austria', 'France', 'Germany', 'Italy']","['Period piece', 'Crime Fiction', 'Mystery', 'World cinema', 'Drama']",2000,9
5068537,Hollywood Or Bust,1956,['United States of America'],"['Road movie', 'Buddy film', 'Comedy']",1950,6
14143864,"Brenda Starr, Reporter",1945,['United States of America'],"['Action', 'Black-and-white', 'Crime Fiction', 'Adventure']",1940,5
14145590,Powder Blue,2008,['United States of America'],"['Crime Fiction', 'Indie', 'Drama', 'Ensemble Film']",2000,8
9328245,Life of the Party,2005,['United States of America'],"['Romantic drama', 'Indie', 'Romance Film', 'Drama']",2000,5
19984678,Dying Breed,2008,"['New Zealand', 'Australia']","['Slasher', 'Horror']",2000,8
9797842,The Condor,2007,['United States of America'],"['Superhero movie', 'Animation', 'Action/Adventure']",2000,7
5161973,Tombs of the Blind Dead,1971,['Spain'],"['Horror', 'World cinema', 'Zombie Film', 'Cult']",1970,1
28745644,Scene of the Crime,1949,['United States of America'],"['Film noir', 'Crime Fiction', 'Drama']",1940,9
31537306,Love Is a Many Stupid Thing,2004,['China'],"['Crime Fiction', 'Comedy', 'Comedy film', 'World cinema', 'Chinese Movies']",2000,4
9416837,Leatherheads,2008,['United States of America'],"['Period piece', 'Comedy', 'Romantic comedy', 'Romance Film', 'Sports']",2000,8
23808966,Bill & Ted's Excellent Adventure,1989,['United States of America'],"['Buddy film', 'Comedy', 'Teen', 'Sci-Fi Adventure', 'Adventure', 'Time travel', 'Science Fiction', 'Family Film', 'Fantasy']",1980,9
13341626,Ruby Gentry,1952,['United States of America'],"['Black-and-white', 'Romance Film', 'Melodrama', 'Drama']",1950,2
5566354,A Guy Named Joe,1943,['United States of America'],"['Romantic fantasy', 'Black-and-white', 'Heaven-Can-Wait Fantasies', 'Romance Film', 'War film', 'Fantasy']",1940,3
62688,Foreign Correspondent,1940,['United States of America'],"['Spy', 'Black-and-white', 'Thriller', 'War film', 'Political thriller']",1940,0
358363,The Happiest Millionaire,1967,"['Canada', 'United States of America']","['Musical', 'Biography', 'Comedy', 'Biopic [feature]', 'Docudrama', 'Drama', 'Family Film']",1960,7
2581365,Blackball,2005,['United Kingdom'],"['Family Drama', 'Comedy', 'Sports', 'Drama']",2000,5
18824395,Vamshi,2008,['India'],['Action'],2000,8
32711541,Angels,2007,['Philippines'],"['Filipino Movies', 'Comedy-drama']",2000,7
7036030,"Love, Life and Laughter",1923,['United Kingdom'],"['Silent film', 'Romance Film', 'Drama']",1920,3
28576162,The Passionate Adventure,1924,['United Kingdom'],['Silent film'],1920,4
4103995,Lace,1984,['United States of America'],"['Melodrama', 'Drama']",1980,4
2551921,Two Rode Together,1961,['United States of America'],"['Revisionist Western', 'Western', 'Indian Western']",1960,1
30864660,Tarazu,1997,['India'],['World cinema'],1990,7
34430206,Sakutumba Saparivaara Sametham,2000,['India'],"['Drama', 'Family Film']",2000,0
26681712,Greetings,2004,['India'],"['Romance Film', 'Comedy']",2000,4
16958733,Krishna,2007,['India'],['Romance Film'],2000,7
1605299,The Invisible Man,1933,['United States of America'],"['Action', 'Black-and-white', 'Action/Adventure', 'Thriller', 'Horror', 'Science Fiction']",1930,3
24565046,Hussy,1980,['United Kingdom'],"['Romance Film', 'Romantic drama', 'Drama']",1980,0
22501925,Hollywood-Hong Kong,2001,"['France', 'Hong Kong', 'Japan']","['Chinese Movies', 'Japanese Movies']",2000,1
24716019,Dallas Doll,1994,['Australia'],['Drama'],1990,4
29679423,Will You Merry Me,2008,['United States of America'],['Comedy film'],2000,8
15446482,A Sailor-Made Man,1921,['United States of America'],"['Black-and-white', 'Comedy', 'Silent film', 'Adventure']",1920,1
8267581,Sherlock Holmes and the House of Fear,1945,['United States of America'],"['Black-and-white', 'Crime Fiction', 'Mystery', 'Thriller', 'Crime Thriller', 'Suspense', 'Detective', 'Horror']",1940,5
4742022,Fly Me to Polaris,1999,['Hong Kong'],['Chinese Movies'],1990,9
20568687,Beautiful,2008,['South Korea'],"['Drama', 'World cinema']",2000,8
5696825,The Dark Half,1993,['United States of America'],"['Psychological thriller', 'Film adaptation', 'Horror', 'Supernatural']",1990,3
4474435,El padrecito,1964,['Mexico'],"['Religious Film', 'Comedy', 'World cinema']",1960,4
5939156,Childstar,2004,['Canada'],"['Indie', 'Parody', 'Satire', 'Comedy']",2000,4
13488854,The Gods Must Be Crazy III,1991,['Hong Kong'],['Chinese Movies'],1990,1
11414473,Finding Forrester,2000,['United States of America'],"['Coming of age', 'Drama']",2000,0
19119554,Stars and Bars,1988,['United States of America'],"['Comedy', 'Satire']",1980,8
1312584,The Gift,2001,['United States of America'],"['Psychological thriller', 'Crime Fiction', 'Mystery', 'Thriller', 'Crime Thriller', 'Courtroom Drama', 'Suspense', 'Supernatural', 'Fantasy']",2000,1
17908428,Hunger,1966,"['Norway', 'Sweden', 'Denmark']",['Drama'],1960,6
6515729,Rehearsal for Murder,1982,['United States of America'],"['Suspense', 'Mystery', 'Thriller', 'Whodunit', 'Drama']",1980,2
7051746,Poltergeist II: The Other Side,1986,['United States of America'],['Horror'],1980,6
24021186,Melody,1953,['United States of America'],"['Musical', 'Animation', 'Short Film', 'Family Film']",1950,3
26431844,Darling Darling,2000,['India'],['Romance Film'],2000,0
6196950,Cordélia,1980,['Canada'],"['Crime Fiction', 'Docudrama', 'Drama', 'Courtroom Drama']",1980,0
13325861,Blinky Bill,1992,['Australia'],['Animation'],1990,2
4385591,The Gypsy Moths,1969,['United States of America'],"['Action', 'Drama', 'Action/Adventure', 'Melodrama']",1960,9
14322994,Black Samurai,1977,['United States of America'],"['Action', 'Spy', 'Blaxploitation', 'Crime Fiction', 'Action/Adventure', 'Martial Arts Film']",1970,7
19571697,Pehchaan,1993,['India'],"['Action/Adventure', 'Drama', 'World cinema']",1990,3
592297,The Girl Next Door,2004,['United States of America'],"['Comedy', 'Teen', 'Romance Film', 'Romantic comedy', 'Drama', 'Sex comedy']",2000,4
22186281,Srutilayalu,1987,['India'],"['Musical', 'Drama', 'Family Film']",1980,7
6693390,Captains of the Clouds,1942,['United States of America'],"['Combat Films', 'Action', 'Drama', 'Action/Adventure', 'War film']",1940,2
1765948,Love Ke Liye Kuchh Bhi Karega,2001,['India'],"['Romantic drama', 'Comedy', 'World cinema', 'Romance Film', 'Romantic comedy', 'Drama']",2000,1
3268903,Night of the Demons,1988,['United States of America'],"['Comedy', 'Teen', 'Horror', 'Supernatural']",1980,8
1371138,The Fox and the Hound,1981,['United States of America'],"['Animation', 'Coming of age', 'Animated Musical', 'Family-Oriented Adventure', ""Children's/Family"", 'Adventure', 'Family Film']",1980,1
20864214,My Only U,2008,['Philippines'],"['Filipino Movies', 'Comedy', 'Romance Film', 'Drama']",2000,8
18612851,Doraemon: Nobita's Dinosaur,1980,"['United Kingdom', 'Japan', 'United States of America']","['Comedy', 'Japanese Movies']",1980,0
8383276,I Started Liking You,2002,['India'],"['Musical', 'Romantic drama', 'Action/Adventure', 'Bollywood', 'World cinema', 'Romance Film', 'Drama', 'Crime Drama']",2000,2
26601629,Miss Kicki,2009,"['Sweden', 'Taiwan']","['Fictional film', 'Drama']",2000,9
15859061,Periya Idathu Penn,1963,['India'],['Drama'],1960,3
673407,My Girl,1991,['United States of America'],"['Family Drama', 'Comedy', 'Childhood Drama', 'Romance Film', ""Children's/Family"", 'Drama', 'Coming of age', 'Comedy-drama', 'Family Film']",1990,1
896652,The Valley of Gwangi,1969,['United States of America'],"['Hybrid Western', 'Action/Adventure', 'Monster movie', 'Western', 'Horror', 'B-movie', 'Stop motion', 'Fantasy']",1960,9
21149094,The Immortal Voyage of Captain Drake,2009,"['Bulgaria', 'United States of America']","['Action/Adventure', 'Adventure', 'Historical fiction', 'Television movie']",2000,9
4193180,Return to Snowy River,1988,"['New Zealand', 'Australia']","['Family Drama', 'Western', 'Action/Adventure', 'World cinema', 'Adventure', 'Drama', 'Family Film']",1980,8
3320466,Winning,1969,['United States of America'],"['Action', 'Sports', 'Drama']",1960,9
12490737,Molière,2007,['France'],"['Romantic drama', 'Comedy', 'World cinema', 'Romance Film', 'Romantic comedy', 'Drama']",2000,7
17124409,Parasakthi,1952,['India'],[],1950,2
3520031,The Milagro Beanfield War,1988,['United States of America'],"['Film adaptation', 'Comedy', 'Comedy-drama', 'Drama']",1980,8
20300024,Nobody's Perfekt,1981,['United States of America'],['Comedy'],1980,1
14913280,Cheeky!,2000,['Italy'],"['LGBT', 'Romantic drama', 'Comedy', 'World cinema', 'Romance Film', 'Drama']",2000,0
2542040,The Wayward Cloud,2005,"['France', 'Taiwan', 'China']","['Surrealism', 'Musical', 'Art film', 'Erotic Drama', 'Comedy', 'Avant-garde', 'World cinema', 'Romance Film', 'Chinese Movies', 'Drama', 'Experimental film', 'Science Fiction']",2000,5
3525382,Radar Men from the Moon,1952,['United States of America'],"['Action', 'Black-and-white', 'Thriller', 'Adventure', 'Science Fiction']",1950,2
9233621,Fighting for Love,2001,['Hong Kong'],"['Comedy', 'World cinema', 'Romance Film', 'Romantic comedy', 'Chinese Movies']",2000,1
9594585,Career,1959,['United States of America'],"['Black-and-white', 'Drama']",1950,9
2610460,Der müde Tod,1921,"['Weimar Republic', 'Germany']","['Black-and-white', 'Drama', 'Indie', 'World cinema', 'Silent film', 'Fantasy']",1920,1
19406235,A Lingering Face,2000,['China'],"['Drama', 'Mystery', 'Chinese Movies']",2000,0
21473164,Ready? OK!,2008,['United States of America'],"['LGBT', 'Indie', 'Comedy', 'Childhood Drama', 'Domestic Comedy']",2000,8
2564144,Crocodile Dundee in Los Angeles,2001,"['New Zealand', 'Australia']","['Action', 'Action Comedy', 'Action/Adventure', 'Comedy', 'World cinema', 'Adventure', 'Drama']",2000,1
19950293,Dirty Gertie from Harlem U.S.A.,1946,['United States of America'],['Drama'],1940,6
12902613,Windwalker,1980,['United States of America'],"['Action/Adventure', 'Western', 'Biopic [feature]', 'Drama']",1980,0
1609553,Walk on Water,2004,['Israel'],"['LGBT', 'Crime Fiction', 'World cinema', 'Drama', 'Gay Themed', 'Gay', 'Gay Interest', 'Road movie']",2000,4
2082449,Original Gangstas,1996,['United States of America'],"['Action', 'Blaxploitation', 'Crime Fiction', 'Gangster Film', 'Action/Adventure', 'Thriller', 'Crime Thriller', 'Drama']",1990,6
6469252,Shooter,2007,['United States of America'],"['Action', 'Film adaptation', 'Mystery', 'Action/Adventure', 'Thriller', 'Crime Thriller', 'Drama', 'Political thriller']",2000,7
11236647,Jaane Tu Ya Jaane Na,2008,['India'],"['Musical', 'Romantic drama', 'Comedy', 'Bollywood', 'World cinema', 'Romance Film', 'Drama', 'Romantic comedy']",2000,8
15101730,April 1st Vidudhala,1991,['India'],['World cinema'],1990,1
665901,My Lucky Stars,1985,['Hong Kong'],"['Action', 'Action/Adventure', 'Buddy film', 'World cinema', 'Chinese Movies', 'Martial Arts Film']",1980,5
13837647,Four Rode Out,1971,"['Spain', 'United States of America']","['Action', 'Western', 'Adventure']",1970,1
14524270,29th and Gay,2005,['United States of America'],"['Gay Themed', 'LGBT', 'Gay', 'Gay Interest', 'Comedy', 'Romance Film']",2000,5
4493967,The Hunchback of Notre Dame II,2002,['United States of America'],"['Music', 'Animated cartoon', 'Animation', 'Animated Musical', ""Children's/Family"", ""Children's"", 'Adventure', 'Family Film']",2000,2
18120048,Melodrama Habibi,2008,['Lebanon'],"['Comedy-drama', 'Comedy', 'Drama']",2000,8
2078932,Deadline at Dawn,1946,['United States of America'],"['Film noir', 'Psychological thriller', 'Mystery']",1940,6
12189765,Saint Monica,2002,['Canada'],"['Family Drama', 'Childhood Drama', ""Children's/Family"", ""Children's"", 'Drama', 'Family Film']",2000,2
10934336,Ninja in the Dragon's Den,1982,['Hong Kong'],"['Chinese Movies', 'Martial Arts Film']",1980,2
1102282,Hotel Rwanda,2004,"['United Kingdom', 'South Africa', 'Italy', 'United States of America']","['History', 'Biography', 'Docudrama', 'Political drama', 'War film', 'Drama']",2000,4
1569551,Care Bears Movie II: A New Generation,1986,"['Canada', 'United States of America']","[""Children's Fantasy"", 'Animation', ""Children's/Family"", ""Children's"", 'Family Film']",1980,6
19360800,School's Out,1930,['United States of America'],"['Short Film', 'Black-and-white', 'Comedy']",1930,0
18005619,Chathurangam,2002,['India'],"['Action', 'Thriller', 'Drama']",2000,2
29162674,Kaliyil Alpam Karyam,1984,[],['Romance Film'],1980,4
14734420,Pies and Guys,1958,['United States of America'],"['Short Film', 'Black-and-white', 'Comedy']",1950,8
4181076,Otesanek,2001,"['United Kingdom', 'Czech Republic', 'Japan']","['Surrealism', 'Animation', 'Comedy', 'World cinema', 'Drama', 'Japanese Movies', 'Horror', 'Stop motion', 'Fantasy']",2000,1
23316260,Missionary Man,2007,['United States of America'],"['Action', 'Action Thrillers', 'Action/Adventure', 'Thriller']",2000,7
11216936,Fantaghirò 3,1993,['Italy'],"['Adventure', 'Family Film']",1990,3
3024499,Limbo,1999,['United States of America'],"['Indie', 'Thriller', 'Adventure', 'Drama']",1990,9
2349235,Sehar,2005,['India'],"['Action/Adventure', 'Thriller', 'World cinema', 'Crime Thriller', 'Drama']",2000,5
2133961,Hostile Waters,1997,"['United Kingdom', 'France', 'Germany', 'United States of America']","['Thriller', 'Television movie', 'Docudrama', 'Political drama', 'Drama', 'Political thriller']",1990,7
4851294,Mazhai,2005,['India'],"['Action', 'Comedy', 'Thriller', 'Romance Film', 'Adventure']",2000,5
12050633,The Devil's Chair,2008,['United Kingdom'],"['Psychological thriller', 'Slasher', 'Horror', 'Sci-Fi Horror']",2000,8
3262031,Motel Hell,1980,['United States of America'],"['Slasher', 'Comedy', 'Satire', 'Horror']",1980,0
30608539,The Turn of the Screw,2009,['United Kingdom'],"['Mystery', 'Thriller', 'Horror', 'Drama']",2000,9
12326404,Maiko Haaaan!!!,2007,['Japan'],"['Japanese Movies', 'Comedy', 'World cinema', 'Sports']",2000,7
23135176,The Girl with the Dragon Tattoo,2009,"['Denmark', 'Norway', 'Sweden', 'Germany']","['Detective fiction', 'Crime Fiction', 'Mystery', 'Thriller', 'Detective', 'World cinema', 'Crime Thriller']",2000,9
1485644,Perfect Strangers,1950,['United States of America'],"['Black-and-white', 'Comedy', 'Comedy-drama', 'Drama']",1950,0
2751845,Girls Will Be Girls,2003,['United States of America'],"['LGBT', 'Parody', 'Comedy', 'Romantic comedy']",2000,3
5744612,The Magnificent Seven Ride,1972,['United States of America'],"['Action', 'Period piece', 'Action/Adventure', 'Western']",1970,2
42361,On the Waterfront,1954,['United States of America'],"['Black-and-white', 'Crime Fiction', 'Romance Film', 'Drama']",1950,4
1606381,Animalympics,1980,['United States of America'],"['Indie', 'Animation']",1980,0
36180452,One Night with the King,2006,['United States of America'],"['Indie', 'Romantic drama', 'Christian film', 'Romance Film', 'Drama', 'Period piece', 'Epic', 'Hagiography']",2000,6
5501808,Wild Rovers,1971,['United States of America'],"['Action', 'Western', 'Action/Adventure']",1970,1
413426,Walker,1987,"['Spain', 'Mexico', 'United States of America']","['Action', 'Biography', 'Satire', 'Biographical film', 'Acid western', 'War film', 'Docudrama', 'Drama', 'Period piece', 'Biopic [feature]', 'Political drama']",1980,7
9905852,Life and Nothing But,1989,['France'],"['Period piece', 'Romantic drama', 'World cinema', 'Romance Film', 'War film', 'Drama']",1980,9
27870294,Land of No Return,1978,['United States of America'],"['Adventure', 'Thriller']",1970,8
2366994,Les Boys,1997,['Canada'],['Comedy'],1990,7
35119605,Al Halfout,1985,['Egypt'],"['Drama', 'Comedy film']",1980,5
6547798,Russian Rhapsody,1944,['United States of America'],['Propaganda film'],1940,4
2134444,Highway 301,1950,['United States of America'],"['Crime Fiction', 'Gangster Film', 'Film noir', 'Crime Drama']",1950,0
27880784,The Runestone,1991,['United States of America'],"['Adventure', 'Comedy film', 'Horror']",1990,1
7690015,The Pretender 2001,2001,['United States of America'],"['Action', 'Crime Fiction', 'Mystery', 'Thriller']",2000,1
19046843,The Forbidden Quest,1993,['Netherlands'],"['Mockumentary', 'Adventure']",1990,3
6457520,"The Good, the Bad, and Huckleberry Hound",1988,['United States of America'],"['Animation', 'Parody', 'Comedy', 'Family Film', 'Fantasy']",1980,8
17901688,Madagascar,2005,['United States of America'],"['Computer Animation', 'Animation', ""Children's"", 'Comedy', 'Adventure', 'Family Film', 'Fantasy']",2000,5
24137754,Blood and Donuts,1995,['Canada'],"['Black comedy', 'Comedy', 'Horror']",1990,5
29754001,Run Chrissie Run!,1986,['Australia'],"['Crime Fiction', 'Adventure', 'Drama']",1980,6
2303174,Ice Age: The Meltdown,2006,['United States of America'],"['Action', 'Animation', 'Comedy', 'Family-Oriented Adventure', ""Children's/Family"", 'Adventure', 'Computer Animation', ""Children's Fantasy"", 'Family Film', 'Fantasy']",2000,6
20907561,Gagana,1989,['India'],['Romance Film'],1980,9
3992363,Mutiny on the Bounty,1962,['United States of America'],"['Action', 'Film adaptation', 'History', 'Action/Adventure', 'Romance Film', 'Adventure', 'Drama']",1960,2
2052515,Mr. Vampire,1985,['Hong Kong'],"['Action', 'Horror Comedy', 'Comedy', 'World cinema', 'Chinese Movies', 'Slapstick', 'Martial Arts Film', 'Parody', 'Horror']",1980,5
5604917,Bacon Grabbers,1929,['United States of America'],"['Black-and-white', 'Indie', 'Short Film', 'Buddy film', 'Comedy', 'Silent film', 'Slapstick']",1920,9
9285886,Manasu Maata Vinadhu,2005,['India'],['Romance Film'],2000,5
28275559,Boomi Malayalam,2009,['India'],['Drama'],2000,9
6650230,Mini Moni Ja Movie: Okashina Daibouken,2002,['Japan'],['Japanese Movies'],2000,2
12832450,Cipher in the snow,1974,['United States of America'],"['Short Film', 'Childhood Drama', ""Children's/Family"", 'Docudrama', 'Drama']",1970,4
19558213,"Take Care of Your Scarf, Tatiana",1994,"['Finland', 'Germany']",['Comedy'],1990,4
26235488,Where's Firuze?,2004,['Turkey'],"['Musical', 'Comedy film']",2000,4
1024760,Winchester '73,1950,['United States of America'],"['Action/Adventure', 'Western']",1950,0
2421498,September,1987,['United States of America'],"['Indie', 'Drama']",1980,7
8203141,Journey of Hope,1990,"['United Kingdom', 'Turkey', 'Switzerland']","['Drama', 'World cinema']",1990,0
1868133,Valerie and Her Week of Wonders,1970,"['Czechoslovakia', 'Czech Republic']","['Horror', 'World cinema', 'Czechoslovak New Wave', 'Drama', 'Fantasy']",1970,0
6947457,The Deep End,2001,['United States of America'],"['Crime Fiction', 'LGBT', 'Mystery', 'Indie', 'Family Drama', 'Thriller', 'Crime Thriller', 'Drama', 'Suspense', 'Crime Drama', 'Melodrama']",2000,1
34033038,Ninaithadhai Mudippavan,1974,[],['Drama'],1970,4
2871613,The Jewel of the Nile,1985,"['France', 'Morocco', 'United States of America']","['Adventure Comedy', 'Action', 'Action/Adventure', 'Comedy', 'Adventure', 'Romance Film', 'Romantic comedy']",1980,5
4118336,Tarzan II,2005,['United States of America'],"['Animation', 'Animated Musical', 'Jungle Film', ""Children's/Family"", 'Adventure', 'Family Film']",2000,5
7489472,Aalavandhan,2001,['India'],['Horror'],2000,1
11087534,Icon,2005,['United States of America'],"['Action', 'Film adaptation', 'Action/Adventure', 'Thriller', 'Television movie']",2000,5
33767640,Oru Muthassi Katha,1988,[],['Drama'],1980,8
23658166,Stage Fright,1989,['United States of America'],['Indie'],1980,9
10867220,Innale,1989,['India'],"['Romance Film', 'Drama']",1980,9
26205838,Sallapam,1996,['India'],"['Musical', 'Romantic drama', 'World cinema']",1990,6
31327605,Dance Macabre,1992,"['Soviet Union', 'United States of America']",['Horror'],1990,2
5764903,The Nativity Story,2006,['United States of America'],"['Period piece', 'Christian film', 'Hagiography', 'Christmas movie', 'Drama']",2000,6
3500965,The Romantic President,2002,['South Korea'],"['Romance Film', 'Comedy', 'Drama']",2000,2
1844300,Last Present,2001,['South Korea'],"['Romance Film', 'Drama']",2000,1
15757816,Double Agent,1987,['United States of America'],"['Action', 'Spy', 'Biography', 'Comedy', 'Adventure', 'Drama', 'Action Comedy', 'Family Film']",1980,7
23704496,Crude,2009,"['England', 'United States of America']","['Political cinema', 'Documentary']",2000,9
16782,King Kong,1933,['United States of America'],"['Action', 'Black-and-white', 'Animation', 'Action/Adventure', 'Disaster', 'Adventure', 'Pre-Code', 'Monster movie', 'Airplanes and airports', 'Horror', 'Stop motion']",1930,3
7005267,They Came To Cordura,1959,['United States of America'],"['Action', 'Drama', 'Action/Adventure', 'Western', 'War film']",1950,9
24995014,Gangster High,2006,['South Korea'],"['Action', 'Crime Fiction']",2000,6
10336027,The Swan Princess II: Escape from Castle Mountain,1997,['United States of America'],"['Animation', 'Indie', 'Adventure', 'Family Film', 'Fantasy']",1990,7
2251745,Welcome to Woop Woop,1997,"['United Kingdom', 'Australia']","['Black comedy', 'Comedy']",1990,7
13617351,Daimajin,1966,['Japan'],"['Japanese Movies', 'Fantasy']",1960,6
6113399,Drive,1998,['United States of America'],"['Action', 'Action/Adventure']",1990,8
6193473,A Chinese Ghost Story III,1991,['Hong Kong'],"['Romantic drama', 'Action/Adventure', 'World cinema', 'Romance Film', 'Chinese Movies', 'Martial Arts Film', 'Drama']",1990,1
23502201,Rocket Singh: Salesman of the Year,2009,['India'],"['Musical', 'Comedy', 'Bollywood', 'World cinema', 'Musical comedy', 'Workplace Comedy']",2000,9
15982164,Lady In Cement,1968,['United States of America'],"['Film adaptation', 'Detective fiction', 'Mystery', 'Thriller', 'Crime Thriller', 'Drama', 'Comedy Thriller', 'Detective']",1960,8
1695109,Pacific Heights,1990,['United States of America'],"['Psychological thriller', 'Suspense', 'Thriller', 'Crime Thriller', 'Drama']",1990,0
3473828,I Love Your Work,2003,['United States of America'],"['Mystery', 'Indie', 'Drama']",2000,3
19290727,Sunday School Musical,2008,"['Canada', 'United States of America']","['Musical', 'Indie', 'Teen', 'Christian film', ""Children's""]",2000,8
30886678,The Least Among You,2009,['United States of America'],"['Period piece', 'Indie', 'Drama']",2000,9
7229887,Palo Alto,2007,['United States of America'],"['Indie', 'Comedy', 'Drama']",2000,7
1175762,Hero,1992,['United States of America'],"['Parody', 'Mystery', 'Comedy', 'Thriller', 'Comedy-drama', 'Drama']",1990,2
12459069,Wedding Bell Blues,1996,['United States of America'],"['Comedy', 'Romance Film', 'Romantic comedy', 'Comedy-drama', 'Ensemble Film']",1990,6
12910750,Your Friend the Rat,2007,['United States of America'],"['Computer Animation', 'Short Film', 'Comedy']",2000,7
2255173,Ms. 45,1981,['United States of America'],"['Action', 'Drama', 'Crime Fiction', 'Indie', 'Thriller', 'Crime Thriller', 'Cult']",1980,1
3283236,Hercules,1983,"['Italy', 'United States of America']","['Action/Adventure', 'Adventure', 'Costume drama', 'Science Fiction', 'Cult', 'Fantasy']",1980,3
5566494,Touch of Pink,2004,"['Canada', 'United Kingdom']","['LGBT', 'Indie', 'Comedy', 'Romance Film', 'Gay Themed', 'Gay', 'Gay Interest', 'Romantic comedy', 'Fantasy Comedy']",2000,4
5702474,Friends and Lovers,1999,['United States of America'],"['Drama', 'Indie', 'Romantic drama', 'Comedy', 'Romance Film', 'Romantic comedy']",1990,9
13144048,Saajan Chale Sasural,1996,['India'],"['Romantic drama', 'Comedy', 'Bollywood', 'World cinema', 'Romance Film', 'Romantic comedy', 'Drama']",1990,6
6006572,Shivamani,2003,['India'],"['Drama', 'World cinema']",2000,3
2750041,Memento,2000,['United States of America'],"['Psychological thriller', 'Crime Fiction', 'Mystery', 'Indie', 'Thriller', 'Crime Thriller', 'Drama', 'Suspense', 'Existentialism']",2000,0
12964992,Steel Toes,2006,"['Canada', 'United States of America']","['Drama', 'Crime Fiction', 'Indie', 'Courtroom Drama']",2000,6
2229321,Thunder Bay,1953,['United States of America'],"['Action', 'Addiction Drama', 'Adventure', 'Drama']",1950,3
24574458,Watcher in the Attic,1976,['Japan'],"['Japanese Movies', 'Thriller', 'World cinema', 'Romance Film', 'Drama']",1970,6
9631759,The Law of the Wild,1934,['United States of America'],"['Action', 'Black-and-white', 'Action/Adventure', 'Western', 'Adventure', 'Drama', 'Family Film']",1930,4
35013730,Mambéty For Ever,2008,"['France', 'Cameroon']",['Documentary'],2000,8
27824303,The Second Time Around,1961,['United States of America'],"['Comedy Western', 'Western', 'Comedy']",1960,1
129585,Dances with Wolves,1990,"['United Kingdom', 'United States of America']","['Film adaptation', 'Revisionist Western', 'Action/Adventure', 'Costume drama', 'Adventure', 'Drama', 'Period piece', 'Epic Western', 'Western', 'Epic', 'War film', 'Indian Western']",1990,0
891807,At Play in the Fields of the Lord,1991,['United States of America'],"['Adventure', 'Drama', 'Jungle Film']",1990,1
68501,McCabe & Mrs. Miller,1971,['United States of America'],"['Revisionist Western', 'Action/Adventure', 'Western', 'New Hollywood', 'Adventure', 'Drama']",1970,1
196176,Straw Dogs,1971,"['United Kingdom', 'United States of America']","['Thriller', 'Drama']",1970,1
17227386,Asukh,1999,['India'],"['Drama', 'Art film']",1990,9
915306,Better Off Dead,1985,['United States of America'],"['Comedy', 'Teen', 'Black comedy', 'Romantic comedy', 'Romance Film']",1980,5
670267,Suburbia,1984,['United States of America'],"['Punk rock', 'Indie', 'Drama']",1980,4
3301903,Undercover Blues,1993,['United States of America'],"['Action', 'Spy', 'Crime Fiction', 'Action/Adventure', 'Comedy']",1990,3
12403535,Rainbow Valley,1935,['United States of America'],"['Black-and-white', 'Western', 'Drama']",1930,5
5042018,Max Havoc: Curse of the Dragon,2004,['United States of America'],"['Action', 'Crime Fiction', 'Gangster Film', 'Action/Adventure', 'Martial Arts Film']",2000,4
1609735,Agatha,1979,"['United Kingdom', 'United States of America']",['Drama'],1970,9
7675727,The Uninvited,1944,['United States of America'],"['Black-and-white', 'LGBT', 'Mystery']",1940,4
238810,Air Force One,1997,"['Germany', 'United States of America']","['Action', 'Action Thrillers', 'Action/Adventure', 'Thriller', 'Disaster', 'Airplanes and airports', 'Suspense', 'Short Film', 'Political drama', 'Political thriller']",1990,7
8633676,The Flying Scotsman,2006,"['United Kingdom', 'Germany']","['Drama', 'Indie', 'World cinema', 'Sports']",2000,6
6349064,Kamen Rider Hibiki & The Seven War Demons,2005,['Japan'],['Japanese Movies'],2000,5
685721,Teen Wolf Too,1987,['United States of America'],"['Creature Film', 'Parody', 'Comedy', 'Cult']",1980,7
20181767,The Castle,1997,"['New Zealand', 'Australia']","['Indie', 'Comedy', 'World cinema', 'Cult']",1990,7
6012645,Dil Ne Phir Yaad Kiya,1966,['India'],"['Bollywood', 'World cinema']",1960,6
68130,Badlands,1973,['United States of America'],"['Crime Fiction', 'Mystery', 'Indie', 'Romantic drama', 'Thriller', 'Romance Film', 'Americana', 'Drama', 'Period piece', 'Existentialism', 'New Hollywood', 'Crime Drama', 'Road movie']",1970,3
27057768,Dirty Pair: Project Eden,1986,['Japan'],['Japanese Movies'],1980,6
4430611,Shock,2006,['India'],['Action'],2000,6
26178713,Music for Millions,1944,['United States of America'],"['Musical', 'Comedy', 'Drama']",1940,4
7862294,Achhut Kanya,1936,['India'],"['Black-and-white', 'Romantic drama', 'Drama']",1930,6
28158384,The International,2006,['Turkey'],"['Music', 'Drama', 'Comedy film']",2000,6
3024556,Casa de los Babys,2003,"['Mexico', 'United States of America']","['Indie', 'Comedy', 'Social problem film', 'Drama', 'Ensemble Film']",2000,3
22406095,Suspect X,2008,['Japan'],"['Detective fiction', 'Crime Fiction', 'Mystery', 'Thriller', 'World cinema', 'Whodunit', 'Crime Thriller', 'Drama', 'Japanese Movies', 'Detective']",2000,8
553101,The Fly,1958,['United States of America'],"['Science Fiction', 'Cult', 'Horror']",1950,8
12284593,Bogus,1996,['United States of America'],"['Comedy', 'Religious Film', 'Fantasy Comedy', 'Family Film', 'Fantasy']",1990,6
24109118,Breakfast for Two,1937,['United States of America'],"['Black-and-white', 'Comedy', 'Romance Film', 'Romantic comedy', 'Slapstick']",1930,7
18004278,Sreekrishna parunthu,1984,['India'],['Horror'],1980,4
24548569,The Wiggles Movie,1997,['Australia'],"['Music', 'Action', 'Comedy film', 'Adventure', 'Family Film']",1990,7
28785611,Escape to Danger,1943,['United Kingdom'],['Thriller'],1940,3
24051101,Nazty Nuisance,1943,['United States of America'],"['Action', 'Short Film', 'Comedy film', 'War film', 'Adventure', 'Fantasy']",1940,3
9056967,The Bodyguard,1944,['United States of America'],"['Animated cartoon', 'Short Film', 'Comedy', 'Family Film']",1940,4
4316412,Final Analysis,1992,['United States of America'],"['Psychological thriller', 'Thriller', 'Crime Thriller', 'Drama']",1990,2
10822118,Kung Fu Instructor,1979,['Hong Kong'],"['Action', 'Drama', 'Chinese Movies', 'Martial Arts Film']",1970,9
26340143,The Choppers,1961,['United States of America'],"['Action', 'Drama', 'Crime Fiction', 'Action/Adventure']",1960,1
15644478,I Love You Beth Cooper,2009,"['Canada', 'United States of America']","['Coming of age', 'Comedy', 'Teen', 'Romance Film', 'Romantic comedy']",2000,9
32170662,Aandhi-Toofan,1985,[],['Drama'],1980,5
24549683,Vesham,2004,['India'],['Drama'],2000,4
145652,None but the Lonely Heart,1944,['United States of America'],"['Film adaptation', 'Drama']",1940,4
1613865,The Woman in the Window,1945,['United States of America'],"['Psychological thriller', 'Film adaptation', 'Black-and-white', 'Crime Fiction', 'Thriller', 'Film noir', 'Crime Thriller', 'Drama', 'Suspense', 'Crime Drama']",1940,5
25328344,Le Boulet,2002,"['United Kingdom', 'France']","['Action', 'Comedy', 'Adventure']",2000,2
23579618,The Nun and the Sergeant,1962,['United States of America'],"['War film', 'Drama']",1960,2
2492402,Waisa Bhi Hota Hai Part II,2003,['India'],"['Action/Adventure', 'World cinema']",2000,3
15770244,Dead Dudes in the House,1991,['United States of America'],"['B-movie', 'Indie', 'Horror']",1990,1
2958168,Lovely & Amazing,2001,['United States of America'],"['Indie', 'Family Drama', 'Comedy', 'Romance Film', 'Drama', 'Domestic Comedy', 'Romantic comedy', 'Comedy-drama']",2000,1
1774803,Bridget Jones's Diary,2001,"['United Kingdom', 'France', 'Ireland']","['Film adaptation', 'Comedy', 'Comedy of manners', 'Romance Film', 'Romantic comedy', 'Drama']",2000,1
32490842,Malibu Shark Attack,2009,[],"['Thriller', 'Horror', 'Television movie', 'Science Fiction']",2000,9
26640913,Shoot Out,1971,['United States of America'],"['Action', 'Action/Adventure', 'Western', 'Adventure']",1970,1
101927,Bound for Glory,1976,['United States of America'],"['Biography', 'Biographical film', 'Drama']",1970,6
2900798,Beyond the Poseidon Adventure,1979,['United States of America'],"['Action', 'Action/Adventure', 'Thriller', 'Disaster', 'Adventure']",1970,9
219712,Final Destination,2000,"['Canada', 'United States of America']","['Slasher', 'Thriller', 'Horror', 'Teen', 'Supernatural', 'Cult']",2000,0
18965982,Love Me and the World Is Mine,1927,['United States of America'],"['Silent film', 'Black-and-white', 'Drama']",1920,7
34764141,A Sacred Duty,2007,[],['Documentary'],2000,7
13517240,John Appa Rao 40 plus,2008,['India'],['Comedy'],2000,8
846239,Preaching to the Perverted,1997,['United Kingdom'],"['LGBT', 'Political satire', 'Indie', 'Political cinema', 'Comedy', 'Sex comedy']",1990,7
15461322,Riders of the Whistling Skull,1937,['United States of America'],"['Action', 'Black-and-white', 'Hybrid Western', 'Action/Adventure', 'Western']",1930,7
146947,Spider-Man,2002,['United States of America'],"['Action', 'Coming of age', 'Action/Adventure', 'Superhero movie', 'Adventure', 'Fantasy']",2000,2
16205281,Brenda Starr,1989,['United States of America'],"['Action', 'Action/Adventure', 'Comedy', 'Adventure']",1980,9
4130836,Mo' Money,1992,['United States of America'],"['Action', 'Crime Fiction', 'Action/Adventure', 'Comedy', 'Thriller', 'Crime Comedy']",1990,2
7482551,This Charming Girl,2005,['South Korea'],['Drama'],2000,5
3261900,Lovers' Concerto,2002,['South Korea'],"['Romantic drama', 'World cinema', 'Romance Film', 'Drama']",2000,2
21700137,Ek Bar Bolo Uttam Kumar,2009,['India'],['Comedy'],2000,9
6557119,The Curse of King Tut's Tomb,2006,['United States of America'],"['Action', 'Action/Adventure', 'Thriller', 'Horror', 'Adventure', 'Fantasy']",2000,6
213275,Back to the Future Part III,1990,['United States of America'],"['Western', 'Hybrid Western', 'Comedy', 'Adventure', 'Science Fiction', 'Family Film']",1990,0
28062869,Charlie Valentine,2009,['United States of America'],"['Crime Drama', 'Crime Fiction', 'Drama']",2000,9
2354145,Curse of the Pink Panther,1983,['United Kingdom'],"['Parody', 'Slapstick', 'Comedy']",1980,3
615121,The Dreamers,2003,"['United Kingdom', 'France', 'Italy']","['History', 'Romantic drama', 'Romance Film', 'Drama']",2000,3
1017172,Red Nightmare,1962,['United States of America'],"['Educational', 'Short Film', 'Propaganda film', 'Drama']",1960,2
28327626,Assault,1971,['United Kingdom'],"['Crime Fiction', 'Mystery', 'Thriller', 'Horror', 'Drama']",1970,1
5566319,The Virginian,1929,['United States of America'],"['Western', 'Black-and-white']",1920,9
1904012,Broken Flowers,2005,"['United States of America', 'France']","['Mystery', 'Comedy', 'Road movie', 'Drama']",2000,5
3515134,Vampire Assassin,2005,['United States of America'],"['Creature Film', 'Action', 'Action Thrillers', 'Indie', 'Action/Adventure', 'Thriller', 'Horror']",2000,5
2423917,Silent Rage,1982,['United States of America'],"['Action', 'Crime Fiction', 'Action/Adventure', 'Romance Film', 'Martial Arts Film', 'Slasher', 'Horror', 'Science Fiction']",1980,2
13614303,Mirush,2007,"['Norway', 'Denmark']","['Crime Fiction', 'Family Drama', 'World cinema', 'Drama']",2000,7
2886036,Talladega Nights: The Ballad of Ricky Bobby,2006,['United States of America'],"['Action', 'Auto racing', 'Parody', 'Action/Adventure', 'Comedy', 'Sports']",2000,6
20016282,A Burning Passion: The Margaret Mitchell Story,1994,['United States of America'],"['Drama', 'Biographical film']",1990,4
18982622,1990: The Bronx Warriors,1982,['Italy'],"['Action', 'Science Fiction', 'Thriller']",1980,2
3432061,Hollywood Chainsaw Hookers,1988,['United States of America'],"['Parody', 'Horror Comedy', 'Slasher', 'Horror', 'Comedy', 'B-movie']",1980,8
27797576,Gavilán o Paloma,1985,['Mexico'],['Drama'],1980,5
11472208,Dauria,1971,['Soviet Union'],"['Period piece', 'Romantic drama', 'Romance Film', 'War film', 'Drama']",1970,1
7832768,The Last Temptation of Christ,1988,"['Canada', 'United States of America']","['Hagiography', 'Drama']",1980,8
35958854,Abdullah,1980,['India'],"['Action', 'Drama', 'Family Film']",1980,0
18301225,The Big Empty,2005,['United States of America'],"['Short Film', 'Comedy', 'Drama', 'Fantasy']",2000,5
23968034,Annarth,2002,['India'],"['Action/Adventure', 'Drama', 'World cinema']",2000,2
9966281,Storm Rider Clash of the Evils,2008,"['China', 'Hong Kong']","['Wuxia', 'Chinese Movies']",2000,8
18498744,Wake up Sid,2009,['India'],"['Romance Film', 'Comedy', 'Drama']",2000,9
22474173,The Candy Snatchers,1973,['United States of America'],"['Crime Fiction', 'Thriller', 'Crime Thriller', 'Drama']",1970,3
19485792,Kathavarayan,2008,['India'],"['Action', 'Comedy']",2000,8
25665895,Mädchen in Uniform,1958,"['Germany', 'West Germany']","['LGBT', 'History', 'Biography', 'World cinema', 'Drama']",1950,8
22937227,Alvin and the Chipmunks: The Squeakquel,2009,['United States of America'],"['Music', 'Computer Animation', 'Comedy', ""Children's"", 'Family Film', 'Fantasy']",2000,9
3548070,"Little Indian, Big City",1994,['France'],"['Romance Film', 'Comedy', 'Adventure']",1990,4
9023878,Spartacus,2004,[],"['Biographical film', 'Movies About Gladiators']",2000,4
8913555,Scarlett,1994,[],"['Romance Film', 'Drama']",1990,4
11235792,Kali Ghata,1980,['India'],"['Romance Film', 'Mystery', 'Thriller']",1980,0
4579510,Fatal Fury: The Motion Picture,1994,['Japan'],"['Anime', 'Japanese Movies', 'Science Fiction']",1990,4
354536,Son of Dracula,1974,['United Kingdom'],"['Musical', 'Comedy', 'Horror']",1970,4
4864939,Ek Duuje Ke Liye,1981,['India'],"['Musical', 'Romantic drama', 'Bollywood', 'World cinema', 'Romance Film', 'Drama']",1980,1
11392834,Patita,1953,['India'],['World cinema'],1950,3
27674928,The Mermaid Chair,2006,"['Canada', 'United States of America']","['Film adaptation', 'Television movie', 'Drama']",2000,6
733657,Carry On Cleo,1964,['United Kingdom'],"['Parody', 'Slapstick', 'Comedy']",1960,4
21271533,Bleeder,1999,['Denmark'],"['Thriller', 'Drama']",1990,9
2888880,Life or Something Like It,2002,['United States of America'],"['Romantic drama', 'Comedy', 'Media Satire', 'Romantic comedy', 'Romance Film', 'Comedy-drama', 'Drama']",2000,2
1191886,Golden Years,1991,['United States of America'],"['Drama', 'Science Fiction', 'Thriller']",1990,1
3523982,Sky High,2003,['Japan'],"['Action', 'Mystery', 'Action/Adventure', 'Thriller', 'World cinema', 'Crime Thriller', 'Drama', 'Japanese Movies', 'Horror', 'Supernatural', 'Fantasy']",2000,3
3635829,Running Scared,2006,"['Germany', 'United States of America']","['Action', 'Gangster Film', 'Action/Adventure', 'Thriller', 'Crime Thriller', 'Drama']",2000,6
5023581,She-Wolf of London,1946,['United States of America'],"['Psychological thriller', 'Black-and-white', 'Mystery', 'Thriller', 'Horror']",1940,6
22074076,Love Rules,2004,['United States of America'],['Romance Film'],2000,4
1891348,Alien Planet,2005,[],[],2000,5
33125317,Sun Seekers,1972,"['Germany', 'German Democratic Republic']","['Drama', 'World cinema']",1970,2
49800,Lara Croft: Tomb Raider,2001,"['Japan', 'United Kingdom', 'Germany', 'United States of America']","['Action', 'Fantasy Adventure', 'Japanese Movies', 'Action/Adventure', 'Thriller', 'Adventure', 'Fantasy']",2000,1
25482380,Ordinary Miracles,2005,['United States of America'],"['Drama', 'Television movie']",2000,5
5338254,Ride Lonesome,1959,['United States of America'],"['Action', 'Western', 'Action/Adventure']",1950,9
6879392,The Ultimate Silly Song Countdown,2001,['United States of America'],"['Musical', 'Animation', 'Short Film', 'Comedy', ""Children's""]",2000,1
29358654,Not Worth a Fig,2009,[],['Drama'],2000,9
14811925,"Cornbread, Earl and Me",1975,['United States of America'],"['Crime Fiction', 'Melodrama', 'Sports', 'Drama']",1970,5
790670,Space Mutiny,1988,['South Africa'],"['World cinema', 'Adventure', 'Science Fiction', 'Cult']",1980,8
6880509,Newsfront,1978,"['New Zealand', 'Australia']","['Period piece', 'Drama', 'Indie', 'World cinema']",1970,8
2212338,The Cry of the Owl,1987,"['France', 'Italy']","['Crime Fiction', 'Thriller', 'World cinema']",1980,7
19286343,En Kadamai,1964,['India'],['Drama'],1960,4
15936289,Barbie and the Diamond Castle,2008,"['Colombia', 'Italy']","[""Children's Fantasy"", 'Animation', ""Children's/Family"", 'Family Film', 'Computer Animation']",2000,8
3537064,Medea,1969,"['France', 'Germany', 'West Germany', 'Italy']","['Drama', 'World cinema']",1960,9
21675573,Postcards from the Edge,1990,['United States of America'],"['Biography', 'Comedy', 'Black comedy', 'Comedy-drama', 'Drama']",1990,0
4125153,Chandni,1989,['India'],"['Musical', 'Romantic drama', 'Bollywood', 'World cinema', 'Romance Film', 'Drama']",1980,9
3645643,Quai des Orfèvres,1947,['France'],"['Crime Fiction', 'Marriage Drama', 'World cinema', 'Crime Drama', 'Drama']",1940,7
12216999,Blood Song,1988,['United States of America'],"['Indie', 'Horror']",1980,8
10085500,Those Were the Days,1934,['United Kingdom'],"['Comedy', 'Black-and-white']",1930,4
20148363,My Bloody Roommates,2006,['South Korea'],"['World cinema', 'Horror']",2000,6
6488612,Gulliver's Travels Beyond the Moon,1965,['Japan'],"['Japanese Movies', 'Science Fiction', 'Sci-Fi Adventure', 'Anime', 'Fantasy']",1960,5
21437626,Duped Till Doomsday,1957,"['Germany', 'German Democratic Republic']","['Black-and-white', 'Drama']",1950,7
26738341,Kill Theory,2008,['United States of America'],"['Indie', 'Slasher', 'Thriller', 'Horror', 'Teen']",2000,8
28470255,The Wind of Change,1961,[],['Drama'],1960,1
28008719,The Black Ninja,2003,['United States of America'],"['Action', 'Action Thrillers', 'Gangster Film', 'Action/Adventure', 'Comedy', 'Thriller', 'Martial Arts Film']",2000,3
33301193,Swarg Se Sundar,1986,['India'],"['Musical', 'Romantic drama', 'Bollywood', 'World cinema', 'Romance Film', 'Drama', 'Family Film']",1980,6
5408166,Sällskapsresan,1980,['Sweden'],['Comedy'],1980,0
20579737,Geet,1970,['India'],['Action'],1970,0
7548126,Gorilla at Large,1954,['United States of America'],"['Detective fiction', 'Mystery', 'Thriller', 'Detective', 'Horror', 'Crime Thriller']",1950,4
19848011,99 Francs,2007,['France'],"['Media Satire', 'Drama', 'Comedy']",2000,7
4426490,Equinox,1970,['United States of America'],"['Monster movie', 'Horror', 'Stop motion', 'B-movie', 'Supernatural', 'Cult']",1970,0
21170436,Evening Bell,1988,['China'],"['Drama', 'Chinese Movies', 'War film']",1980,8
19998694,Absolon,2003,"['Canada', 'United Kingdom']","['Action', 'Action/Adventure', 'Indie', 'Science Fiction', 'Thriller']",2000,3
4634549,Fraidy Cat,1942,['United States of America'],['Short Film'],1940,2
25083700,Christmas in Canaan,2009,['United States of America'],"['Drama', 'Family Film']",2000,9
2748481,Moon Over Miami,1941,['United States of America'],"['Musical', 'Comedy', 'Musical comedy', 'Romance Film', 'Romantic comedy']",1940,1
20909648,The Carpetbaggers,1964,['United States of America'],"['Romance Film', 'Film à clef', 'Drama']",1960,4
1811116,Rookie of the Year,1993,['United States of America'],"['Coming of age', 'Comedy', 'Sports', 'Family Film', 'Fantasy']",1990,3
22265189,Olavum Theeravum,1970,['India'],['Drama'],1970,0
9268117,Khaidi No.786,1988,['India'],['Family Film'],1980,8
92715,Judgment at Nuremberg,1961,['United States of America'],"['Political drama', 'Drama', 'Courtroom Drama']",1960,1
343404,Withnail and I,1987,"['United Kingdom', 'England']","['Period piece', 'Drama', 'Indie', 'Buddy film', 'Comedy', 'Black comedy', 'Cult']",1980,7
5870620,Shakti,1982,['India'],"['Musical', 'Action/Adventure', 'Bollywood', 'World cinema', 'Drama']",1980,2
12231869,Gloria,1999,['United States of America'],"['Crime Fiction', 'Gangster Film', 'Drama']",1990,9
10386609,Frauengefängnis,1976,['Switzerland'],"['Crime Fiction', 'Thriller', 'Horror', 'Drama']",1970,6
1999677,Wolfen,1981,['United States of America'],"['Creature Film', 'Film adaptation', 'Horror', 'Drama']",1980,1
347235,Wes Craven's New Nightmare,1994,['United States of America'],"['Slasher', 'Teen', 'Horror', 'Supernatural', 'Cult']",1990,4
13983035,Ödipussi,1988,['Germany'],['Comedy'],1980,8
22330502,Inspiration,1931,['United States of America'],"['Black-and-white', 'Drama']",1930,1
1530223,Rock Star,2001,['United States of America'],"['Musical', 'Period piece', 'Musical Drama', 'Comedy', 'Comedy-drama', 'Drama']",2000,1
23608595,The First Auto,1927,['United States of America'],"['Silent film', 'Drama', 'Comedy film']",1920,7
7362564,Tale of Cinema,2005,['South Korea'],['Drama'],2000,5
13807033,Kilometer Zero,2007,['Russia'],"['Romance Film', 'Comedy-drama', 'Road movie', 'Tragicomedy', 'Drama']",2000,7
10473518,A Moment of Romance,1990,['Hong Kong'],"['Romantic drama', 'World cinema', 'Romance Film', 'Chinese Movies', 'Drama']",1990,0
12425249,Der Raub der Mona Lisa,1931,['Germany'],"['Black-and-white', 'Drama']",1930,1
7114779,Hold That Ghost,1941,['United States of America'],"['Black-and-white', 'Comedy', 'Horror', 'Slapstick', 'Haunted House Film']",1940,1
7482708,Bewitching Attraction,2006,['South Korea'],"['Drama', 'Comedy', 'Comedy film', 'Black comedy', 'Erotica', 'Adult']",2000,6
14336880,My Best Friend's Girlfriend,2008,['Philippines'],"['Filipino Movies', 'Romantic drama', 'Comedy', 'World cinema', 'Romance Film', 'Romantic comedy', 'Drama']",2000,8
477385,Just Married,2003,['United States of America'],"['Romance Film', 'Romantic comedy', 'Comedy']",2000,3
15051827,Barbie and the Rockers: Out of this World,1987,['United States of America'],"['Animation', 'Adventure', ""Children's/Family"", ""Children's""]",1980,7
20678499,Bitter Sweet,1940,['United States of America'],['Musical'],1940,0
26084706,The Story of Joseph and His Brethren,1962,"['Yugoslavia', 'Italy']","[""Children's/Family"", 'Epic', 'Hagiography', ""Children's"", 'Drama', 'Family Film']",1960,2
57585,Casablanca,1942,['United States of America'],"['Airplanes and airports', 'Black-and-white', 'Romantic drama', 'Romance Film', 'War film', 'Drama']",1940,2
28995043,The Traveller,2009,"['Italy', 'Egypt']","['Romantic drama', 'World cinema', 'Romance Film', 'Drama']",2000,9
3705395,Murder at the Gallop,1963,['United Kingdom'],"['Film adaptation', 'Detective fiction', 'Black-and-white', 'Crime Fiction', 'Mystery', 'Comedy', 'Thriller', 'Whodunit', 'Detective']",1960,3
29752356,Chaalbaaz,2003,['India'],['Action'],2000,3
33921745,Suryavamsam,1998,['India'],['Drama'],1990,8
3692484,Three Godfathers,1948,['United States of America'],"['Western', 'Action/Adventure', 'Christmas movie']",1940,8
2695420,Shooting the Past,1999,['United Kingdom'],"['History', 'Slice of life story', 'Drama']",1990,9
18156174,The Last of the Secret Agents?,1966,['United States of America'],"['Spy', 'Parody', 'Comedy']",1960,6
27137136,Bhargavacharitham Moonam Khandam,2006,['India'],"['Action', 'Comedy film']",2000,6
3383318,The Foreigner,2003,['United States of America'],"['Action', 'Action/Adventure', 'Thriller']",2000,3
1338721,Bunny Lake Is Missing,1965,['United Kingdom'],"['Psychological thriller', 'Mystery', 'Thriller', 'Crime Thriller']",1960,5
17041756,Freelance,2007,['United States of America'],['Comedy'],2000,7
26808448,Appu,1990,['India'],"['Drama', 'Comedy', 'Thriller']",1990,0
25209676,Rikshavodu,1995,['India'],"['Action', 'Drama', 'Family Film']",1990,5
25849276,Ravi Shastri,2006,['India'],['Drama'],2000,6
14964780,Diminished Capacity,2008,['United States of America'],"['Indie', 'Comedy', 'Road movie', 'Sports']",2000,8
2482892,And Soon the Darkness,1970,['United Kingdom'],"['Psychological thriller', 'Suspense', 'Mystery', 'Indie', 'Thriller', 'Horror', 'Crime Thriller']",1970,0
1364299,The Devil and Miss Jones,1941,['United States of America'],"['Black-and-white', 'Satire', 'Comedy', 'Romance Film', 'Workplace Comedy', 'Drama']",1940,1
6685314,The Endurance: Shackleton's Legendary Antarctic Expedition,2001,"['Sweden', 'United Kingdom', 'Germany', 'United States of America']","['Documentary', 'History']",2000,1
1210091,The Little Rascals,1994,['United States of America'],"['Romance Film', 'Comedy', 'Family Film']",1990,4
36474734,Love and Curses,1938,['United States of America'],"['Animation', 'Short Film', 'Family Film']",1930,8
18065990,The River Niger,1976,['United States of America'],"['Social problem film', 'Drama']",1970,6
2920077,Soldier of Orange,1977,['Netherlands'],"['War film', 'Drama', 'World cinema']",1970,7
848218,Always,1989,['United States of America'],"['Airplanes and airports', 'Romantic drama', 'Romance Film', 'Drama', 'Fantasy']",1980,9
35958353,Beast Wars Second: LioConvoy in imminent danger!,1998,['Japan'],"['Anime', 'Japanese Movies']",1990,8
5995554,Jhanak Jhanak Payal Baje,1955,['India'],"['Musical', 'Romantic drama', 'Bollywood', 'World cinema', 'Romance Film', 'Drama']",1950,5
34530005,I Will Repay,1923,"['United Kingdom', 'United States of America']","['Historical drama', 'Silent film', 'Adventure', 'Drama']",1920,3
14725249,Into the Sun,1992,['United States of America'],"['Action', 'Action/Adventure']",1990,2
3494241,The Mummy's Tomb,1942,['United States of America'],"['Creature Film', 'Black-and-white', 'Horror', 'Archaeology']",1940,2
4790321,"Enemies, a Love Story",1989,['United States of America'],"['Film adaptation', 'Romantic drama', 'Comedy', 'Romance Film', 'Drama']",1980,9
5737121,Thicker Than Water,1999,['United States of America'],"['Drama', 'Sports', 'Hip hop movies']",1990,9
28759732,If You Believe,1999,['United States of America'],['Drama'],1990,9
2297409,Queen of Outer Space,1958,['United States of America'],"['Adventure', 'Science Fiction', 'Cult', 'Fantasy']",1950,8
2258378,Houseboat,1958,['United States of America'],"['Comedy', 'Romance Film', 'Romantic comedy', 'Domestic Comedy', 'Drama', 'Family Film']",1950,8
5319350,Dorf Goes Fishing,1993,['United States of America'],"['Sports', 'Short Film', 'Comedy']",1990,3
14503994,Le Chaos,2007,"['France', 'Egypt']","['Art film', 'Drama', 'World cinema']",2000,7
311765,Batman: Mask of the Phantasm,1993,['United States of America'],"['Action', 'Animation', 'Superhero', 'Action/Adventure', 'Thriller', 'Superhero movie', ""Children's/Family""]",1990,3
2684050,A Canção de Lisboa,1933,['Portugal'],"['Comedy', 'Black-and-white']",1930,3
16197097,The House in the Square,1951,['United Kingdom'],"['Romance Film', 'Drama', 'Fantasy']",1950,1
11028867,The Mutilator,1985,['United States of America'],"['Indie', 'Slasher', 'Thriller', 'Horror']",1980,5
5846373,Slaves of New York,1989,['United States of America'],"['Indie', 'Comedy', 'Comedy-drama', 'Comedy of manners', 'Drama']",1980,9
32669119,Mutt Boy,2003,['South Korea'],['Drama'],2000,3
6302125,Viy,1967,"['Russia', 'Soviet Union']","['Gothic Film', 'Horror', 'World cinema', 'Supernatural']",1960,7
6635409,Radha Gopalam,2005,['India'],"['Drama', 'World cinema']",2000,5
12009151,The Mephisto Waltz,1971,['United States of America'],"['Thriller', 'Horror']",1970,1
21760237,The Combination,2009,['Australia'],['Drama'],2000,9
27504477,Radha Kalyanam,1981,['India'],"['Drama', 'Family Film']",1980,1
9135416,Barney's Magical Musical Adventure,1993,[],['Short Film'],1990,3
29026991,Americans at the Black Sea,2007,['Turkey'],['Comedy film'],2000,7
25619997,Love is the Drug,2006,['United States of America'],"['Crime Fiction', 'Romantic drama', 'Romance Film', 'Drama']",2000,6
4941269,The Acid House,1998,"['Kingdom of Great Britain', 'United Kingdom']","['Film adaptation', 'Comedy', 'Black comedy', 'Drama', 'Sex comedy', 'Coming of age', 'Comedy-drama', 'Cult', 'Fantasy']",1990,8
11880818,Laberinto de pasiones,1982,['Spain'],"['Comedy', 'LGBT']",1980,2
26126499,Splinter,2006,['United States of America'],"['Action', 'Psychological thriller', 'Thriller', 'Crime Thriller']",2000,6
11284825,Le Toubib,1979,['France'],"['Romantic drama', 'War film', 'Drama']",1970,9
13631613,The Pathetic Fallacy,1958,['India'],['Drama'],1950,8
27365078,Battle of the Coral Sea,1959,['United States of America'],['War film'],1950,9
1962219,Hocus Pocus,1993,['United States of America'],"['Comedy', 'Horror', 'Family Film', 'Fantasy']",1990,3
2351490,Attack of the Crab Monsters,1957,['United States of America'],"['Creature Film', 'Monster', 'Thriller', 'Horror', 'B-movie', 'Science Fiction', 'Natural horror films']",1950,7
8097289,Channelling Baby,1999,['New Zealand'],"['Mystery', 'Family Drama', 'Drama']",1990,9
23139830,Let's Dance,2009,['India'],"['Drama', 'Bollywood', 'World cinema']",2000,9
2583808,InuYasha the Movie: The Castle Beyond the Looking Glass,2002,['Japan'],"['Action', 'Animation', 'Japanese Movies', 'Anime', 'Fantasy']",2000,2
5124302,Footpath,2003,['India'],"['Drama', 'World cinema']",2000,3
4562661,Rio Rita,1929,['United States of America'],"['Musical', 'Black-and-white', 'Romance Film', 'Roadshow theatrical release']",1920,9
22243471,Pulse 3: Invasion,2008,['United States of America'],['Horror'],2000,8
26296281,Wallander – Tjuven,2009,[],"['Drama', 'Thriller', 'Detective']",2000,9
7093096,Taste of Fear,1961,['United Kingdom'],"['Black-and-white', 'Thriller']",1960,1
5559871,Tears of the Black Tiger,2000,['Thailand'],"['Action', 'Romance Film', 'Comedy']",2000,0
35808039,La mujer del ministro,1981,"['Mexico', 'Spain']","['Pornography', 'Gay pornography', 'Drama']",1980,1
26452379,Safar Barlik,1967,[],"['Musical', 'Drama']",1960,7
5938502,Laud Weiner,2001,['United States of America'],"['Short Film', 'Comedy']",2000,1
19437242,Ke Tumi,2008,['India'],"['Suspense', 'Thriller']",2000,8
12393362,Clannad,2007,['Japan'],"['Japanese Movies', 'Anime', 'Drama', 'Fantasy']",2000,7
4207542,Cast a Dark Shadow,1955,['United Kingdom'],"['Psychological thriller', 'Film noir', 'Thriller']",1950,5
4018516,Endgame,1983,"['Italy', 'United States of America']","['Action', 'Science Fiction']",1980,3
4984630,Relax,1998,['India'],"['Action', 'Adventure']",1990,8
1204621,The Chorus,2004,"['France', 'Germany', 'Switzerland']","['Musical', 'Drama']",2000,4
1975933,Ugetsu,1953,['Japan'],"['Japanese Movies', 'World cinema', 'Drama', 'Fantasy']",1950,3
3878318,Arahan,2004,['South Korea'],"['Action', 'Action/Adventure', 'Comedy', 'World cinema', 'Martial Arts Film']",2000,4
12122902,Her Best Move,2007,['United States of America'],"['Coming of age', 'Comedy', 'Teen', 'Romance Film', 'Comedy-drama', 'Sports', 'Family Film']",2000,7
302797,Ishtar,1987,['United States of America'],"['Music', 'Adventure Comedy', 'Buddy film', 'Comedy', 'Adventure']",1980,7
20797139,"Tokyo Tower: Mom and Me, and Sometimes Dad",2007,['Japan'],"['Japanese Movies', 'Drama']",2000,7
2150739,Awaara,1951,['India'],"['Musical', 'Family Drama', 'Bollywood', 'World cinema', 'Drama']",1950,1
6562947,The Amityville Curse,1990,['Canada'],"['Mystery', 'Haunted House Film', 'Horror']",1990,0
31131834,No Way Back,1949,['United Kingdom'],"['Drama', 'Crime Fiction']",1940,9
31744787,Takkar,1995,['India'],"['Romance Film', 'Drama', 'World cinema']",1990,5
2001498,Father Goose,1964,['United States of America'],"['Adventure Comedy', 'Comedy', 'Romance Film', 'Romantic comedy', 'War film', 'Adventure']",1960,4
19885541,Duress,2009,['United States of America'],"['Psychological thriller', 'Suspense', 'Indie', 'Thriller']",2000,9
24165847,The Girl in the Red Velvet Swing,1955,['United States of America'],"['Crime Fiction', 'Biographical film', 'Thriller', 'Romance Film', 'Drama']",1950,5
36492668,"Shake, Rattle and Roll: An American Love Story",1999,['United States of America'],['Drama'],1990,9
28173243,Funky Monkey,2004,"['Germany', 'United States of America']","['Animal Picture', 'Comedy', 'Family Film']",2000,4
113449,Places in the Heart,1984,['United States of America'],"['Period piece', 'Family Drama', 'Americana', 'Drama', 'Family Film']",1980,4
27617888,The Americano,1955,['United States of America'],"['Action/Adventure', 'Western']",1950,5
26135272,Georgica,1998,['Estonia'],['Drama'],1990,8
2480103,River Queen,2005,"['United Kingdom', 'New Zealand', 'Australia']","['Period piece', 'World cinema', 'War film', 'Drama']",2000,5
2324959,Roadblock,1951,['United States of America'],"['Black-and-white', 'Crime Fiction', 'Film noir', 'Drama']",1950,1
25175182,George & A.J.,2009,[],['Short Film'],2000,9
1688975,Sade,2000,['France'],"['Period piece', 'Biopic [feature]', 'World cinema', 'Drama']",2000,0
4151108,High Spirits,1988,"['United Kingdom', 'Ireland', 'United States of America']","['Comedy', 'Horror', 'Fantasy Comedy', 'Haunted House Film', 'Fantasy']",1980,8
2632306,Waterboys,2001,['Japan'],"['LGBT', 'Japanese Movies', 'Coming of age', 'Comedy', 'Sports', 'Ensemble Film']",2000,1
2291440,Twisted Desire,1996,['United States of America'],"['Drama', 'Crime Fiction']",1990,6
19637784,Porridge,1979,['United Kingdom'],"['Escape Film', 'Comedy']",1970,9
11740933,White Hell of Pitz Palu,1930,"['Weimar Republic', 'Germany']","['Black-and-white', 'Short Film', 'Action/Adventure', 'World cinema', 'Silent film', 'Disaster', 'Drama']",1930,0
25660562,The Hit,1979,['Israel'],"['Musical', 'Comedy', 'World cinema']",1970,9
8008969,Me and My Pal,1933,['United States of America'],"['Short Film', 'Black-and-white', 'Comedy']",1930,3
1151458,Fallen,1998,['United States of America'],"['Crime Fiction', 'Thriller', 'Drama', 'Fantasy']",1990,8
5252749,Swashbuckler,1976,['United States of America'],"['Action', ""Children's"", 'Action/Adventure', 'Comedy', 'Romance Film', 'Swashbuckler films', 'Adventure']",1970,6
858597,The Secret of Roan Inish,1994,"['Ireland', 'United States of America']","['Fantasy Adventure', 'Indie', ""Children's/Family"", 'Adventure', 'Drama', ""Children's Fantasy"", 'Family Film', 'Fantasy']",1990,4
4556313,Love on the Run,1936,['United States of America'],"['Romance Film', 'Black-and-white', 'Comedy']",1930,6
3066864,Nemesis,1993,"['Denmark', 'United States of America']","['Indie', 'Science Fiction', 'Thriller']",1990,3
19366458,Amy,1997,['Australia'],"['Music', 'Drama']",1990,7
103033,Norma Rae,1979,['United States of America'],"['Social problem film', 'Family Drama', 'Drama']",1970,9
26458140,On the Threshold of Space,1956,['United States of America'],['Drama'],1950,6
10640608,Athisaya Piravi,1990,['India'],"['Action', 'Drama', 'Comedy film']",1990,0
16915757,Hu die fei,2008,['Hong Kong'],"['Romantic fantasy', 'Romantic drama', 'Chinese Movies', 'Fantasy Comedy', 'Fantasy']",2000,8
8093849,Himalaya Singh,2005,['Hong Kong'],"['Romantic drama', 'Comedy', 'World cinema', 'Romance Film', 'Chinese Movies', 'Martial Arts Film', 'Drama', 'Parody', 'Romantic comedy']",2000,5
54540,Coming to America,1988,['United States of America'],"['Comedy', 'Comedy of manners', 'Romance Film', 'Romantic comedy', 'Drama', 'Comedy of Errors']",1980,8
1684124,The Enchanted Cottage,1945,['United States of America'],"['Black-and-white', 'Romance Film', 'War film', 'Drama', 'Fantasy']",1940,5
2294830,The Rebel Rousers,1970,['United States of America'],"['Crime', 'Drama']",1970,0
3324212,Rainbow Brite and the Star Stealer,1985,"['Japan', 'United States of America']","['Animation', ""Children's/Family"", ""Children's"", ""Children's Fantasy"", 'Japanese Movies', 'Science Fiction', 'Family Film', 'Fantasy']",1980,5
23242236,Scrubbers,1983,['United Kingdom'],"['Prison', 'Crime Fiction', 'Drama']",1980,3
4625149,Trust the Man,2006,['United States of America'],"['Drama', 'Indie', 'Marriage Drama', 'Comedy', 'Romance Film', 'Romantic comedy', 'Slice of life story']",2000,6
192461,Three Kings,1999,"['United States of America', 'Australia']","['Crime Fiction', 'Action/Adventure', 'Comedy', 'Gulf War', 'Adventure', 'Drama', 'Comedy-drama', 'War film']",1990,9
1017650,Death Race 2000,1975,['United States of America'],"['Action', 'Indie', 'Action/Adventure', 'Satire', 'Dystopia', 'Sports', 'Science Fiction', 'Cult']",1970,5
13667132,Candy Stripers,1978,['United States of America'],['Pornographic movie'],1970,8
32529107,Scout's Honor,1980,[],"['Family Film', 'Drama', 'Comedy film']",1980,0
8288693,Mississippi,1935,['United States of America'],"['Musical', 'Black-and-white', 'Comedy', 'Musical comedy', 'Romantic comedy']",1930,5
11961005,Swami,2006,['India'],"['Drama', 'World cinema']",2000,6
5884882,Even Hitler Had A Girlfriend,1991,['United States of America'],['Comedy'],1990,1
15301003,The Adventures of Food Boy,2008,['United States of America'],"['Coming of age', 'Indie', 'Comedy', 'Teen', 'Drama', 'Family Film']",2000,8
1443103,The Professionals,1966,['United States of America'],"['Action', 'Western', 'Action/Adventure']",1960,6
14062612,Happy Campers,2001,['United States of America'],"['Black comedy', 'Comedy']",2000,1
576204,Cousins,1989,['United States of America'],"['Romance Film', 'Romantic comedy', 'Comedy']",1980,9
8502589,The Astounding She-Monster,1957,['United States of America'],"['Alien Film', 'Science Fiction', 'Horror']",1950,7
27722004,La Nuit fantastique,1942,['France'],['Fantasy'],1940,2
3654231,L'eclisse,1962,"['France', 'Italy']","['Black-and-white', 'Art film', 'World cinema', 'Drama']",1960,2
4822799,Tales of Ordinary Madness,1981,['Italy'],"['Drama', 'Indie', 'Biography', 'World cinema']",1980,1
7764230,Black Beauty,1994,"['United Kingdom', 'United States of America']","['Film adaptation', 'Coming of age', 'Romance Film', 'Adventure', 'Drama', 'Family Film']",1990,4
444061,Idaho Transfer,1973,['United States of America'],"['Science Fiction', 'Time travel']",1970,3
19400692,Our Gang Follies of 1936,1935,['United States of America'],"['Musical', 'Black-and-white', 'Short Film', 'Comedy', 'Family Film']",1930,5
12424219,Displaced,2006,['United Kingdom'],"['Action', 'Buddy film', 'Adventure', 'Martial Arts Film', 'Science Fiction']",2000,6
3940904,Eleven Men Out,2007,"['United Kingdom', 'Finland', 'Iceland']","['LGBT', 'Comedy', 'World cinema', 'Comedy-drama', 'Sports', 'Drama']",2000,7
2506530,Hu Tu Tu,1999,['India'],"['Musical', 'Art film', 'Bollywood', 'World cinema', 'Drama']",1990,9
407628,Superman IV: The Quest For Peace,1987,"['United Kingdom', 'United States of America']","['Action', 'Superhero', 'Action/Adventure', 'Thriller', 'Superhero movie', 'Science Fiction', 'Fantasy']",1980,7
8974603,Rockford,1999,['India'],"['Comedy', 'Bollywood', 'Drama', 'Family Film']",1990,9
230481,Predator,1987,['United States of America'],"['Creature Film', 'Monster movie', 'Action', 'Action/Adventure', 'Horror', 'Alien Film', 'Science Fiction']",1980,7
34394367,The Mouse that Jack Built,1959,['United States of America'],"['Animation', 'Short Film', 'Comedy film', 'Family Film']",1950,9
4380748,Blood on Satan's Claw,1971,['United Kingdom'],['Horror'],1970,1
733927,Outbreak,1995,['United States of America'],"['Action', 'Action Thrillers', 'Thriller', 'Disaster', 'Science Fiction', 'Drama']",1990,5
15974702,"Harry Tracy, Desperado",1982,['Canada'],"['Western', 'Drama']",1980,2
4639222,1408,2007,['United States of America'],"['Film adaptation', 'Thriller', 'Horror', 'Supernatural']",2000,7
748895,Sonatine,1993,['Japan'],"['Action', 'Crime Fiction', 'Action/Adventure', 'Thriller', 'World cinema', 'Crime Thriller', 'Drama', 'Japanese Movies']",1990,3
1336564,Backlash,1956,['United States of America'],['Western'],1950,6
7803049,Shiloh,1996,['United States of America'],"['Coming of age', 'Family Drama', 'Drama', 'Family Film']",1990,6
9948022,Muni,2007,['India'],"['Musical', 'Thriller', 'Bollywood', 'Horror', 'World cinema']",2000,7
8908715,Epoch,2000,['United States of America'],"['Thriller', 'Television movie', 'Disaster', 'Science Fiction']",2000,0
6030973,Grizzly Falls,1999,"['United Kingdom', 'United States of America', 'Canada']","['Animal Picture', 'Family-Oriented Adventure', 'Adventure', 'Drama']",1990,9
1873017,Boxcar Bertha,1972,['United States of America'],"['Period piece', 'Crime Fiction', 'Thriller', 'Docudrama', 'Crime Thriller', 'Road movie', 'Drama']",1970,2
19351229,Alibi Bye Bye,1935,['United States of America'],"['Short Film', 'Black-and-white']",1930,5
1231877,Patch Adams,1998,['United States of America'],"['Biography', 'Comedy', 'Biographical film', 'Tragicomedy', 'Drama', 'Medical fiction', 'Biopic [feature]', 'Comedy-drama']",1990,8
8924330,The Confession,1999,['United States of America'],"['Drama', 'Thriller', 'Courtroom Drama']",1990,9
1798744,Ark,2005,"['United States of America', 'South Korea']","['Action', 'Animation', 'Anime', 'Science Fiction', 'Drama', 'Computer Animation']",2000,5
24646309,"No Pain, No Gain",2005,['United States of America'],"['Drama', 'Comedy film']",2000,5
7094159,The New Spirit,1942,['United States of America'],"['Animation', 'Short Film', 'Comedy', 'Documentary', 'War film', 'Drama']",1940,2
1064199,Metroland,1997,"['United Kingdom', 'France', 'Spain']","['Film adaptation', 'Erotic Drama', 'Indie', 'Romantic drama', 'Romance Film', 'Drama', 'Period piece', 'Marriage Drama', 'Domestic Comedy', 'Comedy-drama']",1990,7
26546192,Into Temptation,2009,['United States of America'],"['Drama', 'Crime Fiction', 'Mystery', 'Indie', 'Thriller', 'Crime Thriller']",2000,9
10572944,Tumsa Nahin Dekha,1957,['India'],"['Musical', 'Romance Film']",1950,7
11804101,"Next Stop, Greenwich Village",1976,['United States of America'],"['LGBT', 'Comedy', 'New Hollywood', 'Romance Film', 'Romantic comedy', 'Comedy-drama', 'Drama']",1970,6
13161598,The Tom and Jerry Cartoon Kit,1962,[],"['Animation', 'Short Film', 'Comedy', 'Family Film']",1960,2
4835940,Death in Venice,1971,"['France', 'Italy']","['Gay Themed', 'Film adaptation', 'LGBT', 'Drama']",1970,1
2560398,The Man on the Roof,1976,['Sweden'],"['Crime Fiction', 'Mystery', 'Thriller']",1970,6
14615341,Pardon My Clutch,1948,['United States of America'],"['Short Film', 'Black-and-white', 'Comedy']",1940,8
18733273,In a Year of 13 Moons,1978,"['Germany', 'West Germany']",['Drama'],1970,8
12713722,Goodbye Charlie Bright,2001,['United Kingdom'],"['Crime Drama', 'Buddy film', 'Drama']",2000,1
15094348,City of Life and Death,2009,"['China', 'Hong Kong']","['Black-and-white', 'World cinema', 'Chinese Movies', 'Drama', 'Anti-war', 'Period piece', 'History', 'Anti-war film', 'Historical Epic', 'Historical fiction', 'War film']",2000,9
8910297,Decoration Day,1990,['United States of America'],"['Film adaptation', 'Drama', 'Family Drama', 'Television movie', 'Slice of life story', 'Family Film']",1990,0
23172276,Hide and Seek,1964,[],"['Action', 'Crime Fiction', 'Thriller']",1960,4
5703032,The Haunted Castle,1921,"['Weimar Republic', 'Germany']","['Black-and-white', 'Mystery', 'Indie', 'Silent film']",1920,1
9386023,Double Bunk,1961,['United Kingdom'],"['Romantic comedy', 'Black-and-white', 'Comedy']",1960,1
36430069,Khudai,1994,['India'],['Drama'],1990,4
3645528,The White Sheik,1951,['Italy'],"['Black-and-white', 'Satire', 'Comedy', 'World cinema', 'Comedy-drama', 'Drama']",1950,1
25772675,La Cucina,2007,['United States of America'],"['LGBT', 'Romantic drama', 'Romance Film', 'Drama']",2000,7
26315574,Savages,1974,['United States of America'],['Thriller'],1970,4
14066515,Fräulein,1958,['United States of America'],"['Romance Film', 'Drama']",1950,8
28362983,Vigilante,1983,['United States of America'],"['Action', 'Drama', 'Crime Fiction', 'Action/Adventure', 'Thriller']",1980,3
3123893,Absolute Power,1997,['United States of America'],"['Suspense', 'Crime Fiction', 'Thriller', 'Crime Thriller', 'Political drama', 'Drama', 'Political thriller']",1990,7
2490751,Dr. Jekyll and Mr. Hyde,1941,['United States of America'],"['Black-and-white', 'Science Fiction', 'Horror']",1940,1
4032134,Jade,1995,['United States of America'],"['Action', 'Psychological thriller', 'Mystery', 'Thriller', 'Crime Thriller', 'Drama', 'Suspense', 'Erotic thriller']",1990,5
5904996,Veyyil,2006,['India'],['Drama'],2000,6
12614703,Love Can Seriously Damage Your Health,1996,['Spain'],"['Comedy', 'World cinema', 'Romance Film', 'Romantic comedy']",1990,6
11115743,Heavy Petting,2008,['United States of America'],"['Indie', 'Comedy', 'Romance Film', 'Romantic comedy']",2000,8
10701274,Prancer,1989,['United States of America'],"[""Children's Fantasy"", 'Animal Picture', ""Children's/Family"", 'Christmas movie', 'Drama', 'Fantasy']",1980,9
12006635,The Dark Horse,1932,['United States of America'],['Drama'],1930,2
76345,Shaft,1971,['United States of America'],"['Action', 'Blaxploitation', 'Crime Fiction', 'Mystery', 'Action/Adventure', 'Thriller', 'Drama', 'Suspense', 'Detective']",1970,1
5018435,The Godless Girl,1929,['United States of America'],"['Black-and-white', 'Silent film', 'Goat gland', 'Pre-Code', 'Drama']",1920,9
4518130,Support Your Local Gunfighter!,1971,['United States of America'],"['Action', 'Parody', 'Action/Adventure', 'Western', 'Comedy']",1970,1
10871400,Yehi Hai Zindagi,1977,['India'],['Bollywood'],1970,7
35071703,Vic,2006,['United States of America'],"['Short Film', 'Drama']",2000,6
26286352,I Killed That Man,1941,['United States of America'],"['Detective fiction', 'Mystery', 'Thriller', 'Detective', 'Film noir', 'Crime Thriller', 'Drama']",1940,1
3422774,Excess Baggage,1997,['United States of America'],"['Romance Film', 'Romantic comedy', 'Comedy']",1990,7
7111027,Then She Found Me,2007,['United States of America'],"['Comedy', 'Romance Film', 'Romantic comedy', 'Comedy-drama', 'Drama']",2000,7
7471088,The Edge of Love,2008,['United Kingdom'],"['Period piece', 'Romantic drama', 'Biographical film', 'Romance Film', 'War film', 'Drama']",2000,8
26205476,Song of the Islands,1942,['United States of America'],['Musical'],1940,2
6752032,The Lookout,2007,['United States of America'],"['Psychological thriller', 'Crime Fiction', 'Mystery', 'Thriller', 'Crime Thriller', 'Drama', 'Suspense', 'Heist']",2000,7
413207,Taxi,1998,['France'],"['Crime Fiction', 'Buddy film', 'Comedy']",1990,8
1343517,Head in the Clouds,2004,"['Spain', 'Canada', 'United Kingdom', 'United States of America']","['Period piece', 'LGBT', 'Romantic drama', 'Romance Film', 'War film', 'Drama']",2000,4
35487517,Hammer of the Gods,2009,['United States of America'],"['Action', 'Thriller', 'Horror', 'Adventure', 'Drama', 'Fantasy']",2000,9
3412583,The Longest Nite,1998,['Hong Kong'],"['Crime Fiction', 'World cinema', 'Crime Thriller', 'Chinese Movies']",1990,8
1705316,The Monkey's Uncle,1965,['United States of America'],"['Slapstick', 'Comedy', 'Animal Picture', 'Family Film']",1960,5
20164495,Passion's Way,1999,"['Germany', 'United States of America', 'Czech Republic']","['Period piece', 'Film adaptation', 'Romantic drama', 'Romance Film', 'Drama']",1990,9
5098517,My Boss's Daughter,2003,['United States of America'],"['Comedy', 'Romance Film', 'Romantic comedy', 'Slapstick']",2000,3
2274481,Psych-Out,1968,['United States of America'],"['Music', 'Drama', 'Thriller']",1960,8
21755178,Green Lantern: First Flight,2009,['United States of America'],"['Action', 'Animation', 'Superhero', 'Action/Adventure', 'Adventure', 'Superhero movie', 'Science Fiction', 'Fantasy']",2000,9
8009315,Going Bye Bye,1934,['United States of America'],"['Short Film', 'Black-and-white', 'Comedy']",1930,4
26509668,Bled,2009,['United States of America'],['Horror'],2000,9
24655985,Jekyll,2007,['United States of America'],"['Horror', 'Science Fiction']",2000,7
6480179,Alice's Wonderland,1923,['United States of America'],"['Black-and-white', 'Animation']",1920,3
5259161,The Host,2006,['South Korea'],"['Action/Adventure', 'Comedy', 'Monster', 'Horror', 'World cinema', 'Science Fiction', 'Drama']",2000,6
7192628,Betty Boop's Rise to Fame,1934,['United States of America'],['Musical'],1930,4
7847214,Down in the Delta,1998,['United States of America'],"['Coming of age', 'Indie', 'Childhood Drama', 'Americana', 'Drama']",1990,8
7195808,Lola,1961,"['France', 'Italy']","['Black-and-white', 'World cinema', 'Romance Film', 'Drama']",1960,1
19248582,Hornets' Nest,1970,['Italy'],"['War film', 'Drama']",1970,0
16198979,Kipps,1941,['United Kingdom'],"['Comedy', 'Black-and-white']",1940,1
1213319,Weekend at Bernie's II,1993,['United States of America'],"['Slapstick', 'Comedy', 'Buddy film', 'Black comedy', 'Comedy of Errors']",1990,3
19025284,Nevada,1997,['United States of America'],['Drama'],1990,7
7028314,The Little Hut,1957,['United States of America'],"['Romance Film', 'Romantic comedy', 'Comedy']",1950,7
1570532,The Set-Up,1949,['United States of America'],"['Boxing', 'Black-and-white', 'Film noir', 'Sports', 'Drama']",1940,9
8029549,Mr. Suave,2003,['Philippines'],"['Filipino Movies', 'Romantic drama', 'Comedy', 'World cinema', 'Romance Film', 'Romantic comedy', 'Drama']",2000,3
15808758,Patalghar,2003,['India'],"['Science Fiction', 'Fantasy']",2000,3
101555,When Father Was Away on Business,1985,"['Yugoslavia', 'Bosnia and Herzegovina']","['Family Drama', 'Coming of age', 'Comedy', 'World cinema', 'Comedy-drama', 'Political drama', 'Drama']",1980,5
8747643,Hell's Half Acre,1954,['United States of America'],"['Black-and-white', 'Crime Fiction', 'Mystery', 'Thriller', 'Film noir', 'Crime Thriller', 'Adventure', 'Drama']",1950,4
2492165,Rumor Has It...,2005,"['Germany', 'United States of America', 'Australia']","['Screwball comedy', 'Comedy', 'Romance Film', 'Romantic comedy', 'Drama']",2000,5
9230965,The Bullfighter and the Lady,1951,['United States of America'],"['Action', 'Black-and-white', 'Romantic drama', 'Romance Film', 'Sports', 'Drama']",1950,1
11795259,Kate's Secret,1986,['United States of America'],"['Melodrama', 'Drama']",1980,6
11854011,Lathe of Heaven,2002,"['Canada', 'United States of America']","['Psychological thriller', 'Film adaptation', 'Thriller', 'Television movie', 'Science Fiction', 'Fantasy']",2000,2
14445050,Fraternity Row,1977,['United States of America'],"['Drama', 'Docudrama', 'Teen']",1970,7
13562181,Tex,1982,['United States of America'],"['Coming of age', 'Family Drama', 'Drama', 'Family Film']",1980,2
27568194,A Hero Ain't Nothin' but a Sandwich,1978,['United States of America'],['Drama'],1970,8
21637956,Interceptor Force 2,2002,['United States of America'],"['Action', 'Action Thrillers']",2000,2
19609512,Aanchal,1980,['India'],"['Romantic drama', 'World cinema', 'Romance Film', 'Drama']",1980,0
6056195,A Fighter's Blues,2000,['Hong Kong'],"['Romance Film', 'Drama', 'Chinese Movies']",2000,0
8759169,House,2008,"['Poland', 'United States of America']","['Suspense', 'Film adaptation', 'Psychological thriller', 'Thriller', 'Horror', 'Christian film', 'Supernatural']",2000,8
17469575,Road to Dawn,2007,"['China', 'Malaysia']",['Biography'],2000,7
34979422,The Changed Man,1998,['Iran'],"['Romantic comedy', 'Comedy film']",1990,8
19317198,Bawre Nain,1950,['India'],['Romance Film'],1950,0
32815923,Khara Kadhi bolu naye,1987,['India'],['Comedy film'],1980,7
17594472,Fatal Deception: Mrs. Lee Harvey Oswald,1993,['United States of America'],['Drama'],1990,3
19758193,All About Hash,1940,['United States of America'],"['Black-and-white', 'Short Film', 'Comedy', 'Family Film']",1940,0
652445,Armour of God II: Operation Condor,1991,['Hong Kong'],"['Action', 'Crime Fiction', 'Action/Adventure', 'Comedy', 'Thriller', 'World cinema', 'Chinese Movies', 'Martial Arts Film', 'Adventure']",1990,1
10393442,The Wiser Sex,1932,['United States of America'],"['Black-and-white', 'Comedy', 'Drama']",1930,2
9272916,Alli Arjuna,2001,['India'],"['Romantic drama', 'World cinema', 'Romance Film', 'Drama']",2000,1
24199729,Coronation Street: Romanian Holiday,2009,['United Kingdom'],['Comedy film'],2000,9
326124,Irma Vep,1996,['France'],"['Art film', 'Satire', 'Comedy', 'Comedy of manners', 'World cinema', 'Drama', 'Ensemble Film']",1990,6
20472949,Fate,2008,['South Korea'],['Drama'],2000,8
19405420,"Hurry Up, Or I'll Be 30",1973,['United States of America'],"['Drama', 'Comedy']",1970,3
7986093,The Hamiltons,2006,['United States of America'],"['Psychological thriller', 'Coming of age', 'Slasher', 'Horror', 'Cult']",2000,6
924799,"Honey, I Blew Up the Kid",1992,['United States of America'],"['Comedy', 'Adventure', 'Family-Oriented Adventure', 'Science Fiction', 'Family Film']",1990,2
9337481,The Piano Man's Daughter,2003,['Canada'],"['Period piece', 'Film adaptation', 'Family Drama', 'Drama']",2000,3
1102966,Killer's Kiss,1955,['United States of America'],"['Black-and-white', 'Crime Fiction', 'Gangster Film', 'Thriller', 'Film noir', 'Crime Thriller', 'Drama', 'Suspense', 'Sports']",1950,5
8900180,4 for Texas,1963,['United States of America'],"['Comedy Western', 'Screwball comedy', 'Action/Adventure', 'Western', 'Comedy']",1960,3
2199333,Angel Face,1952,['United States of America'],"['Black-and-white', 'Film noir', 'Romance Film', 'Drama']",1950,2
10815301,60 Second Assassin,1978,['Hong Kong'],"['Action', 'Drama', 'Chinese Movies', 'Martial Arts Film']",1970,8
193882,Two Women,1960,"['France', 'Italy']","['Black-and-white', 'World cinema', 'Romance Film', 'Drama']",1960,0
18906393,Make Mine a Million,1959,['United Kingdom'],"['Comedy', 'Crime Fiction']",1950,9
1068884,Mishima: A Life in Four Chapters,1985,['United States of America'],"['LGBT', 'Biography', 'Biographical film', 'Biopic [feature]', 'Erotica', 'Drama']",1980,5
11584574,Acacia,2003,['South Korea'],"['World cinema', 'Horror']",2000,3
3175826,SubUrbia,1996,['United States of America'],"['Film adaptation', 'Drama', 'Indie', 'Comedy', 'Black comedy', 'Comedy-drama']",1990,6
5080159,Bank Shot,1974,['United States of America'],"['Action', 'Heist', 'Crime Fiction', 'Caper story', 'Action/Adventure', 'Comedy', 'Crime Comedy']",1970,4
17389056,Alter Ego,2007,"['Greece', 'Cyprus']","['Romance Film', 'Drama']",2000,7
28174778,Io sto con gli ippopotami,1979,['Italy'],"['Action', 'Adventure', 'Comedy film']",1970,9
4385123,ATL,2006,['United States of America'],"['Coming of age', 'Comedy', 'Drama']",2000,6
26014758,Hawa,2003,['India'],"['World cinema', 'Thriller', 'Horror']",2000,3
10330008,The Battle of the Sexes,1959,['United Kingdom'],"['Comedy', 'Black-and-white']",1950,9
26655950,Well Done Abba,2009,['India'],"['Musical', 'Political satire', 'Comedy', 'Bollywood', 'World cinema', 'Drama']",2000,9
3389311,Cadence,1990,['United States of America'],"['Period piece', 'Prison', 'Drama']",1990,0
17845260,Hotel for Dogs,2009,"['Germany', 'United States of America']","['Adventure Comedy', 'Comedy', ""Children's/Family"", 'Family Film', ""Children's""]",2000,9
4130795,One Way Street,1950,['United States of America'],['Film noir'],1950,0
4807263,A Time for Miracles,1980,['United States of America'],"['Drama', 'Biography', 'Biopic [feature]']",1980,0
1135295,Thir13en Ghosts,2001,"['Canada', 'United States of America']","['Mystery', 'Thriller', 'Horror', 'Supernatural']",2000,1
28786220,Attack of the 50 Ft. Woman,1993,['United States of America'],"['Remake', 'Television movie', 'Alien Film', 'Science Fiction', 'Feminist Film']",1990,3
2460231,Mike's New Car,2002,['United States of America'],"['Animation', 'Short Film', 'Comedy', 'Computer Animation']",2000,2
14536762,Catacombs,2007,['United States of America'],"['Psychological thriller', 'Horror']",2000,7
22604307,The Terrorizers,1986,"['Hong Kong', 'Taiwan']","['Chinese Movies', 'Drama']",1980,6
6589725,The Burglars,1971,['France'],"['Action', 'Crime Fiction', 'Caper story', 'Thriller', 'Crime Thriller']",1970,1
16035327,Farmhouse,2008,['United States of America'],"['Psychological thriller', 'Indie', 'Thriller', 'Horror']",2000,8
9263475,Lassie,1994,['United States of America'],"['Family Drama', 'Adventure', 'Drama', 'Family Film']",1990,4
18915082,The Messenger,2009,['United States of America'],"['Romance Film', 'War film', 'Drama']",2000,9
1924191,Rampage,1988,['United States of America'],"['Crime Fiction', 'Thriller', 'Horror', 'Drama']",1980,8
18562775,If I Had My Way,1940,['United States of America'],"['Musical', 'Black-and-white', 'Comedy']",1940,0
35009216,The Public Menace,1935,['United States of America'],"['Romance Film', 'Drama', 'Comedy film']",1930,5
21733496,The Hitchhiker,2007,['United States of America'],"['Psychological thriller', 'Indie', 'Slasher', 'Horror', 'B-movie']",2000,7
13539674,Centennial Summer,1946,['United States of America'],"['Musical', 'History', 'Comedy', 'Musical comedy']",1940,6
19828357,Calling All Kids,1943,['United States of America'],"['Black-and-white', 'Short Film', 'Comedy', 'Family Film']",1940,3
73371,The Black Pirate,1926,['United States of America'],"['Action', 'Drama', 'Indie', 'Action/Adventure', 'Silent film', 'Swashbuckler films']",1920,6
8960868,White Wolves: A Cry in the Wild II,1993,['United States of America'],"['Action', 'Action/Adventure', 'Animal Picture', 'Family-Oriented Adventure', ""Children's/Family"", 'Adventure', 'Family Film']",1990,3
670445,Love Me Tender,1956,['United States of America'],"['Musical', 'Action/Adventure', 'Western', 'Drama']",1950,6
1346601,The Kremlin Letter,1970,['United States of America'],"['Spy', 'Film adaptation', 'Political thriller', 'Thriller', 'Drama']",1970,0
12082059,Star Spangled Girl,1971,['United States of America'],"['Romantic comedy', 'Political cinema', 'Comedy']",1970,1
8749213,Dracula père et fils,1976,['France'],"['Costume Horror', 'Comedy', 'Horror']",1970,6
3299612,Twins Effect II,2004,"['China', 'Hong Kong']","['Action', 'Action/Adventure', 'Comedy', 'World cinema', 'Chinese Movies', 'Martial Arts Film']",2000,4
29275321,Hot Snow,1972,['Soviet Union'],['War film'],1970,2
6954675,Yamakinkarudu,1982,['India'],"['Action', 'Crime Fiction', 'Drama']",1980,2
6871187,Surcos,1950,['Spain'],"['Black-and-white', 'Drama', 'Family Drama', 'Indie']",1950,0
31417443,B-Girl,2009,['United States of America'],"['Music', 'Crime Fiction', 'Drama']",2000,9
23775053,Trailer Park Boys: Countdown to Liquor Day,2009,['Canada'],"['Action', 'Action/Adventure', 'Comedy', 'Cult', 'Absurdism']",2000,9
11783858,I Girasoli,1970,"['Russia', 'France', 'Italy']","['Romantic drama', 'World cinema', 'Romance Film', 'Melodrama', 'War film', 'Drama']",1970,0
6093047,Sacred Evil,2006,['India'],"['Mystery', 'Horror', 'Supernatural', 'Drama']",2000,6
21487398,Maman est chez le coiffeur,2008,"['Canada', 'France']","['Period piece', 'Indie', 'Drama']",2000,8
22562616,Linewatch,2008,['United States of America'],"['Action', 'Drama', 'Crime Fiction', 'Action/Adventure', 'Thriller']",2000,8
9935760,Dolphins,2007,['United Kingdom'],"['Action', 'Romance Film', 'Drama']",2000,7
37478048,Mr. Bechara,1996,[],['Comedy film'],1990,6
7885996,The Catered Affair,1956,['United States of America'],"['Black-and-white', 'Family Drama', 'Drama']",1950,6
3834822,Hombre,1967,['United States of America'],"['Action', 'Drama', 'Revisionist Western', 'Action/Adventure', 'Western']",1960,7
13846179,What Makes Daffy Duck?,1948,['United States of America'],"['Animation', 'Short Film', 'Comedy', 'Family Film']",1940,8
23934336,The Sign of Four,1932,['United Kingdom'],"['Crime Fiction', 'Mystery', 'Romance Film', 'Drama']",1930,2
54166,Indiana Jones and the Raiders of the Lost Ark,1981,['United States of America'],"['Action', 'Airplanes and airports', 'Costume Adventure', 'Action/Adventure', 'New Hollywood', 'Adventure']",1980,1
11390255,Night of The Hell Hamsters,2006,"['New Zealand', 'United Kingdom']","['Indie', 'Short Film', 'Comedy', 'Horror', 'Supernatural']",2000,6
4198757,Space Truckers,1996,"['United Kingdom', 'Ireland', 'United States of America']","['Satire', 'Comedy', 'Anime', 'Comedy-drama', 'Road movie', 'Science Fiction', 'Drama']",1990,6
35601361,First offenders,1939,[],[],1930,9
4500088,All the King's Men,1950,['United States of America'],"['Drama', 'Political drama']",1950,0
3550033,Thirteen Conversations About One Thing,2001,['United States of America'],"['Indie', 'Drama']",2000,1
14261811,La Bohème,1926,['United States of America'],"['Black-and-white', 'Drama', 'Indie', 'Silent film']",1920,6
11153699,I Really Hate My Job,2007,['United Kingdom'],"['Workplace Comedy', 'Indie', 'Comedy']",2000,7
22449964,Absolution,1978,['United Kingdom'],"['Thriller', 'Crime Thriller']",1970,8
26247201,Gen,2006,['Turkey'],['Thriller'],2000,6
6845557,A Little Bit of Fluff,1928,['United Kingdom'],"['Black-and-white', 'Indie', 'Comedy', 'Silent film']",1920,8
25532589,Miss Fane's Baby Is Stolen,1934,['United States of America'],"['Drama', 'Comedy film']",1930,4
4277910,Dil Aashna Hai,1992,['India'],"['Bollywood', 'World cinema']",1990,2
3162951,One Crazy Summer,1986,['United States of America'],"['Comedy', 'Teen', 'Romance Film', 'Romantic comedy']",1980,6
9727542,Riffraff,1936,['United States of America'],"['Black-and-white', 'Drama']",1930,6
8815105,Our Daily Bread,1934,['United States of America'],"['Black-and-white', 'Drama']",1930,4
5877719,3 Strikes,2000,['United States of America'],"['Action', 'Crime Fiction', 'Screwball comedy', 'Action/Adventure', 'Comedy', 'Crime Comedy', 'Comedy of Errors']",2000,0
15642630,Porky's Last Stand,1940,['United States of America'],"['Animation', 'Short Film', 'Comedy film', 'Family Film']",1940,0
3077660,All Night Long,1981,['United States of America'],"['Romantic drama', 'Comedy', 'Romance Film', 'Romantic comedy', 'Drama']",1980,1
25689802,Murder in Three Acts,1986,['United States of America'],"['Suspense', 'Mystery', 'Thriller', 'Television movie', 'Drama']",1980,6
9551895,The Railway Children,1970,['United Kingdom'],"['Family Drama', 'Adventure', 'Drama', 'Family Film']",1970,0
6306820,Cleopatra,1934,['United States of America'],"['Black-and-white', 'Biography', 'Romantic drama', 'Romance Film', 'Costume drama', 'Pre-Code', 'Drama', 'Epic']",1930,4
11254779,Khandan,1965,['India'],"['Musical', 'Bollywood', 'World cinema', 'Drama']",1960,5
35028178,Fast Charlie... the Moonbeam Rider,1979,['United States of America'],['Comedy film'],1970,9
19360297,Bear Shooters,1930,['United States of America'],"['Black-and-white', 'Short Film', 'Comedy', 'Family Film']",1930,0
33157118,Fascination,2004,"['United Kingdom', 'Germany']","['Psychological thriller', 'Mystery', 'Thriller', 'World cinema', 'Erotic thriller']",2000,4
5501399,Mister Cory,1957,['United States of America'],['Drama'],1950,7
11094299,The Magnetic Monster,1953,['United States of America'],"['Horror', 'Science Fiction']",1950,3
29243068,The Night Invader,1943,['United Kingdom'],"['War film', 'Thriller']",1940,3
7906976,Seema Shastri,2007,['India'],['Comedy'],2000,7
1094672,Carrington V.C.,1955,['United Kingdom'],"['Courtroom Drama', 'Drama']",1950,5
35663798,David's Birthday,2009,['Italy'],"['LGBT', 'Romantic drama', 'World cinema', 'Romance Film', 'Drama']",2000,9
2931524,Halloweentown II: Kalabar's Revenge,2001,['United States of America'],"[""Children's Fantasy"", ""Children's/Family"", ""Children's"", 'Fantasy']",2000,1
5349098,Ji,2005,['India'],"['Action', 'Romance Film', 'Tamil cinema']",2000,5
17418486,Noise,2007,['United States of America'],"['Political cinema', 'Indie', 'Comedy', 'Black comedy', 'Drama']",2000,7
13779507,Everybody Wants to be Italian,2008,['United States of America'],"['Indie', 'Comedy', 'Romance Film', 'Romantic comedy', 'Slice of life story']",2000,8
15708657,Giallo,2009,['Italy'],"['Crime Fiction', 'Slasher', 'Thriller', 'Horror', 'Detective']",2000,9
6139849,El juego de Arcibel,2003,['Argentina'],"['Drama', 'Indie', 'World cinema', 'Political drama']",2000,3
2511602,Dr. Dolittle,1998,['United States of America'],"['Comedy', 'Fantasy Comedy', 'Family Film']",1990,8
3596717,The Story of the Last Chrysanthemums,1939,['Japan'],"['Japanese Movies', 'Black-and-white']",1930,9
7010510,The Super Cops,1974,['United States of America'],"['Action', 'Crime Fiction', 'Action Thrillers', 'Comedy', 'Thriller', 'Docudrama', 'Drama']",1970,4
1146934,Office Killer,1997,['United States of America'],"['Psychological thriller', 'Comedy', 'Thriller', 'Black comedy', 'Crime Thriller', 'Slasher', 'Horror', 'Workplace Comedy']",1990,7
10925906,By the Sword,1991,['United States of America'],"['Action', 'Drama', 'Action Thrillers', 'Thriller']",1990,1
1424754,Cinderella Man,2005,['United States of America'],"['Boxing', 'Biography', 'Romantic drama', 'Biographical film', 'Romance Film', 'Drama', 'Period piece', 'Sports']",2000,5
1198987,Lost Embrace,2004,"['Spain', 'Argentina', 'France', 'Italy']","['Drama', 'Indie', 'Comedy', 'World cinema', 'Ensemble Film']",2000,4
980461,Sex: The Annabel Chong Story,1999,['United States of America'],"['Gender Issues', 'Interpersonal Relationships', 'Biography', 'Indie', 'Documentary', 'Culture & Society', 'Pornographic movie', 'Erotica']",1990,9
99031,Butch Cassidy and the Sundance Kid,1969,['United States of America'],"['Action', 'Outlaw', 'Action/Adventure', 'Buddy film', 'Comedy', 'Adventure', 'Drama', 'Western', 'New Hollywood']",1960,9
935996,Revenge,1990,['United States of America'],"['Crime Fiction', 'Romantic drama', 'Thriller', 'Romance Film', 'Crime Thriller', 'Drama']",1990,0
11924045,Daulat Ki Jung,1992,['India'],"['Action', 'Romance Film', 'Adventure']",1990,2
18895191,Red Riding Hood,1989,['United States of America'],['Family Film'],1980,9
28207640,Dizzy Red Riding Hood,1931,['United States of America'],"['Animated cartoon', 'Animation', 'Short Film']",1930,1
21234681,Jud Süß,1940,"['Nazi Germany', 'Germany']","['Propaganda film', 'Drama']",1940,0
6107147,Heading South,2006,"['Canada', 'France']","['Period piece', 'Erotic Drama', 'Romantic drama', 'World cinema', 'Romance Film', 'Political drama', 'Drama']",2000,6
17726219,Disaster Movie,2008,['United States of America'],"['Action', 'Parody', 'Action/Adventure', 'Comedy', 'Doomsday film', 'Disaster', 'Absurdism']",2000,8
4870165,Monster Island,2004,"['Canada', 'United States of America']","['Parody', 'Monster', 'Comedy', 'Horror', 'Adventure', 'Television movie', 'Science Fiction']",2000,4
5253337,Beyond Rangoon,1995,"['United Kingdom', 'United States of America']","['Action', 'Period piece', 'Drama', 'Political drama', 'Adventure']",1990,5
28207220,Minding the Baby,1931,['United States of America'],['Short Film'],1930,1
4913042,The Alibi,2006,['United States of America'],['Romantic comedy'],2000,6
27296052,The Lamp Still Burns,1943,['United Kingdom'],['Drama'],1940,3
2082397,Mystic India,2004,['India'],"['Short Film', 'Documentary']",2000,4
28493148,The Border Post,2006,"['Republic of Macedonia', 'Austria', 'Serbia and Montenegro', 'Croatia', 'Slovenia', 'United Kingdom', 'Hungary']","['Action', 'Romantic drama', 'Comedy', 'World cinema', 'Romance Film', 'Romantic comedy', 'Drama']",2000,6
24458416,Dollman,1991,['United States of America'],"['Action', 'Action/Adventure', 'Science Fiction', 'Comedy', 'Thriller']",1990,1
16792210,Obsessed,2009,['United States of America'],"['Suspense', 'Thriller', 'Erotic thriller', 'Drama']",2000,9
17884388,Dil Kabaddi,2008,['India'],"['Musical', 'Romantic drama', 'Bollywood', 'World cinema', 'Romance Film', 'Drama']",2000,8
18627879,Patayin Sa Sindak Si Barbara,1995,['Philippines'],"['Filipino Movies', 'Horror']",1990,5
739821,D.A.R.Y.L.,1985,"['United Kingdom', 'United States of America']","['Science Fiction', 'Adventure', 'Family Film']",1980,5
151465,Austin Powers: International Man of Mystery,1997,"['Germany', 'United States of America']","['Action', 'Spy', 'Crime Fiction', 'Comedy', 'Master Criminal Films', 'Absurdism', 'Time travel', 'Parody']",1990,7
560837,Dirty Work,1998,"['Canada', 'United States of America']","['Black comedy', 'Buddy film', 'Comedy']",1990,8
15022751,Deewana Mujh Sa Nahin,1990,['India'],"['Romantic drama', 'World cinema', 'Romance Film', 'Drama']",1990,0
1853570,Mesa of Lost Women,1953,['United States of America'],"['Creature Film', 'Black-and-white', 'Monster', 'Horror', 'B-movie', 'Science Fiction']",1950,3
27175946,Shaapa,2000,['India'],['Drama'],2000,0
2451914,Four for Venice,1998,['Germany'],['Comedy'],1990,8
11335771,Lahu Ke Do Rang,1979,['India'],['Action'],1970,9
18977312,Suspect,2007,['Germany'],['Short Film'],2000,7
5024840,The 24th Day,2004,['United States of America'],"['Psychological thriller', 'Film adaptation', 'LGBT', 'Mystery', 'Indie', 'Thriller', 'Drama', 'Gay Themed', 'Gay', 'Gay Interest']",2000,4
3103765,Matango,1963,['Japan'],"['Creature Film', 'Surrealism', 'Japanese Movies', 'Science Fiction', 'Horror', 'World cinema', 'Fantasy']",1960,3
22218325,Moss & Cat,2009,['India'],"['Drama', 'Comedy']",2000,9
22068361,Toinen jalka haudasta,2009,['Finland'],"['Slice of life story', 'Comedy-drama']",2000,9
16626430,"No Dessert, Dad, til You Mow the Lawn",1994,['United States of America'],"['Comedy', 'Family Film']",1990,4
16223480,The Black Box,2005,['France'],"['Mystery', 'Thriller']",2000,5
23378582,The Spikes Gang,1974,['United States of America'],"['Action', 'Crime Fiction', 'Western']",1970,4
11715400,The Dead Pit,1989,['United States of America'],"['Slasher', 'Horror', 'B-movie', 'Zombie Film']",1980,9
2792524,Seoul Raiders,2005,"['Hong Kong', 'South Korea']","['Action', 'Action Thrillers', 'Action/Adventure', 'Comedy', 'Thriller', 'World cinema', 'Crime Thriller', 'Chinese Movies', 'Martial Arts Film', 'Drama']",2000,5
18394422,002 Operazione Luna,1965,['Italy'],"['Comedy', 'Black-and-white']",1960,5
18995832,Rabbit Without Ears,2007,['Germany'],"['Romantic drama', 'Comedy', 'World cinema', 'Romance Film', 'Romantic comedy', 'Drama']",2000,7
26548166,Netherworld,1992,['United States of America'],"['Horror', 'B-movie']",1990,2
1958815,Christopher Strong,1933,['United States of America'],"['Black-and-white', 'Romance Film', 'Pre-Code', 'Drama']",1930,3
10591637,Look Back in Anger,1959,['United Kingdom'],"['Black-and-white', 'British New Wave', 'Kitchen sink realism', 'Drama']",1950,9
4600837,The Mysterious Dr. Fu Manchu,1929,['United States of America'],"['Black-and-white', 'Thriller']",1920,9
31981147,The Place at the Coast,1987,['Australia'],"['Romance Film', 'Drama']",1980,7
24117367,All The Best: Fun Begins,2009,['India'],"['Action', 'Musical', 'Action/Adventure', 'Comedy', 'Bollywood', 'World cinema']",2000,9
7989310,Midnight My Love,2005,['Thailand'],"['Romance Film', 'Drama']",2000,5
10006475,Jetsam,2007,['United Kingdom'],['Thriller'],2000,7
606614,Buster,1988,['United Kingdom'],"['Heist', 'Indie', 'Comedy', 'Romance Film', 'Romantic comedy']",1980,8
26638304,The Car,1997,['India'],['Comedy'],1990,7
348356,Bringing Out the Dead,1999,['United States of America'],"['Film adaptation', 'Drama']",1990,9
10628994,Annamalai,1992,['India'],"['Action', 'Romantic drama', 'Bollywood', 'World cinema', 'Romance Film', 'Drama']",1990,2
6690287,Moon of the Wolf,1972,['United States of America'],"['Mystery', 'Indie', 'Thriller', 'Crime Thriller', 'Creature Film', 'Suspense', 'Horror', 'Supernatural']",1970,2
6607195,Autumn in New York,2000,['United States of America'],"['Romantic drama', 'Romance Film', 'Drama', 'Medical fiction']",2000,0
3101492,Apaches,1977,['United Kingdom'],"['Education', ""Children's"", 'Short Film', 'Western', 'Drama']",1970,7
4767200,Prozac Nation,2001,"['Germany', 'United States of America']","['Film adaptation', 'Drama', 'Coming of age', 'Indie']",2000,1
6819660,Adventures of Mowgli,1973,['Soviet Union'],"['Animation', 'Adventure', 'Family Film']",1970,3
9478308,Battle in Seattle,2007,"['Germany', 'United States of America', 'Canada']","['Drama', 'Indie', 'Docudrama', 'Political drama', 'Ensemble Film']",2000,7
8914341,Taking Five,2007,['United States of America'],"['Indie', 'Comedy', 'Teen', 'Family Film']",2000,7
23265233,Independence Day,1983,['United States of America'],['Drama'],1980,3
3826800,The Sensuous Nurse,1975,['Italy'],"['Comedy', 'Comedy film', 'Sex comedy']",1970,5
19924644,Ernest and Bertram,2002,['United States of America'],"['Parody', 'Short Film', 'Comedy', 'Mockumentary']",2000,2
34841834,No Way Out,1973,"['France', 'Italy']","['Action', 'Drama', 'Crime Fiction', 'Thriller']",1970,3
7278140,Tomb of the Werewolf,2004,['United States of America'],"['Softcore Porn', 'Horror']",2000,4
1505118,Rent,2005,['United States of America'],"['Musical', 'LGBT', 'Musical Drama', 'Romance Film', 'Drama']",2000,5
19502184,Columbus Day,2008,['United States of America'],"['Heist', 'Crime Fiction', 'Thriller', 'Crime Thriller', 'Drama']",2000,8
17459571,Cup Final,1991,['Israel'],"['World cinema', 'Sports', 'War film', 'Drama']",1990,1
10178483,City Limits,1985,['United States of America'],"['Indie', 'Science Fiction']",1980,5
3745331,Hellraiser III: Hell on Earth,1992,['United States of America'],"['Slasher', 'Horror', 'Supernatural', 'Cult']",1990,2
896812,The Trollenberg Terror,1958,['United Kingdom'],"['Science Fiction', 'Monster']",1950,8
9387059,Hard to Die,1990,['United States of America'],"['Action', 'Drama', 'Action/Adventure', 'Thriller']",1990,0
2901971,Howling II: Stirba - Werewolf Bitch,1985,"['United Kingdom', 'Italy', 'United States of America']","['Indie', 'Horror']",1980,5
1111223,The Blood of Heroes,1989,"['New Zealand', 'Australia']","['World cinema', 'Apocalyptic and post-apocalyptic fiction', 'Sports', 'Science Fiction']",1980,9
2704622,Juggernaut,1974,['United Kingdom'],"['Action', 'Action/Adventure', 'Thriller', 'Crime Thriller', 'Disaster']",1970,4
4188875,Warrior of the Lost World,1985,['Italy'],"['Dystopia', 'Thriller', 'World cinema', 'Adventure', 'Science Fiction']",1980,5
16506768,Bhale Dongalu,2008,['India'],"['Romantic drama', 'Melodrama']",2000,8
12894844,The Adventures of the Wilderness Family,1975,['United States of America'],"['Family Drama', ""Children's"", 'Family-Oriented Adventure', 'Adventure', 'Drama', 'Family Film']",1970,5
19534959,"Not Quite Hollywood: The Wild, Untold Story of Ozploitation!",2008,"['United States of America', 'Australia']","['Documentary', 'World cinema']",2000,8
2441360,The Long Riders,1980,['United States of America'],"['Outlaw', 'Action/Adventure', 'Western']",1980,0
15726696,Star Wars: The Clone Wars,2008,['United States of America'],"['Action', 'Animation', 'Thriller', 'Adventure', 'Computer Animation', 'Science Fiction', 'Family Film', 'Fantasy']",2000,8
21296221,Resan till Melonia,1989,"['Sweden', 'Norway']",['Animation'],1980,9
32664870,Come Up Smiling,1939,[],"['Musical', 'Comedy film']",1930,9
7277067,"Brutti, sporchi e cattivi",1976,['Italy'],['Comedy'],1970,6
23961650,Behave Yourself!,1951,['United States of America'],"['Black-and-white', 'Screwball comedy', 'Comedy', 'Black comedy']",1950,1
3849407,The Unknown Man,1951,['United States of America'],"['Psychological thriller', 'Black-and-white', 'Thriller', 'Film noir']",1950,1
25417974,Benji's Very Own Christmas Story,1978,['United States of America'],"[""Children's/Family"", 'Adventure', ""Children's Fantasy"", 'Short Film', 'Animal Picture', 'Television movie', 'Family Film', 'Fantasy']",1970,8
3006708,Hot Fuzz,2007,"['United Kingdom', 'France', 'United States of America']","['Action', 'Crime Fiction', 'Mystery', 'Action/Adventure', 'Satire', 'Comedy', 'Buddy film', 'Black comedy', 'Parody', 'Action Comedy']",2000,7
8915053,Hand Of Death,1976,['Hong Kong'],"['Action/Adventure', 'World cinema', 'Chinese Movies', 'Martial Arts Film']",1970,6
2328289,Hear My Song,1991,"['Ireland', 'United Kingdom']","['Indie', 'Comedy', 'Comedy of Errors']",1990,1
4488504,L'important c'est d'aimer,1975,['France'],"['Romance Film', 'Romantic drama', 'Drama']",1970,5
34991301,Sarah... Ang Munting Prinsesa,1995,['Philippines'],"['War film', 'Drama', 'Family Film']",1990,5
10374514,I as in Icarus,1979,['France'],['Thriller'],1970,9
4619136,Double Take,2001,['United States of America'],"['Action', 'Crime Fiction', 'Action/Adventure', 'Comedy']",2000,1
22558707,Tormented,2009,['United Kingdom'],"['Comedy', 'Teen', 'Horror', 'Black comedy']",2000,9
5262931,The Busy Body,1967,['United States of America'],"['Crime Fiction', 'Screwball comedy', 'Indie', 'Comedy']",1960,7
1524596,Hitch,2005,['United States of America'],"['Romance Film', 'Romantic comedy', 'Comedy']",2000,5
25575072,Maa Tujhhe Salaam,2002,['India'],"['Action/Adventure', 'Drama', 'World cinema']",2000,2
19182579,Yokai Monsters: Vol. 1: Spook Warfare,1968,['Japan'],"['Creature Film', ""Children's Fantasy"", 'Japanese Movies', 'World cinema', 'Horror', 'Adventure', 'Fantasy']",1960,8
2100486,Two Hands,1999,"['New Zealand', 'Australia']","['Action', 'Crime Fiction', 'Gangster Film', 'Indie', 'Action/Adventure', 'Comedy', 'World cinema', 'Black comedy', 'Drama', 'Romantic comedy']",1990,9
1636036,The Cuckoo,2002,['Russia'],"['Period piece', 'Romantic drama', 'Comedy', 'World cinema', 'Romance Film', 'War film', 'Drama']",2000,2
19271071,Golmaal,2008,['India'],"['Action', 'Romance Film', 'Comedy']",2000,8
2942947,The Secret Fury,1950,['United States of America'],"['Mystery', 'Film noir']",1950,0
17693186,Slave Widow,1967,['Japan'],"['Erotic Drama', 'World cinema', 'Romance Film', 'Drama', 'Japanese Movies', 'Sexploitation', 'Pornographic movie', 'Pinku eiga', 'Erotica']",1960,7
30033169,Meharbaan,1993,['India'],"['Musical', 'Bollywood', 'World cinema', 'Drama']",1990,3
8914059,Soul of the Game,1996,['United States of America'],"['Period piece', 'Sports', 'Biopic [feature]', 'Historical fiction', 'Television movie', 'Docudrama', 'Drama']",1990,6
2822859,Twilight of the Dark Master,1997,['Japan'],"['Action', 'Animation', 'World cinema', 'Anime', 'Japanese Movies', 'Horror', 'Science Fiction', 'Fantasy']",1990,7
9763251,Dome Car Magic,2006,[],"['Short Film', 'Documentary']",2000,6
458573,Pi,1998,['United States of America'],"['Surrealism', 'Psychological thriller', 'Thriller', 'Avant-garde', 'Experimental film', 'Science Fiction', 'Drama']",1990,8
8273894,The Midas Touch,1997,"['Romania', 'United States of America']","['Family Drama', 'Drama', 'Family Film', 'Fantasy']",1990,7
5654660,Andhrawala,2004,['India'],"['Action', 'Tollywood', 'Adventure', 'Drama']",2000,4
15670343,The Detective,1968,['United States of America'],"['Mystery', 'Crime Fiction', 'Thriller', 'Crime Thriller', 'Drama']",1960,8
6031723,Busy Bodies,1933,['United States of America'],"['Short Film', 'Black-and-white', 'Comedy']",1930,3
3007132,Duck! Rabbit! Duck!,1953,['United States of America'],"['Animation', 'Short Film', 'Comedy', 'Family Film']",1950,3
7173760,Stop That Noise,1935,['United States of America'],"['Musical', 'Animation', 'Short Film']",1930,5
11590470,Offending Angels,2000,['United Kingdom'],"['Drama', 'Comedy']",2000,0
32134054,Too Young the Hero,1988,[],"['War film', 'Drama']",1980,8
3434688,Thinner,1996,['United States of America'],"['Film adaptation', 'Horror', 'Supernatural', 'Cult']",1990,6
11595146,Today We Live,1933,['United States of America'],"['Romance Film', 'Black-and-white', 'Drama']",1930,3
6641217,Athanokkade,2005,['India'],"['Musical', 'Bollywood', 'World cinema', 'Drama']",2000,5
2210683,Jagte Raho,1956,['India'],"['Comedy', 'Bollywood', 'World cinema', 'Drama']",1950,6
3694699,Carry On Cruising,1962,['United Kingdom'],"['Parody', 'Comedy', 'Romance Film', 'Slapstick']",1960,2
2324217,2001: A Space Travesty,2002,"['Germany', 'United States of America', 'Canada']","['Parody', 'Comedy', 'Adventure', 'Slapstick', 'Science Fiction']",2000,2
23419513,The Bushbaby,1969,['United States of America'],"['Action', 'Adventure']",1960,9
236793,Crush,2001,"['United Kingdom', 'Germany']","['Drama', 'Indie', 'Romantic drama', 'Comedy', 'Romance Film', 'Romantic comedy']",2000,1
4558294,The Blues Brothers,1980,['United States of America'],"['Action', 'Adventure Comedy', 'Musical', 'Screwball comedy', 'Action/Adventure', 'Comedy', 'Buddy film', 'Absurdism', 'Action Comedy', 'Cult']",1980,0
20622475,Curiosity Kills the Cat,2006,['China'],"['Mystery', 'Thriller', 'Chinese Movies', 'Drama']",2000,6
10594195,Betaab,1983,['India'],"['Musical', 'Bollywood']",1980,3
1566225,If These Walls Could Talk 2,2000,['United States of America'],"['Gay Themed', 'LGBT', 'Gay', 'Gay Interest', 'Romance Film', 'Drama', 'Feminist Film']",2000,0
6832750,Ritual,2001,['United States of America'],"['Suspense', 'Drama', 'Indie', 'Thriller', 'Horror', 'Supernatural']",2000,1
3745507,Hellraiser VII: Deader,2005,"['Romania', 'United States of America']","['Slasher', 'Horror', 'Supernatural', 'Cult']",2000,5
714228,Ikiru,1952,['Japan'],"['Black-and-white', 'Art film', 'Japanese Movies', 'Existentialism', 'World cinema', 'Drama', 'Medical fiction']",1950,2
2448736,Lone Wolf McQuade,1983,['United States of America'],"['Action', 'Crime Fiction', 'Action Thrillers', 'Action/Adventure', 'Thriller', 'Martial Arts Film', 'Drama']",1980,3
2533984,"Goodbye South, Goodbye",1996,"['Taiwan', 'China', 'Japan']","['Crime Fiction', 'Japanese Movies', 'World cinema', 'Crime Drama', 'Chinese Movies', 'Drama']",1990,6
30861685,Tirangaa,1992,['India'],['Bollywood'],1990,2
2826413,Michael Lucas' Dangerous Liaisons,2005,['United States of America'],['Gay pornography'],2000,5
342926,The Flight of Dragons,1983,['United States of America'],"['Fantasy Adventure', 'Animation', 'Fantasy', 'Sword and sorcery', 'Costume drama', 'Adventure', 'Sword and sorcery films']",1980,3
73437,Dont Look Back,1967,['United States of America'],"['Music', 'Rockumentary', 'Indie', 'Documentary', 'Drama']",1960,7
2183017,The Accidental Spy,2001,['Hong Kong'],"['Action', 'Action Thrillers', 'Action/Adventure', 'Comedy', 'Thriller', 'World cinema', 'Chinese Movies', 'Martial Arts Film', 'Adventure', 'Comedy Thriller']",2000,1
2485103,Vice Squad,1982,['United States of America'],"['Action', 'Crime Fiction', 'Mystery', 'Indie', 'Action/Adventure', 'Thriller', 'Crime Thriller', 'Drama']",1980,2
31413100,Bed of Lies,1992,['United States of America'],"['Docudrama', 'Drama']",1990,2
10426237,Daadshah,1983,['Iran'],['Biographical film'],1980,3
30311658,Dark Nature,2009,['United Kingdom'],"['Suspense', 'Crime Thriller', 'Thriller']",2000,9
20678521,Righteous Ties,2006,['South Korea'],"['Crime Fiction', 'Gangster Film', 'Comedy', 'Crime Comedy', 'World cinema', 'Drama']",2000,6
25006668,The Wonderful Country,1959,['United States of America'],['Western'],1950,9
29121790,The Survivors Club,2004,"['Canada', 'United States of America']","['Drama', 'Crime Fiction', 'Thriller']",2000,4
13093495,Elite Squad,2007,"['Brazil', 'Argentina', 'Netherlands', 'United States of America']","['Action', 'Crime Fiction', 'Action/Adventure', 'Thriller', 'World cinema', 'Social problem film', 'Drama']",2000,7
3878666,Emile,2003,"['Canada', 'United Kingdom']","['Drama', 'Family Drama', 'Indie', 'Biography']",2000,3
12320705,Lekin,1991,['India'],"['Musical', 'Bollywood', 'World cinema', 'Drama']",1990,1
10890876,Aadmi Sadak Ka,1977,['India'],"['Musical', 'Romantic drama', 'Bollywood', 'World cinema', 'Romance Film', 'Drama']",1970,7
3578467,Our Day Out,1977,['United Kingdom'],['Drama'],1970,7
19134187,The President's Mistress,1978,['United States of America'],"['Spy', 'Action', 'Drama', 'Whodunit', 'Political drama']",1970,8
9998297,La Raulito,1975,['Argentina'],['Comedy-drama'],1970,5
1208705,Look at Me,2004,"['France', 'Italy']","['Music', 'Comedy', 'World cinema', 'Drama', 'Coming of age', 'Romantic comedy', 'Comedy-drama', 'Ensemble Film']",2000,4
584770,Genghis Blues,1999,['United States of America'],"['Music', 'Biography', 'Indie', 'Documentary', 'Culture & Society']",1990,9
5150901,Woman in a Dressing Gown,1957,['United Kingdom'],['Drama'],1950,7
9313886,Fever Pitch,1997,['United Kingdom'],"['Comedy', 'Romantic comedy', 'Romance Film', 'Sports']",1990,7
3815111,The Mayor of Hell,1933,['United States of America'],"['Black-and-white', 'Crime Fiction', 'Melodrama', 'Pre-Code', 'Drama']",1930,3
27260560,The Three Musketeers,1935,['United States of America'],"['Action', 'Adventure']",1930,5
14091678,Before I Hang,1940,['United States of America'],"['Crime Fiction', 'Thriller', 'Horror', 'Science Fiction']",1940,0
34941246,No. 1 of the Secret Service,1970,['United Kingdom'],['Action'],1970,0
28064494,Eighteen Springs,1997,"['China', 'Hong Kong']",['Chinese Movies'],1990,7
19271559,Happy Together,1989,['United States of America'],"['Indie', 'Comedy', 'Romance Film', 'Romantic comedy']",1980,9
17385651,Floundering,1994,['United States of America'],"['Comedy-drama', 'Indie', 'Comedy']",1990,4
17102867,Book of Blood,2008,['United Kingdom'],"['Mystery', 'Horror']",2000,8
26475355,Vasthuhara,1991,['India'],"['Romance Film', 'Drama']",1990,1
6549044,Everest '82,2007,['Canada'],"['Indie', 'Drama']",2000,7
7236640,Chantabbai,1986,['India'],['Comedy'],1980,6
3921141,Seventh Curse,1986,['Hong Kong'],"['Chinese Movies', 'World cinema', 'Horror', 'Fantasy']",1980,6
15298947,Men in Black,1934,['United States of America'],"['Short Film', 'Black-and-white']",1930,4
2850308,B*A*P*S,1997,['United States of America'],['Comedy'],1990,7
5376856,Nigel Planter And The Chamber Pot of Secrets / Circus of Fear,1966,"['United Kingdom', 'West Germany']","['Mystery', 'Black-and-white']",1960,6
23254066,Love & Debate,2006,['United States of America'],"['Romantic drama', 'Comedy', 'Teen', 'Romance Film', 'Drama']",2000,6
74984,Suspicion,1941,['United States of America'],"['Mystery', 'Thriller', 'Film noir', 'Romance Film']",1940,1
394536,Infernal Affairs,2002,['Hong Kong'],"['Crime Fiction', 'Gangster Film', 'Mystery', 'Thriller', 'Chinese Movies']",2000,2
1232216,The Harvey Girls,1946,['United States of America'],"['Musical', 'Comedy', 'Musical comedy']",1940,6
1526194,2 Days in the Valley,1996,['United States of America'],"['Crime Fiction', 'Indie', 'Ensemble Film', 'Comedy', 'Crime Comedy', 'Black comedy']",1990,6
32883986,Hullo Marmaduke,1924,[],['Comedy film'],1920,4
773501,"Faster, Pussycat! Kill! Kill!",1965,['United States of America'],"['Action', 'Indie', 'Action/Adventure', 'Comedy', 'Drama', 'Sexploitation', 'Chase Movie', 'Action Comedy', 'Cult']",1960,5
144798,Shadow of the Thin Man,1941,['United States of America'],"['Detective fiction', 'Black-and-white', 'Crime Fiction', 'Screwball comedy', 'Mystery', 'Comedy', 'Thriller', 'Crime Thriller', 'Comedy Thriller', 'Detective']",1940,1
1223359,That Was Then... This Is Now,1985,['United States of America'],"['Drama', 'Coming of age', 'Teen']",1980,5
1365411,My Cousin Rachel,1952,['United States of America'],"['Period piece', 'Black-and-white', 'Mystery', 'Family Drama', 'Romance Film', 'Drama']",1950,2
167724,Jungle Fever,1991,['United States of America'],"['Social issues', 'Romantic drama', 'Romance Film', 'Drama']",1990,1
3145892,Ditto,2000,['South Korea'],"['Romantic drama', 'World cinema', 'Romance Film', 'Drama', 'Fantasy']",2000,0
2821933,The Time Machine,1960,['United States of America'],"['Action', 'Film adaptation', 'Action/Adventure', 'Adventure', 'Drama', 'Time travel', 'Dystopia', 'Epic', 'Doomsday film', 'Science Fiction']",1960,0
21666555,Long Weekend,2008,"['New Zealand', 'Australia']","['Remake', 'Horror']",2000,8
12715927,Song of the Exile,1990,"['Hong Kong', 'Taiwan']","['Chinese Movies', 'Drama']",1990,0
8562048,Dhaam Dhoom,2008,['India'],"['Courtroom Drama', 'Thriller']",2000,8
1220079,Von Ryan's Express,1965,['United States of America'],"['Period piece', 'Action', 'Escape Film', 'Action/Adventure', 'War film', 'Drama']",1960,5
3510242,Suspense,1946,['United States of America'],"['Film noir', 'Black-and-white', 'Drama']",1940,6
24318707,Sura,2009,['India'],['Action'],2000,9
3459901,Street Fight,2005,['United States of America'],"['Social issues', 'Political cinema', 'Biography', 'Documentary', 'Political drama', 'Culture & Society']",2000,5
249956,Rabbit-Proof Fence,2002,"['New Zealand', 'Australia']","['Period piece', 'Film adaptation', 'History', 'Action/Adventure', 'World cinema', 'Adventure', 'Drama']",2000,2
4200803,I Wanna Hold Your Hand,1978,['United States of America'],"['Musical', 'Screwball comedy', 'Comedy', 'Teen', 'Ensemble Film']",1970,8
33539015,Kakkai Siraginilae,2000,[],['Drama'],2000,0
22087546,Julie,2004,['India'],"['Romantic drama', 'World cinema', 'Romance Film', 'Drama']",2000,4
1380482,Boat Trip,2003,"['Germany', 'United States of America']","['LGBT', 'Buddy film', 'Comedy', 'Romantic comedy', 'Adventure', 'Comedy of Errors']",2000,3
17824843,Bloedbroeders,2008,['Netherlands'],"['Crime Thriller', 'Drama', 'World cinema']",2000,8
12230524,Cold Steel,1987,['United States of America'],"['Action', 'Drama', 'Crime Fiction', 'Action/Adventure', 'Thriller']",1980,7
6574607,Kaleidoscope,1966,['United Kingdom'],['Crime Fiction'],1960,6
4417953,Right on Track,2003,['United States of America'],"['Biographical film', 'Television movie', 'Family Film', 'Drama']",2000,3
24566491,Venice/Venice,1992,['United States of America'],['Drama'],1990,2
2422067,The Proud Family Movie,2005,['United States of America'],"['Animated cartoon', 'Animation', 'Comedy', 'Family-Oriented Adventure', ""Children's/Family"", ""Children's"", 'Television movie', 'Fantasy']",2000,5
8066937,Breath,2002,"['France', 'Italy']","['Indie', 'Comedy', 'World cinema', 'Drama']",2000,2
15385105,Marriage Story,1992,['South Korea'],"['Romantic comedy', 'Comedy']",1990,2
22742441,Violent Playground,1958,['United Kingdom'],"['Crime Fiction', 'Crime Drama', 'Juvenile Delinquency Film', 'Drama']",1950,8
1161955,Reach for the Sky,1956,['United Kingdom'],"['War film', 'Biographical film', 'Drama']",1950,6
3654117,Fighting Elegy,1966,['Japan'],"['Black-and-white', 'Japanese Movies', 'Action/Adventure', 'World cinema', 'Martial Arts Film', 'Drama']",1960,6
5776856,Mysterious Island,2005,['United States of America'],"['Action', 'Science Fiction', 'Adventure']",2000,5
1849347,The Truth About Jane and Sam,1999,['Hong Kong'],['Chinese Movies'],1990,9
26009758,Severed Ties,1992,['United States of America'],['Horror'],1990,2
2236976,August Rush,2007,['United States of America'],"['Music', 'Romantic fantasy', 'Musical Drama', 'Childhood Drama', 'Romance Film', 'Drama']",2000,7
6675831,Crazy,2006,['United States of America'],"['Musical', 'Biography', 'Biographical film', 'Drama']",2000,6
23348055,Corrado,2009,['United States of America'],"['Action', 'Gangster Film', 'Action/Adventure', 'Thriller', 'Crime Thriller']",2000,9
2415005,It Couldn't Happen Here,1988,['United Kingdom'],"['Musical', 'Musical comedy']",1980,8
19356961,Malai Malai,2009,[],['Action'],2000,9
209549,Point of No Return,1993,['United States of America'],"['Action', 'Crime Fiction', 'Action/Adventure', 'Thriller', 'Remake', 'Romance Film', 'Drama']",1990,3
22657183,Feet of Clay,2007,['United States of America'],"['Short Film', 'Comedy film']",2000,7
3450583,A Star Is Born,1976,['United States of America'],"['Musical', 'Indie', 'Romantic drama', 'Romance Film', 'Drama']",1970,6
32677131,Docteur Jekyll et les femmes,1981,[],['Horror'],1980,1
30653283,Snehapoorvam Anna,2000,[],['Romance Film'],2000,0
26967437,Ultimate Force,2006,"['Croatia', 'United States of America']","['Action', 'Crime Fiction', 'Action Thrillers', 'Action/Adventure', 'Thriller', 'Martial Arts Film']",2000,6
11697273,Stuck,2007,"['Canada', 'United Kingdom', 'Germany', 'United States of America']","['Psychological thriller', 'Comedy', 'Thriller', 'Horror', 'Drama']",2000,7
16167639,Whistle,2002,['India'],"['Crime Fiction', 'Thriller', 'World cinema', 'Crime Thriller', 'Drama']",2000,2
32800688,Line of Demarcation,1966,[],['Drama'],1960,6
11617594,La Chèvre,1981,"['Mexico', 'France']","['Adventure Comedy', 'Crime Fiction', 'Comedy', 'Comedy film', 'World cinema', 'Road movie', 'Adventure']",1980,1
455182,Inochi,2002,['Japan'],"['Japanese Movies', 'Drama']",2000,2
1608019,This Gun for Hire,1942,['United States of America'],"['Black-and-white', 'Crime Fiction', 'Mystery', 'Thriller', 'Film noir', 'Crime Thriller', 'Drama']",1940,2
23407296,The Brainiacs.com,2001,['United States of America'],"['Comedy', 'Family Film']",2000,1
2119835,"Cherry, Harry & Raquel!",1970,['United States of America'],"['Sexploitation', 'Comedy']",1970,0
10665065,Conversation Piece,1974,"['France', 'Italy']","['LGBT', 'Drama']",1970,4
7206930,Prince of Players,1955,['United States of America'],"['Drama', 'Biopic [feature]']",1950,5
13663937,See How They Run,1964,['United States of America'],['Adventure'],1960,4
3154829,Invasion,1997,['United States of America'],"['Science Fiction', 'Thriller']",1990,7
3066519,Plenty,1985,"['United Kingdom', 'United States of America']","['Period piece', 'Romantic drama', 'Romance Film', 'Drama']",1980,5
26869980,The Crouching Beast,1935,['United Kingdom'],['Drama'],1930,5
14827370,Arpan,1983,['India'],"['Romantic drama', 'World cinema', 'Romance Film', 'Drama']",1980,3
261237,The Gods Must Be Crazy,1980,['South Africa'],"['Adventure Comedy', 'Indie', 'Action/Adventure', 'Comedy', 'World cinema', 'Slapstick', 'Adventure', 'Cult']",1980,0
1139763,The Hunger,1983,['United Kingdom'],"['LGBT', 'Erotic Drama', 'Thriller', 'Romance Film', 'Horror', 'Erotic thriller', 'Erotica', 'Cult']",1980,3
18777685,Belly 2: Millionaire Boyz Club,2008,['United States of America'],"['Crime Fiction', 'Biographical film', 'Thriller', 'Crime Drama', 'Drama']",2000,8
11671832,Sleuth,2007,['United States of America'],"['Psychological thriller', 'Suspense', 'Film adaptation', 'Mystery', 'Thriller', 'Crime Thriller', 'Drama']",2000,7
268833,GoldenEye,1995,"['United Kingdom', 'United States of America']","['Action', 'Spy', 'Action Thrillers', 'Action/Adventure', 'Thriller', 'Glamorized Spy Film', 'Adventure']",1990,5
4131838,The Left Hand of God,1955,['United States of America'],"['Adventure', 'Drama']",1950,5
61323,The Love Parade,1929,['United States of America'],"['Musical', 'Black-and-white', 'Comedy', 'Musical comedy', 'Romance Film', 'Romantic comedy', 'Pre-Code']",1920,9
11320470,Bommalattam,2008,['India'],"['Action', 'Crime Fiction']",2000,8
227291,The Hot Chick,2002,['United States of America'],"['Comedy', 'Teen', 'Slapstick', 'Fantasy Comedy', 'Fantasy']",2000,2
26452149,Of Love & Betrayal,1995,['United States of America'],"['Romance Film', 'Adventure', 'Drama']",1990,5
2632500,Single White Female,1992,['United States of America'],"['Psychological thriller', 'Suspense', 'Thriller', 'Crime Thriller', 'Drama']",1990,2
550579,I Am Not What You Want,2001,['Hong Kong'],"['Chinese Movies', 'LGBT']",2000,1
30237779,On the Way Home,1992,['United States of America'],['Short Film'],1990,2
21091632,When I Met U,2009,['Philippines'],"['Filipino Movies', 'Romantic drama', 'World cinema', 'Romance Film', 'Romantic comedy', 'Drama']",2000,9
13295969,Any Mother's Son,1997,['United States of America'],['Drama'],1990,7
33628861,Kan Simittum Neram,1988,[],['Thriller'],1980,8
30413435,A Million,2009,['South Korea'],['Thriller'],2000,9
33643382,The Rainbowmaker,2008,[],['Romance Film'],2000,8
3961516,Distant,2002,['Turkey'],"['Drama', 'World cinema']",2000,2
155303,Heavy Metal,1981,['Canada'],"['Animation', 'Indie', 'Adventure', 'Science Fiction', 'Cult', 'Fantasy']",1980,1
3626936,Island in the Sky,1953,['United States of America'],"['Action', 'Drama', 'Action/Adventure', 'Adventure', 'Disaster']",1950,3
2405186,The Chase,1946,['United States of America'],"['Black-and-white', 'Crime Fiction', 'Mystery', 'Film noir', 'Drama']",1940,6
331860,Trick,1999,['United States of America'],"['Musical', 'LGBT', 'Comedy', 'Romance Film', 'Gay Themed', 'Gay', 'Gay Interest', 'Romantic comedy', 'Sex comedy']",1990,9
1976777,Hannibal Rising,2007,"['United Kingdom', 'France', 'Czech Republic', 'Italy']","['Psychological thriller', 'Film adaptation', 'Thriller', 'Crime Thriller', 'Cult', 'Drama', 'Suspense', 'Slasher', 'Horror', 'War film']",2000,7
7140979,The Bumblebee Flies Anyway,1999,['United States of America'],"['Coming of age', 'Romantic drama', 'Romance Film', 'Drama', 'Medical fiction']",1990,9
770260,For the Boys,1991,['United States of America'],"['Period piece', 'Musical Drama', 'Comedy', 'Romantic comedy', 'Comedy-drama', 'War film', 'Drama']",1990,1
1140398,Blue Thunder,1983,['United States of America'],"['Action', 'Crime Fiction', 'Action Thrillers', 'Action/Adventure', 'Thriller', 'Crime Thriller', 'Drama']",1980,3
144161,Conspiracy Theory,1997,['United States of America'],"['Action', 'Crime Fiction', 'Action Thrillers', 'Mystery', 'Action/Adventure', 'Thriller', 'Romance Film', 'Suspense', 'Chase Movie']",1990,7
7741538,The Inspector General,1949,['United States of America'],"['Musical', 'Screwball comedy', 'Comedy']",1940,9
4232830,Narco,2004,['France'],['Comedy'],2000,4
1747266,Follow that Dream,1962,['United States of America'],"['Musical', 'Comedy']",1960,2
1959014,The Greatest Game Ever Played,2005,['United States of America'],"['Period piece', 'History', 'Sports', 'Drama']",2000,5
1424178,The Simpsons Movie,2007,['United States of America'],"['Animation', 'Parody', 'Satire', 'Comedy', 'Domestic Comedy', 'Adventure']",2000,7
25850782,Kilukkampetti,1991,['India'],"['Drama', 'Comedy film']",1990,1
12270563,The Lost Boys,1978,['United Kingdom'],"['Drama', 'Biographical film']",1970,8
36355103,Inspector Garud,2007,[],"['Action', 'Comedy film']",2000,7
3978804,Joy in the Morning,1965,['United States of America'],"['Romantic drama', 'Drama']",1960,5
24057387,The Escort,1993,['Italy'],"['Crime Fiction', 'Action/Adventure', 'Thriller', 'World cinema', 'Crime Thriller', 'Political thriller']",1990,3
15657123,Chervona Ruta,1972,"['Soviet Union', 'Ukranian SSR']","['Musical', 'Television movie']",1970,2
12428147,The Underground World,1943,['United States of America'],"['Animation', 'Superhero', 'Short Film', 'Superhero movie', 'Adventure', 'Fantasy']",1940,3
25748112,Capitaine Conan,1996,['France'],"['Action/Adventure', 'World cinema', 'War film', 'Drama']",1990,6
10875573,The Devil and Daniel Webster,1941,['United States of America'],"['Courtroom Drama', 'Black-and-white', 'Drama', 'Fantasy']",1940,1
12782082,Cowboy,1958,['United States of America'],"['Action', 'Western', 'Action/Adventure']",1950,8
1101306,The Wild,2006,"['Canada', 'United States of America']","['Computer Animation', 'Animation', 'Comedy', ""Children's/Family"", 'Adventure', 'Family Film']",2000,6
22113550,Walang awa kung pumatay,1990,['Philippines'],['Filipino Movies'],1990,0
13461141,Common Wealth,2000,['Spain'],"['Crime Fiction', 'Mystery', 'Comedy', 'Thriller', 'World cinema', 'Black comedy', 'Crime Thriller', 'Drama']",2000,0
865561,Happiness,1998,['United States of America'],"['Indie', 'Comedy', 'Black comedy', 'Comedy-drama', 'Drama']",1990,8
28483386,The Flaming Urge,1953,['United States of America'],"['Crime Fiction', 'Thriller', 'Crime Drama', 'Drama']",1950,3
28282310,The Governor,2009,['Turkey'],['Action'],2000,9
1765978,Hum Dil De Chuke Sanam,1999,"['Hungary', 'India']","['Musical', 'Romantic drama', 'Comedy', 'Bollywood', 'Romance Film', 'Drama']",1990,9
3479622,L'Année des méduses,1984,['France'],"['Romance Film', 'Erotic Drama', 'Drama']",1980,4
4920511,Miracle at Midnight,1998,['United States of America'],"['Family Drama', 'Television movie', 'Family Film', 'Drama']",1990,8
12149946,See Grace Fly,2004,['Canada'],['Drama'],2000,4
5305120,Homecoming,1996,['United States of America'],"['Film adaptation', 'Family Drama', 'Television movie', 'Family Film', 'Drama']",1990,6
20903190,Ek Mahal Ho Sapno Ka,1975,['India'],"['Musical', 'Bollywood', 'World cinema', 'Drama']",1970,5
10658708,Wafadaar,1985,['India'],['Action'],1980,5
13048303,Pyar Ka Mandir,1988,['India'],['World cinema'],1980,8
14144257,Gunfighters of the Northwest,1954,['United States of America'],"['Adventure', 'Black-and-white']",1950,4
3033155,King Kong Lives,1986,['United States of America'],"['Creature Film', 'Monster movie', 'Action', 'Indie', 'Action/Adventure', 'Adventure']",1980,6
2792455,Sweet Sixteen,2002,"['Spain', 'United Kingdom', 'Germany', 'Scotland']","['Drama', 'Crime Fiction']",2000,2
18502214,7th Cavalry,1956,['United States of America'],['Western'],1950,6
19437157,Antaratama,2008,['India'],['Drama'],2000,8
247098,Sabotage,1936,['United Kingdom'],"['Mystery', 'Crime Thriller', 'Thriller']",1930,6
948706,Beginning of the End,1957,['United States of America'],"['Creature Film', 'Monster', 'Horror', 'Cult', 'Science Fiction', 'Natural horror films']",1950,7
26897990,The Lady Is Willing,1934,['United Kingdom'],['Comedy'],1930,4
4253806,Ordinary Magic,1993,['Canada'],['Drama'],1990,3
19818759,Rölli - hirmuisia kertomuksia,1991,['Finland'],"['Comedy', 'Adventure', 'Family Film', 'Fantasy']",1990,1
1405221,The Rules of Attraction,2002,"['Germany', 'United States of America']","['Film adaptation', 'LGBT', 'Indie', 'Satire', 'Thriller', 'Comedy', 'Romance Film', 'Black comedy', 'Drama', 'Romantic comedy', 'Comedy-drama']",2000,2
3252860,Sunshine,2007,"['United Kingdom', 'United States of America']","['Science Fiction', 'Adventure', 'Thriller']",2000,7
15234387,A Flower in Hell,1958,['South Korea'],"['Drama', 'Crime Fiction']",1950,8
19860911,Freeze Frame,1992,['United States of America'],"['Thriller', 'Family Film']",1990,2
1406573,Seducing Doctor Lewis,2003,['Canada'],"['Indie', 'Ensemble Film', 'Comedy', 'Comedy of Errors']",2000,3
5871867,Logan's Run,1976,['United States of America'],"['Action', 'Science Fiction']",1970,6
13934307,Mammoth,2009,"['Sweden', 'Germany', 'Denmark']","['Indie', 'Drama', 'World cinema']",2000,9
10899890,First Spaceship on Venus,1960,"['Germany', 'Poland']","['Science Fiction', 'Comedy']",1960,0
20719704,Boy! What a Girl!,1947,['United States of America'],"['Musical', 'Black-and-white', 'Comedy']",1940,7
16690320,Ikaw Na Sana,1998,[],"['Romance Film', 'Drama']",1990,8
30050474,Desperate Lives,1982,['United States of America'],['Drama'],1980,2
3097826,The Jack Bull,1999,['United States of America'],"['Film adaptation', 'Revisionist Western', 'Action/Adventure', 'Western', 'Television movie', 'Drama']",1990,9
9825500,Fifty Pills,2007,['United States of America'],"['Black comedy', 'Indie', 'Comedy']",2000,7
2037403,Light of Day,1987,['United States of America'],"['Musical', 'Family Drama', 'Musical Drama', 'Indie', 'Drama']",1980,7
31315579,The manor of Araucaima,1986,[],['Drama'],1980,6
18515925,Go Into Your Dance,1935,['United States of America'],"['Musical', 'Musical Drama', 'Drama']",1930,5
12857910,The Devil to Pay!,1930,['United States of America'],"['Romance Film', 'Drama', 'Comedy film']",1930,0
26551722,The Vicar of Bray,1937,['United Kingdom'],['History'],1930,7
19392800,Six Reasons Why,2008,['Canada'],"['Hybrid Western', 'Action/Adventure', 'Western', 'Drama']",2000,8
12139569,Redbelt,2008,['United States of America'],"['Action', 'Crime Fiction', 'Action Thrillers', 'Action/Adventure', 'Thriller', 'Martial Arts Film', 'Drama', 'Sports', 'War film']",2000,8
30105461,The Last Leaf,1983,[],['Short Film'],1980,3
6722122,The Passenger,2006,"['France', 'Canada', 'Japan']","['Drama', 'Japanese Movies', 'Thriller']",2000,6
17453425,Abby in Wonderland,2008,['United States of America'],"['Animation', ""Children's"", 'Adventure']",2000,8
26729747,Grand Larceny,1987,"['United Kingdom', 'France', 'United States of America']",['Thriller'],1980,7
240173,Ride with the Devil,1999,['United States of America'],"['Film adaptation', 'Romantic drama', 'Action/Adventure', 'Romance Film', 'Drama', 'Period piece', 'Western', 'War film']",1990,9
24085074,Clear Blue Tuesday,2009,['United States of America'],"['Music', 'Musical', 'Indie', 'Comedy film', 'Drama']",2000,9
5641052,The Charge of the Light Brigade,1936,['United States of America'],"['Action', 'Black-and-white', 'Romantic drama', 'Action/Adventure', 'Romance Film', 'War film', 'Drama']",1930,6
18589178,Prince Valiant,1954,['United States of America'],"['Action', 'Swashbuckler films', 'Action/Adventure', 'Adventure', 'Drama', 'Family Film', 'Fantasy']",1950,4
10615842,Mere Jeevan Saathi,1972,['India'],"['Action', 'Drama', 'Adventure']",1970,2
19575497,The Dark Country,2009,['United States of America'],"['Suspense', 'Mystery', 'Thriller', 'Crime Thriller']",2000,9
4861212,Sumo of the Opera,2004,['United States of America'],"['Musical', 'Animation', 'Short Film', 'Comedy', ""Children's""]",2000,4
11360989,The Framed Cat,1950,['United States of America'],"[""Children's/Family"", 'Short Film', 'Comedy']",1950,0
27670293,Robbery Under Arms,1957,['United Kingdom'],"['Action', 'Crime Fiction', 'Western', 'Historical drama', 'Adventure', 'Drama']",1950,7
474527,Confessions of a Teenage Drama Queen,2004,"['Germany', 'United States of America']","['Musical', 'Comedy', 'Teen', 'Romance Film', 'Family Film']",2000,4
24381383,Next of Kin,1982,"['New Zealand', 'Australia']","['Mystery', 'Thriller', 'Horror']",1980,2
13048086,2 Days in Paris,2007,"['France', 'Germany']","['Drama', 'Indie', 'Comedy', 'World cinema', 'Romance Film', 'Romantic comedy']",2000,7
3463593,Crack in the World,1965,['United States of America'],"['Action/Adventure', 'Science Fiction', 'Doomsday film', 'Disaster']",1960,5
18149943,Courage Mountain,1990,"['United States of America', 'France']","['Family Drama', 'Childhood Drama', 'Family-Oriented Adventure', ""Children's/Family"", 'War film', 'Adventure', 'Drama', 'Family Film']",1990,0
3584534,Game of Death II,1981,"['Hong Kong', 'South Korea']","['Action', 'Action/Adventure', 'World cinema', 'Chinese Movies', 'Martial Arts Film', 'Drama']",1980,1
34760845,Hail the New Puritan,1987,['United Kingdom'],['Documentary'],1980,7
1204638,Puss in Boots,1999,['United States of America'],['Animation'],1990,9
11781740,Fantaghirò 5,1996,['Italy'],"['Adventure', 'Family Film']",1990,6
5593097,Texasville,1990,['United States of America'],"['Romantic drama', 'Romance Film', 'Americana', 'Drama']",1990,0
2682493,Koshish,1972,['India'],"['Romantic drama', 'Bollywood', 'World cinema', 'Romance Film', 'Drama']",1970,2
2480504,The Twelve Chairs,1970,['United States of America'],"['Parody', 'Slapstick', 'Comedy']",1970,0
6062060,Imsai Arasan 23m Pulikesi,2006,['India'],"['Musical', 'Tamil cinema', 'World cinema', 'Drama']",2000,6
14187360,The Capture,1950,['United States of America'],"['Black-and-white', 'Crime Fiction', 'Hybrid Western', 'Action/Adventure', 'Western', 'Crime Drama', 'Drama']",1950,0
2804211,The Maddening,1995,['United States of America'],"['Psychological thriller', 'Thriller', 'Horror']",1990,5
6612985,Drive In Massacre,1976,['United States of America'],"['Slasher', 'B-movie', 'Horror']",1970,6
31133095,Lorry,1980,[],['Drama'],1980,0
18917701,Toomorrow,1970,"['United Kingdom', 'United States of America']","['Musical', 'Science Fiction', 'Comedy']",1970,0
1571097,Eragon,2006,"['Australia', 'United Kingdom', 'Hungary', 'United States of America']","['Action', 'Fantasy Adventure', 'Film adaptation', 'Costume drama', 'Adventure', 'Drama', 'Coming of age', 'Sword and sorcery', 'Family Film', 'Fantasy']",2000,6
2397550,Windows,1980,['United States of America'],"['LGBT', 'Drama', 'Thriller']",1980,0
603557,The Beast,1988,['United States of America'],"['War film', 'Drama']",1980,8
29417291,Morena Clara,1954,['Spain'],"['Musical', 'Romance Film', 'Comedy']",1950,4
17415962,Young Cassidy,1965,['United Kingdom'],"['Drama', 'Biography', 'Biopic [feature]']",1960,5
11202796,Abuja Connection,2003,['Nigeria'],"['Action', 'Drama', 'Comedy', 'Thriller']",2000,3
24104622,Heliopolis,2009,['Egypt'],"['Indie', 'Drama', 'World cinema']",2000,9
19091567,M'Liss,1936,['United States of America'],"['Black-and-white', 'Drama']",1930,6
20168380,L'Inhumaine,1924,['France'],"['Silent film', 'Black-and-white', 'Drama']",1920,4
18918169,Cirrhosis of the Louvre,1966,['United States of America'],"['Short Film', 'Animation']",1960,6
4600711,Goddess of Mercy,2003,"['China', 'Hong Kong']","['Action', 'Psychological thriller', 'Crime Fiction', 'Romantic drama', 'Action/Adventure', 'World cinema', 'Romance Film', 'Crime Thriller', 'Chinese Movies', 'Drama']",2000,3
18998739,The Sorcerer's Apprentice,2002,['South Africa'],"['World cinema', 'Adventure', 'Family Film', 'Fantasy']",2000,2
8293411,Wedding Wars,2006,"['Canada', 'United States of America']","['LGBT', 'Comedy', 'Romance Film', 'Romantic comedy']",2000,6
10815137,Himala,1982,['Philippines'],"['Filipino Movies', 'World cinema', 'Christian film', 'Drama']",1980,2
245515,Twin Peaks: Fire Walk With Me,1992,"['France', 'United States of America']","['Surrealism', 'Psychological thriller', 'Crime Fiction', 'Mystery', 'Avant-garde', 'Thriller', 'Crime Thriller', 'Drama', 'Suspense', 'Horror', 'Experimental film', 'Supernatural']",1990,2
27420928,Dr. O'Dowd,1940,['United Kingdom'],['Drama'],1940,0
26694002,Positive,2008,['India'],"['Musical', 'Bollywood', 'World cinema', 'Drama']",2000,8
773089,Father of the Bride,1991,['United States of America'],"['Comedy', 'Romance Film', 'Romantic comedy', 'Family Film']",1990,1
22328317,Josh,2009,['India'],['Family Film'],2000,9
5171974,Fantasy Mission Force,1983,['Hong Kong'],"['Action', 'Action/Adventure', 'World cinema', 'Chinese Movies', 'Martial Arts Film', 'Adventure']",1980,3
3213541,The Virgin Queen,1955,['United States of America'],"['Period piece', 'Romantic drama', 'Biographical film', 'Romance Film', 'Costume drama', 'Drama']",1950,5
524813,Broken Arrow,1996,['United States of America'],"['Action', 'Spy', 'Action/Adventure', 'Thriller']",1990,6
13443734,Kings,2007,"['Ireland', 'United Kingdom']","['Indie', 'Drama']",2000,7
18226465,Till There Was You,2003,['Philippines'],"['Filipino Movies', 'Romantic drama', 'World cinema', 'Romance Film', 'Drama']",2000,3
31424950,Goodbye Love,1933,['United States of America'],"['Romance Film', 'Romantic comedy', 'Comedy']",1930,3
5649246,Dear God,1996,['United States of America'],"['Comedy', 'Religious Film', 'Workplace Comedy', 'Comedy of Errors']",1990,6
106262,What Women Want,2000,['United States of America'],"['Comedy', 'Romance Film', 'Romantic comedy', 'Workplace Comedy', 'Fantasy Comedy', 'Fantasy']",2000,0
20168100,The Wild World of Batwoman,1966,['United States of America'],"['Black-and-white', 'Parody', 'Comedy', 'Horror Comedy', 'Horror', 'Superhero movie', 'Science Fiction']",1960,6
5101168,Switchback,1997,['United States of America'],"['Action', 'Detective fiction', 'Crime Fiction', 'Mystery', 'Action/Adventure', 'Thriller', 'Crime Thriller', 'Detective']",1990,7
2421596,Robbery,1967,['United Kingdom'],"['Crime Fiction', 'Mystery', 'Drama']",1960,7
24165798,Banjo,1947,['United States of America'],"['Drama', ""Children's/Family""]",1940,7
13287017,Coqueta,1983,['Mexico'],"['Musical', 'Romance Film', 'Drama', 'Family Film']",1980,3
15280057,The Bribe,1949,['United States of America'],"['Black-and-white', 'Crime Fiction', 'Thriller', 'Crime Drama', 'Film noir', 'Drama']",1940,9
30298630,The Shanghai Cobra,1945,[],"['Mystery', 'Crime Thriller', 'Thriller']",1940,5
26736480,Peopletoys,1974,['United States of America'],"['Slasher', 'Teen', 'Horror', 'B-movie']",1970,4
30366792,Round-Up Time in Texas,1937,['United States of America'],"['Action/Adventure', 'Western']",1930,7
5240350,Big Bad Mama,1974,['United States of America'],"['Action', 'Crime Fiction', 'Action/Adventure', 'Comedy', 'Crime Thriller']",1970,4
16024773,The Bedeviled,1975,['Hong Kong'],"['Chinese Movies', 'Horror']",1970,5
11217280,The Go-Getter,2008,['United States of America'],"['Coming of age', 'Indie', 'Comedy', 'Road movie', 'Drama']",2000,8
11895155,Peculiarities of National Fishing,1998,"['Russia', 'Finland']","['Comedy', 'World cinema']",1990,8
28715960,Demon Wind,1990,[],['Horror'],1990,0
2718584,Gamera 3: Awakening of Irys,1999,['Japan'],"['Creature Film', 'Monster movie', 'Japanese Movies', 'Science Fiction', 'World cinema']",1990,9
19005561,Lazybones,1935,['United Kingdom'],"['Romance Film', 'Comedy film']",1930,5
685440,Bedazzled,1967,"['United Kingdom', 'England']","['Comedy', 'Black comedy', 'Romantic comedy', 'Romance Film', 'Fantasy']",1960,7
21922602,Too Romantic,1992,['United States of America'],['Short Film'],1990,2
3099675,Chuck & Buck,2000,['United States of America'],"['Indie', 'Comedy', 'Black comedy', 'Comedy-drama', 'Drama']",2000,0
944960,All the Real Girls,2003,['United States of America'],"['Coming of age', 'Romantic drama', 'Indie', 'Romance Film', 'Drama']",2000,3
3648312,Aaron Loves Angela,1975,['United States of America'],"['Blaxploitation', 'Coming of age', 'Romance Film', 'Melodrama', 'Drama']",1970,5
4050489,Odna,1931,['Soviet Union'],"['Black-and-white', 'Drama']",1930,1
9362656,Passing Glory,1999,['United States of America'],"['Period piece', 'Docudrama', 'Television movie', 'Sports', 'Drama']",1990,9
935950,Lambada,1990,['United States of America'],"['Musical', 'Romantic drama', 'Romance Film', 'Drama']",1990,0
28525801,The Man Without Desire,1923,['United Kingdom'],['Silent film'],1920,3
920062,Special Bulletin,1983,['United States of America'],"['Psychological thriller', 'Doomsday film', 'Science Fiction', 'Drama']",1980,3
8690279,Un tour de manège,1989,['France'],"['Romance Film', 'Crime Fiction', 'Drama']",1980,9
11453579,Pathology,2007,['United States of America'],"['Crime Fiction', 'Thriller', 'Horror', 'Crime Thriller']",2000,7
23969020,Virgin Forest,1985,['Philippines'],"['Filipino Movies', 'War film', 'Drama']",1980,5
6156675,Return Engagement,1990,['Hong Kong'],"['Chinese Movies', 'Drama']",1990,0
5971762,The Truth About Charlie,2002,"['Germany', 'United States of America']","['Suspense', 'Mystery', 'Comedy Thriller', 'Thriller', 'Comedy', 'Romantic comedy', 'Crime Thriller']",2000,2
32751118,Prahalatha,1939,['India'],[],1930,9
23168010,Inspector Hornleigh Goes To It,1941,['United Kingdom'],"['Drama', 'Crime Fiction']",1940,1
2456349,Dead Men Walk,1943,['United States of America'],"['Black-and-white', 'Horror', 'Zombie Film', 'Drama']",1940,3
17112291,Confessions of a Shopaholic,2009,['United States of America'],"['Film adaptation', 'Comedy', 'Romance Film', 'Romantic comedy', 'Workplace Comedy']",2000,9
31421277,Fresh,2009,[],['Documentary'],2000,9
27492406,Amok,1944,['Mexico'],['Drama'],1940,4
27584028,Story of O,1975,"['France', 'Germany', 'Canada']","['Romance Film', 'Drama', 'World cinema']",1970,5
12706080,Along Came Jones,1945,['United States of America'],"['Action', 'Action/Adventure', 'Western', 'Comedy']",1940,5
11959646,A Slave of Fashion,1925,['United States of America'],"['Black-and-white', 'Indie', 'Silent film', 'Romantic comedy']",1920,5
24508400,American Yakuza,1993,['United States of America'],"['Action', 'Crime Fiction', 'Gangster Film', 'Action/Adventure', 'Thriller', 'Crime Thriller', 'Drama']",1990,3
5004716,Kadhal Kondein,2003,['India'],['Drama'],2000,3
662746,Bhoot bungla,1965,['India'],"['Musical', 'Thriller', 'Comedy film']",1960,5
4417478,"Rally 'Round the Flag, Boys!",1958,['United States of America'],['Comedy'],1950,8
24200785,Dallas,1950,['United States of America'],"['Action/Adventure', 'Western']",1950,0
14573459,Gents Without Cents,1944,['United States of America'],"['Black-and-white', 'Short Film', 'Comedy', 'Slapstick']",1940,4
21871346,Without a Paddle: Nature's Calling,2009,['United States of America'],"['Action', 'Indie', 'Comedy', 'Road movie', 'Slapstick', 'Adventure', 'Absurdism']",2000,9
9322953,Deadwater,2008,['United States of America'],"['Action', 'Action/Adventure', 'Thriller', 'Horror', 'Supernatural']",2000,8
33207268,High Pressure,1932,['United States of America'],['Comedy'],1930,2
3015828,Spectre,1977,['United Kingdom'],"['Television movie', 'Horror']",1970,7
3090812,Bringing Down the House,2003,['United States of America'],"['Screwball comedy', 'Comedy', 'Crime Comedy', 'Romantic comedy', 'Comedy of Errors']",2000,3
4813288,"The Long, Hot Summer",1958,['United States of America'],"['Romance Film', 'Romantic drama', 'Drama']",1950,8
32896071,The Dinkum Bloke,1923,[],['Silent film'],1920,3
6060885,Blood Red,1989,['United States of America'],"['Action', 'Drama', 'Western', 'Romance Film']",1980,9
24572702,Mike,1926,[],"['Silent film', 'Crime Fiction', 'Comedy']",1920,6
12633541,Das Spielzeug von Paris,1925,['Austria'],"['Silent film', 'Black-and-white', 'Indie']",1920,5
11765429,Irina Palm,2008,"['Luxembourg', 'Belgium', 'United Kingdom', 'France', 'Germany']","['Indie', 'Comedy', 'World cinema', 'Comedy-drama', 'Drama']",2000,8
10777972,"Scorching Sun, Fierce Winds, Wild Fire",1980,['Hong Kong'],"['Action', 'Action/Adventure', 'World cinema', 'Chinese Movies', 'Martial Arts Film']",1980,0
9415710,Tank Girl,1995,['United States of America'],"['Action', 'Science Fiction', 'Comedy']",1990,5
32307438,Dragon,2006,['United States of America'],"['Indie', 'Fantasy']",2000,6
7784121,Manic,2001,['United States of America'],"['Indie', 'Drama']",2000,1
20795238,On the Buses,1971,['United Kingdom'],['Comedy'],1970,1
12795377,Frozen,2004,['United Kingdom'],['Thriller'],2000,4
35303280,Before It Had a Name,2005,['United States of America'],"['Romance Film', 'Romantic drama', 'Drama']",2000,5
2538123,Made in Britain,1982,"['United Kingdom', 'England']","['Crime Fiction', 'Short Film', 'Crime Drama', 'Television movie', 'Juvenile Delinquency Film', 'Drama']",1980,2
5548592,Race,2008,['India'],"['Musical', 'Thriller', 'Bollywood', 'World cinema', 'Crime Thriller']",2000,8
16915874,Five Fingers,2006,['United States of America'],"['Psychological thriller', 'Action', 'Action Thrillers', 'Action/Adventure', 'Thriller', 'Political thriller']",2000,6
23669013,Tiger Fangs,1943,['United States of America'],"['Suspense', 'Black-and-white', 'Thriller']",1940,3
21618542,Kill Cruise,1990,['West Germany'],"['Psychological thriller', 'Thriller', 'World cinema', 'Crime Thriller']",1990,0
8628620,Thaniavarthanam,1987,['India'],['Drama'],1980,7
3376392,The Overlanders,1946,"['United Kingdom', 'Australia']","['Western', 'Adventure']",1940,6
5975630,Young Man with a Horn,1950,['United States of America'],"['Film à clef', 'Black-and-white', 'Biography', 'Musical Drama', 'Drama']",1950,0
6524086,A Night to Remember,1958,['United Kingdom'],"['Action', 'Film adaptation', 'Action/Adventure', 'Epic', 'Disaster', 'Drama']",1950,8
217750,The Whisperers,1967,['United Kingdom'],"['Film adaptation', 'Crime Fiction', 'Drama']",1960,7
531747,Frequency,2000,['United States of America'],"['Crime Fiction', 'Family Drama', 'Thriller', 'Drama', 'Suspense', 'Time travel', 'Science Fiction', 'Fantasy']",2000,0
27978764,Trainwreck: My Life as an Idiot,2007,['United States of America'],"['Indie', 'Comedy', 'Romance Film', 'Romantic comedy', 'Comedy-drama']",2000,7
27888833,Before Women Had Wings,1997,['United States of America'],"['Family Drama', 'Addiction Drama', 'Drama']",1990,7
20008114,The Killing Room,2009,['United States of America'],"['Mystery', 'Thriller']",2000,9
798584,My Fellow Americans,1996,['United States of America'],"['Political cinema', 'Political satire', 'Satire', 'Buddy film', 'Comedy']",1990,6
22265682,Rathi Nirvedam,1978,['India'],"['Romance Film', 'Drama']",1970,8
236651,Mallrats,1995,['United States of America'],"['Comedy', 'Buddy film', 'Comedy of manners', 'Romance Film', 'Romantic comedy']",1990,5
9830229,Rosemary's Baby,1968,['United States of America'],"['Psychological thriller', 'Mystery', 'Horror', 'Drama']",1960,8
9520953,Todas las Azafatas van al Cielo,2002,"['Argentina', 'Spain']","['Drama', 'Romantic drama', 'Indie', 'Comedy', 'World cinema', 'Romance Film']",2000,2
16749397,This Is My Father,1998,"['Canada', 'Ireland']","['Period piece', 'Drama', 'Indie', 'Romantic drama', 'World cinema', 'Romance Film']",1990,8
24479315,Rechipo,2009,['India'],['Romance Film'],2000,9
13022883,Phobia,1980,"['United States of America', 'Canada', 'Australia']","['Thriller', 'Horror']",1980,0
24567664,Chestnut: Hero of Central Park,2004,[],"['Adventure', 'Family Film']",2000,4
10688518,Hero at Large,1980,['United States of America'],"['Action', 'Superhero', 'Action/Adventure', 'Comedy', 'Superhero movie', 'Comedy of Errors']",1980,0
11020901,Piker's Peak,1957,['United States of America'],"['Animation', 'Short Film', 'Comedy', 'Family Film']",1950,7
27306334,Mr. Vampire II,1986,['Hong Kong'],"['Chinese Movies', 'Comedy', 'Horror', 'World cinema']",1980,6
16143062,Benji: Off the Leash!,2004,['United States of America'],"['Drama', 'Family Film']",2000,4
7605182,Trade,2007,"['Germany', 'United States of America']","['Crime Fiction', 'Thriller', 'Crime Thriller', 'Drama']",2000,7
15486978,"Continental, un film sans fusil",2007,['Canada'],"['Indie', 'Comedy', 'Drama']",2000,7
22872100,The House of the Devil,2009,['United States of America'],"['Slasher', 'Thriller', 'Horror', 'Teen', 'Haunted House Film']",2000,9
26088981,Nirnayam,1995,['India'],"['Action', 'Thriller', 'Bollywood']",1990,5
3132637,Hell's Island,1955,['United States of America'],"['Action', 'Action/Adventure', 'Thriller', 'Adventure', 'Film noir', 'Drama']",1950,5
22735303,Caught Up,1998,['United States of America'],"['Drama', 'Crime Fiction', 'Thriller']",1990,8
28138971,Back to God's Country,1953,['United States of America'],"['Action', 'Drama']",1950,3
28275706,Malayali,2009,['India'],['Drama'],2000,9
11140687,Guna,1991,['India'],['Drama'],1990,1
25337747,Vanished,1995,['United States of America'],"['Film adaptation', 'Romantic drama', 'Thriller', 'Romance Film', 'Television movie', 'Drama']",1990,5
20872587,The Phantom Stockman,1953,['Australia'],"['Action', 'Crime Fiction', 'Western', 'Adventure']",1950,3
36057880,Swarnamukhi,1998,['India'],['Drama'],1990,8
24472535,Thiru Thiru Thuru Thuru,2009,[],"['Romance Film', 'Romantic comedy', 'Comedy']",2000,9
3204869,Zéro de Conduite,1933,['France'],['Black-and-white'],1930,3
9609346,The Vanishing Legion,1931,['United States of America'],"['Action', 'Black-and-white', 'Western', 'Action/Adventure', 'Adventure']",1930,1
31478629,The Magician of Lublin,1979,"['Israel', 'West Germany']",['Drama'],1970,9
27474133,Just My Luck,1957,['United Kingdom'],"['Screwball comedy', 'Comedy']",1950,7
12490207,Over the Rainbow,2002,['South Korea'],"['Romantic drama', 'Thriller', 'World cinema', 'Romance Film', 'Romantic comedy', 'Drama']",2000,2
25575543,Hardboiled Rose,1929,['United States of America'],[],1920,9
32657867,"Dad Rudd, M. P.",1940,['Australia'],['Comedy'],1940,0
13900943,April Fool's Day,2008,['United States of America'],"['Slasher', 'Teen', 'Horror', 'Science Fiction']",2000,8
11140631,Kalaignan,1993,['India'],"['Action', 'Thriller']",1990,3
1503023,Getting My Brother Laid,2002,['Germany'],"['Comedy', 'Romance Film', 'Romantic comedy', 'Drama']",2000,2
29659855,"Sasquatch, the Legend of Bigfoot",1977,[],"['Mystery', 'Adventure']",1970,7
5186681,Mr. Dramatic,2005,['United States of America'],"['Short Film', 'Comedy']",2000,5
2162119,Merry Andrew,1958,['United States of America'],"['Musical', 'Comedy', 'Musical comedy']",1950,8
101998,The Enigma of Kaspar Hauser,1974,"['Germany', 'West Germany']","['Period piece', 'Biographical film', 'Biopic [feature]', 'World cinema', 'Drama']",1970,4
8260752,Minder on the Orient Express,1985,['United Kingdom'],['Thriller'],1980,5
20066145,The Substitute 3: Winner Takes All,1999,['United States of America'],"['Action', 'Action Thrillers', 'Thriller']",1990,9
685720,The Last Tycoon,1976,['United States of America'],"['Period piece', 'Film à clef', 'Film adaptation', 'Romantic drama', 'Romance Film', 'Drama']",1970,6
22029678,Reykjavik Whale Watching Massacre,2009,['Iceland'],"['Slasher', 'Horror']",2000,9
3661762,The Arena,1974,"['Italy', 'United States of America']","['Action', 'Drama', 'Action/Adventure', 'Adventure']",1970,4
3152877,Summer Rental,1985,['United States of America'],"['Screwball comedy', 'Action/Adventure', 'Comedy', 'Romance Film', 'Romantic comedy', 'Domestic Comedy', 'Adventure']",1980,5
23184272,Mending Fences,2009,['United States of America'],['Drama'],2000,9
9695354,Riding High,1950,['United States of America'],"['Musical', 'Sports', 'Comedy']",1950,0
12579118,Ravedactyl: Project Evolution,2005,['United States of America'],"['Action', 'Short Film']",2000,5
2750304,The Daddy of Rock 'N' Roll,2000,['United States of America'],"['Music', 'Social issues', 'Rockumentary', 'Biography', 'Documentary', 'Culture & Society']",2000,0
26527042,Warm Nights on a Slow Moving Train,1987,['Australia'],['Drama'],1980,7
9857632,El Fin de la noche,1944,['Argentina'],['Black-and-white'],1940,4
14445876,The Last Breath,2009,['United Kingdom'],"['Short Film', 'Comedy', 'Thriller', 'Horror', 'Drama']",2000,9
10931140,Blood Brothers,1973,['Hong Kong'],"['Drama', 'Chinese Movies', 'Martial Arts Film']",1970,3
12765604,Operation Mad Ball,1957,['United States of America'],"['War film', 'Comedy']",1950,7
24970545,Go Trabi Go,1991,['Germany'],['Comedy'],1990,1
20986251,Fog Warning,2008,['United States of America'],"['Thriller', 'Horror']",2000,8
11537813,Tere Mere Sapne,1971,['India'],"['Drama', 'World cinema']",1970,1
11320437,Marudhamalai,2007,['India'],['Action'],2000,7
18004274,Kadathanadan Ambadi,1990,['India'],"['Drama', 'Comedy film']",1990,0
24598944,Door to Silence,1991,['Italy'],"['Psychological thriller', 'Thriller', 'Horror', 'World cinema', 'Supernatural']",1990,1
1954206,Yellowbeard,1983,"['United Kingdom', 'United States of America']","['Adventure Comedy', 'Action', 'Parody', 'Action/Adventure', 'Comedy', 'Swashbuckler films', 'Adventure']",1980,3
23047425,April Bride,2009,['Japan'],"['Melodrama', 'Japanese Movies', 'Drama']",2000,9
21739909,Don't Drink the Water,1969,['United States of America'],"['Political cinema', 'Screwball comedy', 'Comedy']",1960,9
18689180,Lilla Jönssonligan på styva linan,1997,['Sweden'],['Family Film'],1990,7
22740168,Kinatay,2009,"['France', 'Philippines']","['Filipino Movies', 'Thriller', 'World cinema', 'Drama']",2000,9
3656559,Stalin,2006,['India'],"['Action', 'Drama']",2000,6
18647257,Final Approach,2008,['United States of America'],"['Action', 'Thriller']",2000,8
8427316,Sammy's Super T-Shirt,1978,['United Kingdom'],"[""Children's"", 'Family Film']",1970,8
7544443,Tomorrow is Forever,1946,['United States of America'],"['Black-and-white', 'Film noir', 'Melodrama', 'Drama']",1940,6
14850708,Bandits from Shantung,1972,['Hong Kong'],"['Wuxia', 'Chinese Movies']",1970,2
15221159,Bumbarash,1971,['Soviet Union'],"['Musical', 'Comedy', 'Comedy-drama', 'War film', 'Adventure']",1970,1
9653767,I Don't Hate Las Vegas Anymore,1994,['United States of America'],"['Mockumentary', 'Comedy', 'Domestic Comedy', 'Road movie']",1990,4
3309192,Three of Hearts,1993,['United States of America'],"['LGBT', 'Romantic drama', 'Comedy', 'Romance Film', 'Drama', 'Gay Themed', 'Gay', 'Gay Interest', 'Romantic comedy', 'Comedy-drama', 'Sex comedy']",1990,3
17120190,Tarzan Triumphs,1943,['United States of America'],"['Adventure', 'Black-and-white']",1940,3
601923,An American Rhapsody,2001,"['Hungary', 'United States of America']","['Period piece', 'Family Drama', 'Television movie', 'Political drama', 'Drama']",2000,1
5590914,Rawhead Rex,1986,['United Kingdom'],"['Creature Film', 'Horror']",1980,6
9092451,The Wolf Man,1924,['United States of America'],"['Black-and-white', 'Drama', 'Indie', 'Silent film']",1920,4
21070862,Escape from the Bronx,1983,['Italy'],"['Action', 'Science Fiction']",1980,3
26460996,Blonde Dynamite,1950,['United States of America'],['Comedy'],1950,0
18975264,Neelakuyil,1954,['India'],['Drama'],1950,4
23463534,Tom Sawyer,1930,['United States of America'],"['Adventure', 'Drama', 'Comedy film']",1930,0
724449,Brotherhood of Death,1976,['United States of America'],"['Action', 'Blaxploitation', 'Drama', 'Thriller']",1970,6
24027834,Love Laughs at Andy Hardy,1946,['United States of America'],"['Romance Film', 'Romantic comedy', 'Comedy']",1940,6
15112212,Meet Mr. Lucifer,1953,['United Kingdom'],"['Ealing Comedies', 'Satire', 'Comedy', 'Fantasy Comedy', 'Fantasy']",1950,3
449547,Licence to Kill,1989,"['United Kingdom', 'United States of America']","['Action', 'Crime Fiction', 'Action Thrillers', 'Thriller', 'Glamorized Spy Film', 'Adventure']",1980,9
7830482,Re-Animated,2006,['United States of America'],"['Animation', 'Comedy', 'Television movie', ""Children's"", 'Fantasy Comedy', 'Family Film']",2000,6
648216,Sholay,1975,['India'],"['Action', 'Comedy', 'Thriller', 'Bollywood', 'World cinema', 'Romance Film', 'Adventure', 'Western']",1970,5
7634531,Darby's Rangers,1958,['United States of America'],"['Combat Films', 'Black-and-white', 'War film']",1950,8
14838849,A Spray of Plum Blossoms,1931,['China'],"['Black-and-white', 'Indie', 'Silent film', 'Chinese Movies']",1930,1
18471018,Straight from the Heart,2003,"['Germany', 'United States of America']","['Film adaptation', 'Romantic drama', 'Romance Film', 'Television movie', 'Drama']",2000,3
1683515,Alpha Dog,2006,['United States of America'],"['Crime Fiction', 'Biographical film', 'Teen', 'Crime Drama', 'Docudrama', 'Drama']",2000,6
4851257,Kingdom of the Spiders,1977,['United States of America'],"['Horror', 'B-movie', 'Science Fiction', 'Natural horror films']",1970,7
3815680,Slam,1998,['United States of America'],"['Crime Fiction', 'Coming of age', 'Indie', 'Hip hop movies', 'Drama']",1990,8
5874219,Beyond Belief,1990,['United States of America'],"['Musical', 'Adventure', 'Drama', 'Family Film']",1990,0
326446,El Mariachi,1992,"['Mexico', 'United States of America']","['Action', 'Gangster Film', 'Indie', 'Action/Adventure', 'Action Thrillers', 'Thriller', 'World cinema']",1990,2
12352451,Samson,1961,['Poland'],"['Coming of age', 'World cinema', 'Romance Film', 'War film', 'Drama', 'Tragedy']",1960,1
556974,Bollywood Dreams,1995,['India'],"['Musical', 'Romantic drama', 'Bollywood', 'World cinema', 'Romance Film', 'Melodrama', 'Drama']",1990,5
7273232,The Undying Monster,1942,['United States of America'],"['Creature Film', 'Melodrama', 'Horror']",1940,2
7667364,Zigeunerweisen,1980,['Japan'],"['Drama', 'Erotic Drama', 'Japanese Movies', 'Indie', 'Thriller', 'World cinema']",1980,0
2951156,Street Fighter Alpha: Generations,2005,['Japan'],"['Action', 'Fantasy Adventure', 'Animation', 'Japanese Movies', 'Anime', 'Martial Arts Film']",2000,5
13603154,Super High Me,2008,['United States of America'],"['Social issues', 'Indie', 'Stoner film', 'Stand-up comedy', 'Documentary', 'Culture & Society']",2000,8
3909180,Control,2007,"['Japan', 'Australia', 'United Kingdom', 'United States of America']","['Musical', 'Drama', 'Japanese Movies', 'Biography', 'Indie', 'Biographical film']",2000,7
11140795,Chanakyan,1989,['India'],['Thriller'],1980,9
16781552,Another Part of the Forest,1948,['United States of America'],"['Black-and-white', 'Drama']",1940,8
6695231,Nertsery Rhymes,1933,['United States of America'],"['Short Film', 'Comedy']",1930,3
2324846,Personal Best,1982,['United States of America'],"['Gay Themed', 'LGBT', 'Gay', 'Romantic drama', 'Gay Interest', 'Sports', 'Drama']",1980,2
10386740,The Night of the Shooting Stars,1982,['Italy'],"['Family Drama', 'World cinema', 'War film', 'Drama', 'Fantasy']",1980,2
13180264,Veerappu,2007,['India'],"['Action', 'Drama']",2000,7
12839891,Popcorn,1991,['United States of America'],"['Indie', 'Slasher', 'Comedy', 'Horror', 'B-movie']",1990,1
8829690,The Love Letter,1999,['United States of America'],"['Film adaptation', 'Comedy', 'Romance Film', 'Romantic comedy', 'Drama']",1990,9
1145761,Where Eagles Dare,1968,"['United Kingdom', 'United States of America']","['Action', 'Action/Adventure', 'War film', 'Roadshow theatrical release', 'Adventure', 'Drama']",1960,8
23759625,House Broken,2009,['United States of America'],['Comedy'],2000,9
11507737,Sherlock Holmes and the Baker Street Irregulars,2007,"['Ireland', 'United Kingdom']","['Detective fiction', 'Crime Fiction', 'Mystery', 'Thriller', 'Crime Thriller', 'Drama', 'Detective', 'Television movie', 'Fantasy']",2000,7
7883438,The Invasion,2007,"['United States of America', 'Australia']","['Action', 'Film adaptation', 'Thriller', 'Drama', 'Horror', 'Doomsday film', 'Science Fiction', 'Political thriller']",2000,7
10320328,Those She Left Behind,1989,['United States of America'],['Drama'],1980,9
35527324,War Nurse,1930,['United States of America'],"['Romance Film', 'War film', 'Drama']",1930,0
20721001,How to Stuff a Woodpecker,1960,['United States of America'],"['Animation', 'Short Film', 'Comedy', 'Family Film']",1960,0
2080825,The Legend of Hell House,1973,['United Kingdom'],"['Supernatural', 'Haunted House Film', 'Horror']",1970,3
14832787,Fast Break,1979,['United States of America'],"['Sports', 'Comedy']",1970,9
29677455,Stalingrad,1990,"['Czechoslovakia', 'German Democratic Republic', 'Soviet Union', 'United States of America']",['War film'],1990,0
35117027,Illusions,1982,['United States of America'],"['Short Film', 'Drama']",1980,2
3894665,Sukumar Ray,1987,['India'],"['Short Film', 'Documentary']",1980,7
18703589,Hôtel du Nord,1938,['France'],"['Black-and-white', 'Melodrama', 'Drama']",1930,8
3317165,The Joker Is Wild,1957,['United States of America'],"['Musical', 'Black-and-white', 'Crime Fiction', 'Biography', 'Romantic drama', 'Romance Film', 'Drama', 'Period piece', 'Biopic [feature]', 'Epic']",1950,7
504242,Serenity,2005,['United States of America'],"['Action', 'Comedy', 'Thriller', 'Space western', 'Adventure', 'Drama', 'Dystopia', 'Western', 'Space opera', 'Science Fiction']",2000,5
14769428,Feathers in the Wind,2005,['South Korea'],"['Romance Film', 'Drama']",2000,5
8020399,The Abandoned,2007,"['United Kingdom', 'Spain', 'Bulgaria']","['Supernatural', 'Horror']",2000,7
3889952,The Manster,1962,"['Japan', 'United States of America']","['Creature Film', 'Monster movie', 'Japanese Movies', 'Science Fiction', 'Horror', 'B-movie']",1960,2
24539635,Blume in Love,1973,['United States of America'],['Comedy film'],1970,3
1582683,The Wrong Man,1956,['United States of America'],"['Film noir', 'Crime Fiction', 'Drama']",1950,6
26022310,Vellinakshatram,2004,['India'],"['Mystery', 'Horror']",2000,4
877044,Project Moonbase,1953,['United States of America'],"['Science Fiction', 'Adventure']",1950,3
21061501,Dream of a Cossack,1950,['Soviet Union'],['Drama'],1950,0
12619383,Peoria Babylon,1997,['United States of America'],"['LGBT', 'Indie', 'Comedy']",1990,7
4110642,Blind Flight,2003,['United Kingdom'],"['Prison', 'Drama']",2000,3
2040174,Cry Of The Banshee,1970,['United Kingdom'],"['Costume Horror', 'Horror']",1970,0
32309840,Odor of the Day,1948,[],"['Animation', 'Short Film', 'Comedy film', 'Family Film']",1940,8
16208244,Split Second,1953,['United States of America'],"['Black-and-white', 'Thriller']",1950,3
1800944,The Punch and Judy Man,1963,['United Kingdom'],"['Drama', 'Comedy']",1960,3
2063141,The Devil's Rejects,2005,"['Germany', 'United States of America']","['Thriller', 'Horror']",2000,5
20297563,That Certain Age,1938,['United States of America'],"['Musical', 'Black-and-white', 'Comedy', 'Musical comedy']",1930,8
3751460,Super Xuxa,1988,['Brazil'],"['Comedy', 'Family Film', 'Fantasy']",1980,8
10520690,The Day I Became a Woman,2000,['Iran'],"['Comedy', 'World cinema', 'Drama', 'Feminist Film']",2000,0
3445885,Kamen Rider ZO,1993,['Japan'],['Japanese Movies'],1990,3
1641416,A Wild Hare,1940,['United States of America'],"['Short Film', 'Comedy']",1940,0
1388981,Cold Creek Manor,2003,"['United Kingdom', 'United States of America', 'Canada']","['Psychological thriller', 'Mystery', 'Thriller', 'Crime Thriller', 'Drama']",2000,3
2530377,The Center of the World,2001,['United States of America'],"['Erotic Drama', 'Romantic drama', 'Indie', 'Romance Film', 'Erotica', 'Drama']",2000,1
9442979,Young and Willing,1943,['United States of America'],['Comedy'],1940,3
18926657,Luna de Miel,1959,"['United Kingdom', 'Spain']","['Romantic drama', 'Musical Drama', 'Romance Film', 'Drama']",1950,9
3220552,Scandal Sheet,1952,['United States of America'],"['Black-and-white', 'Crime Fiction', 'Thriller', 'Film noir', 'Crime Thriller', 'Drama']",1950,2
26044505,The Flying Serpent,1946,['United States of America'],"['B-movie', 'Thriller', 'Horror']",1940,6
964721,Windtalkers,2002,['United States of America'],"['Combat Films', 'Action', 'Drama', 'War film']",2000,2
6322722,Broken Bridges,2006,['United States of America'],"['Music', 'Drama']",2000,6
28551215,Blonde Ice,1948,['United States of America'],"['Crime Fiction', 'Slasher', 'Film noir', 'Romance Film', 'Drama']",1940,8
88609,Star Trek IV: The Voyage Home,1986,['United States of America'],"['Time travel', 'Comedy', 'Adventure', 'Science Fiction', 'Family Film']",1980,6
30690327,Totò Le Mokò,1951,['Italy'],['Comedy film'],1950,1
4530423,Los tres mosqueteros,1942,['Mexico'],"['Comedy', 'Black-and-white']",1940,2
25215930,A Lecture on Camouflage,1944,['United States of America'],"['Short Film', 'Animation']",1940,4
1392986,Seeing Other People,2004,['United States of America'],"['Indie', 'Comedy', 'Romance Film', 'Romantic comedy', 'Sex comedy']",2000,4
8267742,G-Men vs The Black Dragon,1943,['United States of America'],"['Action', 'Spy', 'Black-and-white', 'Action/Adventure', 'Adventure']",1940,3
16921881,Alive,2006,['Russia'],"['Mystery', 'Drama', 'Fantasy']",2000,6
12212954,The Munsters' Scary Little Christmas,1996,['United States of America'],['Comedy'],1990,6
2805108,Roadgames,1981,['Australia'],"['Psychological thriller', 'Suspense', 'Thriller', 'World cinema', 'Drama']",1980,1
27782311,The True Story of Lynn Stuart,1958,['United States of America'],"['Drama', 'Crime Fiction']",1950,8
10934134,Blazing Temple,1976,"['Hong Kong', 'Taiwan']","['Action', 'Action/Adventure', 'World cinema', 'War film', 'Chinese Movies', 'Martial Arts Film', 'Drama']",1970,6
11925733,Command Decision,1948,['United States of America'],"['Action', 'Black-and-white', 'War film', 'Drama']",1940,8
22081857,Letters from Alou,1990,['Spain'],['Drama'],1990,0
2905998,The Fallen Ones,2005,['United States of America'],"['Action/Adventure', 'Thriller', 'Horror', 'Adventure', 'Television movie', 'Supernatural', 'Science Fiction']",2000,5
40672,Léon: The Professional,1994,['France'],"['Action', 'Crime Fiction', 'Indie', 'Action/Adventure', 'Buddy film', 'Thriller', 'World cinema', 'Crime Thriller', 'Drama', 'Coming of age']",1990,4
5501952,That's Life!,1986,['United States of America'],"['Drama', 'Indie', 'Marriage Drama', 'Comedy', 'Comedy of manners', 'Comedy-drama']",1980,6
171051,The Fisher King,1991,['United States of America'],"['Drama', 'Indie', 'Buddy film', 'Comedy', 'Comedy-drama', 'Fantasy Comedy', 'Fantasy']",1990,1
7771466,Porky's Poultry Plant,1936,['United States of America'],['Short Film'],1930,6
19729210,My Old Man,1979,['United States of America'],"['Drama', 'Television movie']",1970,9
25440524,Aalaya Sikharam,1983,['India'],"['Action', 'Family Film']",1980,3
26011350,"Tora-san, the Go-Between",1985,['Japan'],['Japanese Movies'],1980,5
5157418,What To Do In Case Of Fire,2002,['Germany'],"['Political cinema', 'Political satire', 'Comedy', 'World cinema', 'Ensemble Film']",2000,2
5343145,The Rocket,2005,['Canada'],"['Sports', 'Biography', 'Biographical film', 'Drama']",2000,5
8899981,Johnny Kapahala: Back on Board,2007,['United States of America'],"['Comedy', 'Television movie', 'Sports', 'Drama']",2000,7
15615865,The Road,2009,['United States of America'],"['Drama', 'Adventure', 'Thriller']",2000,9
103026,Kramer vs. Kramer,1979,['United States of America'],"['Family Drama', 'Marriage Drama', 'New Hollywood', 'Drama', 'Courtroom Drama']",1970,9
35754303,A Fugitive from Justice,1940,['United States of America'],"['Drama', 'Crime Fiction']",1940,0
19524834,The Liquidator,1965,['United Kingdom'],"['Action', 'Spy', 'Crime Fiction', 'Thriller', 'Comedy film', 'Adventure', 'Drama']",1960,5
5134079,"Puff, Puff, Pass",2006,['United States of America'],"['Stoner film', 'Comedy', 'Crime Comedy']",2000,6
35789374,Sleepwalker,2000,"['Sweden', 'Norway']","['Mystery', 'Thriller', 'Horror']",2000,0
30872204,Land of Plenty,2004,"['Germany', 'United States of America', 'Canada']","['Road movie', 'Indie', 'Drama']",2000,4
5493659,Slugs,1988,"['Spain', 'United States of America']","['Creature Film', 'Horror', 'World cinema', 'Science Fiction', 'Natural horror films']",1980,8
3492340,D.O.A.,1988,['United States of America'],"['Psychological thriller', 'Suspense', 'Neo-noir', 'Mystery', 'Thriller', 'Remake', 'Crime Thriller']",1980,8
14746678,Goof on the Roof,1953,['United States of America'],"['Short Film', 'Black-and-white', 'Comedy']",1950,3
8866943,A Single Woman,2007,['United States of America'],"['History', 'Biography', 'Biographical film']",2000,7
11220590,The War on Democracy,2007,"['United Kingdom', 'Australia']","['Social issues', 'Political cinema', 'History', 'Documentary', 'War film', 'Culture & Society']",2000,7
21325575,Kindred of the Dust,1922,['United States of America'],"['Black-and-white', 'Silent film', 'Romance Film', 'Melodrama', 'Drama']",1920,2
24135578,Actresses,2007,['France'],['Drama'],2000,7
25131085,Short of Love,2009,['Hong Kong'],"['Comedy', 'Romance Film', 'Romantic comedy', 'Chinese Movies']",2000,9
9221733,Malicious,1973,['Italy'],"['Coming of age', 'Comedy', 'Erotica', 'Romantic comedy', 'Romance Film', 'Fantasy', 'Sex comedy']",1970,3
26359547,Het Gangstermeisje,1966,['Netherlands'],['Drama'],1960,6
4483482,Lisztomania,1975,['United Kingdom'],"['Musical', 'Musical Drama', 'Biographical film', 'Biopic [feature]', 'Comedy-drama']",1970,5
2404582,Gabriel Over the White House,1933,['United States of America'],"['Black-and-white', 'Political satire', 'Comedy', 'Romance Film', 'Pre-Code', 'Drama', 'Parody', 'Fantasy']",1930,3
5321895,Live Freaky! Die Freaky!,2006,['United States of America'],"['Musical', 'Animation', 'Science Fiction']",2000,6
7222016,The Mudlark,1950,"['United Kingdom', 'United States of America']","['Period piece', 'Black-and-white', 'Drama']",1950,0
7759122,Vidheyan,1993,['India'],['Drama'],1990,3
35785369,Wedding Days,2002,['Spain'],"['Dogme 95', 'Drama']",2000,2
3304414,Camera,2000,['Canada'],"['Indie', 'Short Film', 'Comedy']",2000,0
3166983,Bates Motel,1987,['United States of America'],"['Comedy', 'Drama', 'Horror']",1980,7
24036235,The Wall,1962,['United States of America'],"['Short Film', 'Documentary']",1960,2
14038231,Deafula,1975,['United States of America'],['Horror'],1970,5
25893588,Dum,2003,['India'],"['Action', 'Crime Fiction']",2000,3
14997446,Forever and a Day,1943,"['United Kingdom', 'United States of America']","['Period piece', 'Black-and-white', 'Drama', 'Ensemble Film']",1940,3
31156298,Achanum Bappayum,1972,[],[],1970,2
15117659,The Night Brings Charlie,1990,['United States of America'],"['Mystery', 'Indie', 'Slasher', 'Horror']",1990,0
70508,Brief Encounter,1945,['United Kingdom'],"['Black-and-white', 'Romantic drama', 'Romance Film', 'Drama']",1940,5
8702038,Dinosaurs! - A Fun-Filled Trip Back in Time!,1987,['United States of America'],"['Short Film', 'Stop motion']",1980,7
3648503,Death Wish 3,1985,['United States of America'],"['Action', 'Crime Fiction', 'Action Thrillers', 'Action/Adventure', 'Thriller', 'Crime Thriller']",1980,5
9040455,Jaanwar,1999,['India'],['Drama'],1990,9
18651829,Edipo Alcalde,1996,['Colombia'],"['Action', 'Drama', 'World cinema', 'War film', 'Tragedy']",1990,6
26839407,Samsaram adhu minsaram,1995,['India'],"['Musical', 'Romantic drama', 'Bollywood', 'World cinema', 'Romance Film', 'Drama']",1990,5
19744255,Behind the Rising Sun,1943,['United States of America'],"['War film', 'Propaganda film', 'Drama']",1940,3
1582000,Raju Ban Gaya Gentleman,1992,['India'],"['Drama', 'Bollywood', 'World cinema']",1990,2
4073773,Ellis in Glamourland,2004,['Netherlands'],['Comedy'],2000,4
24646020,Hideous!,1997,['United States of America'],['Horror'],1990,7
239009,To Catch a Thief,1955,['United States of America'],"['Suspense', 'Crime Fiction', 'Mystery', 'Thriller', 'Romance Film', 'Crime Thriller']",1950,5
3787617,Fulltime Killer,2001,"['China', 'Hong Kong']","['Action', 'Crime Fiction', 'Action Thrillers', 'Action/Adventure', 'Thriller', 'World cinema', 'Chinese Movies', 'Martial Arts Film', 'Drama']",2000,1
4788277,Tarantula,1955,['United States of America'],"['Monster', 'Science Fiction', 'Horror']",1950,5
683486,Little Big Man,1970,['United States of America'],"['Action', 'Revisionist Western', 'Action/Adventure', 'Comedy', 'Black comedy', 'Indian Western', 'Adventure', 'Drama', 'Period piece', 'History', 'Epic Western', 'Western', 'New Hollywood', 'War film']",1970,0
32644388,King of the Coral Sea,1954,['Australia'],"['Adventure', 'Crime Fiction']",1950,4
11825918,The Last Hurrah,1958,['United States of America'],"['Black-and-white', 'Political drama', 'Drama']",1950,8
1022566,G-Force,2009,['United States of America'],"[""Children's"", 'Comedy', 'Animal Picture', ""Children's/Family"", 'Adventure', 'Family Film']",2000,9
24367337,Bedroom Eyes,1984,['Canada'],"['Mystery', 'Thriller']",1980,4
5668860,Lonesome Jim,2005,['United States of America'],"['Drama', 'Indie', 'Family Drama', 'Romantic drama', 'Comedy', 'Romance Film', 'Romantic comedy']",2000,5
3312256,L'armata Brancalone,1966,['Italy'],"['Comedy', 'Adventure']",1960,6
25943503,Detective Story,1983,[],"['Mystery', 'Romance Film']",1980,3
1591831,Lonelyhearts,1958,['United States of America'],"['Film adaptation', 'Black-and-white', 'Film noir', 'Melodrama', 'Drama']",1950,8
400797,Happy Gilmore,1996,['United States of America'],"['Sports', 'Slapstick', 'Comedy']",1990,6
145892,28 Days Later,2002,"['United Kingdom', 'Netherlands', 'United States of America']","['Thriller', 'Horror', 'Plague', 'Zombie Film', 'Doomsday film', 'Sci-Fi Horror', 'Science Fiction']",2000,2
18456072,Bloodhounds of Broadway,1989,['United States of America'],"['Period piece', 'Film adaptation', 'Drama', 'Crime Fiction', 'Indie', 'Comedy']",1980,9
19105438,In Search of Gregory,1969,"['United Kingdom', 'Italy']",['Drama'],1960,9
8335457,Ultraman Mebius & Ultraman Brothers,2006,['Japan'],['Japanese Movies'],2000,6
23388551,Fort Saganne,1984,['France'],"['Romantic drama', 'World cinema', 'Romance Film', 'Drama', 'Period piece', 'Historical Epic', 'Epic', 'War film']",1980,4
18867292,Tugboat Granny,1956,['United States of America'],"['Animation', 'Short Film', 'Comedy']",1950,6
564947,"I, Robot",2004,"['Germany', 'United States of America']","['Action', 'Film adaptation', 'Mystery', 'Thriller', 'Science Fiction', 'Drama']",2000,4
4956603,Priyamana Thozhi,2003,['India'],"['Romantic drama', 'World cinema', 'Romance Film', 'Drama']",2000,3
23533257,Foxy by Proxy,1952,['United States of America'],"['Short Film', 'Animation']",1950,2
10604801,Naval Commandos,1977,['Hong Kong'],"['Chinese Movies', 'Martial Arts Film']",1970,7
5318135,My Friend Irma Goes West,1950,['United States of America'],"['Crime Fiction', 'Road movie', 'Comedy']",1950,0
32269287,Veerta,1991,[],"['Action', 'Crime Fiction', 'Adventure']",1990,1
967999,Eegah,1962,['United States of America'],"['Indie', 'Horror']",1960,2
4838538,Summer with Monika,1953,['Sweden'],"['Black-and-white', 'Romantic drama', 'Romance Film', 'Drama']",1950,3
5979988,Escape to Athena,1979,['United Kingdom'],"['War film', 'Escape Film', 'Adventure']",1970,9
206721,Splendor in the Grass,1961,['United States of America'],"['Romance Film', 'Drama']",1960,1
1086222,The Architect,2006,['United States of America'],"['Indie', 'Drama']",2000,6
10620698,Shaolin Rescuers,1979,['Hong Kong'],"['Action', 'Action/Adventure', 'World cinema', 'Chinese Movies', 'Martial Arts Film']",1970,9
11059900,Sliver,1993,['United States of America'],"['Psychological thriller', 'Thriller', 'Erotic thriller', 'Romance Film']",1990,3
6085720,Bloodsport 3,1997,['United States of America'],"['Action', 'Action/Adventure', 'Thriller', 'Martial Arts Film']",1990,7
6939673,The Thing Called Love,1993,['United States of America'],"['Romantic drama', 'Comedy', 'Romance Film', 'Romantic comedy', 'Drama', 'Ensemble Film']",1990,3
1041202,Wide Awake,1998,['United States of America'],"['Family Drama', 'Comedy', 'Comedy-drama', 'Drama', 'Family Film']",1990,8
19286389,Ullasam,1997,[],"['Action', 'Romance Film']",1990,7
10720467,Paano Kita Iibigin,2007,['Philippines'],"['Filipino Movies', 'Romantic drama', 'World cinema', 'Romance Film', 'Drama']",2000,7
1789884,Best of Youth,2003,['Italy'],['Drama'],2000,3
1024448,Fat Pizza: The Movie,2003,['Australia'],['Comedy'],2000,3
1695219,Vertical Limit,2000,"['Germany', 'United States of America']","['Action', 'Action Thrillers', 'Thriller', 'Adventure']",2000,0
105401,The Class of Nuke 'Em High,1986,['United States of America'],"['Teen', 'Horror', 'Black comedy', 'B-movie', 'Science Fiction', 'Cult']",1980,6
4806533,Keith,2008,['United States of America'],"['Romantic drama', 'Indie', 'Romance Film', 'Drama']",2000,8
32343017,Daughter of the Tong,1939,[],"['Action', 'Spy', 'Crime Fiction', 'Thriller', 'Crime Thriller', 'Drama']",1930,9
24069500,A Fig Leaf for Eve,1944,['United States of America'],['Drama'],1940,4
10139922,Haseena Maan Jaayegi,1999,['India'],"['Action/Adventure', 'Drama', 'World cinema']",1990,9
25830355,Daddy's Gone A-Hunting,1969,['United States of America'],['Thriller'],1960,9
17672196,Public Hero No. 1,1935,[],"['Action', 'Black-and-white', 'Drama', 'Crime Fiction']",1930,5
619688,Thriller: A Cruel Picture,1974,['Sweden'],"['Action', 'Action/Adventure', 'Thriller', 'World cinema', 'Crime Thriller']",1970,4
427173,Distance,2001,['Japan'],['Japanese Movies'],2000,1
12441423,Captain from Castile,1947,['United States of America'],"['Action', 'Action/Adventure', 'Historical fiction', 'Epic', 'Adventure', 'Drama']",1940,7
19672025,Class of 1999 II: The Substitute,1990,['United States of America'],"['Action', 'Indie', 'Thriller', 'Horror', 'Science Fiction']",1990,0
20127118,Catch as Cats Can,1947,['United States of America'],"['Animation', 'Short Film', 'Family Film']",1940,7
8558285,Path of Destruction,2005,['United States of America'],"['Action', 'Television movie', 'Science Fiction']",2000,5
13516269,Shriman Prithviraj,1973,['India'],['Romantic comedy'],1970,3
16368206,Paul Blart: Mall Cop,2009,['United States of America'],"['Action', 'Crime Fiction', 'Action Comedy', 'Action/Adventure', 'Comedy', 'Slapstick', 'Family Film']",2000,9
23775497,The Babymaker: The Dr. Cecil Jacobson Story,1994,['United States of America'],"['Melodrama', 'Television movie', 'Drama']",1990,4
5531874,The Vigilante Fighting Hero of the West,1947,['United States of America'],"['Action', 'Black-and-white', 'Crime Fiction', 'Western', 'Adventure']",1940,7
18316313,Brothel,2008,['United States of America'],"['Suspense', 'Psychological thriller', 'Thriller', 'Supernatural', 'Drama']",2000,8
3371773,There Will Be No Leave Today,1959,['Soviet Union'],['Short Film'],1950,9
25330086,Liberty & Bash,1989,['United States of America'],['Action'],1980,9
2332654,Le Petit Soldat,1960,['France'],"['Black-and-white', 'World cinema', 'Political drama', 'Drama']",1960,0
9149498,American Madness,1932,['United States of America'],"['Melodrama', 'Americana', 'Pre-Code', 'Drama']",1930,2
23558826,The Quick and the Dead,1987,['United States of America'],"['Film adaptation', 'Action/Adventure', 'Western', 'Television movie']",1980,7
3826681,Phir Hera Pheri,2006,['India'],"['Musical', 'Comedy', 'Bollywood', 'Crime Comedy', 'World cinema']",2000,6
8178460,Maria Marten or Murder in the Red Barn,1936,['United Kingdom'],"['Crime Fiction', 'Thriller', 'Crime', 'Melodrama', 'Drama']",1930,6
3654479,Gate of Flesh,1964,['Japan'],"['Erotic Drama', 'Japanese Movies', 'World cinema', 'Erotica', 'Drama']",1960,4
9125100,The Accidental Tourist,1988,['United States of America'],"['Romance Film', 'Romantic drama', 'Drama']",1980,8
2862407,Double Team,1997,['United States of America'],"['Action', 'Action Thrillers', 'Action/Adventure', 'Buddy film', 'Thriller', 'Martial Arts Film']",1990,7
3682257,Murder on Flight 502,1975,['United States of America'],"['Action', 'Crime Fiction', 'Action Thrillers', 'Action/Adventure', 'Thriller', 'Disaster', 'Drama']",1970,5
5126944,When the Whales Came,1989,['United Kingdom'],['Drama'],1980,9
6170272,Mickey,1948,['United States of America'],"['Coming of age', 'Indie', 'Drama']",1940,8
2318141,Mystery Street,1950,['United States of America'],"['Film noir', 'Thriller']",1950,0
14738217,Vagabond Loafers,1949,['United States of America'],"['Black-and-white', 'Short Film', 'Comedy', 'Slapstick']",1940,9
2123910,"If It's Tuesday, This Must Be Belgium",1969,['United States of America'],"['Parody', 'Comedy', 'Romantic comedy', 'Ensemble Film']",1960,9
6339348,Kamen Rider Kabuto: God Speed Love,2006,['Japan'],"['Science Fiction', 'Japanese Movies']",2000,6
26628884,Mr. Ricco,1975,['United States of America'],"['Drama', 'Crime Fiction', 'Thriller']",1970,5
5384618,The Out-of-Towners,1970,['United States of America'],"['Screwball comedy', 'Comedy']",1970,0
318772,The American Friend,1977,"['France', 'Germany', 'West Germany']","['Neo-noir', 'Crime Fiction', 'World cinema', 'Drama']",1970,7
15402569,Kiss the Bride,2008,['United States of America'],"['Gay Themed', 'LGBT', 'Indie', 'Comedy', 'Romance Film', 'Romantic comedy']",2000,8
16455553,The Blank Generation,1976,['United States of America'],"['Black-and-white', 'Drama', 'Indie', 'Romantic drama', 'Documentary', 'Romance Film', 'Punk rock']",1970,6
5756611,The Fighting Prince of Donegal,1966,"['United Kingdom', 'United States of America']","['Action', 'Drama', 'Family-Oriented Adventure', 'Historical fiction', 'Adventure']",1960,6
5221043,Geulimja,1935,"['Korea', 'South Korea']","['Melodrama', 'Drama']",1930,5
7299710,The Next of Kin,1942,['United Kingdom'],['War film'],1940,2
6703830,Knights of the Round Table,1953,"['United Kingdom', 'United States of America']","['Action', 'Film adaptation', 'Costume Adventure', 'Action/Adventure', 'Costume drama', 'Adventure', 'Drama', 'Epic']",1950,3
13522574,Heaven on Earth,2008,"['Canada', 'India']","['Art film', 'Drama', 'World cinema']",2000,8
3075802,Date Movie,2006,"['Switzerland', 'United States of America']","['Parody', 'Comedy', 'Romance Film', 'Romantic comedy']",2000,6
19751960,The Happy Thieves,1961,['United States of America'],"['Crime', 'Drama', 'Comedy']",1960,1
43849,The Apartment,1960,['United States of America'],"['Workplace Comedy', 'Black-and-white', 'Comedy', 'Romance Film', 'Romantic comedy', 'Comedy-drama', 'Drama']",1960,0
15114837,Men Don't Leave,1990,['United States of America'],"['Family Drama', 'Indie', 'Comedy', 'Drama', 'Feminist Film', 'Coming of age', 'Comedy-drama', 'Family Film']",1990,0
7566141,Stickmen,2001,"['New Zealand', 'Australia']","['Action', 'Crime Fiction', 'Indie', 'Action/Adventure', 'Comedy', 'World cinema', 'Drama', 'Comedy of Errors', 'Action Comedy', 'Crime Comedy', 'Comedy-drama', 'Sports']",2000,1
204019,Notting Hill,1999,"['United Kingdom', 'United States of America']","['Romance Film', 'Romantic comedy', 'Comedy']",1990,9
2294746,The Shooting,1967,['United States of America'],"['Action', 'Drama', 'Indie', 'Action/Adventure', 'Western', 'Acid western']",1960,7
15306630,Deadline - U.S.A.,1952,['United States of America'],"['Black-and-white', 'Crime Fiction']",1950,2
15532254,Surviving My Mother,2007,['Canada'],"['Family Drama', 'Comedy', 'Comedy-drama', 'Drama']",2000,7
6852733,Nenjil Jil Jil,2006,['India'],"['Romance Film', 'Comedy']",2000,6
11142340,Ponni,1976,['India'],"['Film adaptation', 'Drama']",1970,6
24491288,The Way of a Girl,1925,['United States of America'],['Silent film'],1920,5
7586530,The Road to Reno,1931,['United States of America'],"['Black-and-white', 'Drama']",1930,1
2979277,Bandidas,2006,"['France', 'Mexico', 'United States of America']","['Action', 'Crime Fiction', 'Revisionist Western', 'Action/Adventure', 'Buddy film', 'Comedy', 'Feminist Film', 'Western']",2000,6
7515465,Betty Boop's Trial,1934,['United States of America'],"['Animation', 'Short Film', 'Comedy', 'Family Film']",1930,4
5604654,That's My Wife,1929,['United States of America'],"['Black-and-white', 'Indie', 'Short Film', 'Comedy', 'Silent film']",1920,9
17528010,L'aile ou la cuisse,1976,['France'],"['Comedy', 'Satire']",1970,6
2077360,Crash,1996,"['United Kingdom', 'France', 'Canada']","['Psychological thriller', 'Film adaptation', 'LGBT', 'Indie', 'Thriller', 'Drama', 'Erotic thriller', 'Erotica']",1990,6
829663,Alice,1988,"['Czechoslovakia', 'Switzerland', 'United Kingdom', 'Germany', 'West Germany', 'Czech Republic']","['Surrealism', 'Animation', 'Thriller', 'Stop motion', 'Adventure', 'Fantasy']",1980,8
5455247,Hour of the Gun,1967,['United States of America'],"['Revisionist Western', 'Action/Adventure', 'Western', 'Historical fiction', 'Docudrama', 'Drama']",1960,7
2108445,Porky's II: The Next Day,1983,"['Canada', 'United States of America']","['Screwball comedy', 'Comedy', 'Sex comedy']",1980,3
452313,Varalaru,2006,['India'],"['Action', 'Musical', 'Drama', 'Tamil cinema']",2000,6
3832964,Irreconcilable Differences,1984,['United States of America'],"['Romantic drama', 'Comedy', 'Romance Film', 'Domestic Comedy', 'Comedy-drama', 'Drama', 'Courtroom Drama']",1980,4
25536699,Staying Together,1989,['United States of America'],"['Family Drama', 'Indie', 'Comedy', 'Comedy-drama']",1980,9
28170061,The Naked Bunyip,1970,['Australia'],"['Comedy', 'Documentary']",1970,0
2873368,For Your Consideration,2006,['United States of America'],"['Mockumentary', 'Parody', 'Comedy']",2000,6
29634498,Vienna,1968,[],['Short Film'],1960,8
4544500,Progeny,1999,['United States of America'],"['Horror', 'B-movie', 'Sci-Fi Horror', 'Science Fiction']",1990,9
14914342,Vaana,2008,['India'],"['Music', 'Romance Film', 'Comedy']",2000,8
1411281,The Navigator: A Medieval Odyssey,1988,"['New Zealand', 'Australia']","['Fantasy Adventure', 'Time travel', 'World cinema', 'Adventure', 'Fantasy']",1980,8
33175831,Jamai Raja,1991,['India'],"['Musical', 'Bollywood', 'World cinema', 'Drama']",1990,1
55720,Mulan,1998,['United States of America'],"['Music', 'Musical', 'Animation', ""Children's"", 'Adventure', 'Drama', 'Family Film']",1990,8
2354153,It's a Great Feeling,1949,['United States of America'],"['Musical', 'Comedy', 'Musical comedy', 'Romance Film', 'Romantic comedy']",1940,9
13957349,The Saphead,1920,['United States of America'],"['Black-and-white', 'Drama', 'Indie', 'Satire', 'Comedy', 'Silent film']",1920,0
2514817,Guilty by Suspicion,1991,"['United States of America', 'France']","['Period piece', 'Thriller', 'Political drama', 'Drama', 'Courtroom Drama']",1990,1
2367298,If You Could See What I Hear,1982,['Canada'],"['Drama', 'Indie', 'Biographical film', 'Biopic [feature]', 'Melodrama', 'Docudrama']",1980,2
31165263,Eight on the Lam,1967,['United States of America'],"['Screwball comedy', 'Comedy']",1960,7
16788448,Do It For Johnny,2007,['United States of America'],"['Music', 'Documentary']",2000,7
35509800,Night Eyes 4: Fatal Passion,1996,['United States of America'],"['Adult', 'Thriller', 'Erotica', 'Drama']",1990,6
16451841,Flashbacks of a Fool,2008,"['Australia', 'United Kingdom', 'South Africa', 'United States of America']","['Indie', 'Drama']",2000,8
1469221,Scream of the Wolf,1974,['United States of America'],"['Supernatural', 'Thriller', 'Horror']",1970,4
1153485,What the Deaf Man Heard,1997,['United States of America'],"['Comedy-drama', 'Drama', 'Comedy of Errors']",1990,7
17082171,Canvas Back Duck,1953,['United States of America'],"['Animation', 'Short Film', 'Comedy', 'Family Film']",1950,3
1204611,Air Bud,1997,"['Canada', 'United States of America']","['Coming of age', 'Comedy', 'Animal Picture', ""Children's/Family"", 'Family Film']",1990,7
6079405,The Cutting Edge: Going for the Gold,2006,['United States of America'],"['Romantic drama', 'Comedy', 'Romantic comedy', 'Romance Film', 'Sports', 'Drama']",2000,6
26137841,The Hollywood Sign,2001,"['Germany', 'United States of America', 'Netherlands']","['Action', 'Film adaptation', 'Action/Adventure', 'Comedy', 'Thriller', 'Crime Thriller', 'Drama', 'Heist', 'Crime Comedy']",2000,1
16880543,Predictions of Fire,1996,"['Slovenia', 'United States of America']",['Documentary'],1990,6
18881791,Man in the 5th Dimension,1964,['United States of America'],"['Short Film', 'Christian film']",1960,4
2649865,Man's Favorite Sport?,1964,['United States of America'],"['Screwball comedy', 'Comedy', 'Romance Film', 'Romantic comedy', 'Slapstick']",1960,4
3419442,Love Hurts,1991,['United States of America'],"['Drama', 'Indie', 'Comedy', 'Comedy-drama']",1990,1
5150937,Cinderella III: A Twist in Time,2007,['United States of America'],"['Animated cartoon', 'Animation', 'Romance Film', ""Children's/Family"", 'Family Film', 'Fantasy']",2000,7
26655268,Drei Mann in einem Boot,1961,"['Austria', 'West Germany']",['Comedy'],1960,1
2968058,Sunday Too Far Away,1975,['Australia'],['Drama'],1970,5
2527873,Bright Leaf,1950,['United States of America'],"['Romance Film', 'Melodrama', 'Drama']",1950,0
33887035,Collateral Damage,2002,['United States of America'],"['Action', 'Drama', 'Action/Adventure', 'Thriller', 'Tragedy']",2000,2
23852142,Sauda,1995,['India'],"['Melodrama', 'Drama', 'Ensemble Film']",1990,5
16038065,Who's My Favourite Girl,2000,['United Kingdom'],['Short Film'],2000,0
7642474,The Turning,1992,['United States of America'],"['Family Drama', 'Drama']",1990,2
1705391,Naked,1993,['United Kingdom'],"['Black comedy', 'Comedy', 'Drama']",1990,3
3116758,The Deadly Affair,1966,['United Kingdom'],"['Spy', 'Drama']",1960,6
19485841,Poi Solla Porom,2008,[],['Comedy'],2000,8
25502984,King Kelly of the U.S.A.,1934,['United States of America'],"['Musical', 'Comedy', 'Romance Film', 'Romantic comedy']",1930,4
24468896,Vachan,1955,['India'],"['Drama', 'Bollywood', 'World cinema']",1950,5
5682277,Ladies' Night,2003,['Mexico'],"['Comedy', 'World cinema', 'Romance Film', 'Romantic comedy']",2000,3
9426325,I Phouska,2001,['Greece'],"['Comedy', 'Crime Fiction']",2000,1
8760054,Men of Tomorrow,1932,['United Kingdom'],"['Romance Film', 'Black-and-white', 'Drama']",1930,2
22500985,My Family and Other Animals,2005,['United Kingdom'],"['Family Drama', 'Comedy-drama', 'Drama', 'Family Film']",2000,5
1520391,The Serpent's Egg,1977,"['Sweden', 'Germany']","['Psychological thriller', 'Period piece', 'Mystery', 'Thriller', 'World cinema', 'Political drama', 'Drama']",1970,7
1471636,Sabretooth,2002,['United States of America'],"['Fantasy', 'Science Fiction', 'Horror']",2000,2
826409,Collateral,2004,['United States of America'],"['Crime Fiction', 'Thriller', 'Crime Thriller', 'Drama']",2000,4
2298699,Armored Car Robbery,1950,['United States of America'],"['Black-and-white', 'Crime Fiction', 'Gangster Film', 'Thriller', 'Film noir', 'Crime Thriller', 'Drama', 'Heist', 'Caper story']",1950,0
35420580,Thunder Run,1986,['United States of America'],"['Action', 'Thriller']",1980,6
10216340,Last Hurrah for Chivalry,1979,['Hong Kong'],"['Action', 'Action/Adventure', 'World cinema', 'Wuxia', 'Chinese Movies', 'Martial Arts Film', 'Adventure']",1970,9
18932654,Koyaanisqatsi,1983,['United States of America'],"['Indie', 'Avant-garde', 'Documentary', 'Culture & Society', 'Social issues', 'Essay Film', 'Environmental Science', 'Experimental film']",1980,3
25887597,Tora's Tropical Fever,1980,['Japan'],['Japanese Movies'],1980,0
17877562,Farlig Ungdom,1953,['Denmark'],['Drama'],1950,3
27365004,Tarawa Beachhead,1958,['United States of America'],"['War film', 'Drama']",1950,8
19161747,Beautiful Stranger,1954,['United Kingdom'],"['Mystery', 'Drama']",1950,4
21633125,Reconstruction,2003,['Denmark'],"['Romance Film', 'Drama']",2000,3
26661348,Die Bienen - Tödliche Bedrohung,2008,['Germany'],"['Action', 'Suspense', 'Action/Adventure', 'Thriller', 'Horror', 'World cinema', 'Disaster']",2000,8
16201346,Where No Vultures Fly,1951,['United Kingdom'],"['Adventure', 'Drama']",1950,1
18198974,Cherished,2005,['United Kingdom'],['Drama'],2000,5
10933245,36 Deadly Styles,1980,"['Hong Kong', 'Taiwan']","['Action', 'Martial Arts Film', 'Action Comedy', 'Action/Adventure', 'Comedy', 'World cinema', 'Chinese Movies']",1980,0
17672486,The Bottom of the Bottle,1956,['United States of America'],"['Romance Film', 'Drama']",1950,6
1214384,Black Orpheus,1959,"['Brazil', 'France', 'Italy']","['Music', 'Romantic drama', 'Comedy', 'World cinema', 'Romance Film', 'Drama', 'Fantasy']",1950,9
10488450,Frankenstein vs. the Creature from Blood Cove,2005,['United States of America'],"['Creature Film', 'Monster movie', 'Black-and-white', 'Monster', 'Horror', 'B-movie']",2000,5
7237781,Rich And Famous,1987,"['China', 'Hong Kong']","['Action/Adventure', 'World cinema', 'Chinese Movies', 'Martial Arts Film']",1980,7
780888,Fourteen Hours,1951,['United States of America'],"['Black-and-white', 'Thriller', 'Film noir', 'Drama']",1950,1
525270,Kill Bill Volume 2,2004,['United States of America'],"['Action', 'Drama', 'Crime Fiction', 'Thriller', 'Spaghetti Western']",2000,4
2294568,Kidnapped,1996,['United States of America'],"['Costume drama', 'Drama']",1990,6
11143326,Sakalakala Vallavan,1982,['India'],"['Musical', 'Bollywood', 'World cinema', 'Drama']",1980,2
24792097,The Dixie Fryer,1960,[],"['Animation', 'Short Film', 'Comedy', 'Family Film']",1960,0
19844332,The Hunting Party,1971,['United Kingdom'],"['Action', 'Western', 'Action/Adventure']",1970,1
28222345,Satan's School for Girls,1973,['United States of America'],"['Crime Fiction', 'Mystery', 'Horror', 'Television movie']",1970,3
624314,Drums Along the Mohawk,1939,['United States of America'],"['Period piece', 'Costume Adventure', 'Action/Adventure', 'Western', 'War film', 'Adventure', 'Drama']",1930,9
2755048,Royal Wedding,1951,['United States of America'],"['Musical', 'Comedy', 'Romance Film', 'Romantic comedy']",1950,1
7567720,Breakout,1975,['United States of America'],"['Action', 'Action/Adventure', 'Thriller']",1970,5
2638184,Big Business,1988,['United States of America'],['Comedy'],1980,8
952682,Summer of Sam,1999,['United States of America'],"['Period piece', 'Drama', 'Crime Fiction', 'Indie', 'Thriller', 'Crime Drama', 'Ensemble Film']",1990,9
26810531,Aavanazhi,1986,['India'],"['Action', 'Crime Thriller']",1980,6
26876259,Isabella,1988,['India'],"['Romance Film', 'Drama']",1980,8
17339815,Time Bomb,2006,['Canada'],['War film'],2000,6
299490,Irréversible,2002,['France'],"['Crime Fiction', 'Mystery', 'Marriage Drama', 'Thriller', 'World cinema', 'Crime Drama', 'Drama']",2000,2
6034093,The Secret Life of an American Wife,1968,['United States of America'],"['Romantic comedy', 'Indie', 'Comedy']",1960,8
11735332,The Shade,1999,"['United States of America', 'France']",['Drama'],1990,9
8861805,Alice in the Cities,1974,['West Germany'],"['Black-and-white', 'Road movie', 'Drama']",1970,4
13702668,Squareheads of the Round Table,1948,['United States of America'],"['Short Film', 'Black-and-white', 'Comedy']",1940,8
26165733,The Singer Not the Song,1961,['United Kingdom'],['Drama'],1960,1
2425809,Mississippi Masala,1991,"['United Kingdom', 'India', 'United States of America']","['Drama', 'Family Drama', 'Indie', 'Romantic drama', 'Comedy', 'Romance Film', 'Comedy-drama']",1990,1
4732250,Wilderness,2006,['United Kingdom'],"['Slasher', 'Teen', 'Horror']",2000,6
25496280,Manchupallaki,1982,['India'],"['Drama', 'Family Film']",1980,2
20338576,Ask Any Girl,1959,['United States of America'],"['Romance Film', 'Romantic comedy', 'Comedy']",1950,9
6819976,The Adventures of Huck Finn,1993,['United States of America'],"['Coming of age', ""Children's"", 'Family-Oriented Adventure', ""Children's/Family"", 'Costume drama', 'Adventure', 'Family Film']",1990,3
17124518,Focus,2002,['United States of America'],"['Period piece', 'Film adaptation', 'Romance Film', 'War film', 'Drama']",2000,2
16669958,This is Not a Test,1962,['United States of America'],"['Action', 'Action/Adventure', 'Thriller', 'Doomsday film']",1960,2
21886221,Incident at Raven's Gate,1988,"['New Zealand', 'Australia']","['Thriller', 'Horror', 'World cinema', 'Supernatural', 'Science Fiction', 'Fantasy']",1980,8
961749,Overdrawn at the Memory Bank,1983,"['Canada', 'United States of America']","['Dystopia', 'Parody', 'Satire', 'Adventure', 'Science Fiction']",1980,3
8623910,Soggadu,2005,['India'],['Romance Film'],2000,5
10394260,Honor Among Lovers,1931,['United States of America'],"['Romance Film', 'Black-and-white', 'Drama']",1930,1
25461969,El Monasterio de los Buitres,1973,['Mexico'],['Drama'],1970,3
10353968,Miss Pettigrew Lives for a Day,2008,"['United Kingdom', 'United States of America']","['Period piece', 'Romantic comedy', 'Comedy']",2000,8
4148551,National Lampoon's Senior Trip,1995,"['Canada', 'United States of America']","['Gross out', 'Gross-out film', 'Parody', 'Comedy', 'Slapstick', 'Absurdism']",1990,5
9751411,Boot Hill,1969,['Italy'],"['Spaghetti Western', 'Western', 'Comedy']",1960,9
15644748,The Shepherd: Border Patrol,2008,['United States of America'],"['Action', 'Crime Fiction', 'Action Thrillers', 'Action/Adventure', 'Thriller']",2000,8
1406622,Harvie Krumpet,2003,"['New Zealand', 'Australia']","['Animation', 'Comedy', 'World cinema', 'Black comedy', 'Clay animation', 'Short Film', 'Comedy-drama', 'Stop motion']",2000,3
22047983,Daava,1997,['India'],"['Action/Adventure', 'World cinema']",1990,7
25847898,Tora-san's Dream-Come-True,1972,['Japan'],['Japanese Movies'],1970,2
32463466,Rescue at Midnight Castle,1984,[],['Short Film'],1980,4
15984648,Gingerdead Man 2: Passion of the Crust,2008,['United States of America'],"['Monster movie', 'Slasher', 'Comedy', 'Horror', 'B-movie']",2000,8
6736378,Sankranthi,2005,['India'],['Drama'],2000,5
27749761,Jack O'Lantern,2004,['United States of America'],"['Indie', 'Slasher', 'Teen', 'Horror']",2000,4
12506096,Desolation Canyon,2006,['United States of America'],['Western'],2000,6
12625575,Turtle Diary,1984,"['United Kingdom', 'England', 'United States of America']","['Comedy', 'Romance Film', 'Romantic comedy', 'Comedy-drama', 'Drama']",1980,4
1565282,Dragon Ball Z: Broly – The Legendary Super Saiyan,1993,['Japan'],"['Action', 'Animation', 'Japanese Movies', 'Anime', 'Science Fiction']",1990,3
9461535,The Hit,1984,['United Kingdom'],"['Drama', 'Crime Fiction', 'Thriller']",1980,4
3229227,Goal! 2: Living the Dream...,2007,['United Kingdom'],"['Sports', 'Drama']",2000,7
20672258,New Moon,2009,['United States of America'],"['Film adaptation', 'Romantic drama', 'Thriller', 'Teen', 'Romance Film', 'Adventure', 'Drama', 'Horror', 'Fantasy']",2000,9
24314472,Parasomnia,2008,['United States of America'],"['Suspense', 'Psychological thriller', 'Slasher', 'Thriller', 'Horror', 'Supernatural']",2000,8
12253731,Edakallu Guddada Mele,1973,['India'],"['Romance Film', 'Drama']",1970,3
846354,Bitter Moon,1993,['United Kingdom'],"['Erotic Drama', 'Romantic drama', 'Black comedy', 'Romance Film', 'Drama', 'Marriage Drama', 'Comedy-drama', 'Erotica']",1990,3
24166398,"Condor, El",1970,['United States of America'],"['Action/Adventure', 'Western']",1970,0
7018379,Junk Mail,1997,['Norway'],"['Comedy', 'Thriller']",1990,7
27461296,Slappily Married,1946,[],['Short Film'],1940,6
5090136,Jab Jab Phool Khile,1965,['India'],"['Drama', 'Bollywood', 'World cinema']",1960,5
10234554,The Bikini Carwash Company,1992,['United States of America'],"['Indie', 'Comedy', 'Sex comedy']",1990,2
3757903,The Five Man Army,1969,['Italy'],['Western'],1960,9
22172240,Agraharathil Kazhuthai,1977,['India'],[],1970,7
6877863,Marcelino Pan y Vino,1955,['Spain'],"['Black-and-white', 'Comedy', 'World cinema', 'Christian film', 'Drama']",1950,5
5945009,Aatank Hi Aatank,1995,['India'],"['Musical', 'Romantic drama', 'Bollywood', 'World cinema', 'Romance Film', 'Drama']",1990,5
441926,A Fistful of Dollars,1964,"['Spain', 'Germany', 'Italy']","['Action', 'Western', 'Action/Adventure', 'Remake', 'World cinema', 'Spaghetti Western']",1960,4
1986108,Jurm,2005,['India'],"['Drama', 'Thriller', 'World cinema']",2000,5
9006277,Sunshine State,2002,['United States of America'],"['Drama', 'Indie', 'Comedy', 'Social problem film', 'Americana', 'Ensemble Film']",2000,2
77653,Heaven Can Wait,1943,['United States of America'],"['Comedy', 'Romance Film', 'Romantic comedy', 'Drama', 'Fantasy']",1940,3
1482871,The Spiral Staircase,1946,['United States of America'],"['Psychological thriller', 'Crime Fiction', 'Mystery', 'Thriller', 'Film noir', 'Crime Thriller', 'Drama', 'Suspense']",1940,6
27762093,Foster Child,2007,['Philippines'],"['Filipino Movies', 'Drama']",2000,7
23542046,Sukeban Deka The Movie,1987,['Japan'],"['Action', 'Animation', 'Japanese Movies', 'Action/Adventure', 'Thriller', 'World cinema', 'Anime']",1980,7
19048774,The Loves of Joanna Godden,1947,['United Kingdom'],['Drama'],1940,7
10208216,Hyde and Go Tweet,1960,['United States of America'],"['Animation', 'Short Film', 'Family Film']",1960,0
23393658,That is Pandu,2005,[],"['Romance Film', 'Crime Fiction']",2000,5
25084991,Out-of-Sync,1995,['United States of America'],"['Action', 'Crime Fiction', 'Gangster Film', 'Action/Adventure', 'Thriller', 'Drama']",1990,5
17906864,Moonnam Mura,1988,['Malayalam Language'],"['Action', 'Bollywood', 'Thriller', 'Adventure']",1980,8
3095001,The Wood,1999,['United States of America'],"['Romantic drama', 'Buddy film', 'Comedy', 'Teen', 'Romance Film', 'Drama', 'Coming of age', 'Romantic comedy', 'Comedy-drama']",1990,9
19738730,The Colt,2005,['United States of America'],"['Action', 'Family Drama', 'Historical drama', 'Drama', 'Period piece', 'Television movie', 'War film', 'Family Film']",2000,5
10753947,The Time Traveler's Wife,2009,['United States of America'],"['Film adaptation', 'Mystery', 'Romantic drama', 'Romance Film', 'Science Fiction', 'Drama', 'Fantasy']",2000,9
8708612,Notes on a Scandal,2006,['United Kingdom'],"['Psychological thriller', 'Film adaptation', 'LGBT', 'Romantic drama', 'Romance Film', 'Drama', 'Psycho-biddy', 'Melodrama']",2000,6
24932519,Blade on the Feather,1980,"['United Kingdom', 'England']","['Mystery', 'Thriller']",1980,0
7984798,Step Brothers,2008,['United States of America'],"['Buddy film', 'Comedy', 'Domestic Comedy', 'Slapstick']",2000,8
13207398,Eve & the Fire Horse,2006,['Canada'],"['Period piece', 'Drama', 'Indie', 'Family Drama', 'Childhood Drama', 'Comedy-drama']",2000,6
2994014,The NeverEnding Story III,1994,"['Germany', 'United States of America']","['Adventure', 'Family Film', 'Fantasy']",1990,4
13980265,Paid to Dance,1937,['United States of America'],"['Black-and-white', 'Crime Fiction', 'Dance', 'Romance Film', 'Drama']",1930,7
3279682,American Crime,2004,['United States of America'],"['Psychological thriller', 'LGBT', 'Crime Fiction', 'Mystery', 'Thriller', 'Crime Thriller']",2000,4
9190913,Possessed,1931,['United States of America'],"['Black-and-white', 'Pre-Code', 'Drama']",1930,1
142435,Jerry Maguire,1996,['United States of America'],"['Romantic drama', 'Comedy', 'Romance Film', 'Drama', 'Romantic comedy', 'Comedy-drama', 'Sports', 'Slice of life story']",1990,6
21513978,Pelli Pusthakam,1991,['India'],"['Romance Film', 'Drama', 'Family Film']",1990,1
24922016,The Hole,2009,['United States of America'],"['Thriller', 'Horror', 'Adventure', 'Fantasy']",2000,9
1163257,K-9,1989,['United States of America'],"['Action', 'Crime Fiction', 'Action Comedy', 'Comedy', 'Animal Picture']",1980,9
1888906,What?,1973,"['France', 'Germany', 'West Germany', 'Italy']",['Comedy'],1970,3
14020694,Giant from the Unknown,1958,['United States of America'],"['Monster movie', 'Horror', 'B-movie', 'Science Fiction', 'Cult']",1950,8
21286292,976-Evil II,1992,['United States of America'],"['Cult', 'Horror']",1990,2
3269896,Island at the Top of the World,1974,['United States of America'],"['Action/Adventure', 'Adventure', 'Science Fiction', 'Drama', 'Family Film', 'Fantasy']",1970,4
20457037,Sunny,2008,['South Korea'],['War film'],2000,8
15368904,The Last Supper,1994,['Canada'],"['LGBT', 'Drama', 'Indie']",1990,4
3932594,Big House Bunny,1950,['United States of America'],"['Animation', 'Comedy', 'Family Film']",1950,0
12800749,Millenium Mambo,2001,"['France', 'Taiwan', 'China']","['Art film', 'World cinema', 'Romance Film', 'Chinese Movies', 'Drama']",2000,1
27958557,El abanderado,1943,['Spain'],['History'],1940,3
24586274,Once a Thief,1965,"['France', 'United States of America']","['Drama', 'Crime Fiction', 'Thriller']",1960,5
4644216,Ultimate Avengers 2,2006,['United States of America'],"['Action', 'Animation', 'Superhero', 'Action/Adventure', ""Children's"", 'Superhero movie', 'Science Fiction', 'Fantasy']",2000,6
5889958,Destroyer,1988,['United States of America'],"['Slasher', 'Horror', 'Supernatural', 'Natural horror films']",1980,8
14595722,Two Lovers,2008,['United States of America'],"['Romance Film', 'Drama']",2000,8
13652133,Coup de tête,1979,['France'],"['Sports', 'Comedy', 'Drama']",1970,9
16264226,The Informant!,2009,['United States of America'],"['Film adaptation', 'Crime Fiction', 'Biography', 'Comedy', 'Thriller', 'Crime Thriller', 'Docudrama', 'Drama', 'Comedy of Errors', 'Crime Comedy', 'Comedy-drama']",2000,9
19375225,Shiver My Timbers,1931,['United States of America'],"['Black-and-white', 'Short Film', 'Comedy', 'Family Film']",1930,1
29384407,Customs Diary,1993,[],"['Action', 'Crime Fiction', 'Drama']",1990,3
6656961,Aces Go Places,1982,['Hong Kong'],"['Chinese Movies', 'Parody', 'Comedy']",1980,2
3384976,Galpa Holeo Satyi,1966,['India'],"['Family Film', 'Comedy', 'Bengali Cinema']",1960,6
10270840,Rainbow Song,2006,['Japan'],"['Romance Film', 'Japanese Movies', 'Drama']",2000,6
818234,Judgment Night,1993,"['Japan', 'United States of America']","['Action', 'Psychological thriller', 'Crime Fiction', 'Action Thrillers', 'Action/Adventure', 'Thriller', 'Crime Thriller', 'Japanese Movies']",1990,3
3004271,"My Beautiful Girl, Mari",2002,['South Korea'],"['Animation', 'Anime', 'Drama', 'Fantasy']",2000,2
24607828,"Veritas, Prince of Truth",2009,"['Mexico', 'United States of America']","['Family Film', 'Animation']",2000,9
11053868,Ghost Train,2006,['Japan'],"['Japanese Movies', 'World cinema', 'Horror']",2000,6
12768837,A Hungarian Fairy Tale,1987,['Hungary'],"['Political satire', 'Satire', 'Comedy', 'Fantasy']",1980,7
10198804,The Crooked E: The Unshredded Truth About Enron,2003,['United States of America'],"['Drama', 'Indie', 'Television movie', 'Docudrama']",2000,3
18823192,Abandoned,2001,['Hungary'],"['LGBT', 'Drama', 'World cinema']",2000,1
4524798,Don Juan,1926,['United States of America'],"['Silent film', 'Black-and-white', 'Indie']",1920,6
1211241,Super Troopers,2001,['United States of America'],"['Crime Fiction', 'Mystery', 'Comedy', 'Slapstick', 'Absurdism']",2000,1
18545216,Bitch Slap,2009,['United States of America'],"['Action', 'Action Thrillers', 'Action/Adventure', 'Comedy', 'Thriller', 'Black comedy', 'Crime Thriller', 'Drama']",2000,9
29405798,Two Hearts and One Heaven,1959,['Mexico'],"['Musical', 'World cinema']",1950,9
2410609,Cimarron,1931,['United States of America'],"['Film adaptation', 'Black-and-white', 'Action/Adventure', 'Western', 'Drama']",1930,1
1431305,As It Is in Heaven,2004,['Sweden'],"['Musical', 'Drama', 'World cinema']",2000,4
7006903,Love Affair,1994,['United States of America'],"['Romantic drama', 'Comedy', 'Remake', 'Romance Film', 'Drama']",1990,4
66322,M,1931,"['Weimar Republic', 'Germany']","['Psychological thriller', 'Black-and-white', 'Crime Fiction', 'Art film', 'Thriller', 'World cinema', 'Film noir', 'Crime Thriller', 'Drama']",1930,1
24708434,Sethupathi IPS,1994,[],[],1990,4
23205788,Short Kut: The Con is On,2009,['India'],"['Musical', 'Comedy', 'Bollywood', 'World cinema']",2000,9
14794717,Chasers,1994,['United States of America'],"['Action', 'Action/Adventure', 'Comedy']",1990,4
23281607,20 Years After,2008,[],"['Drama', 'Doomsday film', 'Science Fiction']",2000,8
14587187,Scanner Cop,1994,['United States of America'],"['Science Fiction', 'Sci-Fi Horror', 'Horror']",1990,4
3225960,Green Snake,1993,['Hong Kong'],"['Romantic fantasy', 'Fantasy Adventure', 'Costume Adventure', 'Romantic drama', 'Action/Adventure', 'World cinema', 'Romance Film', 'Chinese Movies', 'Adventure', 'Drama', 'Fantasy']",1990,3
13767243,1957: Hati Malaya,2007,['Malaysia'],['Drama'],2000,7
31567568,Down Terrace,2009,"['United Kingdom', 'England']","['Drama', 'Crime Fiction', 'Animation', 'Indie', 'Comedy', 'Thriller', 'Black comedy']",2000,9
31153511,Vida Parayum Munpe,1981,[],['Drama'],1980,1
10773864,Ponga Pandit,1975,['India'],"['Action', 'Drama', 'Family Film']",1970,5
15336376,The Good Witch,2008,['United States of America'],"['Comedy', 'Romance Film', 'Television movie', ""Children's/Family"", 'Family Film', 'Fantasy']",2000,8
33427517,Indian Babu,2003,['India'],"['Musical', 'Romantic drama', 'Comedy', 'Bollywood', 'World cinema', 'Romance Film', 'Drama', 'Romantic comedy']",2000,3
23227309,Dragon Storm,2004,"['Germany', 'United States of America']","['Action', 'Sci Fi Pictures original films', 'Television movie', 'Fantasy']",2000,4
26614307,Kangaroo,2007,['India'],"['Comedy', 'Thriller', 'Romance Film', 'Drama']",2000,7
2779486,Three on a Match,1932,['United States of America'],"['Pre-Code', 'Black-and-white']",1930,2
1735236,Deuce Bigalow: Male Gigolo,1999,['United States of America'],"['Gross out', 'Gross-out film', 'Comedy', 'Slapstick', 'Sex comedy']",1990,9
3665600,Chasing Papi,2003,['United States of America'],"['Chase Movie', 'Comedy', 'Romance Film', 'Romantic comedy']",2000,3
1614042,Criss Cross,1949,['United States of America'],"['Black-and-white', 'Crime Fiction', 'Mystery', 'Thriller', 'Film noir', 'Crime Thriller', 'Drama']",1940,9
13407047,Chaahat - Ek Nasha,2005,['India'],"['Romantic drama', 'World cinema', 'Romance Film', 'Drama']",2000,5
7452952,Do Ankhen Barah Haath,1958,['India'],"['Musical', 'Bollywood', 'World cinema', 'Drama']",1950,8
27042639,The Intimate Stranger,1956,['United Kingdom'],['Drama'],1950,6
25515516,Pyaar Ka Saaya,1991,['India'],"['Thriller', 'Drama']",1990,1
12060940,Beauty and the Beast,2005,"['United Kingdom', 'South Africa']","['Action', 'Romantic fantasy', 'Action/Adventure', 'Romance Film', 'Adventure', 'Horror', 'Science Fiction', 'Family Film', 'Fantasy']",2000,5
24907027,Prosperity,1932,['United States of America'],"['Drama', 'Comedy film']",1930,2
4348164,Jian Gui 2,2004,"['Hong Kong', 'Thailand']","['Chinese Movies', 'World cinema', 'Horror']",2000,4
594295,Fear,1996,['United States of America'],"['Thriller', 'Drama']",1990,6
68374,True Lies,1994,['United States of America'],"['Action', 'Spy', 'Action Thrillers', 'Action Comedy', 'Thriller', 'Glamorized Spy Film']",1990,4
4781857,The Wanderers,1979,['United States of America'],"['Action', 'Drama', 'Crime Fiction', 'Coming of age', 'Action/Adventure']",1970,9
2198086,"He Said, She Said",1991,['United States of America'],"['Comedy', 'Romance Film', 'Romantic comedy', 'Drama']",1990,1
997174,Domestic Disturbance,2001,['United States of America'],"['Psychological thriller', 'Suspense', 'Crime Fiction', 'Mystery', 'Thriller', 'Crime Thriller', 'Drama']",2000,1
23690998,The Carson City Kid,1940,['United States of America'],"['Action/Adventure', 'Western']",1940,0
10494887,Andala Ramudu,2006,['India'],"['Musical', 'Romantic drama', 'Comedy', 'Bollywood', 'World cinema', 'Romance Film', 'Drama']",2000,6
3688458,Seven Men from Now,1956,['United States of America'],"['Action/Adventure', 'Western']",1950,6
16167652,Alaudin,2003,['India'],['Drama'],2000,3
3077365,The Final Sacrifice,1990,['Canada'],"['Fantasy', 'Adventure', 'Horror']",1990,0
213015,Ragtime,1981,['United States of America'],"['Period piece', 'Film adaptation', 'Political drama', 'Drama']",1980,1
149786,A Song to Remember,1945,['United States of America'],"['Musical', 'Musical Drama', 'Biographical film', 'Biopic [feature]', 'Drama']",1940,5
33447396,Daata,1989,['India'],"['Drama', 'World cinema']",1980,9
1353277,King of Kings,1961,['United States of America'],"['Period piece', 'Biography', 'Christian film', 'Epic', 'Roadshow theatrical release', 'Costume drama', 'Drama']",1960,1
6768832,Grim Prairie Tales,1990,['United States of America'],"['Horror', 'Western']",1990,0
9331521,Suture,1993,['United States of America'],"['Psychological thriller', 'Mystery', 'Indie', 'Thriller', 'Drama']",1990,3
27342926,My Father and I,2003,['China'],"['Drama', 'Chinese Movies', 'World cinema']",2000,3
10988128,Heroes Shed No Tears,1978,['Hong Kong'],"['Action/Adventure', 'World cinema', 'Wuxia', 'Chinese Movies', 'Martial Arts Film']",1970,8
27682546,The Bandit Queen,1950,['United States of America'],['Western'],1950,0
7537205,Taxidermia,2006,"['France', 'Hungary', 'Austria']","['Surrealism', 'Gross out', 'Gross-out film', 'Art film', 'Comedy', 'World cinema', 'Black comedy', 'Drama', 'Horror']",2000,6
24036291,Lies of the Heart: The Story of Laurie Kellogg,1994,['United States of America'],"['Romance Film', 'Biography', 'Drama']",1990,4
3401395,Waterloo Road,1945,['United Kingdom'],['Drama'],1940,5
5603901,Liberty,1929,['United States of America'],"['Black-and-white', 'Indie', 'Short Film', 'Comedy', 'Silent film']",1920,9
642867,The Earthling,1980,"['New Zealand', 'Australia', 'United States of America']","['Action/Adventure', 'World cinema', 'Adventure', 'Drama']",1980,0
7971740,Below Zero,1930,['United States of America'],"['Black-and-white', 'Short Film', 'Comedy', 'Slapstick']",1930,0
26031336,Bulldog Drummond Comes Back,1937,['United States of America'],"['Action', 'Suspense', 'Detective fiction', 'Mystery', 'Action/Adventure', 'Thriller', 'Detective']",1930,7
34467400,The Whalers,1938,['United States of America'],"['Animation', 'Short Film', 'Comedy film', 'Family Film']",1930,8
8449814,The Ferryman,2007,"['New Zealand', 'United Kingdom']","['Thriller', 'Horror']",2000,7
238846,D.O.A.,1950,['United States of America'],"['Psychological thriller', 'Black-and-white', 'Crime Fiction', 'Mystery', 'Thriller', 'Film noir', 'Crime Thriller', 'Drama', 'Suspense']",1950,0
8513659,The Great Land of Small,1986,['Canada'],"[""Children's/Family"", 'Indie', 'Family Film']",1980,6
1291587,Vanity Fair,2004,"['United Kingdom', 'United States of America']","['Period piece', 'Film adaptation', 'Romantic drama', 'Romance Film', 'Costume drama', 'Drama']",2000,4
25655938,I Was a Mail Order Bride,1982,['United States of America'],['Romantic comedy'],1980,2
1973137,Pithamagan,2003,['India'],"['Musical', 'Crime Fiction', 'Thriller', 'Drama']",2000,3
5667453,The Flight of the Phoenix,1965,['United States of America'],"['Airplanes and airports', 'Film adaptation', 'Disaster', 'Adventure', 'Drama']",1960,5
13679495,Barbie as the Island Princess,2007,['United States of America'],"[""Children's"", 'Family Film', 'Computer Animation']",2000,7
22102102,Police Court,1932,['United States of America'],"['Black-and-white', 'Drama']",1930,2
3738468,Wit,2001,"['United Kingdom', 'United States of America']","['Film adaptation', 'Medical fiction', 'Television movie', 'Drama']",2000,1
6299214,Inteha,2003,['India'],"['Musical', 'Romantic drama', 'Thriller', 'Bollywood', 'World cinema', 'Romance Film', 'Drama']",2000,3
27348158,The Man from Down Under,1943,['United States of America'],"['Romance Film', 'Drama']",1940,3
20591773,Desperadas 2,2008,['Philippines'],"['Filipino Movies', 'Comedy', 'World cinema', 'Drama']",2000,8
320506,Terror Tract,2000,['United States of America'],"['Slasher', 'Thriller', 'Horror', 'Supernatural']",2000,0
17240314,Roman de Gare,2007,['France'],"['Psychological thriller', 'Thriller', 'World cinema', 'Drama']",2000,7
8012754,Xtro II: The Second Encounter,1990,['Canada'],"['Horror', 'Science Fiction']",1990,0
10878913,Son of Sinbad,1955,['United States of America'],"['Action', 'Adventure', 'Fantasy']",1950,5
13769297,The Creeping Flesh,1973,['United Kingdom'],"['Thriller', 'Cult', 'Horror']",1970,3
5679960,The Spoilers,1930,['United States of America'],"['Action', 'Western']",1930,0
4602108,Summer Storm,2004,['Germany'],"['Gay Themed', 'LGBT', 'Coming of age', 'Comedy', 'World cinema', 'Drama']",2000,4
73438,Double Indemnity,1944,['United States of America'],"['Crime Fiction', 'Thriller', 'Film noir', 'Drama']",1940,4
1991057,Lammbock,2001,['Germany'],"['Stoner film', 'Comedy']",2000,1
19609453,Amar Deep,1979,['India'],"['Romance Film', 'Drama']",1970,9
24900519,Zombie Movie,2005,['New Zealand'],"['Short Film', 'Comedy', 'Horror']",2000,5
13902854,The Informers,2008,"['Germany', 'United States of America']","['Film adaptation', 'Crime Fiction', 'Indie', 'Thriller', 'Drama']",2000,8
1665725,Carbon Copy,1981,"['United Kingdom', 'United States of America']","['Comedy', 'Black comedy', 'Comedy-drama', 'Drama', 'Comedy of Errors']",1980,1
5349271,The Accidental Husband,2008,"['Ireland', 'United States of America']","['Romance Film', 'Romantic comedy', 'Comedy']",2000,8
2025145,The Revolution Will Not Be Televised,2003,"['United Kingdom', 'Finland', 'Germany', 'Ireland', 'Netherlands', 'United States of America']","['Indie', 'World History', 'Documentary', 'Journalism', 'Culture & Society', 'Social issues', 'Political cinema', 'War film']",2000,3
15080990,Wisegal,2008,['United States of America'],"['Crime Fiction', 'Gangster Film', 'Romantic drama', 'Crime Drama', 'Romance Film', 'Television movie', 'Drama']",2000,8
2718285,A Night in Heaven,1983,['United States of America'],"['Romantic drama', 'Indie', 'Romance Film', 'Erotica', 'Drama']",1980,3
33709712,Punnaram Cholli Cholli,1985,[],['Drama'],1980,5
2930434,Khullam Khulla Pyaar Karen,2001,['India'],['Comedy'],2000,1
12596096,Anne of Green Gables: A New Beginning,2008,[],"['Drama', 'Family Film']",2000,8
32525195,Sarah T. - Portrait of a Teenage Alcoholic,1975,['United States of America'],['Television movie'],1970,5
1726126,A History of Violence,2005,"['Germany', 'United States of America']","['Psychological thriller', 'Marriage Drama', 'Thriller', 'Crime Thriller', 'Drama']",2000,5
630701,Two English Girls,1971,['France'],"['Period piece', 'Erotic Drama', 'Romantic drama', 'World cinema', 'Romance Film', 'Drama']",1970,1
10457303,The Conformist,1970,"['France', 'Germany', 'West Germany', 'Italy']","['Drama', 'Indie', 'World cinema', 'Political drama']",1970,0
35083022,Arasiyal,1997,['India'],[],1990,7
3746391,A Touch of Zen,1969,"['Hong Kong', 'Taiwan']","['Action/Adventure', 'World cinema', 'Wuxia', 'Chinese Movies', 'Martial Arts Film', 'Drama']",1960,9
5374194,MVP 2: Most Vertical Primate,2002,['United States of America'],"['Comedy', 'Sports', ""Children's"", 'Drama', 'Family Film']",2000,2
9375401,Two Flags West,1950,['United States of America'],"['Black-and-white', 'Western', 'Drama']",1950,0
9431878,Au Pair,1999,"['Hungary', 'United States of America']","['Romance Film', 'Romantic comedy']",1990,9
3371527,Minnale,2001,['India'],"['Musical', 'Romantic drama', 'Bollywood', 'World cinema', 'Romance Film', 'Drama']",2000,1
22544242,Robin Hood Makes Good,1939,['United States of America'],"['Animation', 'Short Film', 'Family Film']",1930,9
16916460,A Little Thing Called Murder,2006,['United States of America'],"['Television movie', 'Comedy', 'Drama']",2000,6
982243,Watership Down,1978,['United Kingdom'],"['Film adaptation', 'Drama', 'Animation', 'Indie', 'Adventure', 'Family Film', 'Fantasy']",1970,8
15213832,The Cobbler,1923,['United States of America'],"['Black-and-white', 'Indie', 'Short Film', 'Comedy', 'Silent film', 'Family Film']",1920,3
16298384,Julia,2008,"['Mexico', 'Belgium', 'France', 'United States of America']","['Drama', 'Crime Fiction', 'Indie', 'World cinema']",2000,8
12010127,Stone of Destiny,2008,"['Canada', 'United Kingdom']","['Action', 'Crime Fiction', 'Action/Adventure', 'Indie', 'Comedy', 'Adventure', 'Drama', 'Period piece', 'Caper story', 'Historical fiction']",2000,8
1785981,King's Ransom,2005,"['Canada', 'United States of America']","['Action', 'Crime Fiction', 'Action/Adventure', 'Comedy', 'Black comedy']",2000,5
1179213,The Enforcer,1976,['United States of America'],"['Action', 'Crime Fiction', 'Action/Adventure', 'Thriller']",1970,6
3235385,The Lonely Lady,1983,['United States of America'],"['Romantic drama', 'Romance Film', 'Melodrama', 'Drama']",1980,3
17022948,The Yellow Ticket,1931,['United States of America'],"['Black-and-white', 'Melodrama', 'Drama']",1930,1
14833861,Mirage,1965,['United States of America'],"['Mystery', 'Crime Thriller', 'Thriller']",1960,5
22085818,Red Chillies,2009,['India'],['Thriller'],2000,9
345825,Mackenna's Gold,1969,['United States of America'],"['Western', 'Action/Adventure', 'Adventure']",1960,9
27546208,The Secret Life of Algernon,1997,['United Kingdom'],"['Romantic comedy', 'Comedy-drama', 'Comedy']",1990,7
2731103,Pat and Mike,1952,['United States of America'],"['Comedy', 'Romantic comedy', 'Romance Film', 'Sports']",1950,2
24128130,Don Muthu Swami,2008,['India'],"['Musical', 'Comedy', 'Bollywood', 'World cinema']",2000,8
31304479,Copper Canyon,1950,['United States of America'],"['Action/Adventure', 'Western']",1950,0
1826578,The Art of War,2000,"['Canada', 'United States of America']","['Action', 'Action/Adventure', 'Thriller', 'Crime Thriller', 'Political thriller']",2000,0
7160018,Life Before Her Eyes,2007,['United States of America'],"['Film adaptation', 'Time travel', 'Indie', 'Thriller', 'Drama']",2000,7
4114130,Pecos Pest,1955,[],"['Animation', 'Short Film', 'Comedy', 'Family Film']",1950,5
18373306,Hulk Vs,2009,['United States of America'],"['Animation', 'Action/Adventure', 'Superhero movie', 'Family Film']",2000,9
8007040,Amphibian Man,1962,"['Russia', 'Soviet Union']","['Monster movie', 'World cinema', 'Romance Film', 'Science Fiction']",1960,2
12405367,Conflict,1936,['United States of America'],"['Black-and-white', 'Drama']",1930,6
698969,The Horse Whisperer,1998,['United States of America'],"['Romantic drama', 'Western', 'Romance Film', 'Drama']",1990,8
29303092,Triple Dog,2009,['Canada'],"['Psychological thriller', 'Suspense', 'Indie', 'Thriller']",2000,9
2265234,Repeat Performance,1947,['United States of America'],"['Black-and-white', 'Crime Fiction', 'Mystery', 'Film noir', 'Drama', 'Fantasy']",1940,7
28870327,Air Cadet,1951,['United States of America'],['Drama'],1950,1
1280397,Exiled: A Law & Order Movie,1998,['United States of America'],['Drama'],1990,8
1848371,Outrageous Fortune,1987,['United States of America'],"['Action', 'Spy', 'Mystery', 'Action Comedy', 'Action/Adventure', 'Buddy film', 'Comedy']",1980,7
15047154,The Class,2007,['Estonia'],['Drama'],2000,7
25341428,Safe Conduct,2002,['France'],"['Period piece', 'Drama', 'World cinema']",2000,2
13713473,Saneamento Básico,2007,['Brazil'],['Comedy'],2000,7
28219052,Nila Kaalam,2001,['India'],['Drama'],2000,1
26670965,Rude Awakening,1989,['United States of America'],['Comedy'],1980,9
15133110,Torso,1973,['Italy'],"['Giallo', 'Crime Fiction', 'Mystery', 'Thriller', 'World cinema', 'Teen', 'Slasher', 'Horror']",1970,3
2987468,My Little Bride,2004,['South Korea'],"['Romantic drama', 'Comedy', 'World cinema', 'Romance Film', 'Romantic comedy', 'Drama']",2000,4
8447974,Zhmurki,2005,['Russia'],"['Crime Fiction', 'Action/Adventure', 'Comedy', 'World cinema']",2000,5
14695721,Deadly Intruder,1985,['United States of America'],"['Thriller', 'Horror']",1980,5
27361586,A Time for Killing,1967,['United States of America'],"['Western', 'Adventure', 'Drama']",1960,7
12276195,Starrbooty,2007,['United States of America'],"['Blaxploitation', 'LGBT', 'Gay Themed', 'Parody', 'Indie', 'Comedy', 'Crime Comedy']",2000,7
19518500,Pyaasa,2002,['India'],"['Musical', 'Romantic drama', 'Bollywood', 'World cinema', 'Romance Film', 'Drama']",2000,2
5674562,The Love Nest,1922,['United States of America'],"['Black-and-white', 'Indie', 'Short Film', 'Comedy', 'Silent film']",1920,2
1312231,Batoru rowaiaru II: Chinkonka,2003,['Japan'],"['Action', 'Dystopia', 'Japanese Movies', 'Action/Adventure', 'Thriller', 'World cinema', 'Drama']",2000,3
3584252,Holiday Affair,1949,['United States of America'],"['Romance Film', 'Drama']",1940,9
1364174,The Barefoot Contessa,1954,"['Italy', 'United States of America']","['Crime Fiction', 'Romantic drama', 'Mystery', 'Romance Film', 'Melodrama', 'Drama']",1950,4
626916,Oliver Twist,1948,"['United Kingdom', 'England']","['Film adaptation', 'Crime Fiction', 'Adventure', 'Drama', 'Family Film']",1940,8
1976548,Dead or Alive,1999,['Japan'],"['Action', 'Surrealism', 'Psychological thriller', 'Crime Fiction', 'Gangster Film', 'Action/Adventure', 'Thriller', 'World cinema', 'Japanese Movies']",1990,9
1836603,Hum Tumhare Hain Sanam,2002,['India'],"['Musical', 'Romantic drama', 'Bollywood', 'World cinema', 'Romance Film', 'Drama']",2000,2
12038438,Warriors of Virtue: The Return to Tao,2002,['Australia'],['Fantasy'],2000,2
13301546,Grizzly Rage,2007,['Canada'],"['Action', 'Thriller', 'Horror', 'Teen', 'Natural horror films']",2000,7
13473620,Son of Rambow,2008,"['Spain', 'United Kingdom', 'France', 'Germany']","['Indie', 'Comedy', 'Childhood Drama', 'Drama', 'Slice of life story', 'Period piece', 'Coming of age', 'Parody', 'Comedy-drama']",2000,8
1190931,Godzilla,1998,"['Japan', 'United States of America']","['Action', 'Monster', 'Thriller', 'Remake', 'Disaster', 'Japanese Movies', 'Horror', 'Science Fiction']",1990,8
33289463,Full Alert,1997,['Hong Kong'],"['Chinese Movies', 'World cinema']",1990,7
24615533,Njan Gandharvan,1991,['India'],"['Romance Film', 'Drama', 'Fantasy']",1990,1
6532516,Race with the Devil,1975,['United States of America'],"['Action', 'Chase Movie', 'Horror', 'Supernatural', 'Cult']",1970,5
456601,The Fly,1986,['United States of America'],"['Monster movie', 'Film adaptation', 'Horror', 'Romance Film', 'Science Fiction', 'Drama', 'Tragedy']",1980,6
1082656,Superman Returns,2006,['United States of America'],"['Action', 'Superhero', 'Action/Adventure', 'Adventure', 'Superhero movie', 'Science Fiction', 'Fantasy']",2000,6
21562456,Dream Girl,2009,[],"['Action', 'Musical', 'Drama']",2000,9
1289049,Millions,2005,['United Kingdom'],"['Crime Fiction', 'Family Drama', 'Action/Adventure', 'Comedy', 'Christian film', ""Children's"", 'Adventure', 'Drama', 'Family Film']",2000,5
451023,The Brood,1979,['Canada'],"['Psychological thriller', 'Indie', 'Horror', 'Science Fiction', 'Cult']",1970,9
3632060,Gamera vs. Barugon,1966,['Japan'],"['Monster movie', 'Japanese Movies', 'Action/Adventure', 'World cinema']",1960,6
1704458,Lantana,2001,"['Germany', 'New Zealand', 'Australia']","['Psychological thriller', 'Crime Fiction', 'Mystery', 'Thriller', 'World cinema', 'Crime Thriller', 'Drama', 'Marriage Drama', 'Ensemble Film']",2000,1
8819415,Rails & Ties,2007,['United States of America'],"['Indie', 'Family Drama', 'Drama']",2000,7
22100437,Frontera Film,1980,['Mexico'],"['Action', 'Drama', 'Crime Fiction', 'Thriller', 'Romance Film']",1980,0
1425483,Center Stage,2000,['United States of America'],"['Musical', 'Musical Drama', 'Teen', 'Dance', 'Drama', 'Ensemble Film']",2000,0
3666262,The Roost,2005,['United States of America'],"['Slasher', 'Horror', 'Zombie Film', 'Haunted House Film']",2000,5
2053380,Scooby-Doo and the Witch's Ghost,1999,['United States of America'],"[""Children's Fantasy"", 'Animation', ""Children's/Family"", 'Family Film']",1990,9
27087930,Miss 420,1998,['India'],['Romance Film'],1990,8
23688010,Don Camillo,1952,"['France', 'Italy']","['Political cinema', 'Political satire', 'Comedy', 'Comedy film', 'World cinema', 'Comedy-drama']",1950,2
8356458,Interview,2003,['Netherlands'],['Drama'],2000,3
18513873,Matha,2006,['India'],['Comedy'],2000,6
3866194,Black Book,2006,['Netherlands'],"['Thriller', 'World cinema', 'War film', 'Drama']",2000,6
6030859,The House on Skull Mountain,1974,['United States of America'],"['Action', 'Spy', 'Suspense', 'Horror']",1970,4
9789345,"All the Way, Boys",1973,['Italy'],"['Action', 'Action/Adventure', 'Comedy', 'World cinema', 'Slapstick']",1970,3
27736078,Sarafina!,1992,"['United Kingdom', 'France', 'South Africa', 'United States of America']","['Musical', 'Family Drama', 'World cinema', 'Political drama', 'Drama', 'Family Film']",1990,2
7134109,White Lady,2006,['Philippines'],"['Filipino Movies', 'Thriller', 'Horror', 'World cinema']",2000,6
881249,Eat Drink Man Woman,1994,"['Taiwan', 'China', 'United States of America']","['Comedy', 'World cinema', 'Domestic Comedy', 'Romance Film', 'Comedy-drama', 'Chinese Movies', 'Drama']",1990,4
32345990,Ziddi,1964,['India'],"['Musical', 'Romantic drama', 'Comedy', 'Bollywood', 'World cinema', 'Romance Film', 'Drama']",1960,4
9223339,Band of Angels,1957,['United States of America'],"['Period piece', 'Film adaptation', 'Romance Film', 'Melodrama', 'Costume drama', 'Adventure', 'Drama']",1950,7
28459920,Apology,1986,"['Canada', 'United States of America']",['Thriller'],1980,6
25843561,Sweet Nothing,1996,['United States of America'],"['Indie', 'Addiction Drama', 'Drama']",1990,6
3244025,The Nine Lives of Fritz the Cat,1974,['United States of America'],"['Animation', 'Comedy', 'Adult', 'Fantasy Comedy', 'Cult']",1970,4
10597467,Evil Toons,1992,['United States of America'],"['Animation', 'Comedy', 'Thriller', 'Horror Comedy', 'Sexploitation', 'Parody', 'Horror', 'Supernatural', 'Fantasy']",1990,2
20185209,The Benny Goodman Story,1956,['United States of America'],"['Musical', 'Biography', 'Biographical film', 'Drama']",1950,6
930141,Lumumba,2000,"['Belgium', 'France', 'Germany', 'Haiti']","['Biopic [feature]', 'World cinema', 'Political drama', 'Drama']",2000,0
12213159,Terror Toons,2002,['United States of America'],"['Creature Film', 'B-movie', 'Horror']",2000,2
19394168,Flor Silvestre,1943,['Mexico'],"['Black-and-white', 'Romantic drama', 'Melodrama', 'Drama']",1940,3
7466292,The Banquet,1991,['Hong Kong'],"['Chinese Movies', 'Drama']",1990,1
2710154,Solar Crisis,1990,"['Japan', 'United States of America']","['Psychological thriller', 'Film adaptation', 'Thriller', 'World cinema', 'Adventure', 'Japanese Movies', 'Doomsday film', 'Science Fiction']",1990,0
2021400,The 40-Year-Old Virgin,2005,['United States of America'],"['Comedy', 'Buddy film', 'Romance Film', 'Romantic comedy', 'Sex comedy']",2000,5
29373207,The Bride,1973,['Turkey'],['Drama'],1970,3
13667818,Kenny & Company,1976,['United States of America'],"['Family Drama', 'Comedy', 'Drama', 'Family Film']",1970,6
932407,Beyond the Sea,2004,"['United Kingdom', 'Germany', 'United States of America']","['Music', 'Musical', 'Biography', 'Drama']",2000,4
8517247,Jackpot,2001,['United States of America'],"['Drama', 'Comedy']",2000,1
1137578,Bride and Prejudice,2004,"['United Kingdom', 'United States of America']","['Musical', 'Film adaptation', 'Comedy', 'Comedy of manners', 'Romance Film', 'Romantic comedy', 'Drama']",2000,4
14754221,How to Frame a Figg,1971,['United States of America'],"['Slapstick', 'Comedy', 'Drama', 'Family Film']",1970,1
9117035,Dragonwyck,1946,['United States of America'],"['Period piece', 'Black-and-white', 'Mystery', 'Gothic Film', 'Thriller', 'Romance Film', 'Drama']",1940,6
3377341,Shakha Proshakha,1990,['India'],"['Family Drama', 'Comedy-drama']",1990,0
62668,The Ring,2002,"['Japan', 'United States of America']","['Suspense', 'Mystery', 'Japanese Movies', 'Thriller', 'Horror', 'Supernatural']",2000,2
26665890,Gramaphone,2003,[],"['Musical', 'Comedy film', 'Romance Film', 'Drama', 'Family Film']",2000,3
518687,The Raven,1963,['United States of America'],"['Comedy', 'Horror', 'B-movie', 'Costume drama']",1960,3
26224240,Cell 211,2009,['Spain'],"['Action', 'Drama', 'Thriller', 'World cinema']",2000,9
10189688,Chirutha,2007,['India'],"['Drama', 'Bollywood', 'World cinema']",2000,7
3341961,Sansho the Bailiff,1954,['Japan'],"['Period piece', 'Art film', 'Japanese Movies', 'World cinema', 'Drama']",1950,4
5730679,Chain of Command,2000,"['United States of America', 'France']","['Action', 'Gay pornography', 'Indie', 'Action/Adventure', 'Thriller']",2000,0
11278891,Broadway,1929,['United States of America'],['Musical'],1920,9
418252,One-Eyed Jacks,1961,['United States of America'],"['Western', 'Revisionist Western', 'Action/Adventure']",1960,1
28978641,Mafia,1993,['India'],"['Action', 'Bollywood']",1990,3
30019520,Twenty-One,1991,['United Kingdom'],['Drama'],1990,1
31365129,Chef's Special,2008,['Spain'],"['LGBT', 'Romantic drama', 'Comedy', 'World cinema', 'Romance Film', 'Drama', 'Gay Themed', 'Gay', 'Gay Interest', 'Romantic comedy']",2000,8
9236773,Eleni,1985,['United States of America'],"['Historical fiction', 'War film', 'Political drama', 'Drama']",1980,5
17645471,The Cross of Lorraine,1943,['United States of America'],"['Action', 'Black-and-white', 'War film', 'Adventure']",1940,3
20329403,The Pigeon That Took Rome,1962,['United States of America'],"['Action', 'Period piece', 'Black-and-white', 'Comedy', 'War film']",1960,2
26564418,Lovelorn,2005,['Turkey'],['Drama'],2000,5
10844001,Mr. Wonderful,1993,['United States of America'],"['Romance Film', 'Romantic comedy', 'Comedy']",1990,3
4729744,Wake Me When The War Is Over,1969,['United States of America'],['Comedy'],1960,9
21530274,My Song Goes Forth,1937,['United Kingdom'],"['Short Film', 'Black-and-white']",1930,7
14469799,What's The Matador?,1942,['United States of America'],"['Short Film', 'Black-and-white', 'Comedy']",1940,2
11276518,The Ogre,1996,"['United Kingdom', 'France', 'Germany']","['Drama', 'World cinema']",1990,6
5116790,Hope,1970,['Turkey'],['Drama'],1970,0
20745486,The Pawnbroker,1965,['United States of America'],"['Film adaptation', 'Drama']",1960,5
21586409,The Guilty,2000,"['United Kingdom', 'United States of America', 'Canada']","['Action', 'Suspense', 'Crime Fiction', 'Thriller', 'Crime Thriller']",2000,0
20731623,Wild Combination: A Portrait of Arthur Russell,2008,['United States of America'],"['Music', 'LGBT', 'Biography', 'Documentary', 'Culture & Society']",2000,8
24816130,Bewitched Bunny,1954,[],"['Animation', 'Short Film', 'Family Film']",1950,4
5916068,Chathikkatha Chanthu,2004,['India'],"['Drama', 'Comedy', 'Comedy film', 'Malayalam Cinema']",2000,4
10620699,Kahani Kismat Ki,1973,['India'],"['Action', 'Drama', 'Family Film']",1970,3
1129299,Dead of Night,1945,['United Kingdom'],"['Psychological thriller', 'Mystery', 'Thriller', 'Horror']",1940,5
215873,Catch Me If You Can,2002,"['Canada', 'United States of America']","['Crime Fiction', 'Biography', 'Comedy', 'Drama']",2000,2
3377394,Abhijan,1962,['India'],"['Drama', 'Art film', 'Bollywood']",1960,2
3626312,Zinda,2006,['India'],"['Crime Fiction', 'Action/Adventure', 'Thriller', 'Bollywood', 'World cinema', 'Crime Thriller']",2000,6
5274232,The Fountainhead,1949,['United States of America'],"['Film à clef', 'Film adaptation', 'Drama']",1940,9
8928152,Because of Winn-Dixie,2005,['United States of America'],"['Family Drama', 'Comedy', 'Comedy-drama', ""Children's"", 'Drama', 'Family Film']",2000,5
1442628,Dawn Anna,2005,['United States of America'],"['Family Drama', 'Television movie', 'Drama', 'Medical fiction']",2000,5
31322355,Marriage in the Shadows,1947,"['Germany', 'German Democratic Republic', 'Soviet occupation zone']",['Drama'],1940,7
405152,Confidentially Yours,1983,['France'],"['Psychological thriller', 'Mystery', 'Thriller', 'World cinema', 'Drama']",1980,3
14073356,The Valley,1976,['New Zealand'],['Short Film'],1970,6
3900943,Lovely Rivals,2004,['South Korea'],['Comedy'],2000,4
6215998,Matinee,1993,['United States of America'],"['Period piece', 'Coming of age', 'Parody', 'Comedy', 'Drama', 'Family Film']",1990,3
28031590,Sivaranjani,1978,['India'],['Drama'],1970,8
113651,Dead Man,1995,"['Germany', 'United States of America', 'Japan']","['Action', 'Black-and-white', 'Indie', 'Action/Adventure', 'Acid western', 'Costume drama', 'Drama', 'Period piece', 'Japanese Movies', 'Western', 'Cult', 'Fantasy']",1990,5
7679820,Andhrudu,2005,['India'],"['Action', 'Drama', 'Romantic drama', 'World cinema', 'Romance Film']",2000,5
24705139,Wieners,2008,['United States of America'],"['Road movie', 'Comedy', 'Absurdism']",2000,8
9559119,Open Water 2: Adrift,2006,"['United Kingdom', 'Germany', 'United States of America']","['Psychological thriller', 'Suspense', 'Indie', 'Thriller', 'Horror']",2000,6
30301695,Black Magic,1944,['United States of America'],"['Mystery', 'Crime Thriller', 'Thriller']",1940,4
19104102,Barbara,1997,"['Sweden', 'Denmark']",['Drama'],1990,7
3782980,An American Haunting,2006,"['Canada', 'United Kingdom', 'Romania', 'United States of America']","['Period piece', 'Supernatural', 'Horror']",2000,6
3377246,Hirak Rajar Deshe,1980,['India'],"['Musical', 'World cinema', 'Bengali Cinema']",1980,0
4759344,The Holy Man,1998,['Thailand'],['Comedy'],1990,8
8259794,Love + hate,2005,"['Ireland', 'United Kingdom']","['Indie', 'Drama']",2000,5
1605320,The Woodsman,2004,['United States of America'],"['Crime Fiction', 'Indie', 'Drama']",2000,4
2444294,Edge of Doom,1950,['United States of America'],"['Film adaptation', 'Crime Fiction', 'Thriller', 'Crime Drama', 'Film noir', 'Crime Thriller', 'Drama']",1950,0
3932157,Beneath,2007,['United States of America'],"['Psychological thriller', 'Thriller', 'Horror', 'Crime Thriller', 'Supernatural']",2000,7
1992647,Driving Lessons,2006,['United Kingdom'],"['Indie', 'Coming of age', 'Comedy', 'Comedy-drama', 'Drama']",2000,6
3466023,She Wore a Yellow Ribbon,1949,['United States of America'],"['Action/Adventure', 'Western', 'Cavalry Film', 'War film']",1940,9
32820811,The Arizona Raiders,1936,['United States of America'],"['Action', 'Film adaptation', 'Comedy Western', 'Action/Adventure', 'Western', 'Drama']",1930,6
6158928,The Tigers,1991,['Hong Kong'],"['Crime Fiction', 'Action/Adventure', 'Thriller', 'World cinema', 'Crime Thriller', 'Chinese Movies', 'Martial Arts Film']",1990,1
20309964,First Love,1939,['United States of America'],"['Musical', 'Romance Film', 'Black-and-white']",1930,9
8355122,Boss Nigger,1974,['United States of America'],"['Action', 'Blaxploitation', 'Action Thrillers', 'Satire', 'Thriller', 'Comedy', 'Parody', 'Western']",1970,4
5148441,Path to War,2002,['United States of America'],"['Period piece', 'Biographical film', 'Television movie', 'Political drama', 'Drama']",2000,2
934809,Operation Petticoat,1959,['United States of America'],"['Action', 'Action/Adventure', 'Comedy', 'War film']",1950,9
1295625,Godzilla: Tokyo SOS,2003,['Japan'],"['Japanese Movies', 'Action/Adventure', 'Monster', 'World cinema', 'Science Fiction', 'Cult', 'Fantasy']",2000,3
19517431,Men Against the Sky,1940,['United States of America'],"['Action', 'Black-and-white', 'Drama']",1940,0
10593987,Boobs in the Woods,1950,['United States of America'],"['Animation', 'Comedy', 'Family Film']",1950,0
2289802,Ride in the Whirlwind,1966,['United States of America'],"['Revisionist Western', 'Western']",1960,6
25714947,Bolo Raam,2009,['India'],"['Musical', 'Thriller', 'Bollywood', 'World cinema']",2000,9
5959458,Un Argentino en New York,1998,['Argentina'],"['Action', 'Science Fiction', 'Drama']",1990,8
30552508,Sisters on the Road,2009,['South Korea'],['Drama'],2000,9
6647011,Hit the Ice,1943,['United States of America'],"['Black-and-white', 'Slapstick', 'Comedy', 'Family Film']",1940,3
8843407,On The Loose,1931,['United States of America'],['Comedy'],1930,1
11144406,They Met in Bombay,1941,['United States of America'],"['Action', 'Black-and-white', 'Comedy', 'Crime Comedy', 'Romance Film', 'Adventure', 'Drama']",1940,1
4055486,Being from Another Planet,1982,['United States of America'],"['Indie', 'Science Fiction', 'Horror']",1980,2
2324841,Guilty Conscience,1985,['United States of America'],"['Crime Fiction', 'Mystery', 'Thriller', 'Crime Thriller', 'Drama']",1980,5
31186833,Kalam Mari Katha Mari,1987,[],"['Romance Film', 'Drama']",1980,7
9506553,Ghazal Al Banat,1949,['Egypt'],"['Musical', 'Romance Film', 'Comedy film']",1940,9
5926353,Margin for Error,1943,['United States of America'],"['Black-and-white', 'Drama']",1940,3
423019,Love Letter,1995,['Japan'],"['Japanese Movies', 'Drama']",1990,5
20011474,Déjà Vu,1988,['Soviet Union'],['Comedy'],1980,8
6041144,The Last Performance,1929,['United States of America'],"['Black-and-white', 'Drama', 'Crime Fiction', 'Indie', 'Silent film', 'Romance Film']",1920,9
6590449,Karate Kiba,1976,"['Japan', 'United States of America']","['Action', 'Crime Fiction', 'Action/Adventure', 'Thriller', 'World cinema', 'Martial Arts Film', 'Drama', 'Japanese Movies']",1970,6
1783356,Cazuza - O Tempo Não Pára,2005,['Brazil'],['Biographical film'],2000,5
15871089,Lights Camera Dead,2007,['United States of America'],"['Horror', 'Comedy film']",2000,7
924954,The Heroes of Telemark,1965,['United Kingdom'],"['Action', 'Action/Adventure', 'War film']",1960,5
5477209,Saps at Sea,1940,['United States of America'],"['Comedy', 'Black-and-white']",1940,0
28902041,The Triumph of the Rat,1926,['United Kingdom'],['Silent film'],1920,6
35886865,Ace of Aces,1933,['United States of America'],"['War film', 'Drama']",1930,3
3878392,Bon Voyage,1944,['United Kingdom'],"['Short Film', 'War film']",1940,4
1974897,Martian Successor Nadesico: The Motion Picture – Prince of Darkness,1998,['United States of America'],"['Action', 'Animation', 'Anime', 'Science Fiction']",1990,8
14375863,The Red Lanterns,1963,['Greece'],"['Black-and-white', 'Drama']",1960,3
7848565,Eureka Stockade,1949,['United Kingdom'],['War film'],1940,9
8997652,The Hunted,1995,['United States of America'],"['Action', 'Action/Adventure', 'Thriller', 'Martial Arts Film']",1990,5
645111,Python,2000,['United States of America'],"['Creature Film', 'Horror', 'B-movie', 'Natural horror films']",2000,0
1794176,Belphégor - Le fantôme du Louvre,2001,['France'],"['Fantasy', 'World cinema', 'Horror']",2000,1
25502752,Nirnayam,1991,['India'],"['Action', 'Comedy-drama']",1990,1
17155163,La Roue,1923,['France'],"['Art film', 'World cinema', 'Silent film', 'Drama']",1920,3
5501492,The Perfect Furlough,1958,['United States of America'],"['Romance Film', 'Romantic comedy', 'Comedy']",1950,8
10069910,Bloody Murder 2: Closing Camp,2003,['United States of America'],"['Slasher', 'Horror']",2000,3
4073844,These Old Broads,2001,['United States of America'],"['Television movie', 'Comedy-drama', 'Comedy']",2000,1
19099601,Anything Goes,1956,['United States of America'],"['Musical', 'Comedy']",1950,6
8279491,The Purple Monster Strikes,1945,['United States of America'],"['Action', 'Black-and-white', 'Adventure', 'Science Fiction']",1940,5
5576724,8mm 2,2005,['United States of America'],"['Crime Fiction', 'Thriller', 'Erotic thriller', 'Crime Thriller', 'Drama']",2000,5
32189232,Bepanaah,1985,['India'],"['Drama', 'Thriller', 'World cinema']",1980,5
29574385,Insaaf Main Karoonga,1985,['India'],"['Drama', 'Thriller', 'World cinema']",1980,5
4040589,The File on Thelma Jordon,1950,['United States of America'],"['Black-and-white', 'Film noir', 'Crime Drama', 'Drama']",1950,0
9139404,Only For You,2007,['United States of America'],"['Romantic drama', 'Indie', 'Romance Film', 'Drama']",2000,7
3545795,Sillunu Oru Kaadhal,2006,['India'],"['Musical', 'Romantic drama', 'Bollywood', 'World cinema', 'Romance Film', 'Drama']",2000,6
18960432,Innocent,2009,['United States of America'],['Action'],2000,9
1792621,Taal,1999,['India'],"['Musical', 'Bollywood', 'World cinema']",1990,9
5823255,Salem's Lot,1979,['United States of America'],"['Film adaptation', 'Horror', 'Television movie', 'Supernatural']",1970,9
1275719,Vampire Hunter D: Bloodlust,2000,"['Hong Kong', 'Japan']","['Action', 'Animation', 'World cinema', 'Romance Film', 'Anime', 'Chinese Movies', 'Japanese Movies', 'Horror', 'Fantasy']",2000,0
8594350,Adam and Paul,2004,['Ireland'],"['Tragicomedy', 'Comedy', 'Drama']",2000,4
246963,Wild at Heart,1990,['United States of America'],"['Crime Fiction', 'Romantic drama', 'Indie', 'Thriller', 'Black comedy', 'Romance Film', 'Crime Thriller', 'Drama', 'Road movie']",1990,0
7901981,The Last Flight,1931,['United States of America'],"['Black-and-white', 'Drama']",1930,1
14480043,A Kiss Before Dying,1956,['United States of America'],"['Psychological thriller', 'Thriller', 'Film noir', 'Drama']",1950,6
15886402,The Final Destination,2009,['United States of America'],"['Auto racing', 'Slasher', 'Teen', 'Thriller', 'Horror']",2000,9
30528716,Going to Pieces: The Rise and Fall of the Slasher Film,2006,['United States of America'],"['Crime Fiction', 'Slasher', 'Documentary']",2000,6
18606338,Stasera niente di nuovo,1942,['Italy'],"['Black-and-white', 'Drama']",1940,2
11625280,Kucch To Hai,2003,['India'],"['Mystery', 'Slasher', 'Thriller', 'Horror', 'World cinema', 'Drama']",2000,3
433824,Die Hard 2,1990,['United States of America'],"['Action', 'Airplanes and airports', 'Crime Fiction', 'Action Thrillers', 'Action/Adventure', 'Thriller']",1990,0
15399751,Chemical Wedding,2008,['United Kingdom'],"['Thriller', 'Horror', 'Erotic thriller', 'Supernatural', 'Science Fiction']",2000,8
2561398,You Wish!,2003,"['New Zealand', 'United States of America']","['Comedy', ""Children's/Family"", 'Drama', 'Family Film', 'Fantasy']",2000,3
223904,"Mary, Queen of Scots",1971,"['United Kingdom', 'United States of America']","['Biography', 'Biographical film', 'Costume drama', 'Drama', 'Period piece', 'Biopic [feature]', 'Historical Epic', 'Historical fiction']",1970,1
6555693,Carry On Emmannuelle,1978,['United Kingdom'],"['Parody', 'Comedy', 'Slapstick', 'Sex comedy']",1970,8
5482994,Treasure Island,1934,['United States of America'],"['Swashbuckler films', 'Black-and-white', 'Action/Adventure', 'Adventure', 'Drama', 'Family Film']",1930,4
142852,The Rogue Song,1930,['United States of America'],"['Musical', 'Comedy', 'Musical comedy', 'Romance Film', 'Romantic comedy']",1930,0
7534904,Woh Lamhe,2006,['India'],"['Musical', 'Romantic drama', 'Bollywood', 'World cinema', 'Romance Film', 'Drama']",2000,6
23140604,See You After School,2006,['South Korea'],"['Coming of age', 'Comedy', 'Teen', 'World cinema', 'Comedy-drama']",2000,6
6736424,Beer and Pretzels,1933,['United States of America'],"['Screwball comedy', 'Short Film', 'Comedy', 'Comedy of manners']",1930,3
3402601,Kim Possible: A Sitch in Time,2003,['United States of America'],"['Animated cartoon', 'Animation', 'Comedy', 'Teen', 'Family-Oriented Adventure', ""Children's/Family"", 'Television movie', 'Family Film']",2000,3
26961604,Raped with Eyes: Daydream,1982,['Japan'],['Japanese Movies'],1980,2
23691324,The Old Corral,1936,['United States of America'],"['Action', 'Crime Fiction', 'Action/Adventure', 'Western']",1930,6
370858,Master and Commander: The Far Side of the World,2003,['United States of America'],"['Action', 'Film adaptation', 'Costume Adventure', 'Action/Adventure', 'Adventure', 'Drama', 'Period piece', 'War film']",2000,3
7639116,Leprechaun: Back 2 tha Hood,2003,['United States of America'],"['Creature Film', 'Monster movie', 'Slasher', 'Horror Comedy', 'Horror', 'Supernatural', 'Cult']",2000,3
7330661,Deck the Halls,2006,['United States of America'],"['Christmas movie', 'Comedy', 'Family Film']",2000,6
2457326,Palindromes,2005,['United States of America'],"['Indie', 'Comedy', 'Avant-garde', 'Satire', 'Black comedy', 'Adventure', 'Drama', 'Coming of age', 'Experimental film', 'Comedy-drama']",2000,5
2231977,Nightwatching,2007,"['Canada', 'United Kingdom', 'France', 'Germany', 'Poland', 'Netherlands']","['Period piece', 'Drama', 'Mystery', 'Indie', 'Biographical film', 'Biopic [feature]', 'Historical drama']",2000,7
3408831,Career Opportunities,1991,['United States of America'],"['Comedy', 'Teen', 'Romance Film', 'Romantic comedy']",1990,1
18600705,Artists and Models Abroads,1938,['United States of America'],"['Romantic comedy', 'Black-and-white']",1930,8
8521952,Hercules Returns,1993,"['United States of America', 'Australia']",['Mythological Fantasy'],1990,3
30238213,Johnny Lingo,1969,['United States of America'],['Short Film'],1960,9
7063029,A Plumbing We Will Go,1940,['United States of America'],"['Black-and-white', 'Short Film', 'Comedy', 'Slapstick']",1940,0
1741327,Problem Child 3: Junior in Love,1995,['United States of America'],"['Comedy', 'Family Film']",1990,5
7242242,House of Frankenstein 1997,1997,['United States of America'],"['Action', 'Mystery', 'Horror']",1990,7
3955571,Stromboli,1949,['Italy'],"['Black-and-white', 'Marriage Drama', 'Melodrama', 'Drama']",1940,9
555857,Poison Ivy,1992,['United States of America'],"['Suspense', 'LGBT', 'Drama', 'Indie', 'Thriller', 'Erotic thriller']",1990,2
1419513,Dance Me Outside,1994,['Canada'],"['Film adaptation', 'Drama', 'Indie', 'Ensemble Film']",1990,4
8949311,Hammer,1972,['United States of America'],"['Action', 'Blaxploitation', 'Boxing', 'Crime Fiction', 'Action/Adventure', 'Drama', 'Melodrama', 'Sports']",1970,2
28462988,Replacing Dad,1999,['United States of America'],"['Drama', 'Comedy film']",1990,9
17571248,Pirates of the Plain,1999,['United States of America'],"['Family-Oriented Adventure', ""Children's/Family"", 'Adventure', 'Family Film']",1990,9
2337370,The Specialist,1994,"['Peru', 'United States of America']","['Action', 'Crime Fiction', 'Action/Adventure', 'Thriller']",1990,4
3581722,Balto III: Wings of Change,2004,['United States of America'],"['Musical', 'Animation', 'Family-Oriented Adventure', 'Adventure', 'Family Film']",2000,4
7639376,Deadly Eyes,1982,['Canada'],"['Horror', 'Natural horror films']",1980,2
22270542,Banty Raids,1963,['United States of America'],"['Animation', 'Short Film', 'Comedy', 'Family Film']",1960,3
5026441,Air Bud: World Pup,2000,"['Canada', 'United States of America']","['Sports', 'Comedy', 'Animal Picture', ""Children's/Family"", ""Children's"", 'Family Film']",2000,0
5906571,Police,2005,['India'],"['Crime Fiction', 'Thriller']",2000,5
27562889,Indraprastham,1996,['India'],"['Action', 'Drama']",1990,6
8134017,Topsy and Bunker: The Cat Killers,1992,['United States of America'],['Indie'],1990,2
15579421,Ashoka,2008,['India'],[],2000,8
1365451,Trial,1955,['United States of America'],"['Crime Fiction', 'Drama', 'Courtroom Drama']",1950,5
2352397,Running with Scissors,2006,['United States of America'],"['Comedy-drama', 'Comedy', 'Drama']",2000,6
24978946,Broken Hill,2009,"['New Zealand', 'Australia']","['Family Drama', 'Teen', 'Romance Film', 'Drama', 'Family Film']",2000,9
6676241,Bloodlust!,1961,['United States of America'],"['Indie', 'Black-and-white']",1960,1
9785975,Blood Brothers,2007,['India'],"['Drama', 'Short Film', 'Thriller']",2000,7
2372982,Best Seller,1987,['United States of America'],"['Psychological thriller', 'Crime Fiction', 'Gangster Film', 'Mystery', 'Thriller', 'Crime Thriller', 'Drama', 'Suspense']",1980,7
15868571,Manners of Dying,2005,['Canada'],['Drama'],2000,5
2093556,The Brides of Dracula,1960,"['United Kingdom', 'United States of America']","['Costume Horror', 'Horror']",1960,0
19042389,Accused,1936,['United Kingdom'],['Mystery'],1930,6
15743241,"Number, Please?",1920,['United States of America'],"['Silent film', 'Black-and-white', 'Short Film']",1920,0
24436496,Equinox,1992,['United States of America'],"['Crime Fiction', 'Indie', 'Drama']",1990,2
1624660,Dersu Uzala,1975,"['Russia', 'Soviet Union', 'Japan']","['Japanese Movies', 'Action/Adventure', 'World cinema', 'Adventure', 'Drama']",1970,5
22714216,Ingane Oru Nilapakshi,2000,['India'],['Musical'],2000,0
26741752,It's Not Cricket,1949,['United Kingdom'],"['Adventure', 'Comedy film']",1940,9
33487771,The Naxalites,1980,[],['Drama'],1980,0
4580345,A Matter of Time,1976,"['Italy', 'United States of America']","['Romance Film', 'Drama', 'Fantasy']",1970,6
33529082,East of Borneo,1931,['United States of America'],"['Action', 'Action/Adventure', 'Jungle Film', 'Melodrama', 'Adventure', 'Drama']",1930,1
1543289,Foxy Brown,1974,['United States of America'],"['Action', 'Blaxploitation', 'Crime Fiction', 'Action/Adventure', 'Thriller', 'Crime Thriller']",1970,4
18537242,Home for the Holidays,1972,['United States of America'],"['Mystery', 'Thriller', 'Horror', 'Drama']",1970,2
6812190,Jolson Sings Again,1949,['United States of America'],"['Musical', 'Biography', 'Biographical film', 'Biopic [feature]', 'Docudrama', 'Drama']",1940,9
28858127,Holiday in Mexico,1946,['United States of America'],"['Musical', 'Comedy', 'Musical comedy']",1940,6
19062669,The Boy in the Striped Pyjamas,2008,"['United Kingdom', 'United States of America']","['Period piece', 'Film adaptation', 'History', 'War film', 'Drama']",2000,8
13422867,It's a Free World...,2007,"['Spain', 'United Kingdom', 'Germany', 'Italy']","['Social problem film', 'Indie', 'Drama']",2000,7
7251868,Sweet Movie,1974,"['France', 'Canada', 'West Germany']","['Indie', 'Satire', 'Comedy', 'Experimental film', 'Absurdism', 'Erotica', 'Sex comedy']",1970,4
22751151,Weddings and Babies,1960,['United States of America'],"['Black-and-white', 'Romantic drama', 'Romance Film', 'Drama']",1960,0
12662789,The Lady Without Camelias,1955,"['France', 'Italy']","['Black-and-white', 'Drama']",1950,5
3489518,The Mummy's Hand,1940,['United States of America'],"['Creature Film', 'Monster movie', 'Black-and-white', 'Horror', 'Archaeology', 'B-movie']",1940,0
34080708,Passion,1999,['Australia'],"['Music', 'Drama', 'Biographical film']",1990,9
7731316,Vijetha,1985,['India'],"['Musical', 'Bollywood', 'World cinema', 'Drama']",1980,5
30887985,Shadows in the Sun,2005,[],"['Romantic drama', 'Comedy', 'Romance Film', 'Romantic comedy', 'Drama']",2000,5
28006082,Détour De Seta,2005,['Italy'],['Documentary'],2000,5
9689762,Rasigan,1994,['India'],"['Action', 'Romance Film']",1990,4
14738317,Hugs and Mugs,1950,['United States of America'],"['Short Film', 'Black-and-white', 'Comedy']",1950,0
20777420,District 9,2009,"['Canada', 'South Africa', 'New Zealand', 'United States of America']","['Action', 'Thriller', 'World cinema', 'Sci-Fi Adventure', 'Science Fiction', 'Drama']",2000,9
9513043,You Don't Mess with the Zohan,2008,['United States of America'],"['Action', 'Drama', 'Comedy']",2000,8
10518816,The Seventh Continent,1989,['Austria'],"['Romance Film', 'Drama', 'World cinema']",1980,9
20959633,The Day the Earth Stopped,2008,['United States of America'],"['Indie', 'Thriller', 'Alien Film', 'Science Fiction']",2000,8
24120424,Tenali Ramakrishna,1956,['India'],['Comedy-drama'],1950,6
8351318,Khao Chon Kai,2006,['Thailand'],"['Drama', 'Comedy', 'Teen']",2000,6
14143940,Who's Guilty?,1945,['United States of America'],"['Black-and-white', 'Mystery', 'Adventure']",1940,5
8637926,The Daring Years,1923,['United States of America'],"['Black-and-white', 'Drama', 'Indie', 'Silent film']",1920,3
22377867,Blackout,2009,['United States of America'],"['Psychological thriller', 'Slasher', 'Thriller', 'Horror']",2000,9
3583781,When Strangers Marry,1944,['United States of America'],"['Psychological thriller', 'Film noir', 'Thriller']",1940,4
1610563,Fresh,1994,['United States of America'],"['Drama', 'Crime Fiction', 'Thriller']",1990,4
7421657,The Only Game in Town,1970,['United States of America'],['Drama'],1970,0
3204685,Woman Thou Art Loosed,2004,['United States of America'],"['Film adaptation', 'Drama', 'Crime Fiction', 'Indie', 'Melodrama', 'Addiction Drama']",2000,4
1463386,White Sun of the Desert,1969,"['Russia', 'Soviet Union']","['Action', 'Action/Adventure', 'Western', 'Comedy', 'World cinema', 'War film', 'Adventure']",1960,9
23890141,A Very Merry Daughter Of the Bride,2008,['Canada'],"['Romantic drama', 'Romance Film', 'Television movie', 'Drama']",2000,8
3746837,The Comancheros,1961,['United States of America'],"['Action', 'Western', 'Action/Adventure']",1960,1
2285959,Alien Lockdown,2005,['United States of America'],"['Creature Film', 'Action', 'Thriller', 'Horror', 'Television movie', 'Science Fiction']",2000,5
24704005,Blind Faith,1990,['United States of America'],['Thriller'],1990,0
8628327,Kala Pani,1996,['India'],"['Action', 'Drama']",1990,6
15799232,The Clay Pigeon,1949,['United States of America'],"['Psychological thriller', 'Black-and-white', 'Thriller', 'Film noir', 'Drama']",1940,9
6392570,Gigot,1962,['United States of America'],"['Comedy-drama', 'Buddy film', 'Comedy']",1960,2
2296056,Sky High,2005,['United States of America'],"['Action/Adventure', 'Comedy', 'Teen', ""Children's"", 'Adventure', 'Coming of age', 'Superhero movie', 'Science Fiction', 'Family Film', 'Fantasy']",2000,5
9148637,Anna Magdalena,1998,['Hong Kong'],"['Romantic comedy', 'Chinese Movies', 'Comedy']",1990,8
29594386,Motives 2: Retribution,2007,['United States of America'],"['Suspense', 'Mystery', 'Thriller', 'Crime Thriller']",2000,7
6787832,Moe and the Big Exit,2007,['United States of America'],"['Musical', 'Animation', 'Short Film', ""Children's""]",2000,7
22042951,C Me Dance,2009,['United States of America'],"['Thriller', 'Drama']",2000,9
26006741,Wild Seed,1965,['United States of America'],"['Romance Film', 'Drama']",1960,5
5989683,Chingaari,2006,['India'],"['Romantic drama', 'World cinema', 'Romance Film', 'Social problem film', 'Drama']",2000,6
13980546,I'll Believe You,2006,['United States of America'],"['Indie', 'Parody', 'Comedy', 'Science Fiction', 'Family Film']",2000,6
31849667,He Is My Brother,1975,[],['Drama'],1970,5
35057029,Corky,1972,['United States of America'],['Drama'],1970,2
12498480,Three Kingdoms: Resurrection of the Dragon,2008,"['Hong Kong', 'South Korea', 'China']","['Action', 'Action/Adventure', 'World cinema', 'Chinese Movies', 'Martial Arts Film', 'Period piece', 'Historical Epic', 'Epic', 'War film']",2000,8
19931038,Churchill's Leopards,1970,"['Spain', 'Italy']","['Action', 'War film', 'Thriller']",1970,0
6212003,Rare Birds,2001,['Canada'],"['Indie', 'Comedy', 'Drama', 'Comedy of Errors']",2000,1
11016612,Simon Magus,1999,"['Kingdom of Great Britain', 'United Kingdom', 'France', 'Germany', 'United States of America']","['Period piece', 'Mystery', 'Romance Film', 'Drama', 'Fantasy']",1990,9
10367777,Kangaroo Palace,1997,['Australia'],"['Drama', 'Ensemble Film']",1990,7
5474126,Loving,1970,['United States of America'],"['Film adaptation', 'Romantic drama', 'New Hollywood', 'Romance Film', 'Drama']",1970,0
23983916,Mixed Blessings,1995,['United States of America'],"['Film adaptation', 'Romantic drama', 'Romance Film', 'Television movie', 'Drama']",1990,5
13183597,S.O.S. - En segelsällskapsresa,1988,['Sweden'],['Comedy'],1980,8
33619567,Skid Marks,2007,['United States of America'],"['Indie', 'Comedy', 'Slapstick', 'Absurdism']",2000,7
719000,Deewar,1975,['India'],"['Musical', 'Bollywood', 'World cinema', 'Drama']",1970,5
31339377,Hajar Bachhor Dhore,2005,['Bangladesh'],['Family Film'],2000,5
17553916,Guns of the Timberland,1960,['United States of America'],['Western'],1960,0
27179450,Fast and Loose,1954,['United Kingdom'],['Comedy'],1950,4
2149056,Sphadikam,1995,['India'],"['Action', 'Drama', 'Bollywood']",1990,5
488623,Dr. Phibes Rises Again,1972,['United Kingdom'],"['Horror', 'Costume Horror', 'Master Criminal Films', 'Cult']",1970,2
1164497,Dreaming of Julia,2003,"['Germany', 'United States of America']","['Action', 'Drama', 'Crime Fiction', 'Indie', 'Action/Adventure', 'Comedy']",2000,3
23148610,The Terror,1939,['United Kingdom'],"['Suspense', 'Crime Thriller', 'Thriller']",1930,9
33845451,The Sensual Man,1973,['Italy'],"['Comedy', 'Drama', 'Comedy film']",1970,3
15698879,Meeting Se Meeting Tak,2008,['India'],['Musical'],2000,8
2451503,Number One,1969,['United States of America'],['Drama'],1960,9
449352,Cross of Iron,1977,"['Yugoslavia', 'United Kingdom', 'Germany', 'West Germany']","['Combat Films', 'Action', 'Drama', 'Action/Adventure', 'War film']",1970,7
7324640,Spies,1928,['Germany'],"['Spy', 'Black-and-white', 'Drama', 'Indie', 'Thriller', 'World cinema', 'Silent film']",1920,8
1872336,A Stranger Among Us,1992,['United States of America'],"['Crime Fiction', 'Mystery', 'Indie', 'Romantic drama', 'Thriller', 'Romance Film', 'Crime Thriller', 'Drama']",1990,2
9016141,Dead or Alive 2: Birds,2000,['Japan'],"['Action', 'Surrealism', 'Japanese Movies', 'Action/Adventure', 'Thriller', 'World cinema', 'Crime Thriller']",2000,0
1328188,Desperate Living,1977,['United States of America'],"['LGBT', 'Crime Fiction', 'Comedy film', 'Horror', 'Fantasy']",1970,7
31406574,Appunni,1984,[],"['Romance Film', 'Drama', 'Comedy film']",1980,4
3826340,Iron & Silk,1990,"['Japan', 'United States of America']","['Film adaptation', 'Japanese Movies', 'Romantic drama', 'Action/Adventure', 'Romance Film', 'Martial Arts Film', 'Drama']",1990,0
1493245,Baby's Day Out,1994,['United States of America'],"['Crime Fiction', 'Comedy', 'Family-Oriented Adventure', ""Children's/Family"", 'Slapstick', 'Adventure', 'Drama', 'Family Film']",1990,4
3177256,Pardon Us,1931,['United States of America'],"['Black-and-white', 'Satire', 'Comedy']",1930,1
6169108,The Laurel-Hardy Murder Case,1930,['United States of America'],"['Black-and-white', 'Short Film', 'Comedy', 'Slapstick']",1930,0
6256985,Teenage Caveman,2002,['United States of America'],"['Television movie', 'Parody', 'Science Fiction']",2000,2
60164,It's a Wonderful Life,1946,['United States of America'],"['Drama', 'Family Film', 'Fantasy']",1940,6
11703461,Asian Stories,2006,['United States of America'],"['Indie', 'Comedy', 'Black comedy', 'Drama']",2000,6
7156183,Pardon My Sarong,1942,['United States of America'],"['Adventure Comedy', 'Black-and-white', 'Satire', 'Comedy']",1940,2
31023204,Return of the Gunfighter,1967,['United States of America'],['Western'],1960,7
6791617,Larry-Boy and the Fib from Outer Space!,1997,[],"['Musical', 'Animation', 'Short Film', ""Children's""]",1990,7
25848285,Tora-san's Forget Me Not,1973,['Japan'],['Japanese Movies'],1970,3
29210441,Educated Evans,1936,['United Kingdom'],['Comedy film'],1930,6
9126014,Across the Pacific,1942,['United States of America'],"['Spy', 'Black-and-white', 'Thriller', 'Drama']",1940,2
4471177,Deaf Sam-Ryong,1929,['South Korea'],"['Black-and-white', 'Drama', 'Indie', 'Silent film']",1920,9
2350468,Prison on Fire II,1991,['Hong Kong'],"['Action', 'Prison', 'Chinese Movies', 'Drama']",1990,1
5254819,Thoughtcrimes,2003,['United States of America'],"['Psychological thriller', 'Crime Fiction', 'Television movie', 'Crime Thriller', 'Drama']",2000,3
11615294,Narrow Margin,1990,['United States of America'],"['Action', 'Crime Fiction', 'Gangster Film', 'Action Thrillers', 'Action/Adventure', 'Thriller', 'Film noir', 'Crime Thriller', 'Suspense']",1990,0
30109909,Once In a Summer,2006,['South Korea'],['Romantic drama'],2000,6
80923,A Letter to Three Wives,1949,['United States of America'],"['Film adaptation', 'Mystery', 'Comedy', 'Romance Film', 'Romantic comedy', 'Drama']",1940,9
18019926,Messengers 2: The Scarecrow,2009,['United States of America'],['Horror'],2000,9
23513341,Savage Vengeance,1993,['United States of America'],['Thriller'],1990,3
22740792,A Prophet,2009,"['France', 'Italy']","['Prison', 'Crime Fiction', 'Thriller', 'World cinema', 'Crime Thriller', 'Drama']",2000,9
6190804,Hot Pursuit,1987,['United States of America'],"['Action', 'Action/Adventure', 'Comedy', 'Teen']",1980,7
3076462,Jo Jeeta Wohi Sikandar,1992,['India'],"['Musical', 'Bollywood', 'World cinema', 'Drama']",1990,2
68082,Abbott and Costello Meet Frankenstein,1948,['United States of America'],"['Black-and-white', 'Screwball comedy', 'Monster', 'Horror Comedy', 'Comedy', 'Slapstick', 'Creature Film', 'Parody', 'Horror']",1940,8
4264016,Husbands,1970,['United States of America'],"['Indie', 'Buddy film', 'Drama', 'Ensemble Film']",1970,0
8448026,Eagle vs Shark,2007,['New Zealand'],"['Indie', 'Comedy', 'Comdedy', 'World cinema', 'Romance Film', 'Romantic comedy']",2000,7
25609202,Murk,2005,"['United Kingdom', 'Denmark']","['Thriller', 'Drama']",2000,5
30822465,Children of God,2009,['Bahamas'],"['Social issues', 'LGBT', 'Romantic drama', 'World cinema', 'Romance Film', 'Drama', 'Culture & Society']",2000,9
30247669,Shadows Over Chinatown,1946,[],"['Crime Fiction', 'Mystery', 'Comedy film']",1940,6
13987143,The Demon,1978,['Japan'],"['Japanese Movies', 'Thriller', 'World cinema', 'Crime Thriller']",1970,8
26679558,Blood Car,2007,['United States of America'],"['Parody', 'Satire', 'Comedy', 'Horror Comedy', 'Horror', 'Black comedy', 'Cult']",2000,7
34153889,Ganda Berunda,1984,['India'],['Adventure'],1980,4
23725400,Turtles Forever,2009,['United States of America'],"['Action', 'Animation', 'Comedy', 'Thriller', 'Adventure']",2000,9
19221106,Extract,2009,['United States of America'],"['Crime Fiction', 'Parody', 'Indie', 'Comedy', 'Romance Film', 'Workplace Comedy']",2000,9
29552477,Nightmare Detective 2,2008,[],['Horror'],2000,8
1417586,Falling from Grace,1992,['United States of America'],"['Music', 'Romantic drama', 'Romance Film', 'Drama']",1990,2
102580,Throne of Blood,1957,['Japan'],"['Action', 'Black-and-white', 'Samurai cinema', 'Thriller', 'World cinema', 'Drama', 'Tragedy', 'Period piece', 'Japanese Movies', 'War film', 'Fantasy']",1950,7
26208121,The Good Guy,2009,['United States of America'],"['Romantic drama', 'Comedy', 'Romance Film', 'Romantic comedy', 'Drama']",2000,9
770348,Blue Sky,1994,['United States of America'],"['Period piece', 'Romantic drama', 'Marriage Drama', 'Romance Film', 'Drama']",1990,4
21880834,"Two Fists, One Heart",2009,['Australia'],"['Action', 'Sports', 'Drama']",2000,9
1044633,Layer Cake,2004,"['United Kingdom', 'England']","['Drama', 'Crime Fiction', 'Gangster Film', 'Indie', 'Thriller', 'Crime Drama', 'Crime Thriller']",2000,4
239587,Finding Nemo,2003,"['United States of America', 'Australia']","['Adventure Comedy', 'Animation', 'Comedy', 'Family-Oriented Adventure', ""Children's/Family"", ""Children's"", 'Adventure', 'Computer Animation', 'Family Film']",2000,3
22318770,The Love-Ins,1967,['United States of America'],"['Satire', 'Comedy-drama']",1960,7
29528534,Anokha Rishta,1986,['India'],"['Musical', 'Romantic drama', 'Bollywood', 'World cinema', 'Romance Film', 'Drama']",1980,6
1099277,Enigma,1983,"['United Kingdom', 'France']","['Thriller', 'Political thriller']",1980,3
13076097,Encounters at the End of the World,2007,['United States of America'],"['Indie', 'Documentary', 'Travel', 'Nature']",2000,7
26624825,The Bar at the Crossing,1972,['France'],['Adventure'],1970,2
13044759,Crutch,2004,['United States of America'],"['LGBT', 'Drama', 'Coming of age', 'Indie', 'Family Drama', 'Addiction Drama']",2000,4
12633105,Yeh Hui Na Mardon Wali Baat,2000,['Pakistan'],['Short Film'],2000,0
17985706,Child of Manhattan,1933,['United States of America'],"['Black-and-white', 'Romance Film', 'Melodrama', 'Pre-Code', 'Drama']",1930,3
3193295,The Myth of Fingerprints,1997,['United States of America'],"['Family Drama', 'Comedy', 'Comedy-drama', 'Drama', 'Ensemble Film']",1990,7
6417790,Dolls,1987,['United States of America'],"['Monster movie', 'Supernatural', 'Horror']",1980,7
2938845,BaadAsssss Cinema,2002,"['United Kingdom', 'United States of America']","['Blaxploitation', 'Film & Television History', 'Indie', 'Biography', 'Action/Adventure', 'Documentary', 'Film']",2000,2
3650653,The Sword in the Stone,1963,['United States of America'],"['Animation', ""Children's/Family"", 'Costume drama', 'Adventure', 'Drama', 'Sword and sorcery films', 'Mythological Fantasy', ""Children's Fantasy"", 'Coming of age', 'Sword and sorcery', 'Historical fiction', 'Family Film', 'Fantasy']",1960,3
25248397,Wrong Turn at Tahoe,2009,['United States of America'],"['Action', 'Crime Fiction', 'Gangster Film', 'Thriller', 'Crime Thriller', 'Drama']",2000,9
9463801,Battling Butler,1926,['United States of America'],"['Black-and-white', 'Drama', 'Indie', 'Comedy', 'Silent film', 'Romantic comedy', 'Sports']",1920,6
13606911,Beyond Our Ken,2004,['Hong Kong'],"['Romantic drama', 'World cinema', 'Romance Film', 'Chinese Movies', 'Drama']",2000,4
35485631,Naan Pesa Ninaipathellam,1993,['India'],['Drama'],1990,3
3825785,The Little Whirlwind,1941,['United States of America'],['Animation'],1940,1
26068451,He's in the Army Now,2003,['Turkey'],['Comedy'],2000,3
6765829,The Geisha Boy,1958,['United States of America'],"['Slapstick', 'Comedy']",1950,8
26286016,The Astonished Heart,1950,['United Kingdom'],"['Film adaptation', 'Romantic drama', 'Romance Film', 'Drama']",1950,0
1969294,"Mother, Jugs & Speed",1976,['United States of America'],"['Comedy', 'Black comedy', 'Workplace Comedy', 'Slapstick']",1970,6
30654425,Dark Places,1974,[],['Horror'],1970,4
6121312,Mighty Joe Young,1998,['United States of America'],"['Action', 'Thriller', 'Adventure', 'Family Film', 'Fantasy']",1990,8
13393790,The Unseen,1982,['United States of America'],"['Monster movie', 'Mystery', 'Indie', 'Slasher', 'Thriller', 'Horror']",1980,2
35628369,Andre the Butcher,2005,[],"['Horror', 'Comedy film']",2000,5
18512674,Sorted,2000,['United Kingdom'],"['Psychological thriller', 'Mystery', 'Indie', 'Thriller', 'Crime Thriller']",2000,0
4185266,Profondo Rosso,1975,['Italy'],"['Psychological thriller', 'Mystery', 'Thriller', 'Horror', 'World cinema', 'Crime Thriller', 'Cult']",1970,5
17947683,Embodiment of Evil,2008,['Brazil'],"['Horror', 'Supernatural', 'World cinema']",2000,8
13555251,Just Another Romantic Wrestling Comedy,2007,['United States of America'],"['Indie', 'Comedy', 'Romantic comedy', 'Romance Film', 'Sports']",2000,7
20724748,Delhi 6,2009,['India'],"['Musical', 'Comedy', 'Bollywood', 'World cinema', 'Road movie', 'Drama', 'Ensemble Film']",2000,9
18408667,Portrait of the Artist as a Young Bunny,1980,['United States of America'],['Comedy'],1980,0
402866,The Hunchback of Notre Dame,1996,['United States of America'],"['Musical', 'Animation', 'Romance Film', 'Drama', 'Family Film']",1990,6
892031,American Psycho 2,2002,['United States of America'],"['Psychological thriller', 'Slasher', 'Thriller', 'Horror']",2000,2
18146509,Edison and Leo,2008,['Canada'],"['Animation', 'Comedy', 'Fantasy']",2000,8
18934473,Flesh and the Spur,1957,['United States of America'],"['Action', 'B-Western', 'Western']",1950,7
14147899,Mr. Jealousy,1997,['United States of America'],"['Screwball comedy', 'Indie', 'Comedy', 'Romance Film', 'Romantic comedy', 'Comedy of Errors']",1990,7
3992212,Mutiny on the Bounty,1935,['United States of America'],"['Action', 'Film adaptation', 'Black-and-white', 'Drama', 'Action/Adventure']",1930,5
19351485,Lucy in London,1966,['United States of America'],['Comedy'],1960,6
16543797,Diamond Dogs,2007,[],"['Action', 'Action Thrillers', 'Action/Adventure', 'Thriller', 'Martial Arts Film']",2000,7
4265882,Case of Evil: Case of Evil,2002,"['United Kingdom', 'Romania', 'United States of America']","['Action', 'Crime Fiction', 'Mystery', 'Thriller', 'Crime Thriller', 'Adventure', 'Drama', 'Television movie']",2000,2
21821426,Blackmail,2005,['India'],"['Drama', 'Thriller', 'World cinema']",2000,5
99984,Una Aventura Llamada Menudo,1982,['Puerto Rico'],['Music'],1980,2
1252955,Telefon,1977,['United States of America'],"['Cold War', 'Psychological thriller', 'Action', 'Spy', 'Action Thrillers', 'War film']",1970,7
12142819,Town Without Pity,1961,['United States of America'],"['Period piece', 'Black-and-white', 'Crime Fiction', 'Drama', 'Courtroom Drama']",1960,1
22558014,Plague Town,2008,['United States of America'],"['Slasher', 'Thriller', 'Horror']",2000,8
3755901,Another Gay Movie,2006,['United States of America'],"['LGBT', 'Comedy', 'Romance Film', 'Gay Themed', 'Gay', 'Parody', 'Coming of age', 'Gay Interest', 'Romantic comedy', 'Sex comedy']",2000,6
2721109,"The Prize Winner of Defiance, Ohio",2005,['United States of America'],"['Period piece', 'Film adaptation', 'Drama', 'Feminist Film', 'Family Drama', 'Indie', 'Americana']",2000,5
5315438,Creature from the Haunted Sea,1961,['United States of America'],"['Black-and-white', 'Crime Fiction', 'Indie', 'Comedy', 'Satire', 'Horror Comedy', 'Creature Film', 'Parody', 'Horror', 'B-movie']",1960,1
35229109,Victims,1982,['United States of America'],"['Drama', 'Television movie']",1980,2
17911663,The Adventures of Young Van Helsing: The Quest for the Lost Scepter,2004,['United States of America'],"['Action', 'Adventure', 'Horror']",2000,4
25169758,Mommy 2: Mommy's Day,1997,['United States of America'],"['Crime Thriller', 'Thriller', 'Horror']",1990,7
2285254,Baby Face,1933,['United States of America'],"['Black-and-white', 'Film noir', 'Romance Film', 'Melodrama', 'Pre-Code', 'Drama']",1930,3
22407961,Bring it On: Fight to the Finish,2009,['United States of America'],"['Comedy', 'Teen', 'Dance', 'Sports']",2000,9
1306774,Witchfinder General,1968,['United Kingdom'],"['Film adaptation', 'Thriller', 'Costume drama', 'Adventure', 'Drama', 'Period piece', 'History', 'Horror', 'War film']",1960,8
19868108,Nancy Drew and the Hidden Staircase,1939,['United States of America'],"['Detective fiction', 'Black-and-white', 'Mystery', 'Comedy', 'Detective']",1930,9
407591,Hulk,2003,['United States of America'],"['Action', 'Action/Adventure', 'Adventure', 'Superhero movie', 'Science Fiction']",2000,3
6195949,Now You Know,2002,['United States of America'],"['Indie', 'Comedy', 'Romance Film', 'Romantic comedy']",2000,2
6920292,Watching the Detectives,2007,['United States of America'],"['Indie', 'Comedy', 'Romance Film', 'Romantic comedy']",2000,7
13481880,Crawlspace,1986,['United States of America'],"['Psychological thriller', 'Slasher', 'Horror', 'Cult']",1980,6
14086748,Volkodav from the Grey Hound Clan,2007,['Russia'],"['Action', 'Action/Adventure', 'World cinema', 'Adventure', 'Fantasy']",2000,7
22090777,You Gotta Stay Happy,1948,['United States of America'],"['Romance Film', 'Romantic comedy', 'Comedy']",1940,8
29558371,Kanamarayathu,1984,[],"['Romance Film', 'Drama']",1980,4
4276030,The Luck of the Irish,2001,['United States of America'],"['Sports', 'Family Film', 'Fantasy']",2000,1
19815384,The Olsen Gang,1968,"['Norway', 'Denmark']","['Comedy', 'Crime Fiction']",1960,8
11324565,Cardcaptor Sakura: The Movie,1999,[],"['Fantasy Adventure', 'Animation', 'World cinema', 'Anime', 'Fantasy']",1990,9
3198630,Porky Chops,1949,['United States of America'],"['Animation', 'Short Film', 'Comedy', 'Family Film']",1940,9
18456463,The Booze Hangs High,1930,[],['Black-and-white'],1930,0
7352319,Hail the Woman,1921,['United States of America'],"['Black-and-white', 'Drama', 'Indie', 'Silent film']",1920,1
22545667,Looking on the Bright Side,1932,['United Kingdom'],"['Musical', 'Comedy film']",1930,2
2194799,Zabriskie Point,1970,['United States of America'],"['Romance Film', 'Road movie', 'Drama', 'Cult', 'Ensemble Film']",1970,0
33777574,Adimakal Udamakal,1987,[],"['Action', 'Crime Fiction', 'Drama']",1980,7
24504158,Manasaare,2009,['India'],"['Romance Film', 'Comedy']",2000,9
716738,Meet Joe Black,1998,['United States of America'],"['Romantic fantasy', 'Mystery', 'Heaven-Can-Wait Fantasies', 'Romantic drama', 'Romance Film', 'Drama', 'Fantasy']",1990,8
25111821,Balayogini,1936,['India'],['Drama'],1930,6
23992760,The Fourth Kind,2009,"['United Kingdom', 'United States of America']","['Psychological thriller', 'Mystery', 'Thriller', 'Sci-Fi Horror', 'Science Fiction']",2000,9
213246,Alien: Resurrection,1997,['United States of America'],"['Action', 'Science Fiction', 'Thriller']",1990,7
22703750,Tampico,1944,['United States of America'],"['War film', 'Drama']",1940,4
414180,Something's Gotta Give,2003,['United States of America'],"['Comedy', 'Romance Film', 'Romantic comedy', 'Drama']",2000,3
7570243,The Postman,1997,['United States of America'],"['Action', 'Drama', 'Adventure', 'Science Fiction']",1990,7
27957563,Madurai Veeran,1956,[],"['Romance Film', 'Drama']",1950,6
5313889,The Flock,2007,['United States of America'],"['Crime Fiction', 'Mystery', 'Thriller', 'Crime Thriller', 'Drama']",2000,7
11094452,Ek Ruka Hua Faisla,1986,['India'],"['Drama', 'World cinema']",1980,6
30249152,Superdome,1978,['United States of America'],"['Crime Fiction', 'Sports', 'Drama']",1970,8
9186114,Nasib Si Labu Labi,1962,['Malaysia'],"['Musical', 'Comedy']",1960,2
3039544,Wyatt Earp,1994,['United States of America'],"['Crime Fiction', 'Biography', 'Action/Adventure', 'Biographical film', 'Drama', 'Period piece', 'Western', 'Epic']",1990,4
1530085,PCU,1994,['United States of America'],"['Political cinema', 'Political satire', 'Parody', 'Stoner film', 'Satire', 'Comedy']",1990,4
8105232,Poitín,1977,['Ireland'],['Drama'],1970,7
9518977,Uuno Turhapuro - Suomen tasavallan herra presidentti,1992,['Finland'],['Comedy'],1990,2
4187434,Snow White Christmas,1980,['United States of America'],"['Animation', 'Comedy', 'Adventure', 'Family Film', 'Fantasy']",1980,0
30674,The Terrorist,1999,['India'],"['Bollywood', 'Thriller', 'World cinema', 'Political drama', 'Drama', 'Political thriller']",1990,9
4120837,The Wind in the Willows,1996,"['Kingdom of Great Britain', 'United Kingdom']","['Animation', ""Children's"", 'Slapstick', 'Comedy', 'Adventure', 'Family Film', 'Fantasy']",1990,6
8045017,Okariki Okaru,2003,['India'],"['Musical', 'Bollywood', 'World cinema', 'Drama']",2000,3
11789084,To Kill a King,2003,"['United Kingdom', 'Germany']","['Period piece', 'Historical fiction', 'War film', 'Political drama', 'Drama']",2000,3
26181218,Man of the East,1972,"['France', 'Yugoslavia', 'Italy']",['Spaghetti Western'],1970,2
21146018,Emergency Landing,1952,['Norway'],"['War film', 'Black-and-white']",1950,2
4298713,Captive Women,1952,['United States of America'],"['Black-and-white', 'Romance Film', 'Science Fiction', 'Drama']",1950,2
5444420,The Bridge of San Luis Rey,2005,"['Spain', 'United Kingdom', 'France', 'United States of America']","['Period piece', 'Film adaptation', 'Drama', 'Indie']",2000,5
23367243,A Man of Principle,1984,['Colombia'],['Drama'],1980,4
76394,Tootsie,1982,['United States of America'],"['Comedy', 'Romance Film', 'Romantic comedy', 'Drama', 'Comedy of Errors']",1980,2
27889108,Miss Grant Goes to the Door,1940,['United Kingdom'],['Short Film'],1940,0
14900129,Princess O'Rourke,1943,['United States of America'],"['Black-and-white', 'Comedy', 'Romance Film', 'Romantic comedy']",1940,3
17477511,Nekromantik 2,1991,['Germany'],"['World cinema', 'Horror']",1990,1
11934067,Personal Property,1937,['United States of America'],"['Black-and-white', 'Drama']",1930,7
32998860,The Girl Next Door,1953,[],"['Musical', 'Comedy film']",1950,3
20513862,Mapado 2: Back to the Island,2007,['South Korea'],['Comedy'],2000,7
33154313,Say It With Flowers,1934,[],['Musical'],1930,4
27391398,All Mine to Give,1957,['United States of America'],"['Film adaptation', 'Family Drama', 'Melodrama', 'Drama', 'Family Film']",1950,7
4038581,No Mercy,1986,['United States of America'],"['Action', 'Crime Fiction', 'Action/Adventure', 'Thriller']",1980,6
5550410,Somebody Help Me,2007,['United States of America'],"['Action', 'Slasher', 'Teen', 'Horror']",2000,7
3347674,Brancaleone alle Crociate,1970,['Italy'],"['Adventure Comedy', 'Costume Adventure', 'Parody', 'Comedy', 'Adventure']",1970,0
5385325,Leila,1996,['Iran'],"['Romance Film', 'Drama', 'World cinema']",1990,6
2367145,The Thomas Crown Affair,1968,['United States of America'],"['Heist', 'Crime Fiction', 'Thriller', 'Crime Thriller']",1960,8
26814445,The House Where Evil Dwells,1982,"['Japan', 'United States of America']","['Japanese Movies', 'Haunted House Film', 'Horror']",1980,2
17786624,Deadline,1987,['United States of America'],"['Action', 'Drama', 'Indie', 'World cinema', 'Political drama', 'Political thriller']",1980,7
29565990,Revolt of the Praetorians,1964,['Italy'],"['Action', 'Drama', 'Adventure']",1960,4
23721976,The Defection of Simas Kudirka,1978,['United States of America'],"['Docudrama', 'Political drama', 'Drama']",1970,8
2689093,Invisible Agent,1942,['United States of America'],"['Action', 'Spy', 'Black-and-white', 'Action Thrillers', 'Thriller', 'Science Fiction', 'War film', 'Propaganda film']",1940,2
6020979,Bonanza Bunny,1959,['United States of America'],"['Animation', 'Short Film', 'Family Film']",1950,9
12799543,Harper Valley PTA,1978,['United States of America'],"['Parody', 'Comedy']",1970,8
508044,Frenzy,1972,['United Kingdom'],"['Psychological thriller', 'Suspense', 'Film adaptation', 'Mystery', 'Thriller', 'Crime Thriller', 'Drama']",1970,2
10361558,I Wonder Who's Killing Her Now?,1976,['United States of America'],"['Crime Fiction', 'Comedy', 'Satire', 'Crime Comedy', 'Black comedy']",1970,6
20529868,Banquet Busters,1948,['United States of America'],"['Animation', 'Short Film', 'Comedy film', 'Family Film']",1940,8
9103852,Barry McKenzie Holds His Own,1974,['Australia'],"['Adventure Comedy', 'Comedy']",1970,4
1062898,Dragon Ball Z: Fusion Reborn,1995,['Japan'],"['Action', 'Animation', 'Japanese Movies', ""Children's"", 'Anime', 'Science Fiction']",1990,5
16897584,Walking Tall Part 2,1975,['United States of America'],"['Action', 'Drama', 'Crime Fiction', 'Action/Adventure', 'Crime Thriller']",1970,5
3528767,The Double 0 Kid,1992,['United States of America'],"['Spy', 'Comedy', 'Adventure']",1990,2
33412185,Deiva Vaakku,1992,['India'],"['Musical', 'Romantic drama', 'Bollywood', 'World cinema', 'Romance Film', 'Drama']",1990,2
25856684,Tora-san Plays Cupid,1977,['Japan'],['Japanese Movies'],1970,7
20217753,Champion,2003,['India'],['Action'],2000,3
8258361,Bilut,2006,['Malaysia'],['Drama'],2000,6
3747178,North to Alaska,1960,['United States of America'],"['Adventure Comedy', 'Action', 'Action/Adventure', 'Western', 'Comedy', 'Romance Film', 'Adventure']",1960,0
312228,House Party,1990,['United States of America'],"['Music', 'Coming of age', 'Buddy film', 'Comedy', 'Romance Film', 'Cult']",1990,0
1851374,The War,1994,['United States of America'],"['Period piece', 'Drama']",1990,4
9289196,Bharatham,1991,['India'],['Drama'],1990,1
7549834,Honor Roll,1992,['France'],"['Comedy', 'Family Film']",1990,2
8378844,Three Little Beers,1935,['United States of America'],"['Short Film', 'Black-and-white', 'Comedy']",1930,5
2903806,Pisaj,2004,['Thailand'],['Horror'],2000,4
31204098,It's a Boy,1933,[],['Comedy film'],1930,3
24328000,New Moon,1930,['United States of America'],['Musical'],1930,0
520990,Trading Places,1983,['United States of America'],"['Satire', 'Comedy', 'Comedy of manners']",1980,3
14791763,My Horrible Year!,2001,['United States of America'],"['Comedy', 'Teen', ""Children's/Family"", 'Drama']",2000,1
4539839,Inteha,1999,['Pakistan'],"['Musical', 'Romance Film', 'Drama']",1990,9
3150852,The Scarlet Pumpernickel,1950,['United States of America'],"['Animation', 'Short Film', 'Comedy film', 'Adventure', 'Family Film']",1950,0
1995696,Donnie Brasco,1997,['United States of America'],"['Period piece', 'Crime Fiction', 'Gangster Film', 'Biography', 'Thriller', 'Crime Drama', 'Drama']",1990,7
2224471,Night Train to Munich,1940,['United Kingdom'],"['Spy', 'Black-and-white', 'Thriller', 'War film']",1940,0
24510690,Rang Birangi,1983,['India'],['Comedy film'],1980,3
786972,Casshern,2004,['Japan'],"['Action', 'Japanese Movies', 'Science Fiction']",2000,4
1775698,"Jamón, jamón",1992,['Spain'],['Comedy'],1990,2
31626786,The Night of Nights,1939,['United States of America'],['Drama'],1930,9
10195586,The Haunted School,2007,['Hong Kong'],['Horror'],2000,7
2803158,Image of the Beast,1980,['United States of America'],"['Science Fiction', 'Thriller']",1980,0
18918743,Make Mine Mink,1960,['United Kingdom'],"['Film adaptation', 'Parody', 'Comedy', 'Slapstick', 'Drama']",1960,0
3871666,Zodiac: The Race Begins,2006,['Singapore'],"['Adventure', 'Animation']",2000,6
26802520,Horn 'OK' Pleassss,2009,['India'],['Comedy'],2000,9
33375064,Mounam,1996,['India'],"['Action', 'Romance Film', 'Thriller']",1990,6
29534579,Adam & Eva,1997,['Sweden'],"['Romance Film', 'Drama', 'Comedy film']",1990,7
30662782,Samaantar,2009,['India'],"['Romantic drama', 'World cinema', 'Romance Film', 'Drama']",2000,9
9743496,Jungle Jim in the Forbidden Land,1952,['United States of America'],"['Action', 'Adventure', 'Jungle Film']",1950,2
3616797,Gladiator,2000,"['United Kingdom', 'United States of America']","['Action', 'Historical drama', 'Costume drama', 'Adventure', 'Drama', 'Tragedy', 'Epic', 'War film', 'Movies About Gladiators']",2000,0
27122123,Swordsmen in Double Flag Town,1991,['China'],"['Action', 'Action/Adventure', 'Thriller', 'World cinema', 'Chinese Movies', 'Martial Arts Film', 'Adventure']",1990,1
52390,Armageddon,1998,['United States of America'],"['Action', 'Thriller', 'Adventure', 'Disaster', 'Science Fiction']",1990,8
17941264,Poison Ivy 4: The Secret Society,2008,"['Canada', 'United States of America']","['Drama', 'Thriller', 'Fantasy']",2000,8
30345613,Osey Ramulamma,1997,[],"['Action', 'Drama']",1990,7
6527176,Paprika,2006,"['Italy', 'Japan']","['Animation', 'Japanese Movies', 'Mystery', 'Thriller', 'Anime', 'Science Fiction', 'Fantasy']",2000,6
8101258,Abbott and Costello in Hollywood,1945,['United States of America'],"['Slapstick', 'Comedy']",1940,5
708870,Don Juan DeMarco,1995,['United States of America'],"['Romantic drama', 'Comedy', 'Comedy of manners', 'Romance Film', 'Romantic comedy', 'Comedy-drama', 'Drama']",1990,5
21037636,Andavan Kattalai,1964,['India'],['Romance Film'],1960,4
24053482,Daughters,1997,['United States of America'],['Drama'],1990,7
1695314,Jack-Jack Attack,2005,['United States of America'],"['Animation', 'Short Film', 'Adventure', 'Family Film', 'Computer Animation']",2000,5
24901937,The Murder Game,1965,['United Kingdom'],"['Drama', 'Crime Fiction']",1960,5
1040518,Zombi 2,1979,['Italy'],"['Splatter film', 'Thriller', 'Horror', 'Zombie Film']",1970,9
3150125,The First Great Train Robbery,1979,['United Kingdom'],"['Period piece', 'Crime Fiction', 'Thriller']",1970,9
318810,8½,1963,"['France', 'Italy']","['Drama', 'Fantasy']",1960,3
7676315,The Haunted World of El Superbeasto,2009,['United States of America'],"['Monster movie', 'Animation', 'Action/Adventure', 'Comedy', 'Superhero movie', 'Fantasy Comedy']",2000,9
24550060,Roudram,2008,['India'],['Action'],2000,8
3531568,Christmas in August,1998,['South Korea'],"['Romantic drama', 'World cinema', 'Romance Film', 'Drama']",1990,8
22657030,Art Of Revenge,2003,['United States of America'],"['Suspense', 'Mystery', 'Thriller', 'Crime Thriller']",2000,3
18906532,Arumugam,2008,['India'],[],2000,8
11137278,Black Mask 2: City of Masks,2002,"['Hong Kong', 'United States of America']","['Action', 'Action/Adventure', 'World cinema', 'Superhero movie', 'Chinese Movies', 'Martial Arts Film', 'Science Fiction']",2000,2
4593920,The Maltese Falcon,1931,['United States of America'],"['Detective fiction', 'Black-and-white', 'LGBT', 'Crime Fiction', 'Mystery', 'Thriller', 'Film noir', 'Romance Film', 'Pre-Code', 'Detective']",1930,1
4888602,Kissi Se Na Kehna,1983,['India'],"['Romantic drama', 'Comedy', 'World cinema', 'Romance Film', 'Romantic comedy', 'Drama']",1980,3
24426132,More Dead Than Alive,1968,['United States of America'],"['Action', 'Western', 'Action/Adventure']",1960,8
14143833,Black Arrow,1944,['United States of America'],"['Adventure', 'Black-and-white']",1940,4
4544340,Fool for Love,1985,['United States of America'],"['Romantic drama', 'Indie', 'Romance Film', 'Drama']",1980,5
1350590,Fight Back to School,1991,['Hong Kong'],"['Action', 'Martial Arts Film', 'Action Comedy', 'Action/Adventure', 'Comedy', 'World cinema', 'Chinese Movies']",1990,1
193868,Sunrise at Campobello,1960,['United States of America'],"['Biographical film', 'Biopic [feature]', 'Political drama', 'Drama']",1960,0
8638966,The Changeling 2,1987,['Italy'],"['World cinema', 'Thriller', 'Horror']",1980,7
844325,The Bitter Tears of Petra Von Kant,1972,"['Germany', 'West Germany']","['LGBT', 'Art film', 'World cinema', 'Drama']",1970,2
5083563,Cops and Robbers,1973,['United States of America'],"['Action', 'Film adaptation', 'Heist', 'Crime Fiction', 'Action/Adventure', 'Comedy', 'Drama']",1970,3
27930967,Crush,2009,"['New Zealand', 'Australia']","['Mystery', 'Indie', 'Thriller', 'Horror', 'World cinema', 'Supernatural']",2000,9
12578919,Sabse Bada Khiladi,1995,['India'],['World cinema'],1990,5
5207807,Junglee,1961,['India'],"['Musical', 'Comedy', 'Bollywood', 'Romance Film', 'Drama', 'Family Film']",1960,1
1765026,Chocolat,2000,"['United Kingdom', 'United States of America']","['Romance Film', 'Mystery', 'Drama']",2000,0
17516121,Science Ninja Team Gatchaman: The Movie,1978,['Japan'],"['Japanese Movies', 'Superhero movie', 'Anime', 'Science Fiction']",1970,8
32400923,My Little Pony: Twinkle Wish Adventure,2009,['United States of America'],['Animation'],2000,9
23669481,Spacked Out,2000,['Hong Kong'],"['Drama', 'Chinese Movies', 'World cinema']",2000,0
11020715,The Wind Blown Hare,1949,['United States of America'],"['Animation', 'Short Film', 'Comedy', 'Family Film', 'Fantasy']",1940,9
23119616,Messages,2007,['England'],"['Thriller', 'Horror']",2000,7
5566219,Hula,1927,['United States of America'],"['Action', 'Black-and-white', 'Indie', 'Silent film', 'Adventure']",1920,7
15790648,No Code of Conduct,1998,['United States of America'],"['Action', 'Suspense', 'Crime Fiction', 'Action/Adventure', 'Thriller', 'Crime Thriller', 'Drama']",1990,8
17344142,Welcome To The Jungle,2007,['United States of America'],"['Jungle Film', 'Slasher', 'Horror']",2000,7
13730827,Mummy's Dummies,1948,['United States of America'],"['Black-and-white', 'Short Film', 'Comedy', 'Slapstick']",1940,8
9987816,We Want Our Mummy,1939,['United States of America'],"['Short Film', 'Black-and-white', 'Comedy']",1930,9
1367110,Lovers and Other Strangers,1970,['United States of America'],"['Indie', 'Comedy', 'Romance Film', 'Romantic comedy', 'Domestic Comedy', 'Ensemble Film']",1970,0
1279798,Plein Soleil,1960,"['France', 'Italy']","['Psychological thriller', 'Suspense', 'Crime Fiction', 'Thriller', 'World cinema', 'Drama']",1960,0
6984559,The Guns of Navarone,1961,"['United Kingdom', 'United States of America']","['Action', 'War film', 'Adventure', 'Drama']",1960,1
13371377,Hero No. 1,1997,['India'],"['Musical', 'Comedy', 'Bollywood', 'World cinema', 'Romance Film']",1990,7
5856167,Chukkallo Chandrudu,2006,['India'],"['Comedy', 'Tollywood']",2000,6
3529788,Padre Padrone,1977,['Italy'],"['Film adaptation', 'Family Drama', 'World cinema', 'Drama']",1970,7
32817565,Rangle River,1936,[],['Western'],1930,6
31748550,Time Runner,1993,"['Canada', 'United States of America']","['Action', 'Science Fiction', 'Thriller']",1990,3
2982138,The Man Who Sued God,2001,['Australia'],"['Heavenly Comedy', 'Comedy', 'World cinema', 'Religious Film']",2000,1
3790323,Violette Nozière,1978,['France'],"['Crime Fiction', 'Romantic drama', 'World cinema', 'Romance Film', 'Docudrama', 'Drama', 'Period piece', 'Crime Drama']",1970,8
26660584,One Hysterical Night,1929,['United States of America'],"['Romance Film', 'Comedy']",1920,9
7697111,Julie,1975,['India'],"['Musical', 'Romantic drama', 'Bollywood', 'World cinema', 'Romance Film', 'Drama']",1970,5
10004664,Mast,1999,['India'],"['Musical', 'Romantic drama', 'World cinema', 'Romance Film', 'Comedy-drama', 'Drama']",1990,9
6210573,The Desert Rats,1953,['United States of America'],"['Combat Films', 'Black-and-white', 'War film', 'Drama']",1950,3
20812616,Backroads,1977,['Australia'],"['Drama', 'Crime Fiction']",1970,7
20224734,Jane Eyre,1934,['United States of America'],"['Period piece', 'Film adaptation', 'Romantic drama', 'Romance Film', 'Drama']",1930,4
13575264,Motor Home Massacre,2005,['United States of America'],"['Slasher', 'Horror']",2000,5
10597970,Invincible Shaolin,1978,['Hong Kong'],"['Action', 'Action/Adventure', 'World cinema', 'Chinese Movies', 'Martial Arts Film']",1970,8
9962261,Ramana,2002,['India'],"['Action', 'Drama']",2000,2
2506848,Dummy,2003,['United States of America'],"['Indie', 'Comedy', 'Romance Film', 'Romantic comedy', 'Drama']",2000,3
12344891,What's So Bad About Feeling Good?,1968,['United States of America'],['Comedy'],1960,8
3910693,Aks,2001,['India'],"['Bollywood', 'Horror']",2000,1
8158494,Who's Minding the Mint?,1967,['United States of America'],"['Comedy', 'Comedy of Errors']",1960,7
35908365,Flesh and Fury,1952,['United States of America'],['Drama'],1950,2
25548266,Katha,2009,['India'],['Drama'],2000,9
4123241,Nola,2003,['United States of America'],"['Indie', 'Comedy', 'Romance Film', 'Romantic comedy']",2000,3
3626050,Zathura,2005,['United States of America'],"['Action', 'Comedy', ""Children's/Family"", 'Adventure', ""Children's Fantasy"", 'Science Fiction', 'Family Film', 'Fantasy']",2000,5
22278175,The Last of Mrs. Cheyney,1929,['United States of America'],"['Black-and-white', 'Comedy', 'Drama']",1920,9
23092641,Angala parameswari,2002,['India'],['Religious Film'],2000,2
21971893,The Divine Woman,1928,['United States of America'],"['Romantic drama', 'Silent film', 'Romance Film', 'Drama']",1920,8
14738953,Three Hams on Rye,1950,['United States of America'],"['Short Film', 'Black-and-white', 'Comedy']",1950,0
11594202,Holy Weapon,1993,['Hong Kong'],"['Wuxia', 'Chinese Movies']",1990,3
106344,The Elephant Man,1980,['United States of America'],"['History', 'Biography', 'Drama']",1980,0
2280521,Angels & Insects,1996,"['United Kingdom', 'United States of America']","['Period piece', 'Film adaptation', 'Erotic Drama', 'Romantic drama', 'Romance Film', 'Drama']",1990,6
74387,How the West Was Won,1962,['United States of America'],"['Action', 'Epic Western', 'Western', 'Romance Film', 'Epic', 'Adventure', 'Drama']",1960,2
896182,Magic,1978,['United States of America'],"['Psychological thriller', 'Thriller', 'Horror', 'Romance Film', 'Drama', 'Cult']",1970,8
26968456,En el nombre del hijo,1987,['Argentina'],['Drama'],1980,7
22188807,The Prince and Me 3: Royal Honeymoon,2008,['United States of America'],"['Romance Film', 'Romantic comedy', 'Comedy']",2000,8
35588517,The Promising Boy,1981,['Yugoslavia'],"['Drama', 'Comedy film']",1980,1
9379337,The Last Word,2008,['United States of America'],"['Drama', 'Indie', 'Romantic drama', 'Comedy', 'Romance Film', 'Comedy-drama']",2000,8
2737675,Into The Fire,2001,['United States of America'],"['Indie', 'Drama']",2000,1
16125220,Flash of Genius,2008,['United States of America'],"['Period piece', 'Biographical film', 'Biopic [feature]', 'Docudrama', 'Drama', 'Courtroom Drama']",2000,8
7780069,Venus,2006,['United Kingdom'],"['Indie', 'Romantic drama', 'Comedy', 'Black comedy', 'Romance Film', 'Drama']",2000,6
18080043,Tokyo Twilight,1957,['Japan'],"['Art film', 'Japanese Movies', 'World cinema', 'Drama']",1950,7
6594677,Mojave Moon,1996,['United States of America'],"['Indie', 'Action/Adventure', 'Comedy Thriller', 'Comedy', 'Romance Film', 'Romantic comedy', 'Adventure']",1990,6
21985080,Monster Shark,1984,['Italy'],"['Science Fiction', 'Natural horror films', 'Horror']",1980,4
4738951,Death on the Nile,2004,['United Kingdom'],"['Crime Fiction', 'Mystery', 'Thriller', 'Drama']",2000,4
2790437,The Dark Mirror,1946,['United States of America'],['Film noir'],1940,6
26011442,Punjabi House,1998,['India'],"['Romantic comedy', 'Comedy-drama']",1990,8
1619323,Ticket to Heaven,1981,['Canada'],"['Film adaptation', 'Indie', 'Drama']",1980,1
10628977,Pandiyan,1992,['India'],['Action'],1990,2
13328842,I Dream of Jeannie: 15 Years Later,1985,['United States of America'],"['Domestic Comedy', 'Comedy', 'Fantasy Comedy']",1980,5
35923292,Blue Scar,1949,['United Kingdom'],['Drama'],1940,9
2037993,The Great St. Louis Bank Robbery,1959,['United States of America'],"['Suspense', 'Crime Fiction', 'Caper story', 'Film noir', 'Docudrama']",1950,9
7277772,La Bestia y la Espada Magica,1983,"['Spain', 'Japan']","['Japanese Movies', 'Horror']",1980,3
20904667,Sarkari Mehmaan,1979,['India'],"['Crime Fiction', 'Drama', 'Family Film']",1970,9
7277895,Licántropo,1996,['Spain'],['Horror'],1990,6
19892255,Legend Of The Bat,1978,['Hong Kong'],"['Wuxia', 'Chinese Movies', 'Adventure']",1970,8
24445186,Did You Hear About the Morgans?,2009,['United States of America'],"['Comedy', 'Romance Film', 'Romantic comedy', 'Drama']",2000,9
21807476,Saving God,2008,['Canada'],"['Drama', 'Crime Fiction']",2000,8
4823450,The Revenge of Frankenstein,1958,['United Kingdom'],"['Creature Film', 'Monster', 'Gothic Film', 'Horror', 'B-movie', 'Costume Horror']",1950,8
1241475,Fresh Hare,1942,['United States of America'],"['Short Film', 'Comedy']",1940,2
26482542,Immini Nalloraal,2005,['India'],"['Romance Film', 'Comedy']",2000,5
181658,They Call Me Trinity,1971,['Italy'],"['Action', 'Comedy Western', 'Action/Adventure', 'Western', 'Comedy', 'World cinema', 'Spaghetti Western']",1970,1
4874236,Secuestro express,2005,['Venezuela'],"['Crime Fiction', 'Action/Adventure', 'Thriller', 'World cinema', 'Crime Drama', 'Adventure', 'Drama']",2000,5
1979808,Tekken: The Motion Picture,1997,['Japan'],"['Action', 'Japanese Movies', 'Anime', 'Martial Arts Film']",1990,7
30443374,Peril,1985,['France'],"['Mystery', 'Thriller', 'Romance Film', 'Drama']",1980,5
25532685,The Little Apocalypse,2006,['Turkey'],"['Psychological thriller', 'Disaster', 'Thriller']",2000,6
803813,A Midwinter's Tale,1995,['United Kingdom'],['Romantic comedy'],1990,5
6838264,Funny Bones,1995,"['United Kingdom', 'England', 'United States of America']","['Family Drama', 'Comedy', 'Comedy-drama', 'Slapstick', 'Drama']",1990,5
9264341,Pineapple Express,2008,['United States of America'],"['Action', 'Crime Fiction', 'Stoner film', 'Action/Adventure', 'Buddy film', 'Thriller', 'Comedy', 'Action Comedy', 'Cult']",2000,8
11612605,Still of the Night,1982,['United States of America'],"['Psychological thriller', 'Suspense', 'Detective fiction', 'Thriller', 'Detective', 'Crime Thriller']",1980,2
28377370,But Not in Vain,1948,['Netherlands'],"['War film', 'Drama']",1940,8
8527516,Eskimo Nell,1975,['United Kingdom'],"['Comedy', 'Sex comedy']",1970,5
917665,Orlando,1993,"['Netherlands', 'Russia', 'United Kingdom', 'France', 'England', 'Italy']","['Film adaptation', 'LGBT', 'Romantic drama', 'Romance Film', 'Costume drama', 'Drama', 'Feminist Film', 'Period piece', 'Fantasy']",1990,3
3845313,Daisy,2006,"['Hong Kong', 'South Korea']",['Chinese Movies'],2000,6
2442464,Swept from the Sea,1998,"['United Kingdom', 'United States of America', 'Canada']","['Period piece', 'Romantic drama', 'Romance Film', 'Drama']",1990,8
26499358,Yashoda Krishna,1975,['India'],"['Musical', 'Drama']",1970,5
930561,Remo Williams: The Adventure Begins,1985,['United States of America'],"['Action', 'Spy', 'Crime Fiction', 'Action/Adventure', 'Comedy', 'Glamorized Spy Film', 'Martial Arts Film', 'Adventure']",1980,5
343408,The Aristocats,1970,['United States of America'],"['Musical', 'Animation', 'Animated Musical', 'Comedy', ""Children's/Family"", 'Adventure', ""Children's Fantasy"", 'Family Film']",1970,0
1329509,Mondo Trasho,1969,['United States of America'],"['Black-and-white', 'Mondo film', 'Comedy', 'Black comedy']",1960,9
1825320,The Legend of 1900,1998,"['Italy', 'United States of America']","['Period piece', 'Drama', 'Indie', 'World cinema']",1990,8
5608667,Men O' War,1929,['United States of America'],"['Black-and-white', 'Short Film', 'Comedy', 'Slapstick']",1920,9
17203681,Nothing Like the Holidays,2008,['United States of America'],"['Drama', 'Indie', 'Family Drama', 'Comedy', 'Romance Film', 'Holiday Film', 'Christmas movie']",2000,8
10638177,Chhupa Rustam,1972,['India'],"['Action/Adventure', 'Thriller', 'World cinema']",1970,2
24160744,Breaking Point,1976,['United States of America'],"['Drama', 'Crime Fiction']",1970,6
8780928,Playing the Ponies,1937,['United States of America'],"['Short Film', 'Black-and-white', 'Comedy']",1930,7
6672824,My Favorite Duck,1942,[],"['Comedy', 'Animation']",1940,2
24539738,Somebody Killed Her Husband,1978,['United States of America'],"['Crime Fiction', 'Mystery', 'Comedy', 'Comedy Thriller']",1970,8
18406924,Dayo: Sa Mundo ng Elementalia,2008,['Philippines'],"['Animation', 'Short Film', 'Adventure', 'Fantasy']",2000,8
22850072,Jaffa,2009,"['Israel', 'France']","['Romantic drama', 'Drama', 'World cinema']",2000,9
30830552,Fist Power,2000,['Hong Kong'],"['Action', 'Action/Adventure', 'Comedy', 'World cinema', 'Chinese Movies', 'Martial Arts Film']",2000,0
29125425,Salt Island,1964,['Venezuela'],"['Drama', 'Comedy film']",1960,4
22550541,The Cookie Carnival,1935,['United States of America'],"['Animation', 'Short Film', 'Comedy']",1930,5
30011023,Ghar Jamai,1992,['India'],"['Family Film', 'Comedy film']",1990,2
2908457,K-911,1999,['United States of America'],"['Action', 'Crime Fiction', 'Action/Adventure', 'Comedy', 'Animal Picture']",1990,9
15398677,Anari,1993,['India'],"['Romantic drama', 'World cinema', 'Romance Film', 'Drama']",1990,3
187107,The Star,1952,['United States of America'],"['Black-and-white', 'Drama']",1950,2
1312481,Raw Deal,1986,['United States of America'],"['Action', 'Crime Fiction', 'Gangster Film', 'Indie', 'Action/Adventure', 'Thriller']",1980,6
1635059,The Purple Rose of Cairo,1985,['United States of America'],"['Romantic fantasy', 'Indie', 'Satire', 'Comedy', 'Romance Film', 'Drama', 'Romantic comedy', 'Fantasy Comedy', 'Fantasy']",1980,5
27613748,Asuravamsam,1997,['India'],['Crime Fiction'],1990,7
6272794,Operation: Jet Fusion,2002,[],[],2000,2
12687445,Swing Vote,2008,['United States of America'],"['Political cinema', 'Comedy', 'Comedy-drama', 'Drama']",2000,8
9034157,Himmat,1996,['India'],"['Action', 'Drama', 'Romantic drama', 'World cinema', 'Romance Film']",1990,6
15802022,National Lampoon's Barely Legal,2003,"['Germany', 'United States of America']","['Parody', 'Coming of age', 'Comedy', 'Comedy-drama']",2000,3
1127016,Facing Windows,2003,"['Portugal', 'United Kingdom', 'Turkey', 'Italy']","['LGBT', 'Romantic drama', 'World cinema', 'Romance Film', 'Drama']",2000,3
6961860,Khatarnak,2006,['India'],['Action'],2000,6
16285439,Family Viewing,1987,['Canada'],"['Romance Film', 'Indie', 'Drama']",1980,7
32759391,En Tu Ausencia,2008,['Spain'],"['Drama', 'World cinema']",2000,8
7421620,Man of the Frontier,1936,['United States of America'],"['Musical', 'Black-and-white', 'Action/Adventure', 'Western']",1930,6
2651593,Water,2005,"['Canada', 'India']","['Art film', 'Romantic drama', 'World cinema', 'Romance Film', 'Drama']",2000,5
9677936,The Milky Waif,1946,['United States of America'],"['Animation', 'Short Film', 'Family Film']",1940,6
35485637,Gokulam,1993,['India'],['Drama'],1990,3
16067750,Assassination of a High School President,2009,['United States of America'],"['Mystery', 'Indie', 'Comedy', 'Thriller', 'Black comedy']",2000,9
1735676,My Six Convicts,1952,['United States of America'],"['Prison', 'Black-and-white', 'Comedy', 'Biographical film', 'Comedy-drama', 'Drama']",1950,2
4473622,Images,1972,"['United Kingdom', 'Ireland', 'United States of America']","['Psychological thriller', 'Drama']",1970,2
8659765,Krishnaveni,1974,['India'],['Musical'],1970,4
6150355,Prison,1988,['United States of America'],['Horror'],1980,8
11020879,Hare-Way To The Stars,1958,['United States of America'],"['Animated cartoon', 'Short Film', 'Family Film']",1950,8
1834411,Bade Miyan Chote Miyan,1998,['India'],"['Bollywood', 'World cinema']",1990,8
1485962,The Mask,1994,['United States of America'],"['Action', 'Crime Fiction', 'Comedy', 'Romance Film', 'Fantasy']",1990,4
535979,Hysterical Blindness,2002,['United States of America'],"['Period piece', 'Romantic drama', 'Buddy film', 'Romance Film', 'Television movie', 'Drama']",2000,2
213251,Alien³,1992,['United States of America'],"['Action', 'Action/Adventure', 'Thriller', 'Horror', 'Adventure', 'Science Fiction']",1990,2
2521806,The Blob,1988,['United States of America'],"['Science Fiction', 'Teen', 'Horror']",1980,8
5295514,The Vikings,1958,['United States of America'],"['Action', 'Costume Adventure', 'Action/Adventure', 'Adventure', 'Drama', 'Period piece', 'Historical fiction', 'Epic']",1950,8
8605283,Itlu Sravani Subramanyam,2001,['India'],[],2000,1
2572668,"Be My Valentine, Charlie Brown",1975,['United States of America'],"['Animation', 'Short Film', ""Children's/Family"", 'Holiday Film', 'Drama', 'Family Film']",1970,5
18612911,Doraemon: Nobita's Genesis Diary,1995,['Japan'],['Japanese Movies'],1990,5
1809672,The Glenn Miller Story,1953,['United States of America'],"['Musical', 'Period piece', 'Biography', 'Biographical film', 'Biopic [feature]', 'Musical Drama', 'Drama']",1950,3
1273558,The Small Back Room,1949,['United Kingdom'],"['Film adaptation', 'Black-and-white', 'War film', 'Drama']",1940,9
16055802,My Bloody Valentine,2009,"['Canada', 'United States of America']","['Slasher', 'Thriller', 'Horror']",2000,9
21749537,All Night Long,1992,['Japan'],"['Japanese Movies', 'Horror', 'World cinema', 'Drama']",1990,2
812818,In a Lonely Place,1950,['United States of America'],"['Black-and-white', 'Crime Fiction', 'Mystery', 'Thriller', 'Film noir', 'Crime Thriller', 'Drama']",1950,0
5022040,Pyaar Mein Kabhi Kabhi,1999,['India'],"['Musical', 'Romantic drama', 'Bollywood', 'World cinema', 'Romance Film', 'Drama']",1990,9
210219,Irma la Douce,1963,['United States of America'],"['Comedy', 'Comedy of manners', 'Romance Film', 'Romantic comedy', 'Sex comedy']",1960,3
2059713,Cyber Seduction: His Secret Life,2005,['United States of America'],['Drama'],2000,5
5273926,Aetbaar,2004,['India'],"['Musical', 'Mystery', 'Romantic drama', 'Thriller', 'Bollywood', 'World cinema', 'Romance Film', 'Drama', 'Suspense', 'Horror']",2000,4
2304640,Defending Your Life,1991,['United States of America'],"['Satire', 'Comedy', 'Romance Film', 'Heaven-Can-Wait Fantasies', 'Romantic comedy', 'Religious Film', 'Fantasy Comedy', 'Fantasy']",1990,1
4192073,RuPaul Is: Starbooty!,1987,['United States of America'],[],1980,7
1475745,Marion Bridge,2002,['Canada'],"['Drama', 'Family Drama', 'Indie', 'Melodrama']",2000,2
13007900,The Passion of Ayn Rand,1999,['United States of America'],"['Biography', 'Romantic drama', 'Biographical film', 'Romance Film', 'Drama', 'Period piece', 'Biopic [feature]', 'Television movie']",1990,9
31419116,Oru Maymasa Pulariyil,1987,[],['Drama'],1980,7
6482317,Kárhozat,1987,['Hungary'],"['Black-and-white', 'Romantic drama', 'World cinema', 'Romance Film', 'Drama']",1980,7
11392581,Tuesday,2008,['United Kingdom'],['Heist'],2000,8
28963392,The Lone Ranger,1956,['United States of America'],['Western'],1950,6
10640368,Tum Haseen Main Jawaan,1970,['India'],['World cinema'],1970,0
168593,"Good Morning, Vietnam",1987,['United States of America'],"['Comedy-drama', 'War film', 'Comedy']",1980,7
23978412,Edge of Madness,2002,"['Canada', 'United States of America']","['Period piece', 'Suspense', 'Mystery', 'Thriller', 'Crime Thriller', 'Drama']",2000,2
453236,Fast Times at Ridgemont High,1982,['United States of America'],"['Screwball comedy', 'Stoner film', 'Comedy', 'Teen', 'Romance Film', 'Drama', 'Ensemble Film', 'Coming of age', 'Cult', 'Sex comedy']",1980,2
4334606,The Bride,1985,"['United Kingdom', 'United States of America']","['Mystery', 'Monster', 'Romantic drama', 'Romance Film', 'Costume drama', 'Drama', 'Period piece', 'Horror', 'Fantasy']",1980,5
471370,An American Werewolf in London,1981,"['United Kingdom', 'United States of America']","['Creature Film', 'Horror Comedy', 'Horror', 'Fantasy']",1980,1
22507490,Coco avant Chanel,2009,"['France', 'Belgium']","['Romantic drama', 'Biographical film', 'World cinema', 'Romance Film', 'Drama']",2000,9
33159887,Prem Pratigyaa,1989,['India'],"['Romance Film', 'Drama', 'Bollywood']",1980,9
6840273,Spooked,2004,['New Zealand'],"['Crime Fiction', 'Mystery', 'Thriller', 'Drama']",2000,4
12793886,Vera,1987,['Brazil'],['Drama'],1980,7
14543552,Female Convict Scorpion: Jailhouse 41,1972,['Japan'],"['Action', 'Crime Fiction', 'Action/Adventure', 'Thriller', 'World cinema', 'Drama', 'Women in prison films', 'Japanese Movies', 'Erotica']",1970,2
3644720,Diary of a Chambermaid,1964,"['France', 'Italy']","['Crime Fiction', 'Art film', 'Satire', 'World cinema', 'Political drama', 'Drama']",1960,4
10725408,Biraj Bahu,1955,['India'],"['Black-and-white', 'Bollywood']",1950,5
2592990,Rollover,1981,['United States of America'],"['Thriller', 'Crime Thriller', 'Political drama', 'Drama', 'Political thriller']",1980,1
6822795,Sluzhebnyi Roman,1977,['Soviet Union'],"['Romance Film', 'Comedy', 'Drama']",1970,7
11800174,The Velvet Touch,1948,['United States of America'],"['Psychological thriller', 'Black-and-white', 'Crime Fiction', 'Thriller', 'Drama']",1940,8
8039067,Case Closed: The Last Wizard of the Century,1999,['Japan'],"['Action', 'Animation', 'Japanese Movies', 'Thriller', 'World cinema', 'Anime']",1990,9
3653578,Return of the Fly,1959,['United States of America'],"['Monster movie', 'Science Fiction', 'Horror', 'Cult']",1950,9
21404478,One Week,2008,['Canada'],"['Romantic drama', 'Indie', 'Adventure', 'Romance Film', 'Drama']",2000,8
3303352,Crimewave,1985,['United States of America'],"['Crime Fiction', 'Screwball comedy', 'Parody', 'Comedy', 'Crime Comedy', 'Slapstick']",1980,5
21254702,I Can Do Bad All by Myself,2009,['United States of America'],"['Musical', 'Romantic drama', 'Comedy', 'Romance Film', 'Romantic comedy', 'Comedy-drama', 'Drama']",2000,9
2723966,I Step through Moscow,1963,['Soviet Union'],['Romantic comedy'],1960,3
14677635,Ziggy's Gift,1982,['United States of America'],"['Animation', 'Short Film', 'Comedy', 'Holiday Film', 'Family Film']",1980,2
22454630,Waveriders,2009,"['Ireland', 'United Kingdom']","['Extreme Sports', 'Sports', 'Documentary']",2000,9
5466192,Leprechaun 4: In Space,1997,['United States of America'],"['Creature Film', 'Monster movie', 'Horror', 'Adventure', 'Supernatural', 'Science Fiction', 'Cult']",1990,7
18497134,Dev D,2008,['India'],"['Musical', 'Romantic drama', 'Comedy', 'Bollywood', 'World cinema', 'Romance Film', 'Drama']",2000,8
12174495,Fore Play,1975,['United States of America'],"['Indie', 'Comedy', 'Romance Film', 'Romantic comedy']",1970,5
10035818,Hell and High Water,1954,['United States of America'],"['Action', 'Spy', 'Action/Adventure', 'Thriller']",1950,4
12773962,Midnight Ramble,1994,['United States of America'],['Documentary'],1990,4
1714944,Great White,1982,['Italy'],"['Horror', 'Natural horror films']",1980,2
29971069,Miss Nobody,1926,[],['Silent film'],1920,6
6809379,Uyirile Kalanthathu,2000,['India'],['Drama'],2000,0
5088914,Our Wife,1941,['United States of America'],"['Short Film', 'Black-and-white', 'Comedy']",1940,1
2513630,Cyborg,1989,['United States of America'],"['Action', 'Martial Arts Film', 'Science Fiction']",1980,9
10636802,Baseraa,1981,['India'],['Bollywood'],1980,1
20363375,Fujian Blue,2007,['China'],['Drama'],2000,7
8817675,Mee-Shee: The Water Giant,2005,['United Kingdom'],"[""Children's Fantasy"", 'Animal Picture', ""Children's/Family"", 'Adventure', 'Family Film']",2000,5
3737168,Carry On Cowboy,1965,['United Kingdom'],"['Comedy Western', 'Parody', 'Western', 'Comedy', 'Slapstick']",1960,5
11738477,The Munsters' Revenge,1981,['United States of America'],"['Comedy', 'Horror Comedy']",1980,1
34180943,Mahakshathriya,1994,[],['Drama'],1990,4
89818,The 13th Warrior,1999,['United States of America'],"['Action', 'Fantasy Adventure', 'Adventure', 'Fantasy']",1990,9
21161719,Boogeyman 3,2009,['United States of America'],"['Slasher', 'Thriller', 'Horror', 'Teen', 'Supernatural']",2000,9
29382004,Sabse Bada Beiman,2000,['India'],['Action'],2000,0
16694193,Alfie Darling,1976,['United Kingdom'],"['Comedy', 'Romance Film', 'Romantic comedy', 'Comedy-drama', 'Drama', 'Sex comedy']",1970,6
5394632,Chithiram Pesuthadi,2006,['India'],"['Romantic drama', 'Tamil cinema']",2000,6
21318106,Shirley Valentine,1989,"['United Kingdom', 'United States of America']","['Comedy', 'Romance Film', 'Romantic comedy', 'Comedy-drama', 'Drama']",1980,9
20489956,Our Lady of the Assassins,2000,"['Spain', 'Colombia', 'France', 'United States of America']","['LGBT', 'Crime Fiction', 'Romantic drama', 'World cinema', 'Romance Film', 'Drama', 'Gay Themed', 'Gay', 'Gay Interest']",2000,0
20398475,Dream,2008,['South Korea'],['World cinema'],2000,8
20727580,Tauba Tauba,2004,['India'],"['Thriller', 'World cinema']",2000,4
23687966,Wife for a Night,1952,['Italy'],"['Comedy', 'World cinema']",1950,2
5136480,Flight of the Intruder,1991,['United States of America'],"['Action', 'Film adaptation', 'Action/Adventure', 'Thriller', 'Adventure', 'Drama', 'Period piece', 'War film']",1990,1
3870912,Funny Games,1997,['Austria'],"['Psychological thriller', 'Crime Fiction', 'Mystery', 'Indie', 'Thriller', 'World cinema', 'Crime Thriller', 'Drama', 'Horror']",1990,7
4182999,Ijaazat,1988,['India'],"['Musical', 'Bollywood', 'Romance Film', 'Drama']",1980,8
3844016,Cracked Eggs and Noodles,2005,['South Korea'],"['Drama', 'Comedy']",2000,5
34406218,The Fruit Machine,1988,['United Kingdom'],"['Gay Themed', 'LGBT', 'Gay', 'Crime Fiction', 'Gay Interest', 'Thriller', 'Crime Thriller']",1980,8
1702604,The Mirror Crack'd,1980,['United Kingdom'],"['Detective fiction', 'Crime Fiction', 'Mystery', 'Thriller', 'Whodunit', 'Crime Thriller', 'Drama', 'Suspense', 'Detective', 'Ensemble Film']",1980,0
1367498,Tucker: The Man and His Dream,1988,['United States of America'],"['Drama', 'Indie', 'Biography', 'Biographical film', 'Biopic [feature]', 'Americana', 'Courtroom Drama']",1980,8
8481,Dressed to Kill,1980,['United States of America'],"['Psychological thriller', 'Mystery', 'Indie', 'Thriller', 'Crime Thriller', 'Suspense', 'Slasher', 'Horror', 'Erotic thriller', 'Erotica']",1980,0
10092382,Sigaw,2004,['Philippines'],"['Filipino Movies', 'World cinema', 'Horror']",2000,4
25326327,Dinner with a Vampire,1988,['Italy'],"['World cinema', 'Horror']",1980,8
26347221,Ohm Krüger,1941,['Germany'],['War film'],1940,1
23688242,Ravan Raaj: A True Story,1995,['India'],"['Action', 'Crime Fiction']",1990,5
15120929,Crime of Passion,1957,['United States of America'],"['Black-and-white', 'Crime Fiction', 'Thriller', 'Film noir', 'Drama']",1950,7
2280366,The Legend of the 7 Golden Vampires,1974,"['United Kingdom', 'Hong Kong']","['Chinese Movies', 'Action/Adventure', 'Horror', 'Martial Arts Film', 'Cult']",1970,4
14794318,The Evil Stairs,1964,['South Korea'],"['Drama', 'Mystery', 'Thriller']",1960,4
7874568,Desserts,1998,['United Kingdom'],"['Short Film', 'Drama']",1990,8
35110553,Peeping Penguins,1937,['United States of America'],"['Musical', 'Animation', 'Short Film', 'Comedy film', 'Family Film']",1930,7
20581172,Ek Paheli,1971,['India'],"['Drama', 'Thriller', 'Horror']",1970,1
9039026,Un étrange voyage,1981,['France'],"['Road movie', 'Family Drama', 'Drama']",1980,1
4055526,Basket Case 2,1990,['United States of America'],"['Monster movie', 'Slasher', 'Horror Comedy', 'Horror', 'B-movie', 'Cult']",1990,0
12567800,Grahan,2001,['India'],['Drama'],2000,1
11575197,Maker of Men,1931,['United States of America'],"['Black-and-white', 'Melodrama', 'Drama']",1930,1
4215177,Vileness Fats,1984,['United States of America'],['Fantasy'],1980,4
590462,Once Upon a Time in Mexico,2003,['United States of America'],"['Action', 'Action Thrillers', 'Action/Adventure', 'Thriller', 'Crime Thriller', 'Adventure', 'Drama', 'Western']",2000,3
19097189,The Last Time,2006,['United States of America'],"['Romantic drama', 'Comedy', 'Romance Film', 'Drama']",2000,6
6983705,Tilt,1979,['United States of America'],"['Buddy film', 'Comedy', 'Road movie', 'Drama']",1970,9
10940395,Unknown World,1951,['United States of America'],"['Science Fiction', 'Disaster', 'Adventure']",1950,1
2248157,Havoc,2005,"['Germany', 'United States of America']","['Crime Fiction', 'Indie', 'Teen', 'Crime Thriller', 'Drama']",2000,5
25665099,The French Kissers,2009,['France'],"['Coming of age', 'Comedy', 'Teen', 'World cinema', 'Romantic comedy', 'Drama']",2000,9
6193625,Mondo Topless,1966,['United States of America'],"['Mondo film', 'Mockumentary', 'Adult', 'Culture & Society']",1960,6
30575,Twelve Monkeys,1995,['United States of America'],"['Psychological thriller', 'Mystery', 'Thriller', 'Apocalyptic and post-apocalyptic fiction', 'Drama', 'Airplanes and airports', 'Time travel', 'Dystopia', 'Future noir', 'Doomsday film', 'Science Fiction']",1990,5
9169526,Las Boludas,1993,['Argentina'],['Comedy'],1990,3
9459581,Trouble Along the Way,1953,['United States of America'],"['Black-and-white', 'Comedy', 'Melodrama', 'Sports', 'Drama']",1950,3
2763171,11:14,2003,"['Canada', 'United States of America']","['Crime Fiction', 'Indie', 'Comedy', 'Thriller', 'Black comedy', 'Crime Thriller', 'Drama', 'Ensemble Film', 'Crime Comedy', 'Comedy-drama']",2000,3
6071715,Shadowboxer,2006,['United States of America'],"['Action', 'Drama', 'Action/Adventure', 'Thriller', 'Crime Thriller']",2000,6
23542126,Sukeban Deka the Movie 2: Counter-Attack from the Kazama Sisters,1988,['Japan'],"['Action', 'Japanese Movies']",1980,8
9139466,Monster from Green Hell,1957,['United States of America'],"['Creature Film', 'Monster', 'Horror', 'Sci-Fi Horror', 'Science Fiction', 'Natural horror films']",1950,7
7515161,Vanishing Son,1994,['United States of America'],"['Crime Drama', 'Crime Fiction', 'Martial Arts Film']",1990,4
23866355,Mella Thirandhathu Kadhavu,1986,['India'],"['Musical', 'Romantic drama', 'Bollywood', 'World cinema', 'Romance Film', 'Drama']",1980,6
29754100,Blind,2007,['Netherlands'],"['Romance Film', 'Drama']",2000,7
8320074,Take Down,1979,['United States of America'],['Drama'],1970,9
19233817,Younger and Younger,1993,"['Germany', 'United States of America']","['Comedy', 'Black comedy', 'Drama', 'Fantasy']",1990,3
22091841,Navy Blue and Gold,1937,['United States of America'],['Drama'],1930,7
1882947,Crazy/Beautiful,2001,['United States of America'],"['Romantic drama', 'Teen', 'Romance Film', 'Drama']",2000,1
16885680,Escape from Afghanistan,1994,['Russia'],"['Action', 'War film', 'Thriller']",1990,4
1700067,Secrets,1933,['United States of America'],"['Western', 'Black-and-white']",1930,3
4744678,Raising Victor Vargas,2002,"['France', 'United States of America']","['Drama', 'Coming of age', 'Indie', 'Romantic drama', 'Romance Film', 'Comedy-drama']",2000,2
181333,Mrs. Parkington,1944,['United States of America'],"['Black-and-white', 'Family Drama', 'Marriage Drama', 'Romance Film', 'Drama']",1940,4
11577317,This Modern Age,1931,['United States of America'],"['Black-and-white', 'Romance Film', 'Melodrama', 'Drama']",1930,1
32861946,Appointment with Fear,1985,[],['Horror'],1980,5
32944879,The Age of Consent,1932,['United States of America'],"['Romance Film', 'Drama']",1930,2
13920598,May 18,2007,['South Korea'],"['World cinema', 'Political drama', 'Drama', 'Political thriller']",2000,7
22372060,Popi,1969,['United States of America'],"['Satire', 'Comedy film', 'Domestic Comedy', 'Comedy-drama', 'Drama']",1960,9
1066956,The Skulls,2000,['United States of America'],"['Psychological thriller', 'Suspense', 'Thriller', 'Crime Thriller']",2000,0
20904527,Bin Phere Hum Tere,1979,['India'],"['Drama', 'World cinema']",1970,9
1640215,City on Fire,1987,['Hong Kong'],"['Crime Fiction', 'Action/Adventure', 'Thriller', 'World cinema', 'Chinese Movies', 'Martial Arts Film']",1980,7
8551364,The Search for John Gissing,2001,['United Kingdom'],"['Indie', 'Parody', 'Satire', 'Comedy', 'Black comedy', 'Comedy-drama', 'Workplace Comedy']",2000,1
29322223,The Veteran,2006,['United States of America'],"['Psychological thriller', 'Action', 'Action/Adventure', 'Thriller', 'War film', 'Drama']",2000,6
27769335,Widow * Second Wife: Real Sucking Engulfing a Rare Utensil,2004,['Japan'],['Japanese Movies'],2000,4
8267507,Hawk of the Wilderness,1938,['United States of America'],"['Action', 'Black-and-white', 'Western', 'Adventure']",1930,8
6052674,The Hairy Tooth Fairy,2006,"['Argentina', 'Spain']","['Computer Animation', 'Animation', 'Comedy', 'World cinema', 'Fantasy']",2000,6
4112362,Four of the Apocalypse,1975,['Italy'],"['Action/Adventure', 'Western', 'World cinema', 'Spaghetti Western']",1970,5
26964838,Ramu,1968,['India'],['Drama'],1960,8
379851,The Dish,2000,"['New Zealand', 'Australia']","['Indie', 'Comedy', 'Comedy of manners', 'World cinema']",2000,0
25612693,Decalogue VI,1988,['Poland'],['Drama'],1980,8
10045430,The Bunker,2001,['United Kingdom'],"['Action', 'Mystery', 'Horror', 'War film']",2000,1
894709,Shanghai Triad,1995,"['China', 'France']","['Crime Fiction', 'Coming of age', 'Gangster Film', 'World cinema', 'Crime Drama', 'Chinese Movies', 'Drama']",1990,5
25875813,Tora-san's Dream of Spring,1979,['Japan'],['Japanese Movies'],1970,9
14436640,Three Strangers,1946,['United States of America'],"['Black-and-white', 'Crime Fiction', 'Film noir', 'Crime Drama', 'Drama']",1940,6
12438366,Mehndi Waley Hath,2000,['Pakistan'],"['Romance Film', 'Drama']",2000,0
13710243,Left Right,2008,['China'],"['Family Drama', 'World cinema', 'Melodrama', 'Chinese Movies', 'Drama']",2000,8
13763482,Vizontele Tuuba,2004,['Turkey'],['Drama'],2000,4
482383,The King of Comedy,1983,['United States of America'],"['Comedy', 'Documentary', 'Black comedy', 'Drama']",1980,3
5638049,Braddock: Missing in Action III,1988,['United States of America'],"['Action', 'Adventure']",1980,8
8563773,Twenty-four Eyes,1954,['Japan'],"['Art film', 'Japanese Movies', 'World cinema', 'Drama']",1950,4
10468824,Jaane Bhi Do Yaaron,2007,['India'],['Comedy'],2000,7
92703,The Sundowners,1960,"['United Kingdom', 'United States of America']","['Action/Adventure', 'Western', 'World cinema', 'Drama']",1960,0
2471946,Nocturne,1946,['United States of America'],"['Film noir', 'Black-and-white', 'Mystery']",1940,6
6180798,The Silencers,1967,['United States of America'],"['Action', 'Spy', 'Parody', 'Action/Adventure', 'Comedy', 'Thriller']",1960,7
1401912,The Cruel Sea,1953,['United Kingdom'],"['War film', 'Drama']",1950,3
8788984,Benito,1993,"['Spain', 'Germany', 'Czech Republic', 'Italy']","['Period piece', 'Biography', 'Biopic [feature]', 'Television movie', 'Political drama', 'Drama']",1990,3
936429,Miracle Mile,1988,['United States of America'],"['Action/Adventure', 'Thriller', 'Romance Film', 'Doomsday film', 'Disaster', 'Science Fiction', 'Drama']",1980,8
26599792,Kappal Muthalaali,2009,['India'],['Romantic comedy'],2000,9
1600036,Scooby-Doo in Arabian Nights,1994,['United States of America'],"['Family-Oriented Adventure', ""Children's/Family"", 'Fantasy']",1990,4
13133779,Goliath II,1960,['United States of America'],"['Short Film', 'Animation']",1960,0
19713760,Joy Scouts,1939,['United States of America'],"['Black-and-white', 'Short Film', 'Comedy', 'Family Film']",1930,9
2073543,War of the Gargantuas,1966,['Japan'],"['Japanese Movies', 'World cinema', 'Horror']",1960,6
11381825,Daybreakers,2009,"['United States of America', 'Australia']","['Action', 'Thriller', 'World cinema', 'Disaster', 'Drama', 'Creature Film', 'Dystopia', 'Horror', 'Science Fiction']",2000,9
2714347,The Chosen One: Legend of the Raven,1998,['United States of America'],"['Action', 'Action/Adventure', 'Thriller']",1990,8
12355683,"Sabrina, Down Under",1999,['United States of America'],"['Comedy', 'Family Film', 'Fantasy']",1990,9
7022631,Promises! Promises!,1963,['United States of America'],"['Sexploitation', 'Comedy', 'Romance Film', 'Romantic comedy', 'Sex comedy']",1960,3
3607133,Feelin' So Good,2000,['United States of America'],"['Music', 'Documentary']",2000,0
20581106,Zigzag,1970,['United States of America'],"['Thriller', 'Drama']",1970,0
26861455,Bawandar,2000,['India'],"['Drama', 'World cinema']",2000,0
26340076,Gold,1932,['United States of America'],['Western'],1930,2
28470515,"Don Juan, or If Don Juan Were a Woman",1973,"['France', 'Italy']","['Romantic drama', 'World cinema', 'Romance Film', 'Drama']",1970,3
28286160,Vinyan,2008,"['Belgium', 'Australia', 'United Kingdom', 'France']","['Psychological thriller', 'Thriller', 'Jungle Film', 'World cinema']",2000,8
2291894,The Amazing Mr. X,1948,['United States of America'],"['Psychological thriller', 'Black-and-white', 'Indie', 'Thriller', 'Film noir', 'Supernatural']",1940,8
1397198,Butterflies Are Free,1972,['United States of America'],"['Romance Film', 'Romantic comedy', 'Comedy']",1970,2
8907936,Amigomío,1993,"['Argentina', 'Germany']",['Drama'],1990,3
25861920,Two Came Back,1997,['United States of America'],"['Drama', 'Adventure', 'Thriller']",1990,7
16168133,Jananam,2004,['India'],['Drama'],2000,4
6302496,"Finders Keepers, Lovers Weepers!",1968,['United States of America'],"['Thriller', 'Crime Fiction']",1960,8
8970301,The Trial of Tony Blair,2007,['United Kingdom'],"['Drama', 'Political satire']",2000,7
9068424,The Legend of Nigger Charley,1972,['United States of America'],"['Action', 'Blaxploitation', 'Drama', 'Hybrid Western', 'Western']",1970,2
12286771,The Walker,2007,"['United Kingdom', 'United States of America']","['Crime Fiction', 'Mystery', 'Thriller', 'Crime Thriller', 'Political drama', 'Drama']",2000,7
28833073,She'll Follow You Anywhere,1971,['United Kingdom'],"['Romantic comedy', 'Comedy']",1970,1
5581958,Hideous Kinky,1998,"['United Kingdom', 'Morocco', 'France']","['Period piece', 'Family Drama', 'Indie', 'Adventure', 'Drama']",1990,8
9679150,Vishnu,1995,['India'],['World cinema'],1990,5
2685725,Sinbad and the Eye of the Tiger,1977,['United Kingdom'],"['Action', 'Fantasy Adventure', 'Action/Adventure', 'Costume drama', 'Adventure', 'Swashbuckler films', 'Drama', 'Mythological Fantasy', ""Children's Fantasy"", 'Stop motion', 'Science Fiction', 'Family Film', 'Fantasy']",1970,7
5326370,Stir of Echoes: The Homecoming,2007,"['Canada', 'United States of America']","['Thriller', 'Horror', 'Television movie', 'Supernatural']",2000,7
10521522,Aki na Ukwa,2003,['Nigeria'],['Comedy'],2000,3
12496727,Flood,2007,"['United Kingdom', 'South Africa', 'Canada']","['Action', 'Drama', 'Action/Adventure', 'Thriller', 'Disaster']",2000,7
1343342,Ben-Hur,1959,['United States of America'],"['Action', 'Drama', 'History', 'Romance Film', 'Adventure']",1950,9
33508772,Inquilaab,1984,['India'],"['Romantic drama', 'World cinema', 'Romance Film', 'Drama']",1980,4
24126969,Peddamanushulu,1954,['India'],['Drama'],1950,4
725103,Sleepers,1996,['United States of America'],"['Period piece', 'Crime Fiction', 'Coming of age', 'Thriller', 'Drama', 'Courtroom Drama']",1990,6
113463,Children of a Lesser God,1986,['United States of America'],"['Film adaptation', 'Romantic drama', 'Romance Film', 'Drama']",1980,6
6180967,Slayers The Motion Picture,1995,"['Japan', 'United States of America']","['Action', 'Animation', 'Comedy', 'World cinema', 'Adventure', 'Japanese Movies', 'Anime', 'Fantasy']",1990,5
444919,The Redhead from Wyoming,1953,['United States of America'],"['Action', 'Action/Adventure', 'Western', 'Romance Film']",1950,3
14832115,"Shake, Rattle and Roll 9",2007,['Philippines'],"['Filipino Movies', 'Comedy', 'Horror', 'World cinema']",2000,7
23810915,Up in the Air,2009,['United States of America'],"['Film adaptation', 'Romantic drama', 'Comedy', 'Romance Film', 'Romantic comedy', 'Comedy-drama', 'Drama']",2000,9
1961644,Hanover Street,1979,['United Kingdom'],"['Romantic drama', 'Romance Film', 'War film', 'Drama']",1970,9
4343377,Cyborg 2,1993,['United States of America'],"['Action', 'Science Fiction']",1990,3
1785123,The Curse of Frankenstein,1957,['United Kingdom'],"['Creature Film', 'Monster', 'Gothic Film', 'Horror', 'B-movie', 'Costume Horror']",1950,7
5021251,Parthale Paravasam,2001,['India'],"['Musical', 'Romantic drama', 'Comedy', 'Bollywood', 'World cinema', 'Romance Film', 'Drama']",2000,1
4853407,Mudhalvan,1999,['India'],"['Thriller', 'World cinema']",1990,9
18618751,Charlie Chaplin,2002,['India'],['Comedy film'],2000,2
7603624,Godspell,1973,['United States of America'],"['Musical', 'Musical Drama', 'Christian film']",1970,3
2325674,Smithy,1946,['Australia'],['Adventure'],1940,6
28559151,The Call of the Toad,2005,"['Germany', 'Poland']","['Romance Film', 'Drama']",2000,5
15779363,Man on a Tightrope,1953,['United States of America'],['Drama'],1950,3
15424259,Outside,2004,['United States of America'],['Short Film'],2000,4
23960253,Serafino,1968,"['France', 'Italy']",['Comedy film'],1960,8
16643469,Judge Priest,1934,['United States of America'],"['Black-and-white', 'Crime Fiction', 'Comedy', 'Comedy of manners', 'Drama', 'Courtroom Drama']",1930,4
20904123,Kalabaaz,1977,['India'],"['Romantic drama', 'World cinema', 'Romance Film', 'Drama']",1970,7
5467528,Our Relations,1936,['United States of America'],"['Black-and-white', 'Short Film', 'Comedy', 'Comedy of Errors']",1930,6
1515876,Mostly Martha,2001,"['Austria', 'Switzerland', 'Germany', 'Italy']","['Family Drama', 'Romantic drama', 'Comedy', 'World cinema', 'Romance Film', 'Drama', 'Comedy film', 'Romantic comedy']",2000,1
21241505,Rockabye,1932,['United States of America'],"['Black-and-white', 'Drama']",1930,2
8402917,El Acompañamiento,1991,['Argentina'],"['Musical', 'Comedy', 'Drama']",1990,1
12619795,Alice and Martin,1998,"['France', 'Spain']",['Drama'],1990,8
23954729,It's Complicated,2009,['United States of America'],"['Romance Film', 'Romantic comedy', 'Comedy']",2000,9
72453,Signs,2002,['United States of America'],"['Suspense', 'Mystery', 'Thriller', 'Horror', 'Alien Film', 'Science Fiction', 'Drama']",2000,2
1644364,He Got Game,1998,['United States of America'],"['Sports', 'Indie', 'Drama']",1990,8
16702817,Echo,1997,['United States of America'],"['Suspense', 'Drama', 'Thriller']",1990,7
13910273,Buzzin' Around,1933,['United States of America'],"['Short Film', 'Black-and-white', 'Comedy']",1930,3
3535920,In the Good Old Summertime,1949,['United States of America'],"['Musical', 'Comedy', 'Musical comedy', 'Romance Film', 'Romantic comedy']",1940,9
16970911,Crossplot,1969,['United Kingdom'],"['Action', 'Spy', 'Action/Adventure', 'Comedy', 'Thriller', 'Glamorized Spy Film', 'Adventure', 'Political thriller']",1960,9
3256132,"Goodbye, Columbus",1969,['United States of America'],"['Romantic drama', 'Comedy', 'Romance Film', 'Romantic comedy', 'Comedy-drama', 'Drama']",1960,9
11958787,"Me, Natalie",1969,['United States of America'],"['Coming of age', 'Comedy', 'Romance Film', 'Comedy-drama', 'Drama']",1960,9
18727961,Pirates II: Stagnetti's Revenge,2008,['United States of America'],"['Fantasy Adventure', 'Action/Adventure', 'Pornographic movie', 'Swashbuckler films', 'Adventure', 'Fantasy']",2000,8
7766704,Even Cowgirls Get the Blues,1994,['United States of America'],"['Film adaptation', 'LGBT', 'Comedy', 'Romance Film', 'Drama', 'Absurdism', 'Feminist Film', 'Road movie', 'Western', 'Romantic comedy', 'Fantasy']",1990,4
12392394,Coklat Stroberi,2007,['Indonesia'],"['Drama', 'Comedy']",2000,7
13798364,The Truth About Spring,1965,"['United Kingdom', 'United States of America']","['Romance Film', 'Adventure']",1960,5
4610810,3 Ninjas: High Noon at Mega Mountain,1998,['United States of America'],"['Adventure Comedy', 'Action', 'Action/Adventure', 'Comedy', 'Family-Oriented Adventure', ""Children's/Family"", 'Martial Arts Film', 'Adventure', 'Family Film']",1990,8
6081230,Feast of July,1995,"['United Kingdom', 'United States of America']","['Period piece', 'Crime Fiction', 'Mystery', 'Romantic drama', 'Romance Film', 'Costume drama', 'Drama']",1990,5
3178133,Rat Pfink a Boo Boo,1966,['United States of America'],"['Action', 'Parody', 'Action/Adventure', 'Comedy', 'Superhero movie']",1960,6
34631031,Dead Funny,1994,['United States of America'],['Drama'],1990,4
5842075,Fear and Loathing in Las Vegas,1998,['United States of America'],"['Avant-garde', 'Comedy', 'Buddy film', 'Black comedy', 'Adventure', 'Drama', 'Absurdism', 'Experimental film', 'Road movie', 'Cult']",1990,8
23646229,Prince Violent,1961,['United States of America'],"['Animation', 'Short Film', 'Comedy']",1960,1
18676748,Late Last Night,1999,['United States of America'],"['Black comedy', 'Indie', 'Comedy']",1990,9
144640,Another Thin Man,1939,['United States of America'],"['Detective fiction', 'Black-and-white', 'Screwball comedy', 'Mystery', 'Comedy', 'Thriller', 'Crime Thriller', 'Comedy Thriller', 'Detective']",1930,9
22705277,Boy Meets Boy,2008,"['Korea', 'South Korea']","['Short Film', 'LGBT']",2000,8
8719021,Dragon Squad,2005,['Hong Kong'],"['Action', 'Thriller', 'Chinese Movies']",2000,5
3859075,Rescue Dawn,2006,"['Luxembourg', 'United States of America']","['Action', 'Escape Film', 'Biographical film', 'Docudrama', 'War film', 'Adventure', 'Drama']",2000,6
6630151,The Red Spectacles,1987,['Japan'],"['Action', 'Black-and-white', 'Indie', 'Action/Adventure', 'Thriller', 'World cinema', 'Black comedy', 'Japanese Movies', 'Anime', 'Science Fiction']",1980,7
9020753,O Pátio das Cantigas,1942,['Portugal'],['Black-and-white'],1940,2
288360,Gia,1998,['United States of America'],"['LGBT', 'Biographical film', 'Romance Film', 'Drama', 'Period piece', 'Biopic [feature]', 'Television movie', 'Erotica']",1990,8
9121945,De Taali,2008,['India'],"['Musical', 'Romantic drama', 'Bollywood', 'World cinema', 'Romance Film', 'Drama']",2000,8
30871834,Dogs in Space,1987,['Australia'],"['Drama', 'Ensemble Film']",1980,7
24687459,Patient X,2009,['Philippines'],"['Filipino Movies', 'Romantic drama', 'Horror', 'World cinema']",2000,9
6372770,Fight Back to School II,1992,['Hong Kong'],"['Action', 'Action/Adventure', 'Comedy', 'World cinema', 'Chinese Movies', 'Martial Arts Film']",1990,2
19752996,Ashok Kumar,1941,['India'],['Drama'],1940,1
15932362,Officer 444,1926,['United States of America'],"['Action', 'Silent film', 'Black-and-white']",1920,6
19752168,Needful Things,1993,['United States of America'],"['Drama', 'Thriller', 'Horror']",1990,3
77641,Random Harvest,1942,['United States of America'],"['Black-and-white', 'Romantic drama', 'Romance Film', 'Drama']",1940,2
4484593,The Last of Sheila,1973,['United States of America'],"['Psychological thriller', 'Mystery', 'Thriller', 'Black comedy', 'Crime Thriller', 'Whodunit', 'Drama']",1970,3
2956085,We Faw Down,1928,['United States of America'],"['Black-and-white', 'Indie', 'Comedy', 'Silent film', 'Slapstick']",1920,8
2162640,Highway 61,1991,['Canada'],"['Music', 'Indie', 'Comedy', 'Black comedy']",1990,1
5570745,Sgt. Bilko,1996,['United States of America'],"['Slapstick', 'Comedy', 'Family Film']",1990,6
11171190,Up the Chastity Belt,1971,['United Kingdom'],['Comedy'],1970,1
3875767,Penelope,2007,"['United Kingdom', 'United States of America']","['Romantic fantasy', 'Drama', 'Indie', 'Comedy', 'Romance Film', 'Romantic comedy', 'Fantasy']",2000,7
3949733,Dave Chappelle's Block Party,2006,['United States of America'],"['Music', 'Stand-up comedy', 'Comedy', 'Documentary', 'Concert film', 'Hip hop movies']",2000,6
13879045,Daun di Atas Bantal,1998,['Indonesia'],"['Drama', 'Childhood Drama']",1990,8
9471180,The Wedding,2004,['Poland'],"['Romantic drama', 'Comedy', 'World cinema', 'Romance Film', 'Romantic comedy', 'Drama']",2000,4
1985814,Bagdad Café,1987,"['Germany', 'United States of America', 'West Germany']","['Indie', 'Comedy', 'World cinema', 'Drama']",1980,7
1913775,Rock-A-Doodle,1992,"['United Kingdom', 'Ireland', 'United States of America']","['Music', 'Musical', 'Animation', 'Animated Musical', ""Children's/Family"", ""Children's"", ""Children's Fantasy"", 'Family Film', 'Fantasy']",1990,2
1126401,National Lampoon's Van Wilder,2002,"['Germany', 'United States of America']","['Gross out', 'Gross-out film', 'Coming of age', 'Comedy', 'Romance Film', 'Sex comedy']",2000,2
31481142,The Guard,2001,['India'],['Drama'],2000,1
12810600,Born to Be Wild,1995,"['Japan', 'United States of America']","['Japanese Movies', 'Family Drama', ""Children's"", 'Comedy', 'Adventure', 'Drama', 'Family Film']",1990,5
666026,The Philadelphia Experiment,1984,['United States of America'],"['Film adaptation', 'Indie', 'Thriller', 'Romance Film', 'Adventure', 'Drama', 'Time travel', 'Science Fiction', 'Fantasy']",1980,4
2439396,Nacho Libre,2006,['United States of America'],"['Slapstick', 'Buddy film', 'Comedy', 'Sports', 'Family Film', 'Absurdism']",2000,6
23419883,Little Robinson Crusoe,1924,['United States of America'],"['Black-and-white', 'Comedy', 'Silent film', ""Children's/Family""]",1920,4
18900548,J. W. Coop,1972,['United States of America'],"['Action/Adventure', 'Western', 'Sports', 'Drama']",1970,2
19226290,A Serious Man,2009,"['United Kingdom', 'France', 'United States of America']","['Period piece', 'Biography', 'Comedy', 'Black comedy', 'Drama']",2000,9
16888056,Sita Sings the Blues,2008,['United States of America'],"['Musical', 'Drama', 'Animation', 'Indie', 'Romantic drama', 'Romance Film', 'Computer Animation']",2000,8
1936710,Comic Book: The Movie,2004,['United States of America'],"['Action/Adventure', 'Comedy', 'Superhero movie', 'Media Satire', 'Mockumentary']",2000,4
820919,Spies Like Us,1985,['United States of America'],"['Adventure Comedy', 'Action', 'Spy', 'Parody', 'Action/Adventure', 'Comedy', 'Slapstick']",1980,5
18676584,Il padrone del vapore,1951,['Italy'],"['Comedy', 'Black-and-white']",1950,1
21565615,Odd Obsession,1959,['Japan'],"['Japanese Movies', 'Black comedy', 'Comedy-drama', 'Drama', 'Sex comedy']",1950,9
10056712,Jungle Jim,1937,['United States of America'],"['Action', 'Black-and-white', 'Adventure']",1930,7
23581277,O Seeta Katha,1974,['India'],['Drama'],1970,4
22696045,Another Way,1982,['Hungary'],"['LGBT', 'History', 'Biography', 'World cinema', 'Political drama', 'Drama']",1980,2
5512647,Yakeen,2005,['India'],"['Action/Adventure', 'Thriller', 'World cinema']",2000,5
5207995,The Emerald Forest,1985,['United Kingdom'],"['Adventure', 'Drama', 'Jungle Film']",1980,5
249406,Holiday Inn,1942,['United States of America'],"['Musical', 'Black-and-white', 'Comedy', 'Musical comedy', 'Romance Film', 'Romantic comedy', 'Christmas movie']",1940,2
1089071,SuperBabies: Baby Geniuses 2,2004,"['United Kingdom', 'Germany', 'United States of America']","[""Children's Fantasy"", 'Comedy', ""Children's/Family"", 'Adventure', 'Family Film', 'Fantasy']",2000,4
33896582,Oomai Vizhigal,1986,[],"['Action', 'Crime Fiction']",1980,6
23822373,Justice for Annie: A Moment of Truth Movie,1996,"['Canada', 'United States of America']","['Thriller', 'Drama']",1990,6
17515227,The Revenge of Tarzan,1920,['United States of America'],"['Silent film', 'Black-and-white', 'Adventure']",1920,0
6306342,Sexo con Amor,2003,['Chile'],"['LGBT', 'Art film', 'Romantic drama', 'Comedy', 'World cinema', 'Romance Film', 'Drama', 'Ensemble Film', 'Romantic comedy', 'Sex comedy']",2000,3
10701143,Dil Bhi Tera Hum Bhi Tere,1960,['India'],"['Crime Fiction', 'Drama', 'Family Film']",1960,0
3865259,Just Follow Law,2007,['Singapore'],"['Comedy', 'Drama', 'Fantasy']",2000,7
14941280,Ratatouille,2007,['United States of America'],"['Animation', 'Coming of age', 'Comedy', 'Fantasy', 'Drama', 'Family Film', 'Computer Animation']",2000,7
1727511,Tower of Terror,1997,['United States of America'],"['Parody', 'Comedy', 'Thriller', 'Horror', 'Black comedy', 'Supernatural', 'Family Film']",1990,7
10715230,"Not with My Wife, You Don't!",1966,['United States of America'],"['Romance Film', 'Romantic comedy', 'Comedy']",1960,6
4837697,Koi Tujh Sa Kahan,2005,['Pakistan'],['Drama'],2000,5
21683717,Krabat - The Sorcerer's Apprentice,1978,"['Czechoslovakia', 'West Germany', 'Czech Republic']","['Animation', 'Horror', 'Romance Film', 'Fantasy']",1970,8
302491,The Majestic,2001,"['United States of America', 'Australia']","['Period piece', 'Romance Film', 'Americana', 'Drama']",2000,1
8615612,Death and the Maiden,1994,"['United Kingdom', 'France', 'United States of America']","['Suspense', 'Film adaptation', 'Mystery', 'Political thriller', 'Thriller', 'Drama']",1990,4
26628347,The Yellow Canary,1964,['United States of America'],['Drama'],1960,4
7986861,Casper's Scare School,2006,['United States of America'],"['Animation', 'Television movie', 'Family Film', 'Computer Animation']",2000,6
32173262,Mr. Muggs Rides Again,1945,[],['Comedy film'],1940,5
904335,Clockwise,1986,['United Kingdom'],"['Screwball comedy', 'Parody', 'Comedy', 'Comedy of manners', 'Comedy of Errors']",1980,6
12476867,Spliced,2002,['Canada'],"['Slasher', 'Thriller', 'Horror', 'Teen']",2000,2
1291429,Ollie Hopnoodle's Haven of Bliss,1988,['United States of America'],"['Television movie', 'Comedy', 'Family Film']",1980,8
27380224,Yuma,1971,['United States of America'],"['Action', 'Western', 'Action/Adventure']",1970,1
5855306,American Gothic,1988,"['Canada', 'United Kingdom']","['Indie', 'Slasher', 'Horror', 'Cult']",1980,8
9618457,Lucky Miles,2007,"['New Zealand', 'Australia']","['Action/Adventure', 'Comedy', 'World cinema', 'Black comedy', 'Road movie', 'Adventure', 'Drama']",2000,7
31113422,Pin Nilavu,1983,['India'],"['Drama', 'Comedy film']",1980,3
1283046,Pop 'im Pop,1950,['United States of America'],"['Animation', 'Comedy', 'Family Film']",1950,0
1815818,Red Sorghum,1988,['China'],"['Period piece', 'Marriage Drama', 'Chinese Movies', 'War film', 'Drama']",1980,8
10791717,Anthuleni Katha,1976,['India'],"['Drama', 'Family Film']",1970,6
22985747,The Warped Ones,1960,['Japan'],"['Melodrama', 'Drama']",1960,0
1830472,White Water Summer,1987,['United States of America'],"['Action', 'Drama', 'Action/Adventure', 'Thriller', 'Adventure']",1980,7
16702881,King,2008,['India'],"['Action', 'Crime Fiction', 'Mystery', 'Comedy', 'Thriller']",2000,8
27215811,American Nightmare,1983,['Canada'],"['Crime Fiction', 'Thriller', 'Horror']",1980,3
10592815,Main Azaad Hoon,1989,['India'],"['Drama', 'World cinema']",1980,9
12883645,The Night Heaven Fell,1958,"['France', 'Italy']","['Thriller', 'World cinema', 'Crime Drama', 'Romance Film', 'Drama']",1950,8
20225956,Drowning Ghost,2004,['Sweden'],"['Slasher', 'Thriller', 'Horror']",2000,4
25008517,Le Concert,2009,"['Belgium', 'Russia', 'France', 'Romania', 'Italy']","['Music', 'Comedy', 'World cinema', 'Comedy-drama', 'Tragicomedy', 'Drama']",2000,9
30703058,Naya Kadam,1984,['India'],"['Romance Film', 'Drama', 'Family Film']",1980,4
9113663,Spellcaster,1992,['United States of America'],['Horror'],1990,2
4292601,Hollow Man 2,2006,['United States of America'],"['Action', 'Thriller', 'Horror', 'Science Fiction']",2000,6
11064746,Dominick and Eugene,1988,['United States of America'],"['Drama', 'Family Drama', 'Indie', 'Melodrama']",1980,8
677929,Half Baked,1998,['United States of America'],"['Crime Fiction', 'Stoner film', 'Comedy', 'Cult']",1990,8
5110054,Beastly Boyz,2006,"['Canada', 'United States of America']","['LGBT', 'Teen', 'Horror', 'B-movie']",2000,6
3778721,All Fall Down,1962,['United States of America'],['Drama'],1960,2
5109530,Beverly Hills Brats,1989,['United States of America'],"['Parody', 'Satire', 'Comedy', 'Teen']",1980,9
27605812,No Holds Barred,1952,['United States of America'],['Comedy'],1950,2
11236228,36 Ghante,1975,['India'],"['Musical', 'Crime Fiction', 'Action/Adventure', 'Thriller', 'Bollywood', 'World cinema', 'Crime Thriller', 'Drama']",1970,5
20260520,Rhythm on the Range,1936,['United States of America'],"['Musical', 'Black-and-white', 'Western', 'Comedy']",1930,6
1688593,Urban Legends: Final Cut,2000,['United States of America'],"['Slasher', 'Teen', 'Horror', 'Cult']",2000,0
1861566,Saving Star Wars,2004,['United States of America'],"['Indie', 'Comedy']",2000,4
12143456,Transmorphers,2007,['United States of America'],"['Indie', 'Alien Film', 'Science Fiction']",2000,7
163456,Last Tango in Paris,1972,"['France', 'Italy']","['Erotic Drama', 'Romantic drama', 'World cinema', 'Romance Film', 'Erotica', 'Drama']",1970,2
10202645,The Reivers,1969,['United States of America'],"['Action', 'Comedy', 'Adventure', 'Drama']",1960,9
23951232,The Consequence,1977,"['Germany', 'West Germany']","['LGBT', 'Drama', 'World cinema']",1970,7
3644661,The Scarlet Empress,1934,['United States of America'],"['Black-and-white', 'Biography', 'Romantic drama', 'Romance Film', 'Pre-Code', 'Drama', 'Period piece', 'Biopic [feature]', 'Historical fiction']",1930,4
1654789,Assassin of Youth,1937,['United States of America'],"['Black-and-white', 'Parody', 'Comedy', 'Social problem film', 'Addiction Drama', 'Drama']",1930,7
5319616,Dorf on the Diamond,1996,['United States of America'],"['Short Film', 'Comedy']",1990,6
8379881,A Smoky Mountain Christmas,1986,['United States of America'],['Fantasy'],1980,6
2499926,Futureworld,1976,['United States of America'],"['Action', 'Science Fiction', 'Thriller']",1970,6
12898551,The Further Adventures of the Wilderness Family,1978,['United States of America'],"['Drama', ""Children's"", 'Family Film']",1970,8
5454949,Blue Collar Comedy Tour: One For the Road,2006,"['Canada', 'United States of America']","['Stand-up comedy', 'Comedy', 'Television movie', 'Concert film']",2000,6
10046824,The Flower and the Angry Waves,1964,['Japan'],"['Action', 'Drama', 'Japanese Movies', 'Adventure']",1960,4
2084045,Crooklyn,1994,['United States of America'],"['Indie', 'Comedy', 'Childhood Drama', 'Biographical film', 'Americana', 'Drama', 'Period piece', 'Coming of age', 'Comedy-drama', 'Ensemble Film']",1990,4
13525782,Final Exam,1981,['United States of America'],"['Slasher', 'Teen', 'Horror']",1980,1
3406838,The Thief of Bagdad,1940,"['United Kingdom', 'England', 'United States of America']","['Action', 'Action/Adventure', 'Costume drama', 'Adventure', 'Drama', 'Family Film', 'Fantasy']",1940,0
15844263,Codex Atanicus,2007,['Spain'],"['Surrealism', 'Indie', 'Horror', 'Science Fiction', 'Fantasy']",2000,7
10230968,Shola Aur Shabnam,1992,['India'],['Drama'],1990,2
3316775,My Brother Nikhil,2005,['India'],"['LGBT', 'World cinema']",2000,5
614828,Divine Intervention,2002,"['Morocco', 'France', 'Germany', 'Palestinian territories']","['Romantic drama', 'Comedy', 'World cinema', 'Black comedy', 'Romance Film', 'Drama']",2000,2
23472193,Skullduggery,1983,['Canada'],"['Horror', 'B-movie']",1980,3
26619038,Point Blank,1998,['United States of America'],"['Action', 'Drama', 'Crime Fiction', 'Action/Adventure', 'Thriller']",1990,8
915315,Rugrats Go Wild,2003,['United States of America'],"['Drama', 'Animation']",2000,3
13097473,Happy Days,2007,['India'],"['Musical', 'Comedy', 'Bollywood', 'World cinema']",2000,7
80488,Spellbound,1945,['United States of America'],"['Psychological thriller', 'Film adaptation', 'Black-and-white', 'Mystery', 'Thriller', 'Film noir', 'Romance Film', 'Drama', 'Suspense', 'Therimin music']",1940,5
9669953,Everything Happens to Me,1980,['Italy'],['Comedy'],1980,0
221748,Twentieth Century,1934,['United States of America'],"['Screwball comedy', 'Comedy', 'Romance Film', 'Romantic comedy']",1930,4
497081,La Haine,1995,['France'],"['Black-and-white', 'Drama', 'World cinema']",1990,5
28210328,Forbidden,1949,['United Kingdom'],['Thriller'],1940,9
23257674,Flirting with Forty,2008,['United States of America'],"['Comedy', 'Romance Film', 'Romantic comedy', 'Television movie']",2000,8
21757632,Patrick,1978,"['New Zealand', 'Australia']","['Suspense', 'Thriller', 'Horror', 'Science Fiction']",1970,8
25700722,I Am the Cheese,1983,['United States of America'],"['Psychological thriller', 'Film adaptation', 'Drama', 'Fantasy']",1980,3
33355085,Soaappu Seeppu Kannadi,1968,['India'],"['Family Film', 'Drama', 'Comedy film']",1960,8
21037109,Thedi Vandha Lakshmi,1973,[],['Action'],1970,3
11074028,Johnny Stecchino,1991,['Italy'],"['Gangster Film', 'Comedy', 'Crime Comedy', 'Comedy of Errors']",1990,1
5959715,Girl with a Pearl Earring,2003,"['Luxembourg', 'United Kingdom']","['Film adaptation', 'Biography', 'Romantic drama', 'Romance Film', 'Costume drama', 'Drama', 'Period piece', 'Biopic [feature]']",2000,3
13660122,A Love,2007,['South Korea'],"['Romantic drama', 'Drama']",2000,7
32644845,"Good Morning, President",2009,['South Korea'],"['Comedy', 'Drama', 'World cinema']",2000,9
20326141,K-9000,1991,['United States of America'],"['Crime Fiction', 'Action/Adventure', 'Television movie', 'Science Fiction']",1990,1
11919670,Indiralohathil Na Azhagappan,2008,['India'],['Comedy'],2000,8
25226299,Deadline,2009,"['Malaysia', 'United States of America']","['Psychological thriller', 'Drama', 'Indie', 'Thriller', 'Horror', 'Supernatural']",2000,9
12307993,Twitches Too!,2007,['United States of America'],"['Comedy', 'Teen', 'Television movie', 'Family Film']",2000,7
31156797,Swapnam Kondu Thulabharam,2003,['India'],"['Drama', 'Comedy film']",2000,3
142443,Shine,1996,"['New Zealand', 'Australia', 'United States of America']","['Music', 'Musical', 'Biography', 'Biographical film', 'World cinema', 'Romance Film', 'Drama']",1990,6
22600179,Midsummer,2003,"['Sweden', 'Denmark']","['World cinema', 'Horror']",2000,3
8368963,Eating Out 2: Sloppy Seconds,2006,['United States of America'],"['LGBT', 'Indie', 'Comedy', 'Romance Film', 'Gay Themed', 'Gay', 'Gay Interest', 'Romantic comedy', 'Sex comedy']",2000,6
618628,Trog,1970,['United Kingdom'],"['Creature Film', 'Monster movie', 'Horror', 'Cult']",1970,0
469019,Thunderbirds,2004,"['United Kingdom', 'France', 'United States of America']","['Science Fiction', 'Adventure', 'Family Film']",2000,4
9635156,Paisà,1946,['Italy'],"['Black-and-white', 'World cinema', 'War film', 'Drama']",1940,6
16498630,Blue Valley Songbird,1999,['United States of America'],"['Musical', 'Musical Drama', 'Comedy', 'Drama']",1990,9
29077218,Kuberan,2002,[],"['Drama', 'Comedy film']",2000,2
26588184,Karimpinpoovinakkare,1983,['India'],"['Action', 'Crime Fiction', 'Drama']",1980,3
14143521,Holt of the Secret Service,1941,['United States of America'],"['Action', 'Black-and-white', 'Action Thrillers', 'Adventure']",1940,1
12602650,Arranged,2007,['United States of America'],"['Indie', 'Drama', 'Slice of life story']",2000,7
31741575,Vishwanatha Nayakudu,1987,['India'],"['Action', 'Drama', 'Historical drama']",1980,7
16350869,Soccer Mom,2008,['United States of America'],"['Comedy', 'Teen', 'Sports', 'Family Film']",2000,8
31892161,The Blessed Ones,1986,[],['Drama'],1980,6
24290521,The Lost & Found Family,2009,['United States of America'],"['Family Drama', 'Drama', 'Family Film']",2000,9
864183,Indecent Proposal,1993,['United States of America'],"['Romantic drama', 'Marriage Drama', 'Romance Film', 'Erotica', 'Drama']",1990,3
4168921,Toto le Héros,1991,"['France', 'Germany', 'Belgium']",['Drama'],1990,1
24583492,After Midnight,1927,[],['Silent film'],1920,7
225573,Bamboozled,2000,['United States of America'],"['Music', 'Indie', 'Satire', 'Comedy', 'Media Satire', 'Black comedy', 'Drama', 'Comedy-drama']",2000,0
4536823,The Mindscape of Alan Moore,2003,['United Kingdom'],['Documentary'],2000,3
25437767,Allá en el Rancho Grande,1936,['Mexico'],"['Musical', 'Comedy', 'World cinema']",1930,6
7504175,Little Nobody,1936,['United States of America'],"['Short Film', 'Animation']",1930,6
28365633,Always Remember I Love You,1990,['United States of America'],['Drama'],1990,0
10057067,A Prize of Gold,1955,"['United Kingdom', 'United States of America']","['Crime Fiction', 'Caper story', 'Adventure', 'Drama']",1950,5
192469,The Parallax View,1974,['United States of America'],"['Psychological thriller', 'Thriller', 'Drama', 'Suspense', 'Dystopia', 'New Hollywood', 'Political drama', 'Political thriller']",1970,4
15256842,Rakshak,1996,['India'],['Action'],1990,6
14039143,Madame X,1929,['United States of America'],"['Black-and-white', 'Drama']",1920,9
14281617,Beyond the Years,2007,['South Korea'],"['Art film', 'Drama', 'World cinema']",2000,7
23367787,The Broken Melody,1938,['Australia'],['Drama'],1930,8
24979450,Hell Below Zero,1954,['United Kingdom'],"['Action', 'Drama', 'Adventure']",1950,4
19286405,Panakkara Kudumbam,1964,['India'],['Drama'],1960,4
12715828,Janasheen,2003,['India'],"['Musical', 'Romantic drama', 'Action/Adventure', 'Bollywood', 'World cinema', 'Romance Film', 'Drama']",2000,3
24587933,Wild Orchids,1929,[],"['Silent film', 'Marriage Drama', 'Drama']",1920,9
1789600,Seven Hills of Rome,1958,"['Italy', 'United States of America']",['Musical'],1950,8
9150668,McQ,1974,['United States of America'],"['Action', 'Crime Fiction', 'Action/Adventure']",1970,4
4228598,The Devil Thumbs a Ride,1947,['United States of America'],"['Film noir', 'Crime Fiction', 'Crime Thriller']",1940,7
32388899,The Sergeant,1968,['United States of America'],['Drama'],1960,8
3979518,The Immortal Story,1968,['France'],"['Romantic drama', 'Drama']",1960,8
1553486,The Journey of Natty Gann,1985,['United States of America'],"['Coming of age', ""Children's"", 'Family-Oriented Adventure', ""Children's/Family"", 'Adventure', 'Family Film']",1980,5
31524231,Erotic Nights of the Living Dead,1980,['Italy'],"['Horror', 'Zombie Film']",1980,0
24461524,Sinners in Silk,1924,['United States of America'],"['Silent film', 'Romance Film', 'Romantic drama']",1920,4
2647404,Woman on Top,2000,['United States of America'],"['LGBT', 'Romantic drama', 'Comedy', 'Romance Film', 'Romantic comedy', 'Comedy-drama', 'Drama']",2000,0
33625220,Perfumed Garden,2000,"['India', 'United States of America']","['Romance Film', 'Drama']",2000,0
15150993,In the Electric Mist,2008,"['France', 'United States of America']","['Detective fiction', 'Gangster Film', 'Mystery', 'Thriller', 'Detective', 'Crime Thriller', 'Drama']",2000,8
33264013,Strawberries in the Supermarket,2003,"['Serbia and Montenegro', 'Yugoslavia', 'Germany', 'Italy']","['Action', 'Romantic drama', 'Comedy', 'World cinema', 'Romance Film', 'Romantic comedy', 'Drama']",2000,3
9244524,Battles Without Honor and Humanity: Proxy War,1973,['Japan'],"['Crime Fiction', 'Japanese Movies', 'Drama']",1970,3
26600211,Seetha Kalyanam,2009,['India'],['Drama'],2000,9
594488,Shattered Glass,2003,"['Canada', 'United States of America']","['History', 'Indie', 'Biographical film', 'Docudrama', 'Drama']",2000,3
10956794,Love's Enduring Promise,2004,['United States of America'],"['Period piece', 'Film adaptation', 'Romantic drama', 'Romance Film', 'Christian film', 'Television movie', 'Drama']",2000,4
11480694,Sofya Kovalevskaya,1985,['Soviet Union'],"['History', 'Biographical film', 'Drama']",1980,5
2286484,Love Camp 7,1969,['United States of America'],"['War film', 'Thriller', 'Horror']",1960,9
242301,Deadly Weapons,1973,['United States of America'],"['Sexploitation', 'Crime Fiction', 'Comedy', 'Crime Thriller', 'Drama', 'Cult']",1970,3
2728423,Waterloo Bridge,1940,['United States of America'],"['Black-and-white', 'Romance Film', 'War film', 'Drama']",1940,0
23813153,The Grocer's Son,2007,['France'],"['Drama', 'World cinema']",2000,7
6241797,The Canterville Ghost,2003,['United States of America'],"['Animation', 'Comedy', 'Costume drama', 'Television movie', 'Anime', 'Science Fiction', 'Family Film', 'Fantasy']",2000,3
103029,Breaking Away,1979,['United States of America'],"['Coming of age', 'Comedy', 'Comedy-drama', 'Sports', 'Drama', 'Family Film']",1970,9
10777059,Muppet Classic Theater,1994,['United States of America'],"['Music', 'Comedy film', 'Family Film', 'Fantasy']",1990,4
22701017,Vaastu Shastra,2004,['India'],"['World cinema', 'Thriller', 'Horror']",2000,4
12008535,Rudo y Cursi,2008,"['Mexico', 'United States of America']","['Family Drama', 'Comedy', 'Comedy-drama', 'Sports', 'Drama']",2000,8
3535258,Bells of Innocence,2003,['United States of America'],['Horror'],2000,3
1371900,Immortel,2004,"['United Kingdom', 'France', 'Italy']","['Action', 'Crime Fiction', 'Dystopia', 'World cinema', 'Science Fiction', 'Drama']",2000,4
18064087,Tu Chor Main Sipahi,1996,[],"['Action', 'Drama']",1990,6
20596726,American Buffalo,1996,"['United Kingdom', 'United States of America']","['Crime Fiction', 'Indie', 'Drama']",1990,6
27251501,For Them That Trespass,1949,['United Kingdom'],"['Drama', 'Crime Fiction']",1940,9
4627333,Teesri Manzil,1966,['India'],"['Musical', 'Mystery', 'Comedy', 'Thriller']",1960,6
30505812,Pakal,2006,[],['Drama'],2000,6
32269344,Yateem,1988,[],"['Drama', 'Family Film']",1980,8
985304,Deadly Blessing,1981,['United States of America'],"['Indie', 'Gothic Film', 'Thriller', 'Drama', 'Slasher', 'Horror', 'Supernatural', 'Fantasy']",1980,1
2211244,...ing,2003,['South Korea'],['Romance Film'],2000,3
26767717,Kid Monk Baroni,1952,['United States of America'],"['Action', 'Boxing', 'Drama', 'Sports']",1950,2
5565580,The Clock,1945,['United States of America'],"['Romance Film', 'Drama']",1940,5
31180701,The Shaggy Dog,1994,[],"['Family Film', 'Comedy film', 'Fantasy']",1990,4
14493098,Delovak Athara,1966,['Sri Lanka'],['Drama'],1960,6
23316605,Direct Action,2004,"['Canada', 'United States of America']","['Action', 'Crime Fiction', 'Action Thrillers', 'Action/Adventure', 'Thriller']",2000,4
8461302,Slippery Silks,1936,['United States of America'],"['Short Film', 'Black-and-white', 'Comedy']",1930,6
28761678,All Over the Town,1949,['United Kingdom'],"['Drama', 'Comedy']",1940,9
26408134,Bharathchandran I.P.S.,2005,['India'],"['Action', 'Thriller']",2000,5
11853416,The Christmas That Almost Wasn't,1966,['Italy'],"['Musical', 'Comedy', ""Children's/Family"", 'Holiday Film', ""Children's"", 'Drama', ""Children's Fantasy"", 'Family Film']",1960,6
26017276,Precious Find,1994,['United States of America'],['Science Fiction'],1990,4
5416971,Down,2003,"['Netherlands', 'United States of America']","['Action', 'Action/Adventure', 'Thriller', 'Horror']",2000,3
4181412,Mucho Mouse,1957,['United States of America'],"[""Children's/Family""]",1950,7
19933490,Immigrants,2008,['Hungary'],"['Animation', 'Indie', 'Comedy']",2000,8
3064539,Rhubarb,1969,['United Kingdom'],['Short Film'],1960,9
937809,Heavy,1995,['United States of America'],"['Romantic drama', 'Indie', 'Romance Film', 'Drama']",1990,5
8022805,The MatchMaker,1997,"['United Kingdom', 'Ireland', 'United States of America']","['Indie', 'Comedy', 'Romance Film', 'Romantic comedy']",1990,7
24873579,Thenavattu,2008,['India'],['Action'],2000,8
24158073,Getting In,1994,['United States of America'],"['Romance Film', 'Comedy', 'Thriller']",1990,4
4537586,California Split,1974,['United States of America'],"['Drama', 'Indie', 'Buddy film', 'Comedy', 'Black comedy', 'Comedy-drama', 'Addiction Drama']",1970,4
16279840,The Vicious Kind,2008,['United States of America'],"['Indie', 'Comedy', 'Romance Film', 'Comedy-drama', 'Drama']",2000,8
1051400,Better Luck Tomorrow,2003,['United States of America'],"['Crime Fiction', 'Coming of age', 'Teen', 'Crime Drama', 'Drama']",2000,3
3593930,Thanmathra,2005,['India'],['Drama'],2000,5
12054477,You Are My Sunshine,2005,['South Korea'],"['Romantic drama', 'Romance Film', 'Comedy-drama', 'Drama']",2000,5
6127122,Barricade,2007,['Germany'],"['Slasher', 'Horror']",2000,7
4095673,The Utopian Society,2003,['United States of America'],"['Indie', 'Comedy', 'Teen', 'Comedy of manners', 'Ensemble Film']",2000,3
9627061,Asylum,1972,['United Kingdom'],"['Suspense', 'Psychological thriller', 'Mystery', 'Thriller', 'Horror', 'Anthology', 'Supernatural']",1970,2
1128527,Willard,2003,['United States of America'],"['Thriller', 'Horror', 'Cult', 'Drama', 'Natural horror films']",2000,3
15968423,Transporter 3,2008,"['United Kingdom', 'France']","['Action', 'Crime Fiction', 'Action Thrillers', 'Action/Adventure', 'Thriller', 'Crime Thriller', 'Martial Arts Film', 'Adventure']",2000,8
30860177,InuYasha the Movie: Fire on the Mystic Island,2004,['Japan'],"['Action', 'Animation', 'Japanese Movies', 'Anime', 'Fantasy']",2000,4
15204451,The Passionate Plumber,1932,['United States of America'],"['Comedy', 'Black-and-white']",1930,2
30006,The Silence of the Lambs,1991,['United States of America'],"['Psychological thriller', 'LGBT', 'Crime Fiction', 'Thriller', 'Crime Thriller', 'Drama', 'Suspense', 'Horror']",1990,1
18546107,Night Must Fall,1937,['United States of America'],"['Psychological thriller', 'Black-and-white']",1930,7
2274585,The Crossing Guard,1995,['United States of America'],"['Psychological thriller', 'Suspense', 'Drama', 'Crime Fiction', 'Indie', 'Crime Thriller', 'Addiction Drama']",1990,5
14492055,Copacabana,1947,['United States of America'],"['Musical', 'Black-and-white', 'Comedy']",1940,7
1844967,Eye of the Devil,1967,['United Kingdom'],"['Black-and-white', 'Mystery', 'Thriller', 'Horror', 'Supernatural']",1960,7
26640673,Are You in the House Alone?,1978,['United States of America'],"['Psychological thriller', 'Suspense', 'Mystery', 'Thriller', 'Horror', 'Television movie', 'Drama']",1970,8
18799982,Once Around,1991,['United States of America'],"['Romantic drama', 'Comedy', 'Romance Film', 'Romantic comedy', 'Domestic Comedy', 'Comedy-drama', 'Drama']",1990,1
30816196,Dil-E-Nadaan,1982,['India'],"['Romance Film', 'Drama']",1980,2
12278463,Edipo re,1966,['Italy'],"['Art film', 'Drama', 'World cinema']",1960,6
14097392,Year One,2009,['United States of America'],"['Buddy film', 'Comedy', 'Slapstick', 'Adventure', 'Absurdism', 'Period piece', 'Parody', 'Fantasy']",2000,9
300596,Two Arabian Knights,1927,['United States of America'],"['Black-and-white', 'Drama', 'Indie', 'Buddy film', 'Comedy', 'Silent film']",1920,7
2268290,Dracula 3000,2004,"['Germany', 'South Africa']","['Horror', 'Science Fiction']",2000,4
171078,Nixon,1995,['United States of America'],"['Period piece', 'Biography', 'Biopic [feature]', 'Political drama', 'Drama']",1990,5
32038391,Nadodi Thendral,1992,[],['Romance Film'],1990,2
14301340,Drawing Down the Moon,1997,['United States of America'],"['Drama', 'Crime Fiction']",1990,7
10888175,Chhaila Babu,1977,['India'],"['Romantic drama', 'Thriller', 'World cinema', 'Romance Film', 'Drama']",1970,7
19701,Monty Python and the Holy Grail,1974,['United Kingdom'],"['Action/Adventure', 'Comedy', 'Costume drama', 'Adventure', 'Slapstick', 'Absurdism', 'Parody', 'Humour', 'Cult']",1970,4
28757549,The Good Things,2001,['United States of America'],['Short Film'],2000,1
4281397,The Badge,2002,['United States of America'],"['Crime Fiction', 'Thriller', 'Crime Drama', 'Crime Thriller']",2000,2
6429872,Astitva,2000,['India'],"['Art film', 'Family Drama', 'Bollywood', 'Drama']",2000,0
29376195,Hollywood Boulevard,1936,['United States of America'],['Drama'],1930,6
8337507,Barricade,1939,['United States of America'],"['Action', 'Black-and-white', 'Comedy', 'Drama']",1930,9
25446832,Shivudu Shivudu Shivudu,1983,['India'],"['Action', 'Family Film']",1980,3
10610180,The Magic Riddle,1991,['Australia'],['Musical'],1990,1
10333865,El Verdugo,1963,['Spain'],"['Black-and-white', 'Comedy', 'Black comedy', 'Comedy-drama', 'Drama']",1960,3
18507034,Scooby-Doo: In The Beginning,2009,"['Canada', 'United States of America']","['Mystery', 'Comedy', 'Thriller', 'Adventure', 'Family Film']",2000,9
31743547,The Last Adventure,1967,"['France', 'Italy']","['Adventure', 'Drama']",1960,7
7598645,Don,2007,['India'],"['Musical', 'Bollywood', 'World cinema', 'Drama']",2000,7
17139921,L For Love L For Lies,2008,['Hong Kong'],['Chinese Movies'],2000,8
2953325,Snow Cake,2006,"['Canada', 'United Kingdom']","['Indie', 'Drama']",2000,6
1159860,"What's Up, Doc?",1972,['United States of America'],"['Screwball comedy', 'Comedy', 'Romance Film', 'Romantic comedy', 'Slapstick']",1970,2
26553782,Sound Off,1952,['United States of America'],['Comedy'],1950,2
3949808,Buffalo Dreams,2005,['United States of America'],"['Drama', 'Western', 'Teen']",2000,5
7191937,Mana Voori Pandavulu,1978,['India'],['Drama'],1970,8
31304482,The Train,1971,[],"['War film', 'Drama']",1970,1
23986951,House of Secrets,1936,['United States of America'],"['Suspense', 'Crime Fiction', 'Mystery', 'Thriller']",1930,6
5045106,Ullam Ketkumae,2005,['India'],['Romance Film'],2000,5
14887326,Plunder of Peach and Plum,1934,['China'],['Drama'],1930,4
2098445,Thalavattam,1986,['India'],"['Romance Film', 'Comedy', 'Drama']",1980,6
34797036,Undead Pool,2007,['Japan'],"['Japanese Movies', 'Splatter film', 'Horror', 'World cinema']",2000,7
13083579,Evangelion: 1.0 You Are (Not) Alone,2007,['Japan'],"['LGBT', 'Japanese Movies', 'Anime']",2000,7
25273919,Smart Girls Don't Talk,1948,['United States of America'],"['Crime Fiction', 'Gangster Film', 'Mystery']",1940,8
33362127,The Princess of Temple Street,2003,[],['Romantic comedy'],2000,3
28272885,Two Fathers,1944,['United Kingdom'],['Short Film'],1940,4
2666581,The Fugitive,1947,"['Mexico', 'United States of America']","['Black-and-white', 'Drama']",1940,7
8283324,Man with the Steel Whip,1954,['United States of America'],"['Action', 'Black-and-white', 'Western', 'Adventure']",1950,4
11838500,Tribes,1970,['United States of America'],['Drama'],1970,0
7545201,Woman of Straw,1964,['United Kingdom'],"['Film adaptation', 'Crime Fiction', 'Thriller', 'Film noir', 'Crime Thriller', 'Drama']",1960,4
23982633,Harry Brown,2009,['United Kingdom'],"['Action', 'Crime Fiction', 'Action/Adventure', 'Thriller', 'Crime Thriller', 'Drama']",2000,9
16462071,Come Play With Me,1977,['United Kingdom'],"['Comedy', 'Pornographic movie']",1970,7
18969327,Morning Departure,1950,['United Kingdom'],"['Film adaptation', 'War film', 'Adventure', 'Drama']",1950,0
8587476,Okkadunnadu,2007,['India'],"['Musical', 'Bollywood', 'World cinema', 'Drama']",2000,7
13580275,Swarg,1990,['India'],"['Drama', 'World cinema']",1990,0
16355225,Peranmai,2009,['India'],"['Action', 'Drama', 'Adventure']",2000,9
8704400,Dracula,2007,['United Kingdom'],"['Film adaptation', 'Horror', 'Television movie', 'Drama']",2000,7
26922017,Stepmonster,1993,['United States of America'],"['Creature Film', 'Parody', 'Comedy', 'Horror Comedy', 'Horror', ""Children's/Family""]",1990,3
8390680,Abierto de 18 a 24,1988,['Argentina'],['Drama'],1980,8
14846051,How Awful About Allan,1970,['United States of America'],"['Psychological thriller', 'Thriller', 'Television movie', 'Drama']",1970,0
18849366,Nadodi Mannan,1958,['India'],"['Musical', 'Bollywood', 'World cinema', 'Drama']",1950,8
21075146,When Brendan Met Trudy,2001,"['Ireland', 'United Kingdom']","['Black comedy', 'Romance Film', 'Comedy']",2000,1
14045038,Late Fragment,2007,['Canada'],['Drama'],2000,7
29831230,Paap Ki Kamaee,1990,['India'],['Action'],1990,0
23664336,Professor Layton and the Eternal Diva,2009,['Japan'],"['Anime', 'Japanese Movies']",2000,9
28148735,Eva Fools Around,1939,['Czech Republic'],['Comedy'],1930,9
24570345,Daddy's Gone A-Hunting,1925,['United States of America'],['Silent film'],1920,5
7151371,"Ladybird, Ladybird",1994,['United Kingdom'],"['Social problem film', 'Family Drama', 'Drama']",1990,4
20389220,Modern Boy,2008,['South Korea'],"['Period piece', 'Coming of age', 'Thriller', 'World cinema', 'Drama']",2000,8
1311117,Chinese Odyssey 2002,2002,"['China', 'Hong Kong']","['Action', 'Action/Adventure', 'Comedy', 'World cinema', 'Chinese Movies', 'Martial Arts Film', 'Parody', 'Romantic comedy']",2000,2
21872866,Puja Pain Phulatie,2007,['India'],['Drama'],2000,7
23477436,Rope,1948,['United States of America'],"['Psychological thriller', 'Film à clef', 'LGBT', 'Mystery', 'Thriller', 'Film noir', 'Crime Thriller', 'Drama', 'Suspense']",1940,8
3405219,Pähkähullu Suomi,1967,['Finland'],['Comedy'],1960,7
27159956,A Chapter in Her Life,1923,['United States of America'],"['Silent film', 'Drama']",1920,3
23835703,Gnomes and Trolls: The Secret Chamber,2008,['Sweden'],"['Computer Animation', 'Animation', 'Family Film']",2000,8
988136,Wimbledon,2004,"['United Kingdom', 'France']","['Comedy', 'Romantic comedy', 'Romance Film', 'Sports', 'Drama']",2000,4
26069958,Broadway Limited,1941,['United States of America'],['Comedy'],1940,1
19901334,Baler,2008,['Philippines'],"['Filipino Movies', 'Romantic drama', 'World cinema', 'Romance Film', 'War film', 'Drama']",2000,8
1138675,Alexander,2004,"['Netherlands', 'United Kingdom', 'France', 'Germany', 'Italy', 'United States of America']","['Action', 'LGBT', 'Biography', 'Action/Adventure', 'Romance Film', 'Costume drama', 'Adventure', 'Drama', 'Period piece', 'History', 'War film']",2000,4
27784762,Hijack!,1973,['United States of America'],"['Thriller', 'Drama']",1970,3
2891096,Mrs. Henderson Presents,2005,['United Kingdom'],"['Music', 'Period piece', 'Comedy', 'War film', 'Drama']",2000,5
2135286,Flashback,1990,['United States of America'],"['Action', 'Action/Adventure', 'Comedy']",1990,0
5564470,The Phantom,1943,['United States of America'],"['Action', 'Black-and-white', 'Superhero movie', 'Adventure']",1940,3
10619003,Do Anjaane,1976,['India'],"['Musical', 'Romantic drama', 'Bollywood', 'World cinema', 'Romance Film', 'Drama']",1970,6
20485147,My Mighty Princess,2008,['South Korea'],"['Action', 'Martial Arts Film', 'Action Comedy']",2000,8
3072898,Gupt: The Hidden Truth,1997,['India'],"['Bollywood', 'Thriller', 'Horror', 'World cinema', 'Crime Thriller']",1990,7
29250382,Secret Venture,1955,[],"['Mystery', 'Thriller', 'Romance Film', 'Sports', 'Drama']",1950,5
22199055,Bugs Bunny's Overtures to Disaster,1991,['United States of America'],"[""Children's/Family""]",1990,1
3799058,Gorath,1962,['Japan'],"['Action', 'Japanese Movies', 'Adventure', 'Science Fiction']",1960,2
36036933,Rainbow Drive,1990,['United States of America'],['Thriller'],1990,0
26278287,Hell to Pay,2005,"['United Kingdom', 'England']",['Crime Fiction'],2000,5
34334094,Rappadikalude Gatha,1978,['India'],[],1970,8
1679437,Help! I'm a Fish,2000,"['Germany', 'Denmark', 'Ireland']","['Animation', 'Comedy', ""Children's"", 'Adventure', 'Drama', 'Science Fiction', 'Family Film', 'Fantasy']",2000,0
76641,Woman of the Year,1942,['United States of America'],"['Black-and-white', 'Screwball comedy', 'Comedy', 'Romance Film', 'Romantic comedy']",1940,2
2153034,Shout at the Devil,1976,['United Kingdom'],"['Action', 'Action/Adventure', 'Adventure']",1970,6
28684641,Les Gens du voyage,1938,"['France', 'Germany']",['Drama'],1930,8
14033432,Manband the Movie,2006,['United States of America'],"['Indie', 'Comedy film']",2000,6
3769324,The Furies,1950,['United States of America'],"['Western', 'Action/Adventure', 'Film noir', 'Drama']",1950,0
27900541,Gypo,2005,['United Kingdom'],"['Dogme 95', 'Drama']",2000,5
12186438,Jeet,1996,['India'],"['Romantic drama', 'Bollywood', 'World cinema', 'Romance Film', 'Drama']",1990,6
1708475,Born to Kill,1947,['United States of America'],"['Black-and-white', 'Crime Fiction', 'Thriller', 'Film noir', 'Crime Thriller', 'Drama']",1940,7
19134739,Holocaust 2000,1977,"['United Kingdom', 'Italy']","['Thriller', 'Horror', 'Romance Film', 'Science Fiction', 'Drama']",1970,7
3051597,Children of the Corn IV: The Gathering,1996,['United States of America'],"['Supernatural', 'Cult', 'Horror']",1990,6
29857599,Gunahon Ka Devta,1990,['India'],['Action'],1990,0
34470083,Rollo and the Spirit of the Woods,2001,['Finland'],"['Family Film', 'Fantasy']",2000,1
9989914,Slattery's Hurricane,1949,['United States of America'],"['Crime Fiction', 'Film noir', 'Adventure', 'Drama']",1940,9
357715,The First $20 Million Is Always the Hardest,2002,['United States of America'],"['Comedy', 'Workplace Comedy']",2000,2
5639713,Casper's Haunted Christmas,2000,['Canada'],"[""Children's Fantasy"", 'Animation', ""Children's/Family"", 'Holiday Film', 'Christmas movie', 'Computer Animation']",2000,0
5603557,Should Married Men Go Home?,1928,['United States of America'],"['Black-and-white', 'Indie', 'Short Film', 'Buddy film', 'Comedy', 'Silent film', 'Slapstick']",1920,8
16167745,DUM,2003,['India'],"['Romantic drama', 'World cinema', 'Romance Film', 'Drama']",2000,3
177740,A Patch of Blue,1965,['United States of America'],"['Film adaptation', 'Black-and-white', 'Romantic drama', 'Romance Film', 'Drama']",1960,5
1690123,The Edge of the World,1937,"['United Kingdom', 'Scotland']","['Black-and-white', 'Docudrama', 'Drama']",1930,7
23637180,Desert Bloom,1986,['United States of America'],"['Period piece', 'Drama']",1980,6
31153,The Princess Bride,1987,['United States of America'],"['Adventure Comedy', 'Action', 'Comedy', 'Romance Film', ""Children's/Family"", 'Adventure', 'Fairy tale', 'Family Film', 'Fantasy']",1980,7
4815950,The Best Thief in the World,2004,['United States of America'],"['Family Drama', 'Indie', 'Comedy-drama', 'Drama']",2000,4
60174,Seven Brides for Seven Brothers,1954,['United States of America'],"['Musical', 'Comedy', 'Americana', 'Adventure', 'Drama']",1950,4
1142326,The Green Berets,1968,['United States of America'],"['Combat Films', 'War film', 'Drama']",1960,8
5501244,Bring Your Smile Along,1955,['United States of America'],"['Musical', 'Romantic comedy', 'Comedy']",1950,5
23933249,Next Door,2005,"['Norway', 'Denmark']","['Art film', 'Thriller', 'World cinema', 'Drama']",2000,5
12698909,Journey to the 7th Planet,1962,"['Denmark', 'United States of America']","['Science Fiction', 'World cinema', 'Stop motion', 'Cult']",1960,2
16166720,Vaanchinathan,2001,['India'],['Action'],2000,1
10744766,Asambhav,2004,['India'],"['Action/Adventure', 'Thriller', 'World cinema']",2000,4
816862,Ever After,1998,['United States of America'],"['Romantic drama', 'Comedy', 'Romance Film', 'Costume drama', 'Drama', 'Period piece', 'Fairy tale', 'Romantic comedy', 'Fantasy']",1990,8
23033725,Together,2009,['United Kingdom'],['Short Film'],2000,9
11510742,Don't Torture a Duckling,1972,['Italy'],"['Giallo', 'Crime Fiction', 'Mystery', 'Slasher', 'Thriller', 'Horror', 'Whodunit']",1970,2
14780621,"Enteng Kabisote 3 : Okay ka, Fairy Ko: The Legend Goes On and On and On",2006,['Philippines'],"['Filipino Movies', 'Comedy', 'World cinema']",2000,6
11656901,Konservy,2007,['Russia'],['Action'],2000,7
20184221,Desh Drohi,2008,['India'],"['Musical', 'Bollywood', 'World cinema', 'Drama']",2000,8
2374501,The Relic,1997,"['Japan', 'United Kingdom', 'Germany', 'New Zealand', 'United States of America']","['Creature Film', 'Film adaptation', 'Japanese Movies', 'Thriller', 'Horror']",1990,7
1822771,Ziemia Obiecana,1975,['Poland'],"['Period piece', 'Drama', 'World cinema']",1970,5
20393973,Fired Up,2009,['United States of America'],"['Comedy', 'Teen', 'Romantic comedy', 'Romance Film', 'Sports', 'Sex comedy']",2000,9
10778392,Shaolin Daredevils,1979,['Hong Kong'],"['Action', 'Drama', 'Chinese Movies', 'Martial Arts Film']",1970,9
596639,Three Men and a Baby,1987,['United States of America'],"['Buddy film', 'Comedy', 'Remake', 'Domestic Comedy', 'Family Film']",1980,7
3265486,Everynight ... Everynight,1994,['Australia'],"['Black-and-white', 'Crime Fiction', 'Drama']",1990,4
15868479,Black August,2006,['United States of America'],"['Period piece', 'Biography', 'Political drama', 'Drama']",2000,6
2533756,Flowers of Shanghai,1998,"['China', 'Taiwan']","['Period piece', 'Romantic drama', 'World cinema', 'Chinese Movies', 'Drama']",1990,8
6517894,Soulkeeper,2001,['United States of America'],"['Action', 'Action/Adventure', 'Comedy', 'Thriller', 'Horror', 'Adventure', 'Science Fiction']",2000,1
8948871,Coolie,1983,['India'],"['Action', 'Drama', 'Comedy']",1980,3
8723600,The Informant,1997,"['Ireland', 'United States of America']",['Drama'],1990,7
8139956,She Shoulda Said 'No'!,1949,['United States of America'],"['Black-and-white', 'Comedy', 'Drama', 'Cult']",1940,9
11046148,Kit Kittredge: An American Girl Mystery,2008,['United States of America'],"['Period piece', 'Family Drama', 'Comedy', 'Comedy-drama', ""Children's"", 'Drama', 'Family Film']",2000,8
11134797,Yamagola Malli Modalayindi,2007,['India'],['Comedy'],2000,7
3601408,Where Danger Lives,1950,['United States of America'],"['Psychological thriller', 'Black-and-white', 'Thriller', 'Film noir']",1950,0
11159076,Germany Pale Mother,1980,"['Germany', 'West Germany']","['Drama', 'World cinema']",1980,0
11035932,The Velocity of Gary,1999,['United States of America'],"['LGBT', 'Indie', 'Romantic drama', 'Comedy', 'Romance Film', 'Drama', 'Gay Themed', 'Gay', 'Gay Interest', 'Romantic comedy', 'Comedy-drama']",1990,9
21103212,Gallavants,1984,['United States of America'],"['Musical', ""Children's Fantasy"", 'Animation', 'Coming of age', 'Family Film', 'Fantasy']",1980,4
76351,Shane,1953,['United States of America'],"['Western', 'Action/Adventure', 'Drama']",1950,3
1354688,Ghost Ship,2002,"['United States of America', 'Canada', 'Australia']","['Supernatural', 'Slasher', 'Horror']",2000,2
872386,Papillon,1973,"['United States of America', 'France']","['Action', 'Crime Fiction', 'Action/Adventure', 'Thriller', 'New Hollywood', 'Adventure', 'Drama']",1970,3
27138287,Pranayamanithooval,2002,['India'],"['Drama', 'Comedy']",2000,2
13873910,Virgin Snow,2007,"['Japan', 'South Korea']","['Romance Film', 'Japanese Movies', 'Romantic drama']",2000,7
1934018,Grumpy Old Men,1993,['United States of America'],"['Buddy film', 'Comedy', 'Romance Film', 'Romantic comedy', 'Slapstick', 'Drama']",1990,3
24792615,Raw! Raw! Rooster!,1956,[],"['Animation', 'Short Film', 'Comedy film', 'Sports', 'Family Film']",1950,6
2331371,Doc Hollywood,1991,['United States of America'],"['Comedy', 'Comedy of manners', 'Romance Film', 'Romantic comedy', 'Americana']",1990,1
18305011,Wonder Woman,2009,['United States of America'],"['Superhero movie', 'Animation', 'Action/Adventure']",2000,9
29412535,Virgin,2003,['United States of America'],"['Indie', 'Drama']",2000,3
7198945,The Four Seasons,1981,['United States of America'],"['Romantic drama', 'Comedy', 'Romance Film', 'Romantic comedy', 'Drama']",1980,1
27380172,Elaan,1994,['India'],"['Action/Adventure', 'Drama', 'World cinema']",1990,4
1640329,Let It Ride,1989,['United States of America'],"['Horse racing', 'Comedy', 'Sports', 'Slapstick']",1980,9
1526905,The United States of Leland,2003,['United States of America'],"['Prison', 'Crime Fiction', 'Coming of age', 'Indie', 'Drama']",2000,3
29180377,Fear in the Night,1972,['United Kingdom'],"['Psychological thriller', 'Suspense', 'Mystery', 'Thriller', 'World cinema', 'Drama']",1970,2
3075185,One-Trick Pony,1980,['United States of America'],['Drama'],1980,0
31162053,Savate,1995,[],"['Action', 'Western']",1990,5
25040465,Stealing Christmas,2003,['United States of America'],"['Crime Fiction', 'Comedy', 'Romance Film', 'Drama']",2000,3
9757243,Zombies on Broadway,1945,['United States of America'],"['Horror Comedy', 'Comedy', 'Horror', 'Zombie Film']",1940,5
10330695,Arcade,1993,['United States of America'],"['Thriller', 'Horror', 'Science Fiction', 'Fantasy']",1990,3
24713061,A Family Torn Apart,1993,['United States of America'],"['Psychological thriller', 'Crime Fiction', 'Thriller', 'Horror', 'Television movie', 'Crime Thriller', 'Drama']",1990,3
26514248,The House on Carroll Street,1988,['United States of America'],"['Period piece', 'Suspense', 'Thriller', 'Romance Film', 'Political drama', 'Drama', 'Political thriller']",1980,8
438402,Live from Baghdad,2002,['United States of America'],"['Biographical film', 'Political drama', 'Docudrama', 'Television movie', 'Gulf War', 'War film', 'Drama']",2000,2
170590,Forgotten Silver,1995,"['New Zealand', 'Australia']","['Indie', 'Satire', 'Comedy', 'World cinema', 'Mockumentary', 'Drama', 'Parody', 'Cult']",1990,5
14203096,Sheep Ahoy,1954,['United States of America'],"['Animation', 'Short Film', 'Comedy', 'Family Film']",1950,4
8166200,Sing a Song of Six Pants,1947,['United States of America'],"['Black-and-white', 'Short Film', 'Comedy', 'Slapstick']",1940,7
2478590,Tigerland,2000,"['Germany', 'United States of America']","['Period piece', 'Drama', 'Indie', 'War film']",2000,0
23077560,Pipe Dream,2002,['United States of America'],"['Indie', 'Comedy', 'Romance Film', 'Romantic comedy']",2000,2
129644,The Godfather Part III,1990,['United States of America'],"['Film adaptation', 'Crime Fiction', 'Gangster Film', 'Family Drama', 'Mystery', 'Thriller', 'Drama', 'Period piece', 'Crime Drama', 'Ensemble Film']",1990,0
1055440,History Is Made at Night,1999,"['United Kingdom', 'United States of America']","['Action', 'Suspense', 'Indie', 'Comedy', 'Thriller', 'Romance Film', 'Romantic comedy']",1990,9
19361026,Il seme della discordia,2008,['Italy'],['Comedy'],2000,8
12289584,Skeleton Man,2004,['United States of America'],"['Creature Film', 'Action', 'Action Thrillers', 'Action/Adventure', 'Thriller', 'Horror', 'Supernatural']",2000,4
3682283,Terror in the Sky,1971,['United States of America'],"['Action', 'Disaster']",1970,1
19540016,Nasser Asphalt,1958,"['Germany', 'West Germany']","['Black-and-white', 'Thriller', 'World cinema', 'Film noir', 'Drama']",1950,8
10036397,Project ALF,1996,['United States of America'],"['Science Fiction', 'Comedy', 'Family Film']",1990,6
29189504,Nee Kosam,1999,['India'],['Romance Film'],1990,9
12439689,Invisible Target,2007,"['China', 'Hong Kong']","['Action', 'Crime Fiction', 'Action/Adventure', 'Thriller', 'World cinema', 'Chinese Movies', 'Martial Arts Film']",2000,7
14149346,The Reader,2008,"['Germany', 'United States of America']","['Period piece', 'Courtroom Drama', 'Film adaptation', 'Romantic drama', 'Romance Film', 'Drama', 'Tragedy']",2000,8
26299458,Plastic Bag,2009,['United States of America'],"['Romance Film', 'Short Film', 'Drama']",2000,9
17182282,The Doomsday Machine,1972,"['Hong Kong', 'United States of America']","['Melodrama', 'Chinese Movies', 'Science Fiction', 'Drama']",1970,2
24816940,The Student Teachers,1973,['United States of America'],"['Comedy', 'Thriller']",1970,3
1373475,The Cheetah Girls,2003,"['Canada', 'United States of America']","['Musical', 'Family Drama', 'Comedy', 'Teen', ""Children's"", 'Drama', 'Family Film']",2000,3
23258724,Ehsaas is Tarah,1998,['India'],[],1990,8
5009426,Dark Waters,1994,"['Russia', 'United Kingdom', 'Italy']","['Supernatural', 'B-movie', 'Horror']",1990,4
28806846,School Days with a Pig,2008,['Japan'],"['Japanese Movies', 'Drama', 'Comedy film']",2000,8
18387271,Tempo di uccidere,1989,['Italy'],"['Crime Fiction', 'Drama', 'World cinema']",1980,9
7133848,Banjo the Woodpile Cat,1979,['United States of America'],"['Animation', 'Short Film', ""Children's/Family"", 'Family Film']",1970,9
14270550,Shadows of Time,2004,['Germany'],"['Romance Film', 'Drama']",2000,4
4103051,Saravana,2006,['India'],"['Romantic drama', 'World cinema', 'Romance Film', 'Drama']",2000,6
12046410,The Really Big Shrimp,2007,['United States of America'],"['Television movie', 'Family Film']",2000,7
28987948,Red Headed Stranger,1986,['United States of America'],['Western'],1980,6
31859700,Mannu,1978,[],['Drama'],1970,8
11369741,Last Stand at Saber River,1997,['United States of America'],"['Action', 'Film adaptation', 'Action/Adventure', 'Drama', 'Western', 'Historical fiction', 'Television movie', 'Political drama']",1990,7
26760115,Gopalapuranam,2008,['India'],['Romance Film'],2000,8
27420347,Wells Fargo,1937,['United States of America'],"['Action', 'Western', 'Historical Epic', 'Epic', 'Docudrama', 'Drama']",1930,7
14423546,Front Page Woman,1935,['United States of America'],"['Black-and-white', 'Comedy', 'Romance Film', 'Romantic comedy']",1930,5
28376038,Sexton Blake and the Hooded Terror,1938,['United Kingdom'],"['Crime Fiction', 'Horror']",1930,8
17176854,Swapner Din,2004,['India'],['Drama'],2000,4
33550225,Samasthanam,2002,[],['Family Film'],2000,2
28146462,Oral Mathram,1997,[],"['Action', 'Drama', 'Comedy film']",1990,7
12181074,Slam Dance,1987,"['United Kingdom', 'United States of America']","['Suspense', 'Crime Fiction', 'Mystery', 'Thriller', 'Crime Drama', 'Crime Thriller', 'Drama']",1980,7
2530065,Mind Game,2004,['Japan'],"['Fantasy Adventure', 'Japanese Movies', 'Heavenly Comedy', 'Anime', 'Fantasy']",2000,4
8243850,Shart: The Challenge,2004,['India'],"['Musical', 'Romance Film']",2000,4
1893079,Battle Circus,1953,['United States of America'],"['War film', 'Drama']",1950,3
17682521,Vinashak - Destroyer,1998,['India'],"['Thriller', 'World cinema']",1990,8
2584080,Little Red Riding Hood,1997,['United States of America'],"['Short Film', 'Comedy film']",1990,7
5055725,The Looney Looney Looney Bugs Bunny Movie,1981,['United States of America'],"['Animation', ""Children's/Family"", 'Drama', 'Family Film']",1980,1
13688725,Queen Sized,2008,['United States of America'],"['Inspirational Drama', 'Teen', 'Television movie', 'Drama']",2000,8
2413074,School for Scoundrels,1960,['United Kingdom'],"['Film adaptation', 'Black-and-white', 'Parody', 'Comedy', 'Drama']",1960,0
64004,Apt Pupil,1998,"['France', 'United States of America', 'Canada']","['Period piece', 'Psychological thriller', 'Film adaptation', 'Horror', 'Drama']",1990,8
22304534,Desperation,2006,['United States of America'],"['Film adaptation', 'Horror']",2000,6
18422755,The Black Cannon Incident,1985,['China'],"['Comedy', 'World cinema', 'Black comedy', 'Chinese Movies', 'Drama']",1980,5
8283271,Canadian Mounties vs Atomic Invaders,1953,['United States of America'],"['Action', 'Spy', 'Black-and-white', 'Adventure']",1950,3
14004382,"Destruction, Inc.",1942,['United States of America'],"['Short Film', 'Animation']",1940,2
1265864,Brassed Off,1996,"['United Kingdom', 'United States of America']","['Indie', 'Comedy', 'Social problem film', 'Romantic comedy', 'Romance Film', 'Comedy-drama', 'Ensemble Film']",1990,6
5664888,The Trigger Effect,1996,['United States of America'],"['Action', 'Psychological thriller', 'Action/Adventure', 'Thriller', 'Disaster', 'Drama', 'Ensemble Film']",1990,6
1822446,Woo,1998,['United States of America'],"['Comedy', 'Romance Film', 'Romantic comedy', 'Sex comedy']",1990,8
13281178,Vice Versa,1948,['United Kingdom'],"['Comedy', 'Black-and-white']",1940,8
5184036,The Landlord,1970,['United States of America'],"['Film adaptation', 'Comedy', 'New Hollywood', 'Romantic comedy', 'Drama']",1970,0
8355455,Jaane Hoga Kya,2004,['India'],"['Drama', 'World cinema']",2000,4
7971869,Hog Wild,1930,['United States of America'],"['Short Film', 'Black-and-white', 'Comedy']",1930,0
1365330,The Luck of the Irish,1948,['United States of America'],"['Romance Film', 'Comedy', 'Fantasy']",1940,8
22405012,Nabonga,1943,['United States of America'],"['Action', 'Black-and-white', 'Animal Picture', 'Adventure']",1940,3
4102772,The Lady and the Highwayman,1989,['United Kingdom'],"['Film adaptation', 'Costume Adventure', 'Romantic drama', 'Action/Adventure', 'Romance Film', 'Costume drama', 'Drama', 'Adventure', 'Swashbuckler films', 'Period piece', 'Television movie']",1980,9
2809621,The Prestige,2006,"['United Kingdom', 'United States of America']","['Psychological thriller', 'Film adaptation', 'Mystery', 'Thriller', 'Drama', 'Period piece', 'Steampunk', 'Science Fiction', 'Fantasy']",2000,6
3325355,Clifford,1994,['United States of America'],"['Slapstick', 'Comedy', 'Domestic Comedy', 'Family Film']",1990,4
1189614,The Perfect Score,2004,"['Germany', 'United States of America']","['Crime Fiction', 'LGBT', 'Short Film', 'Comedy', 'Teen']",2000,4
35611933,Kumaari,1952,['India'],[],1950,2
7972448,Any Old Port,1932,['United States of America'],"['Short Film', 'Black-and-white', 'Comedy']",1930,2
16613774,Nevidni bataljon,1967,['Yugoslavia'],['War film'],1960,7
14739082,Three Arabian Nuts,1951,['United States of America'],"['Black-and-white', 'Short Film', 'Comedy', 'Slapstick', 'Fantasy Comedy']",1950,1
1252047,Sneakers,1992,['United States of America'],"['Action', 'Crime Fiction', 'Action/Adventure', 'Comedy', 'Thriller', 'Crime Thriller', 'Suspense', 'Heist']",1990,2
3028097,Hoodwinked,2006,['United States of America'],"['Crime Fiction', 'Animation', 'Mystery', 'Indie', 'Comedy', ""Children's"", 'Computer Animation', 'Fairy tale', 'Revisionist Fairy Tale', 'Parody', 'Family Film']",2000,6
5092969,Le Doulos,1962,"['France', 'Italy']","['Crime Fiction', 'Gangster Film', 'Thriller', 'World cinema', 'Crime Thriller', 'Drama']",1960,2
1851648,Kaena: The Prophecy,2003,"['Canada', 'France']","['Action', 'Fantasy Adventure', 'Animation', 'World cinema', 'Adventure', 'Computer Animation', ""Children's Fantasy"", 'Science Fiction', 'Family Film', 'Fantasy']",2000,3
5886412,Teddy Bears' Picnic,2002,['United States of America'],"['Political cinema', 'Political satire', 'Parody', 'Comedy', 'Mockumentary']",2000,2
16794274,Millie,1931,['United States of America'],"['Black-and-white', 'Crime Fiction', 'Crime Drama', 'Melodrama', 'Drama']",1930,1
68388,The General,1926,['United States of America'],"['Action', 'Comedy', 'Romance Film', 'War film']",1920,6
1064260,Thirteen Women,1932,['United States of America'],"['Black-and-white', 'Mystery', 'Slasher', 'Thriller', 'Drama']",1930,2
1374193,Sons and Daughters in a Time of Storm,1935,['China'],"['Chinese Movies', 'Black-and-white']",1930,5
22551381,Green Fields,1937,['United States of America'],"['Romance Film', 'Comedy', 'Drama']",1930,7
2295102,Too Late for Tears,1949,['United States of America'],"['Psychological thriller', 'Crime Fiction', 'Thriller', 'Film noir', 'Crime Thriller', 'Drama']",1940,9
21007560,Promise,1986,['United States of America'],"['Drama', 'Television movie']",1980,6
18785953,How I Spent My Summer Vacation,1997,['United States of America'],['Romantic comedy'],1990,7
8178002,Medium Rare,1992,"['Singapore', 'Australia']",['Thriller'],1990,2
7357270,The Dog Problem,2006,['United States of America'],"['Indie', 'Comedy', 'Romance Film', 'Romantic comedy', 'Comedy-drama']",2000,6
19440836,Men of War,1994,['United States of America'],"['Action', 'Gangster Film', 'Indie', 'Action/Adventure', 'Thriller', 'War film']",1990,4
3250877,La mujer de mi hermano,2005,['Mexico'],"['LGBT', 'Family Drama', 'Romantic drama', 'World cinema', 'Romance Film', 'Drama']",2000,5
19238600,The Banishment,2007,['Russia'],"['Family Drama', 'Drama']",2000,7
269528,Colossus: The Forbin Project,1970,['United States of America'],"['Cold War', 'Action/Adventure', 'Thriller', 'Doomsday film', 'Disaster', 'Science Fiction', 'Drama']",1970,0
22128743,Vidyarthikale Ithile Ithile,1971,['India'],"['Drama', 'Family Film']",1970,1
30947468,God's Gift,2006,[],['Drama'],2000,6
3984733,Bopha!,1993,['United States of America'],"['Drama', 'Political drama']",1990,3
4134701,"Objective, Burma!",1945,['United States of America'],"['Combat Films', 'Action', 'Black-and-white', 'Drama', 'War film']",1940,5
3828133,Dandy Dick,1935,['United Kingdom'],"['Comedy', 'Black-and-white']",1930,5
604150,The Doors,1991,['United States of America'],"['Musical', 'Period piece', 'Biography', 'Biographical film', 'Biopic [feature]', 'Musical Drama', 'Drama']",1990,1
30081679,Kranti Kshetra,1994,['India'],['Action'],1990,4
5939943,Pray TV,1980,['United States of America'],"['Parody', 'Comedy']",1980,0
6061532,Young Billy Young,1969,['United States of America'],"['Action', 'Revisionist Western', 'Action/Adventure', 'Western']",1960,9
18038723,The Last Outlaw,1994,['United States of America'],"['Western', 'Television movie', 'Action/Adventure']",1990,4
5217643,Mugavari,2000,['India'],"['Musical', 'Bollywood', 'World cinema', 'Drama']",2000,0
18877068,Tweet Zoo,1957,['United States of America'],"['Animation', 'Short Film', 'Family Film']",1950,7
10679526,Doctor Jack,1922,['United States of America'],"['Black-and-white', 'Indie', 'Comedy', 'Silent film']",1920,2
5397050,Tenchi Muyo! in Love,1996,['Japan'],"['Animation', 'Japanese Movies', 'Horror', 'Anime', 'Science Fiction']",1990,6
6326220,Sinner,2007,['United States of America'],"['Indie', 'Drama']",2000,7
364541,Ernest Saves Christmas,1988,['United States of America'],"[""Children's"", 'Slapstick', 'Comedy', 'Christmas movie', 'Family Film']",1980,8
9734311,The Tarnished Angels,1958,['United States of America'],"['Airplanes and airports', 'Black-and-white', 'Drama']",1950,8
7893550,No Time for Nuts,2006,['United States of America'],"[""Children's Fantasy"", 'Short Film', 'Comedy', 'Computer Animation']",2000,6
210155,The Core,2003,"['United Kingdom', 'United States of America']","['Action', 'Action/Adventure', 'Thriller', 'Disaster', 'Adventure', 'Drama', 'Doomsday film', 'Science Fiction']",2000,3
5339026,Snakehead Terror,2004,"['Canada', 'United States of America']","['Creature Film', 'Horror', 'Science Fiction', 'Natural horror films']",2000,4
1830725,The 300 Spartans,1962,['United States of America'],"['Action', 'Action/Adventure', 'Sword and Sandal', 'Adventure', 'Drama', 'History', 'Historical Epic', 'Historical fiction', 'Epic', 'War film']",1960,2
9659901,Body Parts,1991,['United States of America'],"['Slasher', 'Horror']",1990,1
19128264,Ankuram,1993,['India'],['Drama'],1990,3
19818008,Unexpected Riches,1942,['United States of America'],"['Black-and-white', 'Short Film', 'Comedy', 'Family Film']",1940,2
444906,Exotica,1994,['Canada'],"['LGBT', 'Erotic Drama', 'Indie', 'Mystery', 'Romance Film', 'Drama', 'Erotica', 'Ensemble Film']",1990,4
10071778,The Secret,2007,['France'],"['Drama', 'Indie', 'Thriller', 'Horror', 'World cinema', 'Supernatural']",2000,7
3320756,G.I. Joe: Valor vs. Venom,2004,['United States of America'],"['Animation', ""Children's"", 'Action/Adventure']",2000,4
9579854,The Hawaiians,1970,['United States of America'],"['Period piece', 'Romantic drama', 'Historical Epic', 'Epic', 'Romance Film', 'Political drama', 'Drama']",1970,0
3812989,Tick Tock Tuckered,1944,['United States of America'],"['Animation', 'Short Film', 'Family Film']",1940,4
5653946,Fatal Desire,2006,"['Canada', 'United States of America']","['Crime Fiction', 'Mystery', 'Thriller', 'Drama']",2000,6
12571772,Sugar Creek,2007,['United States of America'],"['Western', 'Horror', 'B-movie', 'Drama']",2000,7
14784249,Mr. Winkle Goes to War,1944,['United States of America'],"['Black-and-white', 'Comedy', 'Marriage Drama', 'War film']",1940,4
16800849,Zoey 101: Chasing Zoey,2008,[],"['Comedy', 'Drama', 'Family Film']",2000,8
21618156,The Heart of Texas Movie,2009,['United States of America'],"['Christian film', 'Biography', 'Documentary']",2000,9
18334152,Fastest with the Mostest,1960,[],"['Animation', 'Short Film', 'Comedy', 'Family Film']",1960,0
8843403,Like Stars on Earth,2007,['India'],"['Musical', 'Bollywood', 'World cinema', 'Drama']",2000,7
10779181,Salaakhen,1975,['India'],"['Action', 'Thriller']",1970,5
5945156,Rock Opera,2005,['United States of America'],"['Indie', 'Comedy', 'Thriller', 'Crime Comedy']",2000,5
14251601,Monster from the Ocean Floor,1954,['United States of America'],"['B-movie', 'Science Fiction', 'Horror']",1950,4
4305147,Pure,2002,['United Kingdom'],['Drama'],2000,2
32751743,The Power and the Glory,1941,['Australia'],"['Thriller', 'Drama']",1940,1
871013,Sleepover,2004,['United States of America'],"['Coming of age', 'Comedy', 'Teen', ""Children's""]",2000,4
24021257,Mickey's Amateurs,1937,['United States of America'],"['Animation', 'Short Film', 'Family Film']",1930,7
4316469,Smiley,1956,['Australia'],"['Adventure', 'Drama']",1950,6
2215314,Blue Fin,1978,['Australia'],"['Family Drama', 'Thriller', 'Drama', 'Family Film']",1970,8
30018289,Mahasangram,2006,['India'],['Action'],2000,6
5536677,Mahler,1974,['United Kingdom'],"['Period piece', 'Musical Drama', 'Biographical film', 'Biopic [feature]', 'Drama']",1970,4
9698861,Ninaithale,2007,['India'],['Romance Film'],2000,7
2291574,Talk Radio,1988,['United States of America'],"['Film à clef', 'Film adaptation', 'Indie', 'Crime Drama', 'Drama']",1980,8
1616817,Supergirl,1984,['United Kingdom'],"['Action', 'Adventure', 'Superhero movie', 'Science Fiction', 'Fantasy']",1980,4
21859894,Lovely to Look At,1952,['United States of America'],['Musical'],1950,2
2682100,The Man Without a Face,1993,['United States of America'],"['Film adaptation', 'Drama']",1990,3
9667639,Vinnukum Mannukum,2001,['India'],"['Romance Film', 'Comedy']",2000,1
30505786,Hitokiri,1969,[],"['Action', 'Historical fiction', 'Drama']",1960,9
2634920,Forbidden City Cop,1996,['Hong Kong'],"['Action', 'Action/Adventure', 'Comedy', 'World cinema', 'Chinese Movies', 'Martial Arts Film', 'Drama', 'Action Comedy']",1990,6
10394592,His Woman,1931,['United States of America'],"['Black-and-white', 'Romantic drama', 'Romance Film', 'Drama']",1930,1
7382472,Dangerous Mission,1954,['United States of America'],"['Mystery', 'Crime Fiction', 'Thriller', 'Crime Thriller', 'Drama']",1950,4
9226991,El Faro,1998,"['Argentina', 'Spain']","['LGBT', 'Indie', 'Family Drama', 'World cinema', 'Drama']",1990,8
19506776,The Death of Richie,1977,['United States of America'],['Drama'],1970,7
3740551,I Wake Up Screaming,1941,['United States of America'],"['Psychological thriller', 'Black-and-white', 'Crime Fiction', 'Mystery', 'Thriller', 'Film noir', 'Crime Thriller', 'Drama']",1940,1
5456819,Disturbia,2007,['United States of America'],"['Mystery', 'Thriller', 'Teen', 'Drama']",2000,7
7012465,King George and the Ducky,2000,[],"['Musical', 'Animation', 'Short Film', 'Comedy', ""Children's""]",2000,0
5403512,Flyboys,2006,"['United Kingdom', 'United States of America']","['Action', 'Action/Adventure', 'Romance Film', 'Adventure', 'Drama', 'Period piece', 'History', 'War film']",2000,6
19246781,Homam,2008,['India'],"['Action', 'Thriller']",2000,8
8422182,Acrobacias del Corazón,2000,['Argentina'],"['Romance Film', 'Drama']",2000,0
2529009,Just Cause,1995,['United States of America'],"['Action', 'Psychological thriller', 'Film adaptation', 'Detective fiction', 'Crime Fiction', 'Mystery', 'Thriller', 'Crime Thriller', 'Drama', 'Courtroom Drama', 'Suspense', 'Libraries and librarians', 'Detective']",1990,5
73368,The Big Parade,1925,['United States of America'],"['Black-and-white', 'Drama', 'Indie', 'Silent film', 'War film']",1920,5
5454936,Blue Collar Comedy Tour: The Movie,2003,"['Canada', 'United States of America']","['Stand-up comedy', 'Comedy', 'Documentary']",2000,3
3305132,Looking for Comedy in the Muslim World,2006,['United States of America'],"['Political cinema', 'Political satire', 'Parody', 'Satire', 'Comedy']",2000,6
23916223,Darkdrive,1996,['United States of America'],"['Psychological thriller', 'Science Fiction', 'Thriller']",1990,6
4003514,Vaanaprastham,1999,"['India', 'France']","['Musical', 'Art film', 'Bollywood', 'World cinema', 'Romance Film', 'Drama']",1990,9
17064151,Güle Güle,2000,['Turkey'],"['Drama', 'Comedy']",2000,0
3479663,La femme publique,1984,['France'],"['Erotic Drama', 'Drama']",1980,4
165369,This is Cinerama,1952,['United States of America'],['Documentary'],1950,2
27707389,Jerichow,2009,['Germany'],"['Romantic drama', 'World cinema', 'Romance Film', 'Drama']",2000,9
16179835,Nenjai Thodu,2007,['India'],['Romance Film'],2000,7
23487440,Alien,1979,"['United Kingdom', 'United States of America']","['Creature Film', 'New Hollywood', 'Horror', 'Adventure', 'Sci-Fi Horror', 'Science Fiction']",1970,9
5222403,Unishe April,1994,['India'],"['Drama', 'Art film']",1990,4
2674130,Little Giants,1994,['United States of America'],"['Comedy', ""Children's/Family"", 'Sports', 'Family Film']",1990,4
15723201,When Nietzsche Wept,2007,['United States of America'],"['Period piece', 'Film adaptation', 'Romantic drama', 'Romance Film', 'Drama']",2000,7
11646548,When Ladies Meet,1941,['United States of America'],"['Romantic comedy', 'Black-and-white', 'Comedy']",1940,1
23767055,Čovek nije tica,1965,['Yugoslavia'],"['Art film', 'World cinema', 'Romance Film', 'Drama']",1960,5
20281368,Shannon's Rainbow,2009,['United States of America'],['Drama'],2000,9
28170828,Nivedyam,2007,['India'],"['Romance Film', 'Drama']",2000,7
19483119,Sadko,1953,['Soviet Union'],"['Adventure', 'Fantasy']",1950,3
16146028,The Late Show,1977,['United States of America'],"['Action', 'Mystery', 'Action/Adventure', 'Comedy', 'Thriller', 'Romance Film', 'Crime Thriller', 'Detective']",1970,7
213462,2046,2004,"['Hong Kong', 'China', 'France', 'Germany', 'Italy']","['Romantic drama', 'Romance Film', 'Chinese Movies', 'Science Fiction', 'Drama', 'Fantasy']",2000,4
11954401,Buster and Billie,1974,['United States of America'],"['Coming of age', 'Crime Fiction', 'Albino bias', 'Romance Film', 'Drama', 'Tragedy']",1970,4
11680456,La Chiesa,1989,['Italy'],"['Supernatural', 'Horror']",1980,9
5453739,The Computer Wore Tennis Shoes,1969,['United States of America'],"['Comedy', 'Science Fiction', 'Drama', 'Family Film']",1960,9
20898872,So's Your Old Man,1926,['United States of America'],"['Silent film', 'Comedy film']",1920,6
42224,Anywhere But Here,1999,['United States of America'],"['Film adaptation', 'Family Drama', 'Romantic drama', 'Comedy', 'Romance Film', 'Drama', 'Coming of age', 'Comedy-drama', 'Road movie', 'Family Film']",1990,9
10592638,Mere Sanam,1965,['India'],"['Romantic drama', 'World cinema', 'Romance Film', 'Drama']",1960,5
2011391,The Big Trail,1930,['United States of America'],"['Action', 'Black-and-white', 'Epic Western', 'Western', 'Action/Adventure']",1930,0
10783682,A Man of No Importance,1994,"['Ireland', 'United Kingdom']","['LGBT', 'Indie', 'Comedy', 'Drama']",1990,4
36212588,The Slingshot,1993,"['Sweden', 'Denmark']","['Period piece', 'Coming of age', 'Comedy-drama', 'Drama']",1990,3
152058,Beneath the Planet of the Apes,1970,['United States of America'],"['Action', 'Doomsday film', 'Science Fiction']",1970,0
2112239,My Name Is Nobody,1973,"['France', 'Germany', 'Italy']","['Parody', 'Action/Adventure', 'Western', 'World cinema', 'Spaghetti Western']",1970,3
4259508,Devdas,1955,['India'],"['Musical', 'Romantic drama', 'Bollywood', 'World cinema', 'Romance Film', 'Drama']",1950,5
6115870,Scavenger Hunt,1979,['United States of America'],"['Adventure Comedy', 'Chase Movie', 'Comedy', 'Ensemble Film']",1970,9
473260,The Business of Strangers,2001,['United States of America'],"['Psychological thriller', 'Indie', 'Thriller', 'Drama']",2000,1
12410077,999-9999,2002,['Thailand'],['Horror'],2000,2
14624875,Sniper,2009,"['China', 'Hong Kong']","['Action', 'Action/Adventure', 'Thriller', 'World cinema', 'Chinese Movies']",2000,9
1891570,Black Angel,1946,['United States of America'],"['Crime Fiction', 'Mystery', 'Thriller', 'Film noir', 'Crime Thriller', 'Drama']",1940,6
21764056,Just a Kiss,2002,['United States of America'],"['Indie', 'Comedy', 'Black comedy', 'Romantic comedy', 'Romance Film']",2000,2
14526240,Higher Than a Kite,1943,['United States of America'],"['Black-and-white', 'Short Film', 'Comedy', 'Slapstick']",1940,3
12013209,"No Retreat, No Surrender 3: Blood Brothers",1990,['Hong Kong'],['Action'],1990,0
2309459,Brink!,1998,['United States of America'],"['Action', 'Drama', 'Teen', 'Sports']",1990,8
28887886,Python II,2002,['United States of America'],"['B-movie', 'Natural horror films', 'Horror']",2000,2
4702014,Sword of the Valiant: The Legend of Sir Gawain and the Green Knight,1984,['United Kingdom'],"['Period piece', 'Action/Adventure', 'Sword and sorcery', 'Costume drama', 'Adventure', 'Fantasy']",1980,4
2823258,Night Falls on Manhattan,1996,['United States of America'],"['Crime Fiction', 'Political drama', 'Drama', 'Courtroom Drama']",1990,6
20757962,Hard to Hold,1984,['United States of America'],"['Romantic drama', 'Comedy', 'Romance Film', 'Romantic comedy', 'Drama']",1980,4
20980488,Outlaw Trail: The Treasure of Butch Cassidy,2006,[],"['Action/Adventure', 'Western', 'Adventure', 'Family Film']",2000,6
144778,The Guardsman,1931,['United States of America'],"['Black-and-white', 'Pre-Code', 'Comedy']",1930,1
27381879,Jerks of All Trades,1949,['United States of America'],['Short Film'],1940,9
1540319,The Pink Panther Strikes Again,1976,['United Kingdom'],"['Crime Fiction', 'Parody', 'Comedy', 'Crime Comedy', 'Slapstick']",1970,6
6155030,The Midnight Snack,1941,['United States of America'],"['Animation', 'Short Film', 'Comedy', 'Family Film']",1940,1
20903253,Zinda Dil,1975,['India'],"['Action', 'Romance Film']",1970,5
7921068,Holly Hobbie and Friends: Christmas Wishes,2006,['United States of America'],"['Animation', 'Short Film', ""Children's"", 'Family Film']",2000,6
5878470,Mysterious Doctor Satan,1940,['United States of America'],"['Action', 'Black-and-white', 'Adventure', 'Superhero movie', 'Science Fiction']",1940,0
5216578,Love in the Afternoon,1972,['France'],"['Art film', 'Romantic drama', 'World cinema', 'Romance Film', 'Drama']",1970,2
4793122,Fancy Pants,1950,['United States of America'],"['Musical', 'Slapstick', 'Comedy']",1950,0
19152242,National Lampoon's Van Wilder: Freshman Year,2009,['United States of America'],"['Parody', 'Comedy']",2000,9
24417616,Do You Wanna Know a Secret?,2001,['United States of America'],"['Slasher', 'Teen', 'Horror']",2000,1
1542714,Le Déclin de l'empire américain,1986,['Canada'],"['LGBT', 'Indie', 'Satire', 'Comedy', 'Drama', 'Comedy-drama', 'Comedy of manners', 'Ensemble Film']",1980,6
846350,Equinox Flower,1958,['Japan'],"['Art film', 'Family Drama', 'Comedy', 'World cinema', 'Drama', 'Japanese Movies', 'Domestic Comedy', 'Comedy-drama']",1950,8
11328161,Eye of the Dolphin,2006,['United States of America'],"['Animal Picture', 'Indie', 'Drama']",2000,6
4534748,Tarzan the Magnificent,1960,['United Kingdom'],"['Action', 'Adventure', 'Jungle Film']",1960,0
2071077,Christine,1983,['United States of America'],"['Film adaptation', 'Mystery', 'Thriller', 'Horror', 'Supernatural', 'Cult']",1980,3
10034391,I Accuse My Parents,1945,['United States of America'],"['Black-and-white', 'Crime Fiction', 'Teen', 'Drama']",1940,5
21409715,Rezerwat,2007,['Poland'],"['Comedy', 'Crime Drama', 'Tragicomedy', 'Drama']",2000,7
14621521,Tarzan's Hidden Jungle,1955,['United States of America'],"['Black-and-white', 'Adventure', 'Jungle Film']",1950,5
26291262,The Leghorn Blows at Midnight,1950,[],"['Animation', 'Short Film', 'Family Film']",1950,0
14324889,Le lieu du crime,1986,['France'],"['Family Drama', 'Crime Drama', 'Melodrama', 'Drama']",1980,6
14356094,Hedd Wyn,1992,"['United Kingdom', 'Wales']","['Biographical film', 'Biopic [feature]', 'Romance Film', 'War film', 'Drama']",1990,2
22994219,Ojai Bums,2009,['United States of America'],"['Short Film', 'Comedy']",2000,9
4979871,Billy Bathgate,1991,['United States of America'],"['Period piece', 'Film adaptation', 'Crime Fiction', 'Gangster Film', 'Coming of age', 'Crime Thriller', 'Drama']",1990,1
344978,Swingers,1996,['United States of America'],"['Indie', 'Buddy film', 'Comedy', 'Romance Film', 'Romantic comedy', 'Cult']",1990,6
23938010,Baby Blues,2008,['United States of America'],"['Drama', 'Thriller', 'Horror']",2000,8
19200322,Ullathai Allitha,1995,['India'],"['Musical', 'Comedy', 'Bollywood', 'World cinema']",1990,5
2161511,Mom and Dad Save The World,1992,['United States of America'],"['Comedy', 'Adventure', 'Black comedy', 'Romantic comedy', 'Doomsday film', 'Science Fiction', 'Family Film']",1990,2
1286174,Ballistic: Ecks vs. Sever,2002,"['Germany', 'United States of America']","['Action', 'Suspense', 'Spy', 'Action Thrillers', 'Action/Adventure', 'Thriller', 'Glamorized Spy Film']",2000,2
11244712,The Two of Us,1967,['France'],"['Black-and-white', 'Art film', 'Comedy', 'World cinema', 'Drama']",1960,7
31427647,Anubandham,1985,[],['Drama'],1980,5
32449230,Immensee,1943,['Germany'],"['Melodrama', 'Drama']",1940,3
9309429,The Hustler,1961,['United States of America'],"['Black-and-white', 'Sports', 'Drama']",1960,1
3601835,Eddie and the Cruisers,1983,['United States of America'],"['Drama', 'Mystery', 'Indie', 'Musical Drama']",1980,3
12868752,Futile Attraction,2005,"['New Zealand', 'Australia']","['Comedy', 'World cinema', 'Romance Film', 'Romantic comedy', 'Mockumentary']",2000,5
6197600,Flying Tigers,1942,"['Taiwan', 'United States of America']","['Action', 'Black-and-white', 'Action/Adventure', 'Epic', 'War film', 'Drama']",1940,2
25918824,Chhodon Naa Yaar,2007,['India'],"['Musical', 'Thriller', 'Bollywood', 'World cinema']",2000,7
5444611,Accepted,2006,['United States of America'],"['Comedy', 'Teen']",2000,6
24587655,A Woman of Affairs,1928,['United States of America'],"['Film adaptation', 'Romantic drama', 'Silent film', 'Romance Film', 'Melodrama', 'Drama']",1920,8
5006100,Shaan,1980,['India'],"['Romantic drama', 'World cinema', 'Romance Film', 'Drama']",1980,0
23575362,Object of Obsession,1994,['United States of America'],"['Erotic thriller', 'Thriller', 'Pornographic movie']",1990,4
4176100,The Big White,2005,"['Canada', 'Germany', 'New Zealand', 'United States of America']","['Indie', 'Comedy', 'Crime Comedy', 'Black comedy']",2000,5
28212637,Taxi,1996,['Spain'],"['Romance Film', 'Crime Fiction', 'Drama']",1990,6
5541172,The Tenant,1976,"['United States of America', 'France']","['Psychological thriller', 'Mystery', 'Satire', 'Thriller', 'Black comedy', 'Suspense', 'Horror', 'Supernatural']",1970,6
4200829,Hatred of a Minute,2002,['United States of America'],"['Psychological thriller', 'Crime Fiction', 'Thriller', 'Horror', 'Romance Film', 'Crime Thriller']",2000,2
307690,Naked Lunch,1991,"['United Kingdom', 'Canada', 'Japan']","['Surrealism', 'Film adaptation', 'Psychological thriller', 'Erotic Drama', 'Comedy', 'Avant-garde', 'Kafkaesque', 'LGBT', 'Mystery', 'Indie', 'Biography', 'Addiction Drama', 'Drama', 'Japanese Movies', 'Experimental film', 'Fantasy']",1990,1
11149034,The Little Kidnappers,1953,['United Kingdom'],"['Black-and-white', 'Crime Fiction', 'Drama', 'Family Film']",1950,3
29083101,The Way of the Strong,1928,['United States of America'],['Drama'],1920,8
13700717,El Cid: The Legend,2003,['Spain'],['Animation'],2000,3
2674286,Kuffs,1992,['United States of America'],"['Action', 'Crime Fiction', 'Action Comedy', 'Action/Adventure', 'Comedy']",1990,2
73882,The Gold Rush,1925,['United States of America'],"['Black-and-white', 'Drama', 'Indie', 'Comedy', 'Silent film']",1920,5
22225014,Stingray Sam,2009,['United States of America'],"['Musical', 'Comedy film', 'Space western', 'Science Fiction']",2000,9
9143742,Top Secret Affair,1957,['United States of America'],"['Romance Film', 'Black-and-white', 'Comedy']",1950,7
3760059,Sword in the Moon,2003,['South Korea'],"['Action', 'Period piece', 'Samurai cinema', 'Action/Adventure', 'World cinema', 'Martial Arts Film', 'Drama']",2000,3
750965,Homerun,2003,['Singapore'],['Drama'],2000,3
13651637,So Close to Paradise,2001,['China'],"['Romantic drama', 'World cinema', 'Chinese Movies', 'Drama']",2000,1
3843878,Outsourced,2006,['United States of America'],"['Workplace Comedy', 'Drama', 'Indie', 'Comedy', 'Romance Film', 'Romantic comedy']",2000,6
1446009,Mon Oncle,1958,"['France', 'Italy']","['Comedy', 'World cinema']",1950,8
30885438,Penitentiary,1979,[],"['Action', 'Blaxploitation', 'Drama', 'Crime Fiction', 'Action/Adventure', 'Prison film']",1970,9
4594354,Kangaroo Jack: G'Day U.S.A.!,2004,['United States of America'],"['Animation', 'Comedy', 'Adventure', 'Family Film']",2000,4
911882,How to Marry a Millionaire,1953,['United States of America'],"['Romance Film', 'Romantic comedy', 'Comedy']",1950,3
9083684,Anjaane,2005,['India'],"['Thriller', 'World cinema', 'Supernatural', 'Drama']",2000,5
27206044,Two Girls on Broadway,1940,['United States of America'],"['Musical', 'Comedy', 'Musical comedy', 'Romance Film']",1940,0
12837593,Gumapang Ka Sa Lusak,1990,['Philippines'],"['Filipino Movies', 'Drama']",1990,0
8133963,The Ape Man,1943,['United States of America'],"['Creature Film', 'Science Fiction', 'Horror']",1940,3
31390092,VooDoo,2007,['Hong Kong'],"['Chinese Movies', 'Martial Arts Film', 'Action/Adventure', 'Thriller', 'Horror', 'World cinema', 'Supernatural']",2000,7
15213511,A Quiet Street,1922,['United States of America'],"['Black-and-white', 'Indie', 'Short Film', 'Comedy', 'Silent film', ""Children's/Family"", 'Family Film']",1920,2
20889979,Cutlass,2007,['United States of America'],"['Short Film', 'Drama']",2000,7
23733825,The Last Lullaby,2008,['United States of America'],"['Mystery', 'Indie', 'Thriller', 'Crime Drama', 'Drama']",2000,8
28401704,Hindle Wakes,1927,['United Kingdom'],"['Romantic drama', 'Silent film', 'Romance Film', 'Drama']",1920,7
5256886,Maine Dil Tujhko Diya,2002,['India'],"['Musical', 'Romantic drama', 'Bollywood', 'World cinema', 'Romance Film', 'Drama']",2000,2
5618746,The Naughty Nineties,1945,['United States of America'],"['Black-and-white', 'Slapstick', 'Comedy', 'Family Film']",1940,5
20881423,Tarnished Lady,1931,['United States of America'],['Drama'],1930,1
9261448,The Tiger Makes Out,1967,['United States of America'],['Comedy'],1960,7
26007240,The Creeps,1997,['United States of America'],"['Monster movie', 'Monster', 'Horror', 'B-movie']",1990,7
10707025,Baharon Ki Manzil,1968,['India'],['Drama'],1960,8
3794728,The Dark Past,1948,['United States of America'],"['Film noir', 'Crime Drama', 'Drama']",1940,8
16337176,Terry Pratchett's The Colour of Magic,2008,['United Kingdom'],"['Comedy', 'Fantasy']",2000,8
3324690,Typhoon,2005,['South Korea'],"['Action/Adventure', 'World cinema']",2000,5
6534317,The Man from Snowy River,1982,['Australia'],"['Romantic drama', 'Action/Adventure', 'Western', 'World cinema', 'Romance Film', 'Drama']",1980,2
6555707,Carry On Loving,1970,['United Kingdom'],"['Parody', 'Comedy', 'Romantic comedy', 'Sex comedy']",1970,0
4766483,National Velvet,1945,['United States of America'],"['Film adaptation', 'Family Drama', 'Childhood Drama', ""Children's/Family"", 'Drama', 'Coming of age', 'Animal Picture', 'Family Film']",1940,5
36057881,Thiruppu Munai,1989,['India'],['Crime Fiction'],1980,9
15816268,Devil's Doorway,1950,['United States of America'],"['Black-and-white', 'Western', 'Social problem film', 'Indian Western', 'Drama']",1950,0
4525379,Kika,1993,"['France', 'Spain']","['Crime Fiction', 'Comedy', 'Media Satire', 'Black comedy', 'Erotica', 'Drama', 'Sex comedy']",1990,3
12183290,Strange Behavior,1981,"['New Zealand', 'Australia', 'United States of America']","['Psychological thriller', 'Slasher', 'Comedy', 'Thriller', 'Horror', 'Teen']",1980,1
3732970,George White's 1935 Scandals,1935,['United States of America'],"['Musical', 'Romance Film', 'Black-and-white']",1930,5
23691088,Bells of Rosarita,1945,['United States of America'],['Western'],1940,5
519115,Fist of the North Star,1986,['Japan'],"['Science Fiction', 'Japanese Movies']",1980,6
25805385,White Wedding,2009,['South Africa'],"['Comedy', 'World cinema', 'Romance Film', 'Romantic comedy']",2000,9
12504193,The Other Side of the Tracks,2008,['United States of America'],"['Psychological thriller', 'Romantic fantasy', 'Mystery', 'Indie', 'Thriller', 'Drama', 'Tragedy', 'Horror', 'Supernatural', 'Fantasy']",2000,8
105872,Clueless,1995,['United States of America'],"['LGBT', 'Coming of age', 'Comedy', 'Teen', 'Comedy of manners', 'Romantic comedy', 'Romance Film']",1990,5
7332392,Satanic,2006,['United States of America'],"['Supernatural', 'Horror']",2000,6
5499192,The H-Man,1958,['Japan'],"['Science Fiction', 'Japanese Movies', 'World cinema']",1950,8
14143461,White Eagle,1941,['United States of America'],"['Adventure', 'Black-and-white']",1940,1
6934278,Bertie and Elizabeth,2002,['United States of America'],"['Drama', 'Biographical film']",2000,2
13248713,Kiss Them for Me,1957,['United States of America'],"['Comedy', 'Romance Film', 'Romantic comedy', 'Comedy-drama']",1950,7
13130719,The Organizer,1963,['Italy'],"['Black-and-white', 'Drama']",1960,3
6795107,Aval Varuvala,1998,[],[],1990,8
29645864,All Men Are Liars,1995,['Australia'],['Comedy'],1990,5
18814709,Peacock,2009,['United States of America'],"['Psychological thriller', 'Mystery', 'Thriller']",2000,9
15814364,The Corn Is Green,1945,['United States of America'],"['Black-and-white', 'Drama']",1940,5
10602931,10 Tigers from Kwangtung,1979,['Hong Kong'],"['Action/Adventure', 'World cinema', 'Chinese Movies', 'Martial Arts Film']",1970,9
1291998,Lisístrata,2002,['Spain'],['Comedy'],2000,2
26048464,Troublesome Night 14,2002,['Hong Kong'],"['Chinese Movies', 'Comedy', 'Horror', 'Romance Film']",2000,2
35309363,H2O,2002,['India'],[],2000,2
6070855,Scooby-Doo! Pirates Ahoy!,2006,[],"['Family Film', 'Animation']",2000,6
15047151,Final Days of Planet Earth,2006,"['Canada', 'United States of America']","['Action', 'Drama', 'Horror', 'Adventure', 'Television movie', 'Science Fiction']",2000,6
5726392,The Glass Shield,1995,"['United States of America', 'France']","['Action', 'Drama', 'Crime Fiction', 'Crime Thriller']",1990,5
31159789,Nightjohn,1996,['United States of America'],"['Period piece', 'Drama']",1990,6
23266650,Carolina Moon,2007,['United States of America'],"['Psychological thriller', 'Film adaptation', 'Mystery', 'Thriller', 'Television movie', 'Crime Thriller']",2000,7
8059144,O Cheiro do Ralo,2006,['Brazil'],"['Comedy', 'World cinema']",2000,6
922861,Cube 2: Hypercube,2002,['Canada'],"['Psychological thriller', 'Escape Film', 'Thriller', 'Horror', 'Science Fiction']",2000,2
168583,Salvador,1986,"['United Kingdom', 'United States of America']","['Action', 'Biography', 'Indie', 'Thriller', 'War film', 'Drama', 'Political drama', 'Political thriller']",1980,6
26526311,Danielle Steel's The Ring,1996,['United States of America'],"['Film adaptation', 'Romantic drama', 'Romance Film', 'Television movie', 'Drama']",1990,6
15560266,Marrying the Mafia III,2006,['South Korea'],"['Crime Fiction', 'Comedy', 'Drama']",2000,6
21975745,Boy Meets Dog,1938,[],['Short Film'],1930,8
6430353,The Young Savages,1961,['United States of America'],"['Crime Fiction', 'Social problem film', 'Juvenile Delinquency Film', 'Drama', 'Courtroom Drama']",1960,1
25751926,We're in the Money,1935,['United States of America'],"['Music', 'Romance Film', 'Comedy film']",1930,5
3838989,Hawk the Slayer,1980,['United Kingdom'],"['Action/Adventure', 'Fantasy', 'Sword and sorcery', 'Adventure', 'Costume drama', 'Sword and sorcery films']",1980,0
1598127,Rooster Cogburn,1975,['United States of America'],"['Action', 'Action/Adventure', 'Western', 'Comedy', 'Adventure']",1970,5
24632158,Severed Ways: The Norse Discovery of America,2009,[],"['Indie', 'Drama']",2000,9
1372551,London to Brighton,2006,['United Kingdom'],"['Action', 'Drama', 'Crime Fiction', 'Thriller']",2000,6
26117532,Woman Chases Man,1937,['United States of America'],"['Romance Film', 'Comedy film']",1930,7
6898352,Days of Glory,1944,['United States of America'],"['Romance Film', 'War film', 'Drama']",1940,4
5055826,Mysterious Island,1961,"['United Kingdom', 'United States of America']","['Action', 'Film adaptation', 'Monster', 'Action/Adventure', 'Stop motion', 'Adventure', 'Drama', 'Steampunk', 'Science Fiction', 'Family Film', 'Fantasy']",1960,1
4228739,My Giant,1998,['United States of America'],"['Buddy film', 'Comedy', 'Sports', 'Drama', 'Family Film']",1990,8
74858,The Lady Eve,1941,['United States of America'],"['Black-and-white', 'Screwball comedy', 'Comedy', 'Romance Film', 'Romantic comedy']",1940,1
172278,Capricorn One,1977,"['United Kingdom', 'United States of America']","['Action', 'Action/Adventure', 'Thriller', 'New Hollywood', 'Adventure', 'Conspiracy fiction', 'Science Fiction']",1970,7
8677237,Old Men in New Cars,2002,['Denmark'],"['Action', 'LGBT', 'Action/Adventure', 'Comedy', 'Thriller', 'World cinema', 'Black comedy', 'Crime Thriller']",2000,2
4270959,Things Change,1988,['United States of America'],"['Crime Fiction', 'Gangster Film', 'Satire', 'Comedy', 'Drama', 'Parody', 'Crime Comedy', 'Comedy of manners']",1980,8
33844384,Rangbaaz,1996,[],['Action'],1990,6
8166078,Ab Tumhare Hawale Watan Saathiyo,2004,['India'],"['Action', 'Action/Adventure', 'World cinema', 'Romance Film', 'War film', 'Drama']",2000,4
8208923,Life with Judy Garland: Me and My Shadows,2001,"['Canada', 'United States of America']","['Music', 'Period piece', 'Biography', 'Biopic [feature]', 'Biographical film', 'Television movie', 'Drama']",2000,1
24631652,Burning Annie,2007,['United States of America'],"['Drama', 'Indie', 'Parody', 'Romantic drama', 'Comedy', 'Romance Film', 'Romantic comedy']",2000,7
606476,Say Anything...,1989,['United States of America'],"['Romantic drama', 'Comedy', 'Teen', 'Romance Film', 'Drama', 'Coming of age', 'Romantic comedy', 'Comedy-drama']",1980,9
7207768,Ermine and Rhinestones,1925,['United States of America'],"['Silent film', 'Drama']",1920,5
7787290,Dirty Filthy Love,2004,['United Kingdom'],"['Romantic drama', 'Romance Film', 'Comedy-drama', 'Drama']",2000,4
30033405,Pardesi,1993,[],['Action'],1990,3
4241206,Tetsuo II: Body Hammer,1992,['Japan'],"['Thriller', 'World cinema', 'Sci-Fi Horror', 'Creature Film', 'Japanese Movies', 'Horror', 'Science Fiction', 'Fantasy']",1990,2
30033656,Shatranj,1993,['India'],"['Romance Film', 'Drama', 'Comedy film']",1990,3
18712645,"Mirror, Mirror 2: Raven Dance",1994,['United States of America'],"['Teen', 'Horror']",1990,4
4803382,The Anarchist Cookbook,2002,['United States of America'],"['Drama', 'Coming of age', 'Indie', 'Comedy', 'Romantic comedy', 'Black comedy']",2000,2
7446685,Blotto,1930,['United States of America'],"['Short Film', 'Black-and-white', 'Comedy']",1930,0
3020135,The Beast Within,1982,['United States of America'],"['Creature Film', 'B-movie', 'Horror']",1980,2
5734151,Mass,2004,['India'],"['Action/Adventure', 'Drama', 'World cinema']",2000,4
1897496,Provoked,2006,['United Kingdom'],['Drama'],2000,6
8026746,Tot Watchers,1958,['United States of America'],"[""Children's/Family""]",1950,8
12232829,The First Turn-On!,1983,['United States of America'],"['Indie', 'Comedy', 'Sex comedy']",1980,3
16179818,Sasanam,2006,['India'],['Drama'],2000,6
156774,Star Trek Nemesis,2002,['United States of America'],"['Crime Fiction', 'Thriller', 'Adventure', 'Science Fiction']",2000,2
6271212,Mid-Air Crash,1979,['United States of America'],['Drama'],1970,9
2195077,The New Adventures of Tarzan,1935,['United States of America'],"['Action', 'Black-and-white', 'Indie', 'Action/Adventure', 'Jungle Film', 'Adventure']",1930,5
28809499,Golden Arrow,1949,['United Kingdom'],['Comedy'],1940,9
33497207,Stop at Nothing,1991,['United States of America'],['Thriller'],1990,1
2083607,Still Smokin',1983,['United States of America'],"['Stoner film', 'Slapstick', 'Comedy']",1980,3
10745657,Rabbitson Crusoe,1956,['United States of America'],"['Action', 'Short Film', 'Comedy', 'Family Film']",1950,6
15899367,Filming Othello,1978,['West Germany'],['Documentary'],1970,8
19841320,Lost Command,1966,['United States of America'],"['Action', 'Drama', 'Action/Adventure', 'War film']",1960,6
2087175,The Miracle of Our Lady of Fatima,1952,['United States of America'],"['Docudrama', 'Christian film', 'Drama']",1950,2
3447220,Please Don't Eat My Mother,1973,['United States of America'],"['Sexploitation', 'Horror Comedy', 'Comedy', 'Horror', 'B-movie', 'Cult', 'Natural horror films']",1970,3
26057825,Never Too Late,1965,['United States of America'],['Comedy'],1960,5
20121108,Strange Circus,2005,['Japan'],"['Japanese Movies', 'Mystery', 'Thriller', 'World cinema', 'Horror', 'Drama']",2000,5
10203059,"Farewell, My Lovely",1975,['United States of America'],"['Detective fiction', 'Crime Fiction', 'Mystery', 'Thriller', 'Detective']",1970,5
1883157,Singin' in the Rain,1952,['United States of America'],"['Musical', 'Comedy', 'Musical comedy', 'Romance Film']",1950,2
25292924,Mano Po 6: A Mother's Love,2009,"['China', 'Philippines']","['Filipino Movies', 'World cinema', 'Chinese Movies', 'Drama']",2000,9
21180,Natural Born Killers,1994,['United States of America'],"['Crime Fiction', 'Thriller', 'Crime Drama', 'Media Satire', 'Romance Film', 'Road movie', 'Drama']",1990,4
16037718,Looking for Mr. Goodbar,1977,['United States of America'],"['Psychological thriller', 'Film adaptation', 'Feminist Film', 'New Hollywood', 'Erotic thriller', 'Drama']",1970,7
10553723,Humjoli,1970,['India'],"['Romantic drama', 'World cinema', 'Romance Film', 'Drama']",1970,0
194693,Spy Kids 3-D: Game Over,2003,['United States of America'],"['Action', 'Comedy', 'Adventure', 'Science Fiction', 'Family Film']",2000,3
7260740,Bianca,1984,['Italy'],['Comedy'],1980,4
6639892,February 14,2005,"['Taiwan', 'India']","['Short Film', 'Romance Film']",2000,5
1350546,Killer Wave,2006,"['Canada', 'United States of America']","['Disaster', 'Thriller']",2000,6
16146427,Obsessed,2002,['Canada'],"['Crime Fiction', 'Thriller', 'Romance Film', 'Television movie', 'Drama', 'Courtroom Drama']",2000,2
17485007,Aamir,2008,['India'],"['Thriller', 'World cinema']",2000,8
6952880,The World's Greatest Athlete,1973,['United States of America'],"['Comedy', 'Sports', 'Drama', 'Family Film']",1970,3
3583927,2LDK,2004,['Japan'],"['Psychological thriller', 'LGBT', 'Japanese Movies', 'Comedy', 'Thriller', 'World cinema', 'Drama']",2000,4
21665854,Legion of the Dead,2005,['United States of America'],"['Indie', 'Horror', 'B-movie', 'Supernatural']",2000,5
14211990,"Skinny Tiger, Fatty Dragon",1990,['Hong Kong'],"['Action', 'Action Comedy', 'Comedy', 'Chinese Movies', 'Martial Arts Film']",1990,0
5883015,The Lost City,1935,['United States of America'],"['Action', 'Black-and-white', 'Indie', 'Action/Adventure', 'Adventure']",1930,5
2287636,Sleeping Beauty,1959,['United States of America'],"['Musical', 'Animation', 'Romance Film', 'Costume drama', 'Drama', 'Family Film', 'Fantasy']",1950,9
20185493,A Grandpa for Christmas,2007,['United States of America'],"['Comedy film', ""Children's/Family"", 'Holiday Film', 'Christmas movie', 'Drama']",2000,7
6218651,Lal Baadshah,1999,['India'],"['Action/Adventure', 'Thriller', 'World cinema', 'Drama']",1990,9
7684217,Ultimo mondo cannibale,1977,['Italy'],"['Action/Adventure', 'World cinema', 'Horror']",1970,7
7536359,The Sandlot 3,2007,['United States of America'],"['Coming of age', 'Comedy', 'Sports', 'Family Film']",2000,7
14714212,China Girl,1942,['United States of America'],"['War film', 'Drama']",1940,2
2318462,Deuces Wild,2002,"['Germany', 'United States of America']","['Action', 'Period piece', 'Drama', 'Crime Fiction', 'Coming of age', 'Indie']",2000,2
13280124,Grand Tour: Disaster in Time,1992,['United States of America'],"['Time travel', 'Action/Adventure', 'Thriller', 'Adventure', 'Television movie', 'Disaster', 'Science Fiction']",1990,2
12485800,"Bert Rigby, You're a Fool",1989,['United States of America'],"['Musical', 'Americana', 'Comedy']",1980,9
32701850,Army Girl,1938,['United States of America'],"['Romance Film', 'Romantic drama', 'Drama']",1930,8
23863620,Held Hostage,2009,['United States of America'],"['Crime Fiction', 'Television movie', 'Crime Thriller', 'Drama', 'Courtroom Drama']",2000,9
1267738,Aparajito,1956,['India'],"['Art film', 'Coming of age', 'Family Drama', 'Bollywood', 'Bengali Cinema', 'World cinema', 'Drama']",1950,6
2069295,"Snoopy, Come Home",1972,['United States of America'],"['Musical', 'Animation', 'Comedy', ""Children's/Family"", ""Children's"", 'Drama', 'Family Film']",1970,2
25022765,She's Crushed,2009,['United States of America'],"['Slasher', 'Horror']",2000,9
2092559,Herbie Rides Again,1974,['United States of America'],"['Caper story', 'Comedy', ""Children's/Family"", 'Adventure', 'Drama', 'Family Film']",1970,4
15055886,Fireworks Wednesday,2006,['Iran'],"['Marriage Drama', 'Drama', 'World cinema']",2000,6
1173571,The Warriors,1979,['United States of America'],"['Action', 'Crime Fiction', 'Action/Adventure', 'Thriller', 'Drama', 'Cult']",1970,9
19068837,Fragment of Fear,1970,['United Kingdom'],"['Psychological thriller', 'Crime Fiction', 'Mystery', 'Thriller', 'Addiction Drama']",1970,0
26456639,Kung Fu Cult Master,1993,['Hong Kong'],"['Action', 'Action/Adventure', 'Horror Comedy', 'World cinema', 'Chinese Movies', 'Martial Arts Film', 'Horror', 'Wuxia']",1990,3
24062002,Where Got Ghost?,2009,['Singapore'],"['Comedy', 'Horror']",2000,9
25504344,Killer Crocodile,1989,['Italy'],['Horror'],1980,9
4476985,Private Lessons,1980,['United States of America'],"['Statutory rape', 'Coming of age', 'Comedy', 'Erotica']",1980,0
5348774,Kadhalar Dhinam,1999,['India'],"['Romantic drama', 'World cinema', 'Romance Film', 'Drama']",1990,9
22322537,Foolish,1999,['United States of America'],"['Indie', 'Stand-up comedy', 'Comedy film', 'Comedy-drama', 'Drama']",1990,9
503573,Dazed and Confused,1993,['United States of America'],"['Stoner film', 'Indie', 'Comedy', 'Teen', 'Drama', 'Period piece', 'Coming of age', 'Comedy-drama', 'Cult', 'Ensemble Film']",1990,3
1971529,Hiawatha's Rabbit Hunt,1941,['United States of America'],"['Animation', 'Short Film', 'Comedy', 'Family Film']",1940,1
11625324,Mannequin,1937,['United States of America'],"['Black-and-white', 'Drama']",1930,7
7731853,"Laugh, Clown, Laugh",1928,['United States of America'],"['Black-and-white', 'Drama', 'Indie', 'Romantic drama', 'Silent film', 'Romance Film', 'Melodrama']",1920,8
92596,Sayonara,1957,['United States of America'],"['Romantic drama', 'Romance Film', 'War film', 'Drama']",1950,7
2540975,Saint Ange,2004,"['Romania', 'France']","['Psychological thriller', 'Thriller', 'Horror', 'World cinema', 'Supernatural', 'Haunted House Film']",2000,4
2706106,Shunkinshō,1976,['Japan'],['Japanese Movies'],1970,6
1688821,The Silver Fleet,1943,['United Kingdom'],"['War film', 'Black-and-white']",1940,3
31924442,Njattadi,1979,[],['Drama'],1970,9
69625,The Ladykillers,1955,['United Kingdom'],"['Ealing Comedies', 'Crime Fiction', 'Comedy', 'Black comedy']",1950,5
4311750,Duplicate,1998,['India'],"['Comedy', 'Bollywood', 'World cinema']",1990,8
12178589,Mother's Day,1980,['United States of America'],"['Slasher', 'Thriller', 'Horror']",1980,0
12138953,Mulberry Street,2007,['United States of America'],"['Doomsday film', 'Cult', 'Horror']",2000,7
171626,Ali,2001,['United States of America'],"['Period piece', 'Sports', 'Boxing', 'Biography', 'Biographical film', 'Drama']",2000,1
2273984,Thank You for Smoking,2005,['United States of America'],"['Film adaptation', 'Political satire', 'Indie', 'Satire', 'Comedy', 'Black comedy', 'Drama', 'Political cinema', 'Parody', 'Comedy-drama']",2000,5
33109389,The Fire Alarm,1936,[],"['Animation', 'Short Film', 'Family Film']",1930,6
20581282,Annadata,1972,['India'],['Drama'],1970,2
27971019,So Does an Automobile,1939,[],"['Animation', 'Short Film', 'Comedy film', 'Family Film']",1930,9
5363369,Yanks,1979,"['United Kingdom', 'United States of America']","['Period piece', 'Romantic drama', 'Romance Film', 'War film', 'Drama']",1970,9
30247038,Down Our Street,1932,['United Kingdom'],['Drama'],1930,2
2426829,Ashes and Diamonds,1958,['Poland'],"['World cinema', 'War film', 'Political drama', 'Drama']",1950,8
9086301,Goldie,1931,['United States of America'],"['Black-and-white', 'Comedy', 'Romance Film', 'Pre-Code', 'Drama']",1930,1
10536433,License to Wed,2007,['United States of America'],"['Romance Film', 'Romantic comedy', 'Comedy']",2000,7
5875250,Mrs. Harris,2006,['United States of America'],"['Crime Fiction', 'Romantic drama', 'Television movie', 'Drama']",2000,6
6046767,Grayson,2004,['United States of America'],"['Fan film', 'Indie', 'Short Film']",2000,4
284957,Porky's,1982,"['Canada', 'United States of America']","['Coming of age', 'Comedy', 'Teen', 'Sex comedy']",1980,2
5626032,One Good Turn,1931,['United States of America'],"['Short Film', 'Black-and-white', 'Comedy']",1930,1
7252915,Restraint,2008,['Australia'],"['Psychological thriller', 'Suspense', 'Thriller', 'World cinema', 'Drama']",2000,8
24167614,A Life at Stake,1954,['United States of America'],"['Film noir', 'Drama']",1950,4
6115713,Operation: Rabbit,1952,[],"['Animation', 'Short Film', 'Comedy film', 'Family Film']",1950,2
33314767,Code Name: Diamond Head,1977,['United States of America'],"['Action', 'Spy']",1970,7
31887039,Reach for Me,2009,[],"['Drama', 'Comedy']",2000,9
23943237,Her Costly Affair,1996,['United States of America'],['Thriller'],1990,6
4845326,Don,2006,['Netherlands'],['Drama'],2000,6
5208736,Married Life,2007,"['Canada', 'United States of America']","['Period piece', 'Crime Fiction', 'Romance Film', 'Drama']",2000,7
12041854,Singles,2003,['South Korea'],"['Romantic drama', 'World cinema', 'Romance Film', 'Romantic comedy', 'Drama']",2000,3
2915150,Super Hero Central,2004,['United States of America'],['Martial Arts Film'],2000,4
560449,High Sierra,1941,['United States of America'],"['Black-and-white', 'Crime Fiction', 'Gangster Film', 'Mystery', 'Thriller', 'Film noir', 'Crime Thriller', 'Drama', 'Caper story', 'Crime Drama']",1940,1
19824573,The Girlfriend Experience,2009,['United States of America'],"['Indie', 'Comedy', 'Experimental film', 'Drama', 'Slice of life story']",2000,9
760603,Phenomenon,1996,['United States of America'],"['Drama', 'Fantasy']",1990,6
15801310,The Sign of the Ram,1948,['United States of America'],"['Black-and-white', 'Thriller', 'Film noir', 'Drama']",1940,8
30086,The Incredible Shrinking Man,1957,"['United Kingdom', 'United States of America']","['Horror', 'Science Fiction']",1950,7
8505878,Electric Shadows,2005,['China'],"['Period piece', 'Childhood Drama', 'World cinema', 'Chinese Movies', 'Drama']",2000,5
17020718,Lost and Found on a South Sea Island,1923,['United States of America'],"['Black-and-white', 'Silent film', 'Melodrama', 'Adventure', 'Drama']",1920,3
25781444,Sheila Levine Is Dead and Living in New York,1975,['United States of America'],['Comedy'],1970,5
6740261,Eternally Yours,1939,['United States of America'],"['Black-and-white', 'Family Drama', 'Romantic drama', 'Comedy', 'Romance Film', 'Drama']",1930,9
483895,Young Einstein,1989,['Australia'],"['History', 'Parody', 'Comedy', 'Biopic [feature]', 'World cinema', 'Slapstick']",1980,9
5983570,Asterix and the Big Fight,1989,"['France', 'West Germany']","['Animation', 'Comedy', 'Adventure', 'Family Film']",1980,9
7543423,Come September,1961,['United States of America'],"['Romance Film', 'Romantic comedy', 'Comedy']",1960,1
17458139,Rab Ne Bana Di Jodi,2008,['India'],"['Musical', 'Romantic drama', 'Comedy', 'Bollywood', 'World cinema', 'Romance Film', 'Drama']",2000,8
33435391,Agnee,1988,['India'],"['Romantic drama', 'World cinema', 'Romance Film', 'Drama']",1980,8
25240519,A Different Story,1978,['United States of America'],"['LGBT', 'Romantic drama', 'Romance Film', 'Drama']",1970,8
14448028,To a Tee,2006,['United States of America'],"['Gay Themed', 'Gay', 'Gay Interest', 'Romantic comedy', 'Drama']",2000,6
10658893,Kaiyoppu,2007,['India'],['Drama'],2000,7
4932099,A New Leaf,1971,['United States of America'],"['Comedy', 'Black comedy', 'Romantic comedy', 'Romance Film', 'Drama']",1970,1
25911355,Sally of the Sawdust,1925,['United States of America'],"['Comedy', 'Silent film', 'Romantic comedy', 'Melodrama', 'Drama']",1920,5
4440320,Highlander: The Final Dimension,1994,"['United Kingdom', 'France', 'Canada']","['Fantasy Adventure', 'Adventure', 'Sword and sorcery films', 'Science Fiction', 'Fantasy']",1990,4
19521304,Fatal Vacation,1989,['Hong Kong'],"['Action', 'Action/Adventure', 'World cinema', 'Chinese Movies', 'Political thriller']",1980,9
35234888,Kaavalkaaran,1967,['India'],[],1960,7
26609935,Pandora's Box,2008,"['Belgium', 'France', 'Germany', 'Turkey']","['Drama', 'World cinema']",2000,8
26011909,The Messenger,2007,['Turkey'],"['Mystery', 'Fantasy']",2000,7
8527820,Flight of Fury,2007,['United States of America'],"['Action', 'Action/Adventure', 'Thriller']",2000,7
600216,The 'Burbs,1989,['United States of America'],"['Suspense', 'Comedy', 'Thriller', 'Horror', 'Black comedy', 'Cult']",1980,9
15805259,Heroes of the Wild,1927,['United States of America'],"['Action', 'Black-and-white', 'Western', 'Silent film', 'Martial Arts Film']",1920,7
1223711,Far from Heaven,2002,"['France', 'United States of America']","['LGBT', 'Romantic drama', 'Romance Film', 'Drama', 'Period piece', 'Gay Themed', 'Marriage Drama', 'Melodrama']",2000,2
26078841,Parallel college,1991,['India'],"['Drama', 'Comedy']",1990,1
11685641,The Only Thing,1925,['United States of America'],"['Black-and-white', 'Silent film', 'Romance Film', 'Drama']",1920,5
1370246,I Haven't Got a Hat,1935,['United States of America'],"['Short Film', 'Comedy']",1930,5
12073433,The Beginning or the End,1947,['United States of America'],"['Black-and-white', 'Romance Film', 'War film', 'Drama']",1940,7
21851051,The Secrets of Jonathan Sperry,2008,['United States of America'],"['Period piece', 'Family Drama', 'Christian film', ""Children's"", 'Drama', 'Family Film']",2000,8
20617864,"My Boss, My Teacher",2006,['South Korea'],"['Action', 'Comedy']",2000,6
1623267,The Last Dragon,1985,['United States of America'],"['Action', 'Musical', 'Action/Adventure', 'Comedy', 'Mockumentary', 'Martial Arts Film', 'Drama', 'Cult']",1980,5
32792036,Living Dead Girl,2005,[],['Short Film'],2000,5
9796270,Daigoro vs. Goliath,1971,['Japan'],"['Japanese Movies', 'Family Film', 'Fantasy']",1970,1
11387538,Ringing Bell,1978,['Japan'],"['Animation', 'Japanese Movies', 'Anime', 'Drama', 'Family Film']",1970,8
6057891,The Girl He Left Behind,1956,['United States of America'],"['Black-and-white', 'Comedy', 'Adventure', 'Drama']",1950,6
1647182,Mare Nostrum,1926,['United States of America'],"['Spy', 'Black-and-white', 'Indie', 'Silent film']",1920,6
4626174,Naukar Biwi Ka,1983,['India'],['World cinema'],1980,3
944471,Newsies,1992,['United States of America'],"['Musical', 'Period piece', 'Family Drama', 'Musical Drama', 'Drama', 'Family Film']",1990,2
25894953,Tora-san's Promise,1981,['Japan'],['Japanese Movies'],1980,1
31032524,Walk a Crooked Mile,1948,['United States of America'],"['Action', 'Spy', 'Mystery', 'Film noir', 'Melodrama', 'Drama']",1940,8
12770679,Escape from East Berlin,1962,"['Germany', 'United States of America', 'West Germany']","['Drama', 'Docudrama', 'Escape Film']",1960,2
5878174,The Way West,1967,['United States of America'],"['Action', 'Drama', 'Action/Adventure', 'Western']",1960,7
308550,Coal Black and de Sebben Dwarfs,1943,['United States of America'],['Musical'],1940,3
2853254,Iruvar,1997,['India'],"['Biographical film', 'Drama', 'Tamil cinema']",1990,7
29446084,The Bullet Train,1975,['Japan'],"['Disaster', 'Japanese Movies']",1970,5
5454399,Nishi Ginza Station,1958,['Japan'],['Japanese Movies'],1950,8
3987540,The Flying Deuces,1939,['United States of America'],"['Foreign legion', 'Black-and-white', 'Satire', 'Comedy', 'Slapstick']",1930,9
1703740,Big Trouble,2002,['United States of America'],"['Action', 'Crime Fiction', 'Gangster Film', 'Action/Adventure', 'Comedy', 'Black comedy']",2000,2
2620541,The Care Bears' Big Wish Movie,2005,['Canada'],"['Musical', 'Animation', 'Fantasy', 'Computer Animation']",2000,5
9650926,Winter,2009,['India'],['Horror'],2000,9
5153217,The Ghost Galleon,1974,['Spain'],"['Zombie Film', 'World cinema', 'Horror']",1970,4
8068462,Camille,1936,['United States of America'],"['Film adaptation', 'Black-and-white', 'Romantic drama', 'Romance Film', 'Drama']",1930,6
3767190,Man of the House,1995,['United States of America'],"['Comedy', 'Family Film']",1990,5
7174520,A Short Film About Killing,1988,['Poland'],"['Crime Fiction', 'Drama', 'World cinema']",1980,8
25747315,Falling Angels,2003,['Canada'],"['Coming of age', 'Indie', 'Black comedy', 'Drama']",2000,3
28320431,Dr. Pasupathy,1990,['India'],['Comedy film'],1990,0
1273572,Gone to Earth,1950,"['United Kingdom', 'England']","['Romance Film', 'Drama']",1950,0
369790,The Master of Disguise,2002,['United States of America'],"['Comedy', 'Family Film', 'Adventure']",2000,2
9753622,Romanzo Criminale,2005,"['United Kingdom', 'France', 'Italy']","['Drama', 'Crime Fiction']",2000,5
2244052,Arlington Road,1999,['United States of America'],"['Action', 'Psychological thriller', 'Thriller', 'Crime Thriller']",1990,9
27491558,Country Town,1971,['Australia'],['Drama'],1970,1
2510700,Something for Joey,1977,['United States of America'],"['Drama', 'Docudrama', 'Biopic [feature]']",1970,7
2076360,I Love to Singa,1936,['United States of America'],"['Musical', 'Animation', 'Short Film', 'Comedy']",1930,6
13787959,Body,2007,['Thailand'],"['Thriller', 'Horror', 'Erotic thriller', 'World cinema']",2000,7
841551,Invasion of the Bee Girls,1973,['United States of America'],"['Indie', 'Thriller', 'Science Fiction', 'Drama']",1970,3
6768551,Githan,2005,['India'],"['Drama', 'World cinema']",2000,5
13342914,Two Men Went to War,2002,['United Kingdom'],"['War film', 'Comedy']",2000,2
26297740,Heart Beat,1980,['United States of America'],"['Period piece', 'Drama', 'Biopic [feature]']",1980,0
20993667,The Canyon,2009,['United States of America'],"['Psychological thriller', 'Suspense', 'Indie', 'Thriller']",2000,9
24256367,Kakkothikkavile Appooppan Thaadikal,1988,['India'],['Drama'],1980,8
13184162,"Pane, amore e...",1956,['Italy'],['Comedy'],1950,6
15084359,The Red Tent,1969,"['Soviet Union', 'United Kingdom', 'Italy']","['Action', 'Action/Adventure', 'World cinema', 'Docudrama', 'Adventure', 'Drama']",1960,9
920613,Cars,2006,['United States of America'],"['Animation', 'Comedy', ""Children's/Family"", 'Auto racing', 'Adventure', 'Computer Animation', 'Road movie', 'Sports', 'Family Film']",2000,6
30625,The Shawshank Redemption,1994,['United States of America'],"['Prison', 'Drama', 'Crime Fiction', 'Prison film', 'Buddy film', 'Escape Film']",1990,4
2383503,"I Kiss Your Hand, Madame",1929,['Germany'],"['Black-and-white', 'Drama']",1920,9
9271903,Trois,2000,['United States of America'],"['Psychological thriller', 'Indie', 'Thriller', 'Erotic thriller', 'Romance Film']",2000,0
1023043,"Olive, the Other Reindeer",1999,['United States of America'],"[""Children's Fantasy"", ""Children's/Family"", 'Christmas movie']",1990,9
7520173,Raraju,2006,['India'],['Drama'],2000,6
1831039,Timerider: The Adventure of Lyle Swan,1982,['United States of America'],"['Action', 'Time travel', 'Indie', 'Action/Adventure', 'Western', 'Adventure', 'Science Fiction']",1980,2
5090342,Maytime,1937,['United States of America'],"['Musical', 'Black-and-white']",1930,7
32755585,Frogs for Snakes,1998,['United States of America'],"['Crime Fiction', 'Comedy', 'Thriller', 'Comedy Thriller']",1990,8
36435250,OSS 117 n'est pas mort,1957,['France'],"['Drama', 'Crime Fiction']",1950,7
4560018,The Oblong Box,1969,['United Kingdom'],"['Costume Horror', 'Gothic Film', 'Horror']",1960,9
706803,G.I. Jane,1997,['United States of America'],"['Action', 'Drama']",1990,7
4078865,Reign Over Me,2007,['United States of America'],"['Family Drama', 'Buddy film', 'Drama', 'Family Film', 'Tragedy']",2000,7
29420882,When Will I Be Loved?,1990,['United States of America'],['Drama'],1990,0
9865713,The First Deadly Sin,1980,['United States of America'],"['Action', 'Suspense', 'Crime Fiction', 'Thriller', 'Crime Thriller']",1980,0
1647860,Mississippi Mermaid,1969,['France'],"['Crime Fiction', 'Romantic drama', 'Thriller', 'World cinema', 'Romance Film', 'Crime Thriller', 'Drama']",1960,9
32656348,It Isn't Done,1937,['Australia'],['Comedy'],1930,7
5403298,Krysař,1985,"['Czechoslovakia', 'West Germany', 'Czech Republic']","['Stop motion', 'Animation']",1980,5
4121843,Grbavica,2006,"['Austria', 'Croatia', 'Germany', 'Bosnia and Herzegovina']","['Art film', 'Coming of age', 'Family Drama', 'World cinema', 'War film', 'Drama']",2000,6
2636349,Untold Story,1993,['Hong Kong'],"['Chinese Movies', 'Crime Fiction', 'Thriller', 'Horror', 'World cinema']",1990,3
8777894,Dangerous Game,1993,['United States of America'],"['Indie', 'Drama']",1990,3
25211720,Raat Gayi Baat Gayi?,2009,['India'],"['Musical', 'Romantic drama', 'Bollywood', 'World cinema', 'Romance Film', 'Drama']",2000,9
26388629,Gun the Man Down,1956,['United States of America'],"['Action/Adventure', 'Western']",1950,6
2525087,Cool and the Crazy,1994,['United States of America'],"['Crime Fiction', 'Romantic drama', 'Thriller', 'Romance Film', 'Drama', 'Period piece', 'Erotic thriller', 'Television movie']",1990,4
6739865,Satyam,2003,['India'],"['Romantic drama', 'World cinema', 'Romance Film', 'Drama']",2000,3
5422296,Let's Go to Prison,2006,['United States of America'],"['LGBT', 'Crime Fiction', 'Indie', 'Comedy', 'Black comedy']",2000,6
5451062,The French Line,1954,['United States of America'],"['Musical', 'Comedy']",1950,4
8656796,Fiddler on the Roof,1971,['United States of America'],"['Musical', 'Musical Drama', 'Romantic drama', 'Comedy', 'Romance Film', 'Roadshow theatrical release', 'Drama', 'Period piece', 'Comedy-drama', 'Epic']",1970,1
102026,That Thing You Do!,1996,['United States of America'],"['Musical', 'Period piece', 'Comedy', 'Romantic comedy', 'Comedy-drama', 'Drama']",1990,6
29758182,The Scam,2009,['South Korea'],"['Action', 'Crime Fiction', 'Drama']",2000,9
12126070,Dinosaur Island,1994,['United States of America'],"['Animation', 'Adventure', 'Family Film', 'Fantasy']",1990,4
26469255,The Tiger,2005,['India'],"['Action', 'Thriller', 'Bollywood']",2000,5
5819703,Four's a Crowd,1938,['United States of America'],"['Romance Film', 'Screwball comedy', 'Comedy']",1930,8
11943512,The World of Suzie Wong,1960,['United Kingdom'],"['Period piece', 'Romantic drama', 'Romance Film', 'Drama']",1960,0
16055450,If They Tell You I Fell,1989,['Spain'],"['Erotic Drama', 'Thriller', 'World cinema', 'Drama']",1980,9
1683542,Imaginary Heroes,2004,"['Germany', 'United States of America', 'Belgium']","['LGBT', 'Coming of age', 'Family Drama', 'Black comedy', 'Comedy-drama', 'Drama']",2000,4
5022225,Remake,2003,"['France', 'Turkey', 'Bosnia and Herzegovina']",['Drama'],2000,3
25283935,Lake of the Dead,1958,['Norway'],"['Mystery', 'Thriller', 'Horror']",1950,8
30957114,Daku Hasina,1987,[],['Revenge'],1980,7
34709092,"The Girl, the Gold Watch and Dynamite",1981,['United States of America'],"['Television movie', 'Comedy film', 'Fantasy']",1980,1
3829043,The Ghost Goes West,1935,['United Kingdom'],"['Black-and-white', 'Comedy', 'Fantasy Comedy', 'Fantasy']",1930,5
24992742,The Mountain Calls,1938,['Germany'],['Drama'],1930,8
20109381,Voices,2007,['South Korea'],"['Slasher', 'World cinema', 'Horror']",2000,7
1699805,Alien Apocalypse,2005,['United States of America'],"['Dystopia', 'Horror', 'Television movie', 'Alien Film', 'Science Fiction']",2000,5
2275790,The Crazies,1973,['United States of America'],"['Action', 'Indie', 'Action/Adventure', 'Thriller', 'Disaster', 'Horror', 'B-movie', 'Doomsday film', 'Science Fiction', 'Cult']",1970,3
2914693,A Foreign Affair,1948,['United States of America'],"['Comedy', 'Satire', 'Romance Film', 'Romantic comedy']",1940,8
11235553,Mere Apne,1971,['India'],"['Drama', 'World cinema']",1970,1
10944211,Angel,1982,"['United Kingdom', 'Ireland', 'Greece']","['Musical', 'LGBT', 'World cinema', 'Drama']",1980,2
1377041,Tom and Jerry: The Movie,1992,['United States of America'],"['Musical', 'Animation', 'Comedy', 'Family-Oriented Adventure', ""Children's/Family"", 'Family Film']",1990,2
9802830,Pillow of Death,1945,['United States of America'],"['Mystery', 'Crime Fiction']",1940,5
31114108,Stopover Tokyo,1957,['United States of America'],"['Action', 'Spy', 'Film adaptation', 'Romantic drama', 'Thriller', 'Romance Film', 'Glamorized Spy Film', 'Drama']",1950,7
12098561,Busting,1974,['United States of America'],"['Action', 'Crime Fiction', 'Action/Adventure', 'Buddy film', 'Comedy', 'Comedy-drama', 'Drama']",1970,4
3648919,Today You Die,2005,['United States of America'],"['Action', 'Crime Fiction', 'Action/Adventure', 'Thriller', 'Crime Thriller', 'Martial Arts Film']",2000,5
29982473,Rock Slyde,2009,['United States of America'],"['Mystery', 'Indie', 'Comedy', 'Thriller', 'Crime Thriller']",2000,9
2725470,The Naked Kiss,1964,['United States of America'],"['Suspense', 'Black-and-white', 'Drama', 'Indie', 'Crime Drama', 'Film noir', 'Melodrama']",1960,4
25420188,New Delhi,1987,['India'],"['Action', 'Thriller', 'Bollywood']",1980,7
7890513,Badri,2001,['India'],"['Action', 'Sports']",2000,1
13313093,Red Garters,1954,['United States of America'],"['Musical', 'Comedy Western', 'Parody', 'Action/Adventure', 'Western']",1950,4
17569375,Tarzan and the Jungle Boy,1968,"['Switzerland', 'United States of America']","['Adventure', 'Jungle Film']",1960,8
2339194,He Walked by Night,1948,"['United Kingdom', 'United States of America']","['Black-and-white', 'Crime Fiction', 'Thriller', 'Film noir', 'Crime Thriller', 'Drama']",1940,8
4866535,American Gun,2005,['United States of America'],"['Indie', 'Drama']",2000,5
1326081,Om Jai Jagadish,2002,['India'],"['Family Drama', 'Drama', 'World cinema']",2000,2
1992837,The Big Steal,1949,['United States of America'],"['Film noir', 'Black-and-white', 'Thriller']",1940,9
2638362,Emma,1996,"['United Kingdom', 'United States of America']","['Film adaptation', 'Comedy', 'Romance Film', 'Romantic comedy', 'Costume drama', 'Drama']",1990,6
18589876,First Yank into Tokyo,1945,['United States of America'],"['Black-and-white', 'War film', 'Drama']",1940,5
232711,The Truman Show,1998,['United States of America'],"['Comedy', 'Media Satire', 'Drama', 'Parody', 'Existentialism', 'Comedy-drama', 'Science Fiction', 'Fantasy']",1990,8
7076105,Boss,2006,['India'],"['Musical', 'Romantic drama', 'World cinema', 'Romance Film', 'Tollywood', 'Drama']",2000,6
19006017,Jack and the Witch,1967,['Japan'],"['Japanese Movies', 'Anime', 'Adventure']",1960,7
1349518,Les Tontons flingueurs,1963,"['France', 'West Germany']","['Gangster Film', 'Comedy', 'Crime Comedy', 'World cinema']",1960,3
16458577,The English Surgeon,2007,['United Kingdom'],"['Social issues', 'Health & Fitness', 'Biography', 'Documentary', 'Drama', 'Culture & Society']",2000,7
27594853,Permanent Vacation,2007,['United States of America'],"['Black comedy', 'Indie', 'Comedy']",2000,7
21538066,Middle of the Night,1959,['United States of America'],"['Black-and-white', 'Drama']",1950,9
34057325,Hiling,1998,[],"['Family Film', 'Drama', 'Comedy film']",1990,8
2216810,The Anniversary Party,2001,['United States of America'],"['Drama', 'Indie', 'Marriage Drama', 'Comedy', 'Black comedy', 'Comedy-drama', 'Ensemble Film']",2000,1
25447026,Devanthakudu,1984,['India'],"['Action', 'Crime Fiction', 'Drama']",1980,4
1015441,Angels Revenge,1979,['United States of America'],['Action'],1970,9
16808338,Subdivision,2009,['Australia'],"['Drama', 'Comedy film']",2000,9
19742300,Aerial Gunner,1943,['United States of America'],['War film'],1940,3
21759238,Destination Anywhere: The Film,1997,['United States of America'],['Drama'],1990,7
10556722,Astro Boy,2009,"['Hong Kong', 'Japan', 'United States of America']","['Action', 'Adventure Comedy', 'Animation', 'Action/Adventure', 'World cinema', ""Children's/Family"", 'Chinese Movies', 'Adventure', 'Computer Animation', 'Japanese Movies', 'Superhero movie', 'Anime', 'Science Fiction', 'Family Film']",2000,9
18426081,The Herdsman,1982,['China'],"['Chinese Movies', 'Drama']",1980,2
2681108,Voces inocentes,2004,"['Mexico', 'Puerto Rico', 'United States of America']","['War film', 'Drama', 'World cinema']",2000,4
29473043,Pyar Hua Chori Chori,1991,['India'],['Romance Film'],1990,1
12992103,Hold the Dream,1986,['United Kingdom'],"['Romantic drama', 'Family Drama', 'Drama']",1980,6
9556173,Trouble in Store,1953,['United Kingdom'],"['Black-and-white', 'Screwball comedy', 'Comedy', 'Slapstick']",1950,3
8016280,O Ano em Que Meus Pais Sairam de Férias,2006,['Brazil'],"['Coming of age', 'Drama', 'World cinema']",2000,6
9810279,Spring Fever,1982,"['Canada', 'United States of America']","['Indie', 'Comedy film', 'Sports', 'Drama']",1980,2
14818617,Pokrovsky Gates,1982,['Soviet Union'],['Comedy'],1980,2
11122446,Boxer's Adventure,1979,['Hong Kong'],"['Action', 'Action/Adventure', 'World cinema', 'Chinese Movies', 'Martial Arts Film']",1970,9
568034,Free Willy,1993,"['France', 'United States of America']","['Animal Picture', 'Family-Oriented Adventure', ""Children's/Family"", 'Adventure', 'Drama', 'Family Film']",1990,3
35228678,The Comeback Kid,1980,['United States of America'],"['Romance Film', 'Sports', 'Comedy film']",1980,0
13266463,Mandarin Mix-Up,1924,['United States of America'],"['Black-and-white', 'Indie', 'Short Film', 'Silent film']",1920,4
4891419,Twins of Evil,1972,['United Kingdom'],"['Erotica', 'Cult', 'Horror']",1970,2
9447602,Waiting for the Messiah,2004,"['Argentina', 'Spain', 'Italy']","['LGBT', 'Drama', 'Indie', 'Romantic drama', 'Comedy', 'World cinema', 'Romance Film']",2000,4
4569027,Chupke Chupke,1975,['India'],"['Comedy', 'World cinema']",1970,5
2997971,Drumline,2002,['United States of America'],"['Musical Drama', 'Comedy', 'Teen', 'Romance Film', 'Drama', 'Coming of age', 'Romantic comedy', 'Comedy-drama']",2000,2
10649757,Something to Sing About,1937,['United States of America'],['Black-and-white'],1930,7
419688,Lady Liberty,1971,"['France', 'Italy']",['Comedy'],1970,1
1605120,Smile,2005,"['China', 'United States of America']","['Drama', 'Indie', 'Christian film', 'Chinese Movies']",2000,5
28131005,Robbery Alla Turca,2005,['Turkey'],"['Crime Fiction', 'Adventure', 'Comedy film']",2000,5
8904214,4 the People,2004,['India'],"['Drama', 'World cinema']",2000,4
19187224,I Love You,2007,['India'],['Romance Film'],2000,7
28327,Stargate,1994,"['United States of America', 'France']","['Action', 'Thriller', 'Adventure', 'Sci-Fi Adventure', 'Science Fiction']",1990,4
5804128,The Power,1968,['United States of America'],['Science Fiction'],1960,8
29163959,Merrily We Go to Hell,1932,['United States of America'],['Pre-Code'],1930,2
16312328,Hustle,1975,['United States of America'],"['Crime Fiction', 'Mystery', 'Thriller', 'Film noir', 'Crime Thriller', 'Drama']",1970,5
24301781,For Those Who Think Young,1964,['United States of America'],"['Comedy', 'Romance Film', 'Romantic comedy', 'Beach Film', 'Cult']",1960,4
20574919,The Fox Family,2006,['South Korea'],"['Musical', 'Comedy', 'Fantasy']",2000,6
8164826,Anna Karenina,1935,['United States of America'],"['Film adaptation', 'Black-and-white', 'Romantic drama', 'Romance Film', 'Costume drama', 'Drama']",1930,5
18401584,Somewhere in Dreamland,1936,[],"['Animation', 'Short Film', 'Family Film', 'Fantasy']",1930,6
13331589,Something Always Happens,1934,['United Kingdom'],"['Romance Film', 'Comedy']",1930,4
1400602,The Twins Effect,2003,['Hong Kong'],"['Action', 'Action/Adventure', 'Comedy', 'World cinema', 'Chinese Movies', 'Martial Arts Film', 'Action Comedy', 'Horror']",2000,3
21736720,Love Simple,2009,['United States of America'],"['Romance Film', 'Indie', 'Comedy']",2000,9
20579750,Pavitra Paapi,1970,['India'],"['Drama', 'World cinema']",1970,0
10702360,Boy Friend,1961,['India'],"['Musical', 'Comedy', 'Bollywood', 'World cinema']",1960,1
3881308,Something New,2006,['United States of America'],"['Romance Film', 'Comedy', 'Drama']",2000,6
10131333,Zoom and Bored,1957,['United States of America'],['Short Film'],1950,7
11691063,Guyana Tragedy: The Story of Jim Jones,1980,['United States of America'],"['Drama', 'Docudrama', 'Biopic [feature]']",1980,0
4272659,Jack Frost 2: Revenge of the Mutant Killer Snowman,2000,['United States of America'],"['Monster movie', 'Comedy', 'Slasher', 'Comedy film', 'Horror', 'B-movie', 'Fantasy']",2000,0
1274324,Spanglish,2004,['United States of America'],"['Romantic drama', 'Comedy', 'Romance Film', 'Drama', 'Domestic Comedy', 'Romantic comedy', 'Comedy-drama', 'Slice of life story']",2000,4
3129169,Samaritan Girl,2004,['South Korea'],"['Drama', 'World cinema']",2000,4
28545685,Arie,2004,['Russia'],['Drama'],2000,4
25924564,Aparoopa,1982,[],[],1980,2
5919853,The New Women,1935,"['China', 'Taiwan']","['Black-and-white', 'Indie', 'Silent film', 'Chinese Movies', 'Tragedy']",1930,5
1487371,Eulogy,2004,"['United Kingdom', 'Germany', 'United States of America']","['LGBT', 'Indie', 'Comedy', 'Black comedy']",2000,4
35633531,2061 – An exceptional year,2007,['Italy'],['Comedy film'],2000,7
7936993,The V Word,2007,['United States of America'],"['Creature Film', 'Television movie', 'Horror']",2000,7
19192760,Let's Make Music,1941,['United States of America'],"['Musical', 'Black-and-white']",1940,1
13905653,You'll Get Over It,2003,['France'],"['LGBT', 'World cinema', 'Drama', 'Gay Themed', 'Gay', 'Coming of age', 'Gay Interest', 'Comedy-drama']",2000,3
16167607,Thenkasi Pattanam,2002,['India'],"['Action', 'Comedy']",2000,2
6406551,Johnny Was,2006,"['Ireland', 'United Kingdom']","['Action', 'Crime Fiction', 'Action/Adventure', 'Thriller', 'Crime Drama', 'Drama']",2000,6
7627172,The Magic Bullet,1940,['United States of America'],"['Black-and-white', 'Biographical film']",1940,0
32916959,The Hound of the Deep,1926,[],"['Adventure', 'Drama']",1920,6
4179778,Heart Condition,1990,['United States of America'],"['Heavenly Comedy', 'Buddy film', 'Comedy', 'Fantasy Comedy', 'Drama', 'Fantasy']",1990,0
1624525,The Krays,1990,['United Kingdom'],"['Crime Fiction', 'Gangster Film', 'Biography', 'Biographical film', 'Drama', 'Period piece', 'Biopic [feature]', 'Crime Drama']",1990,0
15439159,Kanchivaram,2008,['India'],"['Period piece', 'World cinema', 'Drama', 'Slice of life story']",2000,8
42856,The Bridge on the River Kwai,1957,"['United Kingdom', 'United States of America']","['War film', 'Adventure', 'Drama', 'Ensemble Film']",1950,7
12004,Godzilla,1954,['Japan'],"['Black-and-white', 'Monster', 'Japanese Movies', 'Horror', 'World cinema', 'Science Fiction', 'Doomsday film']",1950,4
4067925,Chemman Chaalai,2005,['Malaysia'],['Drama'],2000,5
26021982,Tora-san Goes North,1987,['Japan'],['Japanese Movies'],1980,7
509792,Frida,2002,"['Mexico', 'United States of America', 'Canada']","['Period piece', 'Romantic drama', 'Biography', 'Biographical film', 'Romance Film', 'Political drama', 'Drama']",2000,2
17931096,When Strangers Appear,2001,"['New Zealand', 'Australia', 'United States of America']","['Psychological thriller', 'Suspense', 'Mystery', 'Thriller', 'Crime Thriller']",2000,1
730734,Scooby-Doo 2: Monsters Unleashed,2004,"['Canada', 'United States of America']","['Action', 'Mystery', 'Comedy', 'Teen', 'Family-Oriented Adventure', ""Children's/Family"", 'Slapstick', 'Adventure', 'Horror', 'Fantasy Comedy', 'Family Film', 'Fantasy']",2000,4
27199407,The Wind Cannot Read,1958,['England'],"['Romance Film', 'Drama']",1950,8
11699443,12:01 PM,1990,['United States of America'],"['Psychological thriller', 'Short Film', 'Science Fiction']",1990,0
18876023,Dragonworld,1994,['United States of America'],"[""Children's Fantasy"", ""Children's/Family"", 'Sword and sorcery films', 'Adventure', 'Fantasy']",1990,4
1399043,Assault on Precinct 13,2005,"['United States of America', 'France']","['Action', 'Action/Adventure', 'Thriller', 'Remake', 'Crime Thriller']",2000,5
2852830,Aragami,2003,['Japan'],"['Japanese Movies', 'Action/Adventure', 'Thriller', 'World cinema', 'Drama']",2000,3
14106445,Coupe de Ville,1990,['United States of America'],"['Road movie', 'Comedy', 'Adventure']",1990,0
19204182,A French Mistress,1961,['United Kingdom'],['Comedy'],1960,1
16490737,Pandi,2008,['India'],"['Romance Film', 'Drama']",2000,8
14143898,The Monster and the Ape,1945,['United States of America'],"['Black-and-white', 'Adventure', 'Sci-Fi Adventure', 'Science Fiction']",1940,5
770156,But I'm a Cheerleader,1999,['United States of America'],"['Satire', 'Comedy', 'Teen', 'Drama', 'Gay Themed', 'Gay', 'Gay Interest', 'Romantic comedy', 'Comedy-drama']",1990,9
1631497,Hard Target,1993,['United States of America'],"['Action', 'Action Thrillers', 'Chase Movie', 'Thriller', 'Martial Arts Film']",1990,3
34883760,Appula Apparao,1991,['India'],"['Bollywood', 'Comedy film', 'World cinema']",1990,1
1970341,The Wild Ride,1960,['United States of America'],"['Chase Movie', 'Drama']",1960,0
525486,The Mission,1986,['United Kingdom'],"['Period piece', 'Christian film', 'Costume drama', 'Adventure', 'Drama']",1980,6
26038444,Kaliyoonjal,1997,['India'],['Drama'],1990,7
10822975,Once an Eagle,1976,['United States of America'],"['Drama', 'War film', 'Thriller']",1970,6
570227,Godzilla vs. Gigan,1972,['Japan'],"['Creature Film', 'Japanese Movies', 'Monster', 'World cinema', 'Science Fiction', 'Cult', 'Fantasy']",1970,2
18141105,Get Smart's Bruce & Lloyd Out of Control,2008,['United States of America'],"['Action', 'Action/Adventure', 'Comedy']",2000,8
4424287,Freeze out,2005,['United States of America'],"['Western', 'Comedy', 'Drama']",2000,5
6201873,The Winslow Boy,1999,"['United Kingdom', 'United States of America']","['Romance Film', 'Drama', 'Courtroom Drama']",1990,9
14120714,Escape,1940,['United States of America'],"['Black-and-white', 'Drama']",1940,0
8850351,Evil Bong,2006,['United States of America'],"['Stoner film', 'Comedy', 'Horror Comedy', 'Horror', 'Black comedy', 'Cult']",2000,6
629072,Hard Eight,1996,['United States of America'],"['Crime Fiction', 'Indie', 'Thriller', 'Crime Drama', 'Drama']",1990,6
34420824,Pudhu Vasantham,1990,['India'],[],1990,0
10487,Evil Dead II,1987,['United States of America'],"['Splatter film', 'Comedy', 'Horror', 'Black comedy', 'Zombie Film', 'Stop motion', 'Cult']",1980,7
22352204,Crossworlds,1996,['United States of America'],"['Action', 'Comedy', 'Adventure', 'Science Fiction']",1990,6
20479983,Captain Prabhakaran,1991,['India'],['Action'],1990,1
28344574,World Cupp 2011,2009,[],"['Crime Fiction', 'Sports', 'Drama']",2000,9
8089406,Family Resemblances,1996,['France'],"['Comedy', 'World cinema']",1990,6
10770671,American Yearbook,2004,['United States of America'],"['Romance Film', 'Thriller']",2000,4
2473644,Fullmetal Alchemist the Movie: Conqueror of Shamballa,2005,['Japan'],"['Action', 'Animation', 'World cinema', 'Adventure', 'Drama', 'Japanese Movies', 'Anime', 'Fantasy']",2000,5
438548,Blackadder: Back & Forth,1999,['United Kingdom'],"['Science Fiction', 'Short Film', 'Comedy']",1990,9
3170133,Solomon & Gaenor,1999,['United Kingdom'],"['Period piece', 'Romantic drama', 'Romance Film', 'Drama']",1990,9
21426256,Maurie,1973,['United States of America'],"['Indie', 'Biographical film', 'Sports', 'Drama']",1970,3
10916960,The Young Doctors,1961,['United States of America'],"['Melodrama', 'Drama', 'Medical fiction']",1960,1
7088713,Devil Doll,1964,['United Kingdom'],"['Cult', 'Horror']",1960,4
67433,The Prince of Central Park,2000,['United States of America'],"['Film adaptation', 'Drama', 'Indie', 'Childhood Drama']",2000,0
3259315,Forever Mine,1999,"['United Kingdom', 'United States of America', 'Canada']","['Crime Fiction', 'Indie', 'Romantic drama', 'Thriller', 'Romance Film', 'Crime Thriller', 'Drama', 'Period piece', 'Erotic thriller', 'Crime Drama']",1990,9
23637837,Angaaray,1998,['India'],"['Action', 'Crime Fiction', 'Drama']",1990,8
1840870,Rising Sun,1993,['United States of America'],"['Action', 'Suspense', 'Crime Fiction', 'Mystery', 'Thriller', 'Crime Thriller', 'Drama']",1990,3
21605606,The Sleeping Child,2004,"['Spain', 'Morocco', 'Belgium']",['Drama'],2000,4
9285865,Gowtam SSC,2005,['India'],['Drama'],2000,5
26128099,The Book of Caleb,2008,['United States of America'],"['Indie', 'Comedy']",2000,8
2372967,Closet Land,1991,['United States of America'],"['Psychological thriller', 'Dystopia', 'Indie', 'Political drama', 'Drama']",1990,1
6506391,Berlin Alexanderplatz,1980,"['Germany', 'West Germany', 'Italy']",['Drama'],1980,0
10227082,Going Spanish,1934,['United States of America'],"['Musical', 'Black-and-white', 'Short Film', 'Comedy']",1930,4
20113019,Jackie's Back,2001,['United States of America'],"['Indie', 'Parody', 'Comedy', 'Mockumentary', 'Drama']",2000,1
11439529,Costa!,2001,['Netherlands'],"['Romance Film', 'Comedy']",2000,1
171939,Small Soldiers,1998,['United States of America'],"['Action', 'Comedy', 'Adventure', 'Action Comedy', 'Science Fiction', 'Fantasy Comedy', 'Family Film', 'Fantasy']",1990,8
905971,¡Three Amigos!,1986,['United States of America'],"['Musical', 'Parody', 'Action/Adventure', 'Western', 'Comedy', 'Adventure']",1980,6
4600467,Portland Street Blues,1998,['Hong Kong'],"['Action', 'Crime Fiction', 'Action Thrillers', 'Gangster Film', 'Action/Adventure', 'Thriller', 'World cinema', 'Chinese Movies', 'Martial Arts Film']",1990,8
14739568,Hula-La-La,1951,['United States of America'],"['Black-and-white', 'Short Film', 'Comedy', 'Slapstick']",1950,1
17432755,China is Near,1967,['Italy'],['Drama'],1960,7
2160782,The Small One,1978,['United States of America'],"[""Children's/Family"", 'Short Film', 'Adventure']",1970,8
11841381,Bye Bye Love,1995,['United States of America'],"['Comedy', 'Romance Film', 'Romantic comedy', 'Domestic Comedy', 'Comedy-drama', 'Ensemble Film']",1990,5
6996468,Twin Falls Idaho,1999,['United States of America'],"['Romantic drama', 'Family Drama', 'Indie', 'Romance Film', 'Drama']",1990,9
14021024,Low Life,2004,['South Korea'],"['Action', 'Crime Fiction', 'Drama']",2000,4
23107879,While the Children Sleep,2007,['United States of America'],"['Psychological thriller', 'Suspense', 'Mystery', 'Thriller', 'Television movie', 'Crime Thriller', 'Drama']",2000,7
17188776,The Experts,1989,"['Canada', 'United States of America']","['Action', 'Spy', 'Action/Adventure', 'Comedy Thriller', 'Thriller', 'Comedy', 'Adventure']",1980,9
25542820,Mano Po 4: Ako Legal Wife,2005,['Philippines'],"['Filipino Movies', 'Comedy', 'World cinema', 'Drama']",2000,5
31209195,Padatha Painkili,1957,[],['Drama'],1950,7
2018332,The Street with No Name,1948,['United States of America'],"['Black-and-white', 'Crime Fiction', 'Gangster Film', 'Thriller', 'Film noir', 'Crime Thriller', 'Drama']",1940,8
1756460,The Cure,1995,['United States of America'],"['LGBT', 'Family Drama', 'Buddy film', 'Comedy', 'Adventure', 'Drama', 'Coming of age', 'Family Film']",1990,5
8009156,Oliver the Eighth,1934,['United States of America'],"['Short Film', 'Black-and-white', 'Comedy']",1930,4
13737266,How to Steal the World,1969,['United States of America'],"['Action', 'Spy', 'Crime Fiction', 'Mystery', 'Thriller', 'Master Criminal Films', 'Adventure']",1960,9
3043131,Death Tunnel,2005,['United States of America'],"['Haunted House Film', 'Horror']",2000,5
9009812,Montenegro,1981,['Sweden'],"['Romantic drama', 'Satire', 'Comedy', 'World cinema', 'Romance Film', 'Black comedy', 'Drama', 'Political cinema', 'Parody', 'Romantic comedy', 'Political drama', 'Sex comedy']",1980,1
11088642,The Treasure of the Sierra Madre,1948,['United States of America'],"['Black-and-white', 'Western', 'Action/Adventure', 'Adventure', 'Drama']",1940,8
2384482,Bound by Honor,1993,['United States of America'],"['Action', 'Drama', 'Crime Fiction', 'Thriller']",1990,3
7274998,Buffet froid,1979,['France'],"['Crime Fiction', 'Comedy', 'Crime Comedy', 'Black comedy']",1970,9
11396051,L'Atlantide,1921,['France'],"['Black-and-white', 'Drama', 'Indie', 'World cinema', 'Silent film', 'Fantasy']",1920,1
24048670,Skull Heads,2009,['United States of America'],"['Monster movie', 'B-movie', 'Horror']",2000,9
3069436,The Night the Lights Went Out in Georgia,1981,['United States of America'],"['Indie', 'Drama']",1980,1
2839258,The Burning,1981,"['Hong Kong', 'United States of America', 'Canada']","['Slasher', 'Teen', 'Horror']",1980,1
125563,Jailhouse Rock,1957,['United States of America'],"['Musical', 'Prison', 'Musical comedy', 'Drama']",1950,7
767099,The Sword and the Rose,1953,['United States of America'],"['Swashbuckler films', 'History', 'Historical fiction', 'Costume drama', 'Adventure', 'Drama', 'Family Film']",1950,3
24225138,Ride the Wild Surf,1964,['United States of America'],"['Sports', 'Comedy']",1960,4
16089223,Lord Love a Duck,1966,['United States of America'],"['Film adaptation', 'Parody', 'Comedy', 'Teen', 'Black comedy', 'Drama']",1960,6
11487271,Voice of a Murderer,2007,['South Korea'],"['Drama', 'Thriller', 'World cinema']",2000,7
113454,Prizzi's Honor,1985,['United States of America'],"['Action', 'Film adaptation', 'Crime Fiction', 'Gangster Film', 'Action/Adventure', 'Comedy', 'Romance Film', 'Black comedy', 'Drama', 'Crime Comedy', 'Romantic comedy']",1980,5
5338985,Fingerprints,2007,['United States of America'],"['Mystery', 'Thriller', 'Horror']",2000,7
15860207,Old Dogs,2009,['United States of America'],"['Buddy film', 'Comedy', 'Family Film']",2000,9
31026092,Amor y sexo,1964,['Mexico'],['Drama'],1960,4
165289,Hercules,1997,['United States of America'],"['Music', 'Animation', 'Comedy', ""Children's"", 'Costume drama', 'Adventure', 'Family Film', 'Fantasy']",1990,7
6971535,Laura,1979,['France'],"['Romance Film', 'Drama']",1970,9
16663872,Valley of Angels,2008,['United States of America'],"['Action', 'Drama', 'Crime Fiction', 'Indie', 'Thriller', 'Crime Thriller']",2000,8
10704002,Sagina Mahato,1971,['India'],['Drama'],1970,1
7156581,Still Green,2006,['United States of America'],"['Drama', 'Indie', 'Romantic drama', 'Slasher', 'Horror', 'Romance Film']",2000,6
12138084,Militia,2000,['United States of America'],"['Action', 'Drama', 'Crime Fiction', 'Action Thrillers', 'Indie', 'Action/Adventure', 'Thriller']",2000,0
3673436,You Only Live Once,1937,['United States of America'],"['Black-and-white', 'Crime Fiction', 'Romantic drama', 'Film noir', 'Romance Film', 'Drama']",1930,7
19104545,Boy Slaves,1939,['United States of America'],"['Black-and-white', 'Drama']",1930,9
31640039,Satan's Baby Doll,1982,[],['Horror'],1980,2
17844049,Strays,1997,['United States of America'],"['Crime Fiction', 'Indie', 'Drama']",1990,7
92582,Giant,1956,['United States of America'],"['Action/Adventure', 'Western', 'Epic', 'Drama']",1950,6
1600828,Thunderbird 6,1968,['United Kingdom'],"['Action', 'Supermarionation', 'Adventure', ""Children's/Family"", 'Science Fiction', 'Drama']",1960,8
3177047,Two Tars,1928,['United States of America'],"['Black-and-white', 'Indie', 'Short Film', 'Comedy', 'Silent film', 'Slapstick']",1920,8
35908536,The Square Jungle,1955,['United States of America'],['Drama'],1950,5
5358915,Case Closed: The Phantom of Baker Street,2002,['Japan'],"['Action', 'Animation', 'Japanese Movies', 'Thriller', 'World cinema', 'Crime Thriller', 'Anime']",2000,2
7514906,Parthiban Kanavu,2003,['India'],"['Romantic drama', 'World cinema', 'Romance Film', 'Drama']",2000,3
76030,The Producers,1968,['United States of America'],"['Musical', 'LGBT', 'Parody', 'Comedy']",1960,8
6394953,Believe In Me,2005,['United States of America'],"['Family Drama', 'Sports', 'Drama', 'Family Film']",2000,5
7032516,John Paul Jones,1959,['United States of America'],"['Biographical film', 'Biopic [feature]', 'Historical fiction', 'Drama']",1950,9
6856411,Four Sons,1928,['United States of America'],"['Black-and-white', 'Silent film', 'War film', 'Drama']",1920,8
32212761,Pups,1999,['United States of America'],"['Crime Fiction', 'Thriller', 'Crime Thriller', 'Drama']",1990,9
26554950,Anna Lucasta,1958,['United States of America'],"['Romance Film', 'Romantic drama', 'Drama']",1950,8
18943833,Striptease,1996,['United States of America'],"['Film adaptation', 'Crime Fiction', 'Satire', 'Comedy', 'Crime Thriller', 'Drama', 'Erotica', 'Sex comedy']",1990,6
28858082,The Gateway of Europe,1999,[],['Historical fiction'],1990,9
6613889,Bloodfist IV: Die Trying,1992,['United States of America'],"['Action', 'Action Thrillers', 'Indie', 'Action/Adventure', 'Thriller', 'Martial Arts Film', 'Adventure']",1990,2
21817139,Bandido,1956,"['Mexico', 'United States of America']","['Action', 'Western']",1950,6
2353166,What Price Hollywood?,1932,['United States of America'],"['Black-and-white', 'Drama']",1930,2
20137083,A Message to Gracias,1963,['United States of America'],"['Animation', 'Short Film', 'Comedy', 'Family Film']",1960,3
16807542,I ragazzi di via Panisperna,1989,"['West Germany', 'Italy']","['Historical fiction', 'Drama']",1980,9
682257,Set It Off,1996,['United States of America'],"['Action', 'LGBT', 'Crime Fiction', 'Action/Adventure', 'Buddy film', 'Thriller', 'Crime Thriller', 'Adventure', 'Drama', 'Heist']",1990,6
3947300,Cavalcade,1933,['United States of America'],"['Musical', 'Black-and-white', 'Pre-Code', 'Drama']",1930,3
1322762,Kitty Kornered,1946,['United States of America'],['Comedy'],1940,6
10327104,I Want Someone to Eat Cheese With,2007,['United States of America'],"['Indie', 'Comedy', 'Romance Film', 'Romantic comedy']",2000,7
19197890,Universalove,2008,"['Luxembourg', 'Serbia', 'Austria']","['Romantic drama', 'World cinema', 'Romance Film', 'Drama']",2000,8
706713,Jeans,1998,['India'],"['Comedy', 'World cinema', 'Tamil cinema', 'Drama']",1990,8
3623774,Gnomes,1980,['United States of America'],"[""Children's Fantasy"", 'Animation', 'Fantasy']",1980,0
690868,Rio Grande,1950,['United States of America'],"['Western', 'Black-and-white', 'Action/Adventure']",1950,0
18851588,Divergence,2005,['Hong Kong'],"['Action', 'Action/Adventure', 'Thriller', 'World cinema', 'Crime Thriller', 'Chinese Movies', 'Drama']",2000,5
12291803,Trapeze,1956,['United States of America'],['Drama'],1950,6
25035877,Adrift,2009,['Vietnam'],"['LGBT', 'Drama', 'World cinema']",2000,9
28455006,The World Owes Me a Living,1945,['United Kingdom'],"['Romance Film', 'War film', 'Drama']",1940,5
19109077,"C'est pas moi, je le jure!",2008,['Canada'],"['Period piece', 'Indie', 'Comedy', 'Drama']",2000,8
8237560,Gunhed,1989,['Japan'],"['Japanese Movies', 'Action/Adventure', 'Science Fiction', 'World cinema']",1980,9
18002266,True Confession,1937,['United States of America'],"['Black-and-white', 'Screwball comedy', 'Comedy']",1930,7
10645970,Rocky,1981,['India'],"['Musical', 'Romantic drama', 'Bollywood', 'World cinema', 'Romance Film', 'Drama']",1980,1
25655893,Mucho Locos,1966,[],"['Animation', 'Short Film', 'Comedy', 'Family Film']",1960,6
21622740,Adrift In Tokyo,2007,['Japan'],"['Japanese Movies', 'Comedy', 'World cinema']",2000,7
695522,At the Circus,1939,['United States of America'],"['Musical', 'Black-and-white', 'Satire', 'Comedy', 'Slapstick']",1930,9
3868588,Someone Special,2004,['South Korea'],"['Romantic comedy', 'Comedy']",2000,4
18662497,Susuk,2008,['Malaysia'],"['Thriller', 'Horror']",2000,8
5609599,A Touch of Spice,2003,['Greece'],"['Comedy', 'World cinema', 'Political drama', 'Drama']",2000,3
25084917,Antibodies,2005,['Germany'],"['Psychological thriller', 'Thriller', 'World cinema', 'Crime Thriller']",2000,5
8828196,The Warrior Class,2004,['United States of America'],"['Crime Fiction', 'Thriller', 'Crime Thriller', 'Drama', 'Courtroom Drama']",2000,4
8613295,Hathyar,1989,['India'],['Action'],1980,9
28947153,Just Another Love Story,2009,['India'],"['LGBT', 'Drama', 'World cinema']",2000,9
4021437,Agnes and His Brothers,2004,['Germany'],"['LGBT', 'Romantic drama', 'Family Drama', 'World cinema', 'Drama']",2000,4
6773693,It's Only Money,1962,['United States of America'],"['Detective fiction', 'Crime Fiction', 'Mystery', 'Comedy', 'Thriller', 'Detective', 'Slapstick']",1960,2
937658,Revenge of the Nerds II: Nerds in Paradise,1987,['United States of America'],"['Comedy', 'Sex comedy']",1980,7
25471984,Eat me!,2000,['United States of America'],['Comedy'],2000,0
6829329,Blind Side,1993,['United States of America'],"['Psychological thriller', 'Suspense', 'Mystery', 'Thriller', 'Crime Thriller']",1990,3
2901759,The Gene Generation,2006,['United States of America'],"['Science Fiction', 'Adventure', 'Thriller']",2000,6
9782858,Rolling Family,2004,"['Brazil', 'Spain', 'Argentina', 'France', 'United Kingdom', 'Germany']","['Indie', 'Comedy', 'World cinema', 'Drama']",2000,4
20611557,Pink-In,1971,[],"['Animation', 'Short Film', 'Comedy film']",1970,1
8464511,Breakfast with Scot,2007,['Canada'],"['Gay Themed', 'LGBT', 'Gay', 'Indie', 'Drama', 'Gay Interest', 'Comedy']",2000,7
2618174,The Dinner Game,1998,['France'],['Comedy'],1990,8
570350,Against All Odds,1984,['United States of America'],"['Action', 'Neo-noir', 'Crime Fiction', 'Mystery', 'Romantic drama', 'Thriller', 'Remake', 'Romance Film', 'Crime Thriller', 'Adventure', 'Drama', 'Erotic thriller', 'Sports']",1980,4
4969123,The Mean Season,1985,['United States of America'],"['Psychological thriller', 'Suspense', 'Crime Fiction', 'Mystery', 'Indie', 'Thriller', 'Crime Thriller']",1980,5
76020,Porky in Wackyland,1938,['United States of America'],"['Surrealism', 'Black-and-white', 'Short Film']",1930,8
28216994,Hotline,1982,['United States of America'],"['Thriller', 'Drama']",1980,2
6177777,Rest Stop,2006,['United States of America'],"['Psychological thriller', 'Slasher', 'Horror', 'Cult']",2000,6
2718480,The Tune,1992,['United States of America'],"['Musical', 'Animation', 'Comedy film']",1990,2
3849638,Resurrection of the Little Match Girl,2002,['South Korea'],"['Action', 'Science Fiction', 'Comedy']",2000,2
261023,The Sweetest Thing,2002,['United States of America'],"['Gross out', 'Gross-out film', 'Comedy', 'Romance Film', 'Romantic comedy', 'Sex comedy']",2000,2
9001422,Shakedown,1988,['United States of America'],"['Crime Fiction', 'Mystery', 'Action/Adventure', 'Thriller', 'Drama', 'Courtroom Drama']",1980,8
8003243,Resurrection,1999,['United States of America'],"['Psychological thriller', 'Suspense', 'Mystery', 'Thriller', 'Horror', 'Crime Thriller']",1990,9
15952338,Portnoy's Complaint,1972,['United States of America'],"['Drama', 'Comedy']",1970,2
12574431,Bezhin Meadow,1937,['Soviet Union'],"['Black-and-white', 'Short Film', 'Drama']",1930,7
9387595,I am Josh Polonski's Brother,2001,"['United States of America', 'France']","['Crime Fiction', 'Indie', 'Family Drama', 'Crime Drama', 'Drama']",2000,1
13809790,Just Desserts,2004,['United States of America'],"['Comedy', 'Romance Film', 'Romantic comedy', 'Television movie']",2000,4
34590503,His and Hers,1997,['United States of America'],"['Black comedy', 'Comedy film']",1990,7
30635974,Aunty No. 1,1998,['India'],"['Romance Film', 'Drama', 'Comedy film']",1990,8
1273515,One of Our Aircraft is Missing,1942,['United Kingdom'],"['Black-and-white', 'War film', 'Drama']",1940,2
1964091,Next,2007,['United States of America'],"['Action', 'Science Fiction', 'Thriller']",2000,7
22380492,Body Politic,2009,['United States of America'],['Drama'],2000,9
19036289,Moloch,1999,"['Japan', 'Russia', 'France', 'Germany', 'Italy']","['Romantic drama', 'Biographical film', 'World cinema', 'Romance Film', 'Drama', 'Period piece', 'Japanese Movies', 'War film']",1990,9
18287712,Beer for My Horses,2008,['United States of America'],"['Action', 'Crime Fiction', 'Action/Adventure', 'Comedy', 'Road movie']",2000,8
1256587,Teenagers from Outer Space,1959,['United States of America'],"['Black-and-white', 'Indie', 'Horror', 'B-movie', 'Alien Film', 'Science Fiction']",1950,9
12794482,Gangs of the Dead,2006,['United States of America'],"['Horror', 'Zombie Film']",2000,6
23765662,Pink Dream,1932,['China'],"['Silent film', 'Drama']",1930,2
14770549,My Dear Kuttichathan,1984,['India'],"['Action', 'Comedy', 'Adventure', 'Family Film', 'Fantasy']",1980,4
10895133,Jibon Thekey Neya,1970,"['Bangladesh', 'Pakistan']","['Historical fiction', 'Drama']",1970,0
14786229,Ghatak: Lethal,1996,['India'],"['Action/Adventure', 'Bollywood', 'World cinema']",1990,6
3019175,Sapphire,1959,['United Kingdom'],"['Detective fiction', 'Crime Fiction', 'Mystery', 'Thriller', 'Detective', 'Crime Thriller', 'Drama']",1950,9
8368715,Johnny Got His Gun,1971,['United States of America'],"['Anti-war', 'Film adaptation', 'Anti-war film', 'Social problem film', 'War film', 'Drama']",1970,1
13571677,Savage Weekend,1976,['United States of America'],"['Slasher', 'B-movie', 'Horror']",1970,6
7601618,Ali Bhai,2007,['India'],['Action'],2000,7
15398161,Appaloosa,2008,['United States of America'],"['Film adaptation', 'Crime Fiction', 'Western', 'Action/Adventure', 'Drama']",2000,8
4508113,Inspector Gadget 2,2003,"['United States of America', 'Australia']","['Action', 'Action/Adventure', 'Comedy', 'Superhero movie', ""Children's/Family"", 'Science Fiction', 'Family Film']",2000,3
5366212,Fan Chan,2003,['Thailand'],['Romantic comedy'],2000,3
2148869,Small Sacrifices,1989,['United States of America'],"['Crime Fiction', 'Crime Drama', 'Docudrama', 'Drama', 'Courtroom Drama']",1980,9
10780834,Listen to Me,1989,['United States of America'],"['Coming of age', 'Romantic drama', 'Romance Film', 'Drama']",1980,9
17305352,La Masseria Delle Allodole,2007,"['Spain', 'Bulgaria', 'France', 'United Kingdom', 'Italy']","['Drama', 'World cinema']",2000,7
807979,Swiss Family Robinson,1960,['United States of America'],"['Costume drama', 'Adventure', 'Drama', 'Family Film']",1960,0
11197989,Sorum,2001,['South Korea'],"['World cinema', 'Haunted House Film', 'Horror']",2000,1
652423,Snake in the Eagle's Shadow,1978,['Hong Kong'],"['Action', 'Slapstick', 'Chinese Movies', 'Martial Arts Film']",1970,8
3671995,"Murder, She Said",1961,['United Kingdom'],"['Film adaptation', 'Detective fiction', 'Black-and-white', 'Crime Fiction', 'Mystery', 'Thriller', 'Whodunit', 'Detective']",1960,1
2942414,Bad Timing,1980,"['United Kingdom', 'England']","['Psychological thriller', 'Mystery', 'Thriller', 'Erotic thriller', 'Crime Thriller', 'Drama']",1980,0
19245641,The Age of Stupid,2009,['United Kingdom'],"['Avant-garde', 'Documentary', 'Social problem film', 'Drama', 'Political cinema', 'History', 'Experimental film', 'War film']",2000,9
22475578,Sukrutham,1994,[],[],1990,4
7508621,The Painted Veil,2006,"['China', 'United States of America', 'Canada']","['Period piece', 'Film adaptation', 'Romantic drama', 'Romance Film', 'Chinese Movies', 'War film', 'Drama']",2000,6
74394,Invasion of the Body Snatchers,1956,['United States of America'],"['Cold War', 'Black-and-white', 'Thriller', 'Horror', 'Alien invasion', 'Doomsday film', 'Science Fiction']",1950,6
11089906,The Man Who Could Cheat Death,1959,['United Kingdom'],"['Psychological thriller', 'Science Fiction', 'Horror']",1950,9
1094721,Ringu 0,2000,['Japan'],"['Japanese Movies', 'World cinema', 'Horror']",2000,0
12142221,Death by Dialogue,1988,['United States of America'],"['Drama', 'Indie', 'Slasher', 'Teen', 'Horror', 'B-movie']",1980,8
1277918,Charlie and the Chocolate Factory,2005,"['United Kingdom', 'United States of America']","[""Children's Fantasy"", 'Comedy', 'Remake', ""Children's/Family"", 'Adventure', 'Family Film', 'Fantasy']",2000,5
15782595,A Match Made in Heaven,1997,['United States of America'],"['Romantic drama', 'Family Drama', 'Drama']",1990,7
1716343,L.I.E.,2001,['United States of America'],"['LGBT', 'Crime Fiction', 'Indie', 'Teen', 'Drama', 'Gay Themed', 'Gay', 'Coming of age', 'Gay Interest']",2000,1
19231136,High Flight,1957,['United Kingdom'],"['War film', 'Adventure', 'Drama']",1950,7
14369179,The Secret of Kells,2009,"['France', 'Ireland', 'Belgium']","[""Children's Fantasy"", 'Animation', ""Children's/Family"", 'Adventure', 'Family Film']",2000,9
13956883,Annie Oakley,1935,['United States of America'],"['Black-and-white', 'Action/Adventure', 'Western', 'Biographical film', 'Drama']",1930,5
21563783,Sassi Punno,2004,['Pakistan'],['Romance Film'],2000,4
13140328,Tragic Hunt,1946,['Italy'],"['Black-and-white', 'Drama']",1940,6
2355009,Juwanna Mann,2002,['United States of America'],"['Comedy', 'Romantic comedy', 'Romance Film', 'Sports']",2000,2
442668,"History of the World, Part I",1981,['United States of America'],"['Parody', 'Comedy']",1980,1
2780675,The Thing with Two Heads,1972,['United States of America'],"['Comedy', 'Horror Comedy', 'Horror', 'B-movie', 'Sci-Fi Horror', 'Science Fiction', 'Cult']",1970,2
6622565,Hitman,1998,"['China', 'Hong Kong']","['Action', 'Crime Fiction', 'Action/Adventure', 'Thriller', 'World cinema', 'Chinese Movies', 'Martial Arts Film']",1990,8
4870723,Bob and Larry's How to Draw!,2004,['United States of America'],"['Musical', 'Animation', 'Family Film']",2000,4
11991967,Ek - The Power of One,2008,['India'],"['Musical', 'Thriller', 'Bollywood', 'World cinema']",2000,8
5790961,Sam's Lake,2009,"['South Korea', 'United States of America', 'Canada']","['Crime Fiction', 'Mystery', 'Thriller', 'Horror']",2000,9
30330800,Kaalia,1997,[],['Action'],1990,7
4603146,Gang Related,1997,['United States of America'],"['Action', 'Crime Fiction', 'Crime Drama', 'Drama', 'Courtroom Drama']",1990,7
28074180,Planeta Bur,1962,['Soviet Union'],['Science Fiction'],1960,2
2163221,Sarfarosh,1999,['India'],"['Musical', 'Bollywood', 'World cinema']",1990,9
23977026,The Mysterious Mr. Wong,1934,['United States of America'],"['Black-and-white', 'Mystery', 'Detective', 'Thriller', 'Crime Thriller', 'Master Criminal Films']",1930,4
2308701,Apocalypto,2006,['United States of America'],"['Action', 'Action/Adventure', 'Adventure', 'Drama', 'Period piece', 'Chase Movie', 'Historical Epic', 'Epic']",2000,6
12876201,At Point Blank,2003,['Sweden'],"['Action', 'Crime Fiction', 'Thriller']",2000,3
22165169,Sontha Ooru,1956,['India'],['Drama'],1950,6
182737,"To Sir, with Love",1967,['United Kingdom'],"['Film adaptation', 'Coming of age', 'Teen', 'Drama']",1960,7
7573757,Hammy's Boomerang Adventure,2006,['United States of America'],['Computer Animation'],2000,6
12590515,The Lost World,1992,['Canada'],"['Monster movie', 'Film adaptation', 'Action/Adventure', 'Adventure', 'Science Fiction', 'Drama', 'Fantasy']",1990,2
26085256,Mixed Blood,1985,"['France', 'United States of America']","['Action', 'Drama', 'Crime Fiction', 'Action/Adventure', 'Black comedy']",1980,5
1469880,Smoke Signals,1998,"['Canada', 'United States of America']","['Film adaptation', 'Indie', 'Buddy film', 'Comedy', 'Americana', 'Drama', 'Comedy-drama', 'Road movie']",1990,8
18163109,Wild Bill,1995,['United States of America'],"['Western', 'Revisionist Western', 'Action/Adventure']",1990,5
4832987,Relative Values,2000,['United Kingdom'],"['Comedy', 'World cinema', 'Romance Film', 'Romantic comedy']",2000,0
34084997,Nam Naadu,1969,[],['Drama'],1960,9
26338405,Summer of the Seventeenth Doll,1959,"['New Zealand', 'Australia']","['Film adaptation', 'Romantic drama', 'Filmed Play', 'World cinema', 'Romance Film', 'Drama']",1950,9
545933,The One,2001,['United States of America'],"['Action', 'Martial Arts Film', 'Time travel', 'Action/Adventure', 'Thriller', 'Supernatural', 'Science Fiction']",2000,1
15863505,Soul Men,2008,['United States of America'],"['Musical', 'Comedy', 'Comedy-drama', 'Road movie', 'Drama']",2000,8
34370049,Stacked,2008,['United Kingdom'],"['Television movie', 'Short Film', 'Drama']",2000,8
2177168,Chain of Fools,2000,['United States of America'],"['Action', 'Detective fiction', 'Screwball comedy', 'Action/Adventure', 'Comedy', 'Black comedy', 'Detective', 'Crime Comedy', 'Romantic comedy']",2000,0
3078749,"Have Rocket, Will Travel",1959,['United States of America'],"['Black-and-white', 'Comedy', 'Adventure', 'Slapstick', 'Science Fiction']",1950,9
1771762,The Brain That Wouldn't Die,1962,['United States of America'],"['Black-and-white', 'Indie', 'Comedy', 'Horror Comedy', 'Horror', 'B-movie', 'Science Fiction', 'Cult']",1960,2
2019000,The Real Blonde,1997,['United States of America'],"['LGBT', 'Drama', 'Indie', 'Comedy', 'Romance Film', 'Romantic comedy', 'Ensemble Film']",1990,7
34934917,Group Marriage,1973,['United States of America'],"['Comedy film', 'Sex comedy']",1970,3
4519643,Larki Panjaban,2003,['Pakistan'],['Drama'],2000,3
6040862,Children of the Revolution,1996,"['New Zealand', 'Australia']","['Political cinema', 'Parody', 'Satire', 'Comedy', 'World cinema', 'Black comedy', 'Drama']",1990,6
2558613,The Woods,2006,"['United Kingdom', 'Germany', 'United States of America']","['Psychological thriller', 'Comedy', 'Teen', 'Horror', 'Supernatural']",2000,6
18695402,Kiki,1931,['United States of America'],"['Romantic comedy', 'Black-and-white', 'Pre-Code']",1930,1
14524599,The Night the Animals Talked,1970,"['Italy', 'United States of America']",['Short Film'],1970,0
67444,Half Past Dead,2002,"['Germany', 'United States of America']","['Action', 'Prison', 'Action Thrillers', 'Action/Adventure', 'Thriller', 'Crime Thriller']",2000,2
1346908,The Kid,2000,['United States of America'],"['Time travel', 'Comedy', 'Drama', 'Family Film', 'Fantasy']",2000,0
1834238,Stonewall,1995,['United Kingdom'],"['Gay Themed', 'LGBT', 'Gay', 'Gay Interest', 'Docudrama', 'Drama']",1990,5
9223332,The Divine Nymph,1975,['Italy'],['Drama'],1970,5
4588808,Thavamai Thavamirundu,2005,['India'],"['Drama', 'World cinema']",2000,5
10131263,Guided Muscle,1955,['United States of America'],"['Animation', 'Short Film', 'Family Film']",1950,5
7146019,The Parent Trap II,1986,['United States of America'],['Comedy'],1980,6
24045906,Danielle Steel's A Perfect Stranger,1994,['United States of America'],"['Film adaptation', 'Romantic drama', 'Romance Film', 'Television movie', 'Drama']",1990,4
10781602,The Five Senses,2000,['Canada'],"['Music', 'Drama', 'Indie', 'Comedy', 'Comedy-drama', 'Ensemble Film']",2000,0
18904524,A High Wind in Jamaica,1965,['United Kingdom'],"['Action', 'Film adaptation', 'Action/Adventure', 'Adventure', 'Swashbuckler films', 'Drama']",1960,5
1688077,Leprechaun,1993,['United States of America'],"['Monster movie', 'Slasher', 'Satire', 'Comedy', 'Horror', 'Supernatural', 'Cult']",1990,3
4544156,A Perfect Couple,1979,['United States of America'],"['Romance Film', 'Romantic comedy', 'Comedy']",1970,9
11151341,Jurmana,1979,['India'],['Bollywood'],1970,9
5996352,Choose Me,1984,['United States of America'],"['Indie', 'Romantic drama', 'Comedy', 'Romance Film', 'Drama', 'Romantic comedy', 'Comedy-drama', 'Ensemble Film']",1980,4
590234,This Is the Army,1943,['United States of America'],"['Musical', 'Comedy', 'Musical comedy', 'Romance Film', 'War film']",1940,3
19389917,Bedtime Worries,1933,['United States of America'],"['Black-and-white', 'Short Film', 'Comedy', 'Family Film']",1930,3
21678090,The Vineyard,1989,"['Canada', 'United States of America']","['Horror', 'Science Fiction']",1980,9
1466166,A Day at the Beach,1970,"['United Kingdom', 'United States of America']","['Drama', 'Comedy']",1970,0
665867,Police Story,1985,"['Hong Kong', 'United States of America']","['Action', 'Crime Fiction', 'Action/Adventure', 'Comedy', 'Thriller', 'World cinema', 'Crime Thriller', 'Chinese Movies', 'Martial Arts Film']",1980,5
26977302,Satan's Slave,1976,['United Kingdom'],['Horror'],1970,6
6010264,The Magical Legend of the Leprechauns,1999,"['United Kingdom', 'Germany', 'United States of America']","['Romantic drama', 'Action/Adventure', 'Romance Film', 'Adventure', 'Drama', 'Fantasy']",1990,9
22216863,Bliss,2007,"['Turkey', 'Greece']","['Drama', 'World cinema']",2000,7
1352995,Johnny Guitar,1954,['United States of America'],"['Revisionist Western', 'Western']",1950,4
26000394,The Wild Hunt,2009,['Canada'],"['Drama', 'Science Fiction', 'Thriller']",2000,9
33974279,Pudhiya Paravai,1964,[],"['Romance Film', 'Drama', 'Thriller']",1960,4
11018205,The Narrows,2008,['United States of America'],"['Film adaptation', 'Drama', 'Crime Fiction', 'Indie', 'Family Drama', 'Crime Thriller', 'Slice of life story']",2000,8
1758524,Kissin' Cousins,1964,['United States of America'],"['Musical', 'Comedy', 'Romance Film', 'Romantic comedy']",1960,4
2610020,Human Traffic,1999,"['Ireland', 'United Kingdom']","['Comedy', 'Dance', 'Black comedy', 'Ensemble Film']",1990,9
27933891,Basil,1998,['United Kingdom'],"['Period piece', 'Romantic drama', 'Indie', 'Romance Film', 'Drama']",1990,8
2903228,The Mothman Prophecies,2002,['United States of America'],"['Psychological thriller', 'Mystery', 'Thriller', 'Horror', 'Supernatural', 'Science Fiction', 'Drama']",2000,2
21407645,The Last of the Knucklemen,1979,['Australia'],"['Action', 'Drama']",1970,9
32253799,Bhopal Express,1999,"['India', 'United States of America']","['Romantic drama', 'World cinema', 'Romance Film', 'Drama']",1990,9
18557182,Ain't She Tweet,1952,['United States of America'],"['Animation', 'Short Film', 'Family Film']",1950,2
12438167,Yellow Earth,1984,['China'],"['Family Drama', 'Chinese Movies', 'Political drama', 'Drama']",1980,4
23541374,Nice Girl?,1941,['United States of America'],['Musical'],1940,1
7487962,Stranger Inside,2000,['United States of America'],"['Prison', 'LGBT', 'Family Drama', 'Indie', 'Drama']",2000,0
20162300,Bokator,2007,['Cambodia'],"['Action', 'Historical Documentaries', 'Martial Arts Film']",2000,7
6836554,The Scarecrow,1920,['United States of America'],"['Black-and-white', 'Indie', 'Short Film', 'Silent film']",1920,0
18586673,"On the Other Hand, Death",2008,"['Canada', 'United States of America']","['LGBT', 'Crime Fiction', 'Mystery', 'Thriller', 'Crime Thriller', 'Drama']",2000,8
560431,Stranger on the Third Floor,1940,['United States of America'],"['Psychological thriller', 'Black-and-white', 'Mystery', 'Thriller', 'Film noir', 'Drama']",1940,0
320500,Tadpole,2002,['United States of America'],"['Coming of age', 'Indie', 'Comedy', 'Romantic comedy', 'Romance Film', 'Sex comedy']",2000,2
251877,King of Hearts,1966,"['France', 'Italy']","['Parody', 'Comedy', 'World cinema', 'War film']",1960,6
4607218,Rose Red,2002,"['Canada', 'United States of America']","['Mystery', 'Thriller', 'Horror', 'Haunted House Film']",2000,2
28714204,Out of True,1951,['United Kingdom'],['Short Film'],1950,1
8288167,I Love You Again,1940,['United States of America'],"['Film adaptation', 'Screwball comedy', 'Comedy', 'Crime Comedy', 'Romance Film', 'Romantic comedy', 'Drama']",1940,0
4968653,The Four Musketeers,1974,"['Panama', 'Spain', 'United Kingdom', 'United States of America']","['Action', 'Film adaptation', 'Action/Adventure', 'Comedy', 'World cinema', 'Costume drama', 'Adventure', 'Drama', 'Swashbuckler films', 'Period piece']",1970,4
30277039,The Ant and the Aardvark,1969,[],"['Short Film', 'Animation']",1960,9
8465510,V.I.P,1997,['India'],"['Romance Film', 'Comedy film']",1990,7
2363899,Son of the Pink Panther,1993,"['Italy', 'United States of America']","['Parody', 'Comedy', 'World cinema', 'Slapstick']",1990,3
27652221,Clipped Wings,1953,['United States of America'],['Comedy'],1950,3
6900343,Getting Away with Murder,1996,"['United Kingdom', 'United States of America']","['Black comedy', 'Comedy']",1990,6
23423124,Men of the Fighting Lady,1954,['United States of America'],['War film'],1950,4
18459855,Barood,1998,['India'],"['Action', 'Romance Film']",1990,8
9938840,El Perro,2004,"['Argentina', 'Spain']","['Indie', 'Drama', 'World cinema']",2000,4
11709212,Night Watch,1995,"['United Kingdom', 'Hong Kong', 'United States of America']","['Action', 'Spy', 'Crime Fiction', 'Action/Adventure', 'Thriller', 'Crime Thriller', 'Chinese Movies']",1990,5
949857,I Know Where I'm Going!,1945,['United Kingdom'],"['Black-and-white', 'Romantic drama', 'Romance Film', 'Drama']",1940,5
21620643,Halloween Night,2006,['United States of America'],"['Psychological thriller', 'Indie', 'Slasher', 'Horror']",2000,6
1443093,John Carpenter's The Fog,1980,['United States of America'],"['Mystery', 'Indie', 'Thriller', 'Horror', 'Supernatural']",1980,0
1126777,Nightbreed,1990,['United States of America'],"['Supernatural', 'Slasher', 'Horror']",1990,0
62097,Grand Illusion,1937,['France'],"['Black-and-white', 'Art film', 'World cinema', 'Escape Film', 'Drama', 'Anti-war', 'Anti-war film', 'War film']",1930,7
8949772,The Walking Dead,1936,['United States of America'],"['Black-and-white', 'Supernatural', 'Horror']",1930,6
22806041,The Smiling Ghost,1941,['United States of America'],"['Mystery', 'Comedy', 'Film noir', 'Black comedy']",1940,1
9969768,Pure Luck,1991,['United States of America'],"['Crime Fiction', 'Buddy film', 'Comedy', 'Comedy of Errors']",1990,1
14665457,The Day Time Ended,1980,['United States of America'],"['Time travel', 'Thriller', 'Stop motion', 'Science Fiction']",1980,0
4055312,The Super,1991,"['Japan', 'United States of America']","['Comedy', 'Japanese Movies']",1990,1
31552848,Amrit,1986,['India'],"['Drama', 'World cinema']",1980,6
20176769,Running Home,1999,['Canada'],['Suspense'],1990,9
2862798,Why Do Fools Fall in Love,1998,['United States of America'],"['Musical', 'Biography', 'Romantic drama', 'Biographical film', 'Musical Drama', 'Romance Film', 'Drama', 'Biopic [feature]']",1990,8
163500,A Special Day,1977,"['India', 'Canada', 'Italy']","['LGBT', 'World cinema', 'Political drama', 'Romance Film', 'War film', 'Drama']",1970,7
13903423,Bhalevadivi Basu,2001,['India'],"['Comedy', 'Family Film']",2000,1
4165940,The Rare Breed,1966,['United States of America'],"['Action/Adventure', 'Western', 'Drama', 'Family Film']",1960,6
25948068,Desperate Cargo,1941,['United States of America'],"['Action', 'Crime Fiction', 'Action/Adventure', 'Thriller', 'Romance Film', 'Adventure', 'Drama']",1940,1
8357233,Interlude,1968,['United Kingdom'],['Drama'],1960,8
10048256,Chor Machaaye Shor,2002,['India'],"['Comedy', 'Crime Comedy', 'World cinema']",2000,2
11761134,Back In Business,2007,['United Kingdom'],"['Comedy', 'Family Film', 'Adventure']",2000,7
12510348,Dr. Wai and the Scripture Without Words,1996,['Hong Kong'],"['Action', 'Comedy', 'Chinese Movies', 'Adventure']",1990,6
24103214,Ngati,1987,['New Zealand'],['Drama'],1980,7
3071025,Cold Showers,2005,['France'],"['Gay Themed', 'LGBT', 'Erotic Drama', 'Coming of age', 'Teen', 'World cinema', 'Drama']",2000,5
17628177,Apple Jack,2003,['United States of America'],"['Short Film', 'Comedy']",2000,3
6673524,Annayya,2000,['India'],"['Action', 'Family Film']",2000,0
7577290,The Odessa File,1974,"['United Kingdom', 'Germany', 'West Germany', 'United States of America']","['Thriller', 'World cinema', 'Drama', 'Political thriller']",1970,4
10090939,The Oregon Trail,1939,['United States of America'],"['Action', 'Black-and-white', 'Western', 'Action/Adventure', 'Adventure']",1930,9
129331,Moonstruck,1987,['United States of America'],"['Romantic drama', 'Comedy', 'Romance Film', 'Romantic comedy', 'Drama']",1980,7
3085944,Sherlock Holmes and the Case of the Silk Stocking,2004,"['United Kingdom', 'United States of America']","['Film adaptation', 'Detective fiction', 'Mystery', 'Thriller', 'Whodunit', 'Crime Thriller', 'Drama', 'Detective', 'Television movie']",2000,4
6967345,Twilight Dancers,2006,['Philippines'],"['Filipino Movies', 'LGBT', 'World cinema', 'Drama']",2000,6
2745708,Death Line,1972,['United Kingdom'],"['Mystery', 'Slasher', 'Horror', 'Cult']",1970,2
9468375,Private Parts,1997,['United States of America'],"['Biography', 'Comedy', 'Biographical film', 'Black comedy', 'Drama']",1990,7
284697,The Rundown,2003,['United States of America'],"['Adventure Comedy', 'Action', 'Action/Adventure', 'Buddy film', 'Thriller', 'Comedy', 'Adventure', 'Action Comedy', 'Jungle Film']",2000,3
30860835,Over the Hedge,2006,['United States of America'],"['Computer Animation', 'Animation', ""Children's"", 'Comedy', ""Children's/Family"", 'Adventure', 'Family Film']",2000,6
20752962,Invasion of the Star Creatures,1962,['United States of America'],"['Science Fiction', 'Alien Film', 'Comedy']",1960,2
14573842,George Washington Slept Here,1942,['United States of America'],"['Black-and-white', 'Slapstick', 'Comedy']",1940,2
9271078,Adventures of Don Juan,1948,['United States of America'],"['Action', 'Costume Adventure', 'Action/Adventure', 'Romance Film', 'Costume drama', 'Adventure', 'Swashbuckler films']",1940,8
12370259,Mujhe Insaaf Chahiye,1983,['India'],['Drama'],1980,3
15810392,Yeti: Curse of the Snow Demon,2008,['United States of America'],"['Monster movie', 'Horror']",2000,8
6114249,Bloody Pit of Horror,1965,['Italy'],"['Horror', 'B-movie']",1960,5
3416335,Death Takes a Holiday,1934,['United States of America'],"['Black-and-white', 'Fantasy']",1930,4
19162048,Café Express,1980,['Italy'],"['Crime Fiction', 'Parody', 'Comedy', 'World cinema']",1980,0
19154254,Pleasures,1986,['United States of America'],['Drama'],1980,6
1246278,Batman & Mr. Freeze: SubZero,1998,['United States of America'],"['Action', 'Animation', 'Superhero', 'Action/Adventure', 'Superhero movie', 'Family Film', 'Fantasy']",1990,8
13751839,I Was A Teenage Faust,2002,"['Canada', 'United States of America']","['Coming of age', 'Comedy', 'Teen', 'Television movie', 'Family Film']",2000,2
11760680,The Last Day of Summer,2007,['United States of America'],"['Comedy', 'Family Film', 'Fantasy']",2000,7
4333107,Make Way for Tomorrow,1937,['United States of America'],"['Film adaptation', 'Black-and-white', 'Family Drama', 'Marriage Drama', 'Drama']",1930,7
5151199,Riens du tout,1992,['France'],['Comedy'],1990,2
2571942,Surviving Picasso,1996,['United States of America'],"['Romantic drama', 'Biographical film', 'Biopic [feature]', 'Romance Film', 'Drama']",1990,6
26852809,Let the Devil Wear Black,1999,['United States of America'],"['Psychological thriller', 'Suspense', 'Crime Fiction', 'Mystery', 'Thriller', 'Crime Thriller', 'Drama']",1990,9
26408513,Sadanandante Samayam,2003,['India'],"['Musical', 'Romance Film']",2000,3
80493,Henry V,1944,"['United Kingdom', 'United States of America']","['War film', 'Epic', 'Roadshow theatrical release', 'Costume drama', 'Drama']",1940,4
4339865,Princess Tam Tam,1935,['France'],"['Musical', 'Black-and-white', 'Romantic drama', 'Comedy', 'World cinema', 'Musical comedy', 'Romance Film', 'Drama', 'Romantic comedy']",1930,5
5347029,The Halloween Tree,1993,['United States of America'],"[""Children's/Family"", 'Animation']",1990,3
4921024,White Noise: The Light,2007,"['Canada', 'United States of America']","['Supernatural', 'Thriller', 'Horror']",2000,7
9179879,A Date With Judy,1948,['United States of America'],"['Musical', 'Comedy', 'Musical comedy']",1940,8
22827171,Fanboy and Chum Chum,2009,[],[],2000,9
22054974,Quick gun Murugan,2009,['India'],"['Action', 'Comedy Western', 'Parody', 'Western', 'Comedy', 'World cinema', 'Drama']",2000,9
19401808,Polvere di stelle,1973,['Italy'],"['Musical', 'Comedy', 'Drama']",1970,3
2908429,The Road,1982,"['France', 'Turkey', 'Switzerland']","['Prison', 'World cinema', 'Romance Film', 'Political drama', 'Drama']",1980,2
34068003,Hot Tamale,2006,[],"['Action', 'Crime Fiction', 'Comedy film']",2000,6
33833232,Lee Seong-gye King Taejo,1965,['South Korea'],"['Historical drama', 'Biography', 'Biographical film', 'Historical fiction', 'Drama']",1960,5
25893786,Can't Be Heaven,2000,['United States of America'],"['Coming of age', 'Heavenly Comedy', 'Romantic drama', 'Romance Film', 'Drama', 'Fantasy']",2000,0
8889869,Apne,2007,['India'],"['Family Drama', 'World cinema', 'Sports', 'Drama']",2000,7
44302,Amélie,2001,"['France', 'Germany']","['Romantic drama', 'Comedy', 'World cinema', 'Romance Film', 'Romantic comedy', 'Drama', 'Fantasy']",2000,1
3118146,The Attic: The Hiding of Anne Frank,1988,"['United Kingdom', 'United States of America']","['Biopic [feature]', 'Docudrama', 'War film', 'Drama']",1980,8
33435755,Meri Zubaan,1989,['India'],"['Action', 'Crime Fiction', 'Drama']",1980,9
7055021,The Lucky Guy,1998,['Hong Kong'],"['Comedy', 'Romantic comedy', 'Chinese Movies', 'Drama']",1990,8
19016611,Gas,2005,['United States of America'],"['Black comedy', 'Indie', 'Comedy']",2000,5
22120174,Best Friends,1982,['United States of America'],"['Screwball comedy', 'Comedy', 'Comedy film', 'Romance Film', 'Romantic comedy', 'Drama']",1980,2
16171201,Zombies! Zombies! Zombies!,2007,['United States of America'],"['Comedy', 'Horror', 'B-movie', 'Zombie Film']",2000,7
5465083,Ivanhoe,1952,['United States of America'],"['Action', 'Film adaptation', 'Romantic drama', 'Action/Adventure', 'Romance Film', 'Swashbuckler films', 'Adventure', 'Drama', 'Period piece']",1950,2
6456038,Elvis Has Left the Building,2004,['United States of America'],"['Action', 'Crime Fiction', 'Action/Adventure', 'Comedy', 'Crime Comedy', 'Road movie']",2000,4
24345943,Goyband,2008,['United States of America'],['Comedy'],2000,8
24979853,Feeders,1996,['United States of America'],"['Science Fiction', 'Drama', 'Horror']",1990,6
21082409,Season of the Sun,1956,['Japan'],"['Japanese Movies', 'Black-and-white']",1950,6
19139672,Space Battleship Yamato,1977,['Japan'],"['Action', 'Animation', 'Japanese Movies', 'Anime', 'Science Fiction']",1970,7
5019011,The Blot,1921,['United States of America'],"['Black-and-white', 'Silent film', 'Melodrama', 'Drama']",1920,1
20847232,Strike Up the Band,1940,['United States of America'],"['Musical', 'Comedy', 'Musical comedy', 'Romance Film', 'Romantic comedy', 'Drama']",1940,0
19912421,Black Water Transit,2009,['United States of America'],"['Crime Fiction', 'Thriller', 'Crime Thriller', 'Drama']",2000,9
20857007,Out of Bounds,2003,['United Kingdom'],"['Psychological thriller', 'Indie', 'Thriller', 'Erotic thriller', 'Drama']",2000,3
14344144,Divided We Fall,2000,['Czech Republic'],"['War film', 'Comedy', 'Drama']",2000,0
603224,Pilgrim,2000,"['United Kingdom', 'Mexico', 'Canada']","['Mystery', 'Indie', 'Thriller', 'Crime Thriller']",2000,0
27009228,Padayani,1986,['India'],[],1980,6
18041934,Hands Up!,1926,['United States of America'],"['War film', 'Comedy']",1920,6
19094684,The Boss,1973,['Italy'],"['Action', 'Action/Adventure', 'Western', 'Thriller', 'World cinema', 'Crime Thriller']",1970,3
27367070,Census Taker,1984,['United States of America'],"['Indie', 'Comedy', 'Thriller', 'Black comedy', 'Crime Thriller']",1980,4
10931425,Happy Go Lovely,1951,['United Kingdom'],"['Musical', 'Comedy', 'Musical comedy', 'Romance Film', 'Romantic comedy']",1950,1
2223425,Cleopatra Jones,1973,['United States of America'],"['Action', 'Blaxploitation']",1970,3
6264910,A Midsummer Night's Dream,1999,['United States of America'],"['Period piece', 'Romantic drama', 'Comedy', 'Romance Film', 'Romantic comedy', 'Drama', 'Fantasy']",1990,9
24282011,Private Eye,2009,['South Korea'],"['Crime Fiction', 'Mystery', 'Thriller']",2000,9
1659954,A Clockwork Orange,1971,"['United Kingdom', 'United States of America']","['Crime Fiction', 'Satire', 'Black comedy', 'Juvenile Delinquency Film', 'Drama', 'Dystopia', 'New Hollywood', 'Science Fiction', 'Cult']",1970,1
2093581,The Curse of the Werewolf,1961,['United Kingdom'],"['Creature Film', 'Costume Horror', 'Horror']",1960,1
300910,Sexy Beast,2000,"['United Kingdom', 'Spain']","['Crime Fiction', 'Gangster Film', 'Thriller', 'Crime Thriller', 'Drama']",2000,0
92539,Three Coins in the Fountain,1954,['United States of America'],"['Romance Film', 'Drama']",1950,4
19828754,The Curse of the Living Corpse,1963,['United States of America'],['Horror'],1960,3
12053509,Loverboy,1989,['United States of America'],"['Romance Film', 'Romantic comedy', 'Comedy']",1980,9
11841904,Seigi Choujin vs. Ancient Choujin,1985,['Japan'],"['Japanese Movies', 'Animation']",1980,5
24052626,Hollywood Wives: The New Generation,2003,"['Canada', 'United States of America']","['Film adaptation', 'Television movie', 'Drama']",2000,3
19553721,Abelay Garam Bhaat,2008,['India'],['Romance Film'],2000,8
20833107,Billy: The Early Years,2008,['United States of America'],"['Biography', 'Biographical film', 'Drama']",2000,8
2449700,Wifemistress,1977,['Italy'],"['Comedy', 'Comedy-drama']",1970,7
16731651,Promise at Dawn,1970,"['United States of America', 'France']",['Drama'],1970,0
18733964,Harry & Son,1984,['United States of America'],['Drama'],1980,4
1823450,House of D,2004,['United States of America'],"['Period piece', 'Coming of age', 'Indie', 'Comedy', 'Drama']",2000,4
5656505,The Cameraman,1928,['United States of America'],"['Black-and-white', 'Comedy', 'Romance Film', 'Slapstick', 'Drama', 'Silent film', 'Romantic comedy', 'Family Film']",1920,8
17055534,Julie & Julia,2009,['United States of America'],"['Biography', 'Comedy', 'Romance Film', 'Domestic Comedy', 'Comedy-drama', 'Drama']",2000,9
2950931,Der Sieg des Glaubens,1933,"['Weimar Republic', 'Germany']","['Black-and-white', 'Propaganda film', 'Documentary']",1930,3
34548840,Prey,1978,['United Kingdom'],"['B-movie', 'Science Fiction', 'Horror']",1970,8
584255,Carry On Behind,1975,['United Kingdom'],"['Parody', 'Comedy', 'Slapstick', 'Sex comedy']",1970,5
23275133,Bun-Rye's Story,1971,['South Korea'],['Drama'],1970,1
23692638,Sankham,2009,['India'],"['Romance Film', 'Drama']",2000,9
6159321,The Bet Collector,2006,['Philippines'],"['Filipino Movies', 'Drama', 'World cinema']",2000,6
5933936,Not Like Everyone Else,2006,['United States of America'],['Drama'],2000,6
8072787,The Screwfly Solution,2006,['United States of America'],"['Horror', 'Television movie', 'Science Fiction', 'Cult']",2000,6
24636388,Baat Ek Raat Ki,1962,['India'],"['Musical', 'Bollywood', 'World cinema', 'Drama']",1960,2
248601,A Hard Day's Night,1964,['United Kingdom'],"['Music', 'Musical', 'Black-and-white', 'Star vehicle', 'Indie', 'Comedy', 'Absurdism', 'Jukebox musical', 'British New Wave', 'Ensemble Film']",1960,4
6650131,Lie with Me,2005,['Canada'],"['Film adaptation', 'Romantic drama', 'Indie', 'Romance Film', 'Drama']",2000,5
2028302,Ginger Snaps Back,2004,['Canada'],"['Period piece', 'Comedy', 'Teen', 'Horror', 'Cult']",2000,4
5551144,Gridiron Gang,2006,['United States of America'],"['Crime Fiction', 'Sports', 'Drama']",2000,6
2443609,Tiovivo c. 1950,2004,['Spain'],"['Drama', 'Comedy']",2000,4
129278,Broadcast News,1987,['United States of America'],"['Satire', 'Comedy', 'Media Satire', 'Romance Film', 'Drama', 'Workplace Comedy', 'Parody', 'Romantic comedy', 'Comedy-drama']",1980,7
32986461,Silk Hope,1999,[],"['Romantic drama', 'Family Drama', 'Romance Film', 'Comedy-drama', 'Drama']",1990,9
34393603,Haunts of the Very Rich,1972,['United States of America'],"['Thriller', 'Drama']",1970,2
9951334,Voyna,2002,['Russia'],['War film'],2000,2
36173338,Short Night of the Glass Dolls,1971,"['Germany', 'Italy']","['Giallo', 'World cinema', 'Horror']",1970,1
18205118,The Big Job,1965,['United Kingdom'],"['Heist', 'Comedy', 'Crime Comedy']",1960,5
20286596,Kannamma,2005,['India'],['Drama'],2000,5
13714405,I've Fallen For You,2007,['Philippines'],"['Filipino Movies', 'Romantic drama', 'World cinema', 'Romance Film', 'Drama']",2000,7
5664067,Recess: All Growed Down,2003,['United States of America'],"['Animation', 'Comedy', 'Family Film']",2000,3
5301628,Eye of the Needle,1981,"['United Kingdom', 'United States of America']","['Spy', 'Film adaptation', 'Crime Fiction', 'Romantic drama', 'Thriller', 'Romance Film', 'Drama', 'Suspense', 'Period piece', 'War film']",1980,1
613037,After Hours,1985,['United States of America'],"['LGBT', 'Indie', 'Comedy', 'Thriller', 'Black comedy']",1980,5
4189858,The River Wild,1994,['United States of America'],"['Action', 'Psychological thriller', 'Crime Fiction', 'Action/Adventure', 'Thriller', 'Adventure']",1990,4
8813317,Bawarchi,1972,['India'],"['Musical', 'Bollywood', 'World cinema']",1970,2
11040052,Ittefaq,1969,['India'],"['Musical', 'Thriller', 'Bollywood', 'World cinema', 'Drama']",1960,9
11482774,Twelve Miles Out,1927,['United States of America'],"['Black-and-white', 'Drama', 'Crime Fiction', 'Indie', 'Silent film', 'Adventure']",1920,7
22623637,Oute gata oute zimia,1954,['Greece'],['Comedy'],1950,4
5416943,A Night in the Life of Jimmy Reardon,1988,['United States of America'],"['Coming of age', 'Romantic drama', 'Teen', 'Romance Film', 'Drama']",1980,8
12010187,Freud: The Secret Passion,1962,['United States of America'],"['Drama', 'Biographical film']",1960,2
6851815,Jimmy and Judy,2006,['United States of America'],"['Action', 'Crime Fiction', 'Indie', 'Action/Adventure', 'Thriller']",2000,6
20136626,Chili Weather,1963,['United States of America'],"['Animation', 'Short Film', 'Family Film']",1960,3
920468,Sister Act,1992,['United States of America'],"['Musical', 'Crime Fiction', 'Comedy', 'Comedy of Errors']",1990,2
290970,East of Eden,1955,['United States of America'],"['Film adaptation', 'Family Drama', 'Drama']",1950,5
26599446,Annan Thambi,2008,['India'],['World cinema'],2000,8
2474297,Omen III: The Final Conflict,1981,"['United Kingdom', 'United States of America']","['Demonic child', 'Horror', 'Supernatural', 'Cult']",1980,1
18913714,MTV Movie Awards Reloaded,2003,[],['Short Film'],2000,3
3395769,Winnie the Pooh: Springtime with Roo,2004,['United States of America'],"['Animated cartoon', 'Animation', ""Children's/Family"", 'Holiday Film', 'Family Film']",2000,4
5915965,Valathottu Thirinjal Nalamathe Veedu,2003,['India'],"['Action', 'Comedy']",2000,3
14040063,Madame X,1937,['United States of America'],"['Black-and-white', 'Drama']",1930,7
11776754,Goodbye America,1997,"['Philippines', 'United States of America']","['Action', 'Filipino Movies', 'Action Thrillers', 'Indie', 'Action/Adventure', 'Thriller', 'Romance Film', 'Drama']",1990,7
3017464,Heart Like a Wheel,1983,['United States of America'],"['Auto racing', 'Biography', 'Biographical film', 'Biopic [feature]', 'Sports', 'Drama', 'Feminist Film']",1980,3
19833925,Women of Valor,1986,['United States of America'],"['Period piece', 'War film', 'Drama']",1980,6
5701463,Latitude Zero,1969,"['Japan', 'United States of America']","['Action', 'Japanese Movies', 'Romantic drama', 'Action/Adventure', 'World cinema', 'Drama']",1960,9
24061036,Borderline,1950,['United States of America'],"['Crime Fiction', 'Thriller', 'Film noir', 'Romance Film', 'Crime Thriller', 'Drama']",1950,0
1400235,After Pilkington,1986,['England'],['Drama'],1980,6
15837630,Madea Goes to Jail,2009,['United States of America'],"['Drama', 'Crime Fiction', 'Indie', 'Family Drama', 'Comedy', 'Comedy-drama']",2000,9
8153729,"Come Back, Charleston Blue",1972,['United States of America'],"['Mystery', 'Crime Fiction']",1970,2
1089042,Robin Hood,1922,['United States of America'],"['Action', 'Black-and-white', 'Indie', 'Action/Adventure', 'Romantic drama', 'Romance Film', 'Swashbuckler films', 'Drama', 'Silent film']",1920,2
11993205,Hurricane,1979,['United States of America'],"['Romantic drama', 'Romance Film', 'Disaster', 'Drama']",1970,9
11839133,Kinnikuman,1984,['Japan'],['Japanese Movies'],1980,4
1219214,Dracula 2000,2000,['United States of America'],"['Action', 'Thriller', 'Horror', 'Romance Film', 'Supernatural']",2000,0
16512511,À gauche en sortant de l'ascenseur,1988,['France'],"['Comedy', 'Comedy of Errors']",1980,8
24624474,The Princess and the Pea,2002,"['Hungary', 'United States of America']","['Animation', 'Family Film', 'Fantasy']",2000,2
10398987,The Eye,2008,"['Canada', 'United States of America']","['Psychological thriller', 'Thriller', 'Horror', 'Supernatural', 'Drama']",2000,8
2583417,Street Kings,2008,['United States of America'],"['Action', 'Drama', 'Crime Fiction', 'Action/Adventure', 'Thriller']",2000,8
20453522,Konga,1961,['United Kingdom'],"['Horror', 'Science Fiction']",1960,1
5239322,The Shakiest Gun in the West,1968,['United States of America'],"['Comedy Western', 'Action/Adventure', 'Western', 'Comedy', 'Family Film']",1960,8
4482088,The Young Rajah,1922,['United States of America'],"['Silent film', 'Black-and-white', 'Indie']",1920,2
13579442,Waah! Tera Kya Kehna,2002,['India'],['Comedy'],2000,2
3454830,The Boy in Blue,1986,['Canada'],"['Period piece', 'Sports', 'Biography', 'Biographical film', 'Drama']",1980,6
31658692,A Nightmare on Elm Street 2: Freddy's Revenge,1985,['United States of America'],"['Slasher', 'Teen', 'Horror', 'Supernatural']",1980,5
7211748,I Heard,1933,['United States of America'],"['Animation', 'Short Film', 'Comedy', 'Family Film']",1930,3
4083603,Indigo,2003,['United States of America'],"['Family Drama', 'Indie', 'Drama', 'Family Film']",2000,3
3656567,The Wedding March,1928,['United States of America'],"['Black-and-white', 'Indie', 'Silent film', 'Melodrama', 'Drama']",1920,8
450141,Panic Room,2002,['United States of America'],"['Psychological thriller', 'Thriller']",2000,2
1716822,Every Which Way But Loose,1978,['United States of America'],"['Action', 'Adventure Comedy', 'Action/Adventure', 'Comedy', 'Adventure']",1970,8
30008595,The Little Prince Said,1992,"['Switzerland', 'France']",['Drama'],1990,2
29607299,Goppinti Alludu,2000,[],['Drama'],2000,0
20674930,Thakara,1980,['India'],"['Romance Film', 'Drama']",1980,0
26741261,Standard Operating Procedure,2008,['United States of America'],"['Social issues', 'Law & Crime', 'Political cinema', 'History', 'Documentary', 'War film', 'Culture & Society']",2000,8
18735140,Barefoot Gen,1983,['Japan'],"['Japanese Movies', 'Anime', 'War film', 'Drama']",1980,3
11387259,One Minute to Zero,1952,['United States of America'],"['Combat Films', 'Romance Film', 'War film']",1950,2
21536300,The Silences of Palace,1994,"['France', 'Tunisia']",['Drama'],1990,4
26616774,Sumangali,1940,['India'],['Drama'],1940,0
1046559,Dracula,1931,['United States of America'],"['Black-and-white', 'Horror', 'Pre-Code', 'Fantasy']",1930,1
20762022,Paradise Grove,2003,['United Kingdom'],"['Drama', 'Indie', 'Comedy', 'Black comedy']",2000,3
594240,Kate & Leopold,2001,['United States of America'],"['Comedy', 'Romance Film', 'Romantic comedy', 'Science Fiction', 'Fantasy']",2000,1
22621748,Diary of Korean-Japanese War,1978,['South Korea'],"['War film', 'Drama']",1970,8
24438195,The Big Bounce,1969,['United States of America'],"['Film adaptation', 'Crime Fiction', 'Romantic drama', 'Romance Film', 'Drama']",1960,9
6686041,Forever Strong,2008,['United States of America'],"['Sports', 'Family Drama', 'Drama']",2000,8
5995771,Himalay Ki God Mein,1965,['India'],"['Musical', 'Bollywood', 'World cinema', 'Drama']",1960,5
336846,Grease,1978,['United States of America'],"['Musical', 'LGBT', 'Comedy', 'Teen', 'Romance Film', 'Romantic comedy']",1970,8
7012612,Madame Blueberry,1998,"['Canada', 'United States of America']","['Musical', 'Animation', 'Short Film', ""Children's""]",1990,8
4213213,CrissCross,1992,['United States of America'],"['Film adaptation', 'Crime Fiction', 'Family Drama', 'Crime Drama', 'Drama']",1990,2
213188,DuckTales the Movie: Treasure of the Lost Lamp,1990,"['United States of America', 'France']","['Animation', ""Children's"", 'Fantasy']",1990,0
2313322,Evilenko,2004,['Italy'],"['Psychological thriller', 'LGBT', 'Thriller', 'World cinema', 'Crime Thriller', 'Drama']",2000,4
26623381,Bharya Onnu Makkal Moonnu,2009,['India'],['Drama'],2000,9
22410343,Oil Lamps,1971,['Czechoslovakia'],['Drama'],1970,1
11353680,Zindagi,1964,['India'],"['Musical', 'Drama', 'Family Film']",1960,4
12147070,Things We Lost in the Fire,2007,"['United Kingdom', 'United States of America']",['Drama'],2000,7
15792241,Free Money,1998,"['Canada', 'United States of America']","['Action', 'Crime Fiction', 'Indie', 'Action/Adventure', 'Comedy', 'Black comedy', 'Heist', 'Crime Comedy', 'Comedy-drama']",1990,8
1712963,Snow Day,2000,['United States of America'],"['Comedy', 'Teen', 'Romance Film', ""Children's/Family"", 'Slapstick', ""Children's"", 'Adventure', 'Family Film']",2000,0
22824677,Shinbone Alley,1971,['United States of America'],"['Musical', 'Animation']",1970,1
20979100,Harlan County War,2000,['United States of America'],"['Television movie', 'Americana', 'Docudrama', 'Drama']",2000,0
6301488,April's Shower,2006,['United States of America'],"['LGBT', 'Indie', 'Comedy', 'Romance Film', 'Drama', 'Gay Themed', 'Gay', 'Gay Interest', 'Romantic comedy', 'Sex comedy']",2000,6
5733617,O Quatrilho,1995,['Brazil'],"['Period piece', 'Romantic drama', 'Romance Film', 'Drama']",1990,5
32669355,Poompuhar,1964,[],['Epic'],1960,4
13253372,The Gentle Gunman,1952,['United Kingdom'],"['Action', 'Black-and-white', 'Political drama', 'Drama']",1950,2
34952379,Spirit Warriors: The Shortcut,2003,['Philippines'],"['Action', 'Horror', 'Adventure', 'Fantasy']",2000,3
177830,Private Worlds,1935,['United States of America'],"['Black-and-white', 'Drama']",1930,5
20396076,A Lady of Chance,1928,['United States of America'],"['Silent film', 'Black-and-white', 'Comedy-drama']",1920,8
1749769,Wakko's Wish,1999,['United States of America'],"['Musical', 'Animation', 'Comedy', 'Adventure', 'Family Film']",1990,9
5016784,La Luna,1979,['Italy'],"['Drama', 'World cinema']",1970,9
2091919,A Moment to Remember,2004,['South Korea'],"['Romance Film', 'Drama']",2000,4
2735558,Tom Sawyer,2000,['United States of America'],"['Family Film', 'Animation']",2000,0
3307987,It Had to Be You!,2005,['Hong Kong'],['Chinese Movies'],2000,5
8960715,A Cry in the Wild,1990,['United States of America'],"['Family Drama', 'Animal Picture', 'Adventure', 'Drama', 'Family Film']",1990,0
29385517,The Flemish Farm,1943,['United Kingdom'],"['War film', 'Drama']",1940,3
3769756,Wind,1992,['United States of America'],"['Sports', 'Action/Adventure', 'Adventure']",1990,2
26163935,Bewitched,1945,['United States of America'],['Film noir'],1940,5
412144,Voor een verloren soldaat,1992,['Netherlands'],"['LGBT', 'Romantic drama', 'World cinema', 'Romance Film', 'Drama']",1990,2
11697505,A Pest in the House,1947,['United States of America'],"['Short Film', 'Comedy', 'Family Film']",1940,7
2020750,Into the Night,1985,['United States of America'],"['Action', 'Action/Adventure', 'Comedy', 'Thriller', 'Adventure']",1980,5
27628976,Dharam Aur Kanoon,1984,['India'],"['Crime Fiction', 'Adventure', 'Thriller']",1980,4
5793348,Thursday's Child,1943,['United Kingdom'],"['Black-and-white', 'Drama']",1940,3
33373735,Zindagani,1986,['India'],"['Drama', 'World cinema']",1980,6
525314,Shrek 2,2004,['United States of America'],"['Animation', 'Comedy', ""Children's/Family"", 'Costume drama', 'Adventure', 'Computer Animation', 'Fairy tale', ""Children's Fantasy"", 'Fantasy Comedy', 'Family Film', 'Fantasy']",2000,4
4745376,Enakku 20 Unakku 18,2004,['India'],"['Musical', 'Romantic drama', 'World cinema', 'Tamil cinema', 'Romance Film', 'Drama']",2000,4
15966157,I Do,2004,['Canada'],"['Romance Film', 'Comedy', 'Drama']",2000,4
19691543,Middle of Nowhere,2008,['United States of America'],"['Drama', 'Indie', 'Coming of age', 'Comedy', 'Romantic comedy', 'Comedy-drama']",2000,8
17565926,Antha Ezhu Naatkal,1983,['India'],"['Romance Film', 'Drama']",1980,3
1428872,The Long Good Friday,1980,['United Kingdom'],"['LGBT', 'Crime Fiction', 'Gangster Film', 'Thriller', 'Crime Drama', 'Crime Thriller', 'Drama']",1980,0
26017039,Toss-Up,2004,"['Turkey', 'Greece']",['Drama'],2000,4
6146523,Santosham,2002,['India'],"['Romance Film', 'Comedy', 'Drama']",2000,2
8609183,Romeo and Juliet,1982,['United States of America'],['Drama'],1980,2
10639715,Abhinetri,1970,['India'],"['Drama', 'Family Film']",1970,0
25451837,State Rowdy,1989,['India'],"['Action', 'Crime Fiction', 'Drama']",1980,9
37501922,Terminal Bliss,1992,['United States of America'],['Drama'],1990,2
6960205,Girl,1998,['United States of America'],"['Music', 'Comedy film', 'Romance Film', 'Drama']",1990,8
8959809,The Great DeGaulle Stone Operation,1965,['United States of America'],"['Comedy', 'Animation']",1960,5
20390234,Krantikaal,2005,['India'],['Drama'],2000,5
8870565,Achtung! - Auto-Diebe!,1930,['Weimar Republic'],"['Black-and-white', 'Crime Fiction']",1930,0
11401326,Three Sappy People,1939,['United States of America'],"['Short Film', 'Black-and-white', 'Comedy']",1930,9
26004059,Ang Darling Kong Aswang,2009,['Philippines'],"['Filipino Movies', 'World cinema', 'Horror']",2000,9
14738854,Love at First Bite,1950,['United States of America'],"['Short Film', 'Black-and-white', 'Comedy']",1950,0
14421091,Cirque du Freak: The Vampire's Assistant,2009,['United States of America'],"['Creature Film', ""Children's Fantasy"", 'Action/Adventure', 'Thriller', 'Horror', 'Fantasy']",2000,9
2388465,Madigan,1968,['United States of America'],"['Crime Fiction', 'Mystery', 'Thriller', 'Crime Thriller']",1960,8
33446,Waterloo,1970,"['Russia', 'Soviet Union', 'Italy']","['Action', 'World cinema', 'Epic', 'War film', 'Drama']",1970,0
14642351,The Man Who Loved Yngve,2008,['Norway'],"['Musical', 'LGBT', 'Comedy', 'Teen', 'World cinema', 'Romance Film', 'Drama', 'Gay Themed', 'Gay', 'Coming of age', 'Gay Interest']",2000,8
694787,The Dukes of Hazzard,2005,"['United States of America', 'Australia']","['Action', 'Chase Movie', 'Action Comedy', 'Action/Adventure', 'Buddy film', 'Comedy']",2000,5
21853291,Tsumugi,2004,['Japan'],"['Softcore Porn', 'Erotic Drama', 'Japanese Movies', 'Pornographic movie', 'Erotica', 'Adult']",2000,4
23641804,Aahaa,1997,['India'],['Drama'],1990,7
18931926,O' Horten,2007,"['Denmark', 'Norway', 'France', 'Germany']","['Comedy', 'Drama', 'World cinema']",2000,7
1211596,Geri's Game,1997,['United States of America'],"['Animation', 'Short Film', 'Comedy', 'Family Film', 'Computer Animation']",1990,7
12779395,Vento del sud,1959,['Italy'],"['Black-and-white', 'Crime Fiction', 'Thriller']",1950,9
5979828,The Wedding Album,2006,['United States of America'],[],2000,6
13318485,Lost Boundaries,1949,['United States of America'],"['Social problem film', 'Black-and-white', 'Drama']",1940,9
30273551,Love Hurts,2009,['United States of America'],"['Indie', 'Comedy', 'Romance Film', 'Romantic comedy']",2000,9
26378018,Adieu Philippine,1962,"['France', 'Italy']",['Drama'],1960,2
23691006,Young Bill Hickok,1940,['United States of America'],"['Action', 'Black-and-white', 'Western', 'Action/Adventure']",1940,0
4783479,The Thirty-Nine Steps,1978,['United Kingdom'],"['Action', 'Spy', 'Mystery', 'Indie', 'Thriller']",1970,8
8165631,Al Haram,1965,['Egypt'],['Drama'],1960,5
6399993,Public Enemies,2009,['United States of America'],"['Film adaptation', 'Crime Fiction', 'Gangster Film', 'Biographical film', 'Thriller', 'Historical fiction', 'Drama']",2000,9
26912727,Easy Riches,1938,['United Kingdom'],['Comedy'],1930,8
28257968,For Love Alone,1986,['Australia'],"['Romance Film', 'Historical fiction', 'Drama']",1980,6
2918858,The Fog,2005,['United States of America'],"['Action', 'Action/Adventure', 'Thriller', 'Horror', 'Supernatural']",2000,5
1389264,The Missing,2003,['United States of America'],"['Action', 'Film adaptation', 'Action/Adventure', 'Thriller', 'Adventure', 'Period piece', 'Suspense', 'Western']",2000,3
20201626,Don't Fade Away,2009,['United States of America'],['Drama'],2000,9
29653730,Squeeze a Flower,1970,[],['Comedy'],1970,0
8671328,Mumbai Godfather,2005,['India'],"['Romantic drama', 'Thriller', 'World cinema', 'Romance Film', 'Drama']",2000,5
4141849,The Horror of Frankenstein,1970,['United Kingdom'],"['Satire', 'Horror Comedy', 'Horror', 'Costume Horror']",1970,0
13734834,Okka Magaadu,2008,['India'],"['Action', 'Drama', 'Comedy']",2000,8
9367905,The Big Bad Swim,2006,['United States of America'],"['Drama', 'Indie', 'Comedy', 'Comedy-drama', 'Sports', 'Ensemble Film']",2000,6
24543179,Super Rhino,2009,['United States of America'],"['Animation', 'Short Film', 'Comedy film', 'Adventure', 'Family Film']",2000,9
1291440,My Summer Story,1994,['United States of America'],"['Film adaptation', 'Coming of age', 'Comedy', 'Drama', 'Family Film']",1990,4
8601568,Serving in Silence: The Margarethe Cammermeyer Story,1995,['United States of America'],"['Gay Themed', 'LGBT', 'Gay', 'Gay Interest', 'Television movie', 'Docudrama', 'Drama']",1990,5
7331264,The Honourable Wally Norman,2003,['Australia'],"['Comedy', 'Comedy of manners']",2000,3
867905,Stray Dog,1949,['Japan'],"['Black-and-white', 'Crime Fiction', 'Buddy film', 'Thriller', 'World cinema', 'Film noir', 'Crime Thriller', 'Drama', 'Japanese Movies']",1940,9
9012227,Mean Guns,1997,['United States of America'],"['Action', 'Action Thrillers', 'Action/Adventure', 'Thriller', 'Crime Thriller']",1990,7
4103941,Providence,1977,['France'],['Drama'],1970,7
2023833,Railroaded!,1947,['United States of America'],"['Suspense', 'Black-and-white', 'Crime Fiction', 'Mystery', 'Thriller', 'Film noir']",1940,7
3202250,The Ten Commandments,1923,['United States of America'],"['Black-and-white', 'Drama', 'Indie', 'Silent film', 'Christian film', 'Epic', 'Costume drama']",1920,3
8283082,The Invisible Monster,1950,['United States of America'],"['Action', 'Black-and-white', 'Adventure', 'Science Fiction']",1950,0
28646493,Buick Riviera,2008,"['Croatia', 'United Kingdom', 'Germany', 'Bosnia and Herzegovina', 'United States of America']",['Drama'],2000,8
16617822,"Tähdet kertovat, komisario Palmu",1962,['Finland'],"['Crime Fiction', 'Comedy', 'Thriller']",1960,2
5209057,Raja Kumarudu,1999,['India'],"['Action', 'Drama', 'Comedy', 'Romance Film']",1990,9
25214825,Housefull,1999,[],['Thriller'],1990,9
13327521,Return to the Lost World,1992,['Canada'],"['Monster movie', 'Fantasy Adventure', 'Action/Adventure', 'Adventure', 'Science Fiction', 'Fantasy']",1990,2
10299510,Hajji Washington,1998,['Iran'],"['Historical drama', 'Comedy']",1990,8
4802267,The Beach,2000,"['United Kingdom', 'United States of America']","['Action', 'Psychological thriller', 'Film adaptation', 'Stoner film', 'Action/Adventure', 'Thriller', 'Romance Film', 'Adventure', 'Drama']",2000,0
16932738,"Khrustalyov, My Car!",1998,"['Russia', 'France']","['Black-and-white', 'Comedy', 'Drama']",1990,8
24154924,The Girl Who Played with Fire,2009,"['Sweden', 'Germany', 'Denmark']","['Detective fiction', 'Crime Fiction', 'Mystery', 'Thriller', 'World cinema', 'Crime Thriller', 'Drama', 'Detective']",2000,9
6768574,Vanathai Pola,2001,['India'],"['Musical', 'Romance Film', 'Drama']",2000,1
17547483,Underworld,1997,['United States of America'],"['Action', 'Crime Fiction', 'Action/Adventure', 'Comedy', 'Thriller', 'Film noir', 'Black comedy', 'Crime Thriller', 'Drama']",1990,7
10874116,St. Trinian's,2007,['United Kingdom'],"['Comedy', 'Crime Comedy']",2000,7
9811498,The Wooden Camera,2003,"['United Kingdom', 'France', 'South Africa']","['LGBT', 'Drama', 'Coming of age', 'Indie', 'Family Drama', 'World cinema', 'Family Film']",2000,3
2412049,Night Has a Thousand Eyes,1948,['United States of America'],"['Psychological thriller', 'Film noir', 'Thriller']",1940,8
3736782,Carry On Jack,1963,['United Kingdom'],"['Adventure Comedy', 'Parody', 'Comedy']",1960,3
403227,The Nightmare Before Christmas,1993,['United States of America'],"['Musical', 'Animation', 'Animated Musical', 'Stop motion', ""Children's/Family"", 'Christmas movie', 'Creature Film', ""Children's Fantasy"", 'Family Film', 'Fantasy']",1990,3
13202044,Strawberry Shortcake: Let's Dance,2007,['United States of America'],"['Animation', ""Children's/Family"", ""Children's"", ""Children's Entertainment""]",2000,7
203993,The League of Gentlemen,1959,['United Kingdom'],"['Action', 'Crime Fiction', 'Action/Adventure', 'Comedy', 'Heist', 'Caper story', 'Crime Comedy', 'War film', 'Ensemble Film']",1950,9
9387177,Chile 672,2006,['Argentina'],"['Indie', 'Drama']",2000,6
1027060,Elizabeth: The Golden Age,2007,"['United Kingdom', 'France', 'Germany']","['Biography', 'Romantic drama', 'Biographical film', 'Romance Film', 'Drama', 'Period piece', 'History', 'Biopic [feature]', 'Historical Epic', 'Historical fiction']",2000,7
19745532,A Bunny's Tale,1985,['United States of America'],"['Biographical film', 'Biopic [feature]', 'Comedy film', 'Comedy-drama', 'Drama']",1980,5
42993,Back to the Future,1985,['United States of America'],"['Comedy', 'Sci-Fi Adventure', 'Americana', 'Adventure', 'Time travel', 'Humour', 'Science Fiction', 'Family Film']",1980,5
210239,Seance on a Wet Afternoon,1964,['United Kingdom'],"['Film adaptation', 'Crime Fiction', 'Thriller', 'Horror', 'Crime Drama', 'Drama']",1960,4
4708827,The World is Hot Enough,2008,['Canada'],"['Comedy', 'Animation']",2000,8
3614683,The Land Before Time VI: The Secret of Saurus Rock,1998,['United States of America'],"[""Children's Fantasy"", 'Animation', 'Family-Oriented Adventure', ""Children's/Family"", 'Adventure', 'Family Film']",1990,8
8083590,A Shot at Glory,2000,"['United Kingdom', 'Scotland', 'United States of America']","['Sports', 'Drama']",2000,0
9670095,Home Beyond the Sun,2004,['Canada'],"['Period piece', 'Television movie', 'Drama']",2000,4
8846079,Sufferin' Cats,1943,[],"['Animation', 'Family Film', 'Comedy film']",1940,3
24654654,Through the Glass,2008,"['Nigeria', 'United States of America']",[],2000,8
18084420,Evil Dead Trap,1988,['Japan'],"['Japanese Movies', 'World cinema', 'Horror']",1980,8
1262718,Candy,1968,"['France', 'Italy', 'United States of America']","['Comedy', 'Cult', 'Sex comedy']",1960,8
2837025,End of Days,1999,['United States of America'],"['Action', 'Action Thrillers', 'Action/Adventure', 'Thriller', 'Horror', 'Albino bias', 'Supernatural']",1990,9
18849274,Maya Machindra,1939,['India'],['Drama'],1930,9
2113868,Rock Around the Clock,1956,['United States of America'],"['Musical', 'Black-and-white']",1950,6
11387615,The Scent of Green Papaya,1993,"['France', 'Vietnam']","['Music', 'Romantic drama', 'World cinema', 'Romance Film', 'Drama']",1990,3
23214188,Runway,2009,['India'],"['Thriller', 'World cinema']",2000,9
11038654,Drunken Tai Chi,1984,['Hong Kong'],"['Action', 'Comedy film', 'Chinese Movies', 'Martial Arts Film']",1980,4
7730324,The Bashful Buzzard,1945,['United States of America'],"['Animation', 'Short Film', 'Comedy', 'Family Film']",1940,5
18809464,Cheyenne Warrior,1994,['United States of America'],"['Action', 'Action/Adventure', 'Western', 'Television movie']",1990,4
8556941,Dekada '70,2002,['Philippines'],"['Filipino Movies', 'Political cinema', 'World cinema', 'Drama']",2000,2
18892608,P.U.N.K.S.,1999,['United States of America'],"['Comedy', 'Adventure', 'Family-Oriented Adventure', ""Children's/Family"", 'Science Fiction', 'Family Film']",1990,9
20451434,Eye for an Eye,2008,['South Korea'],"['Action', 'Crime Fiction']",2000,8
21492573,Morphine,2008,['Russia'],"['Drama', 'World cinema']",2000,8
5637189,Jacob,1994,"['United Kingdom', 'France', 'Germany', 'Czech Republic', 'Italy', 'United States of America']","['Crime Fiction', 'Biography', 'World cinema', 'Christian film', 'Drama', 'History', 'Television movie', 'Epic']",1990,4
489156,Little Man Tate,1991,['United States of America'],"['Family Drama', 'Childhood Drama', 'Drama', 'Family Film']",1990,1
8660363,Dulha Mil Gaya,2008,['India'],"['Musical', 'Comedy', 'Bollywood', 'World cinema', 'Drama']",2000,8
3116175,Amazing Grace,2006,"['United Kingdom', 'United States of America']","['History', 'Biography', 'Romance Film', 'Drama']",2000,6
8408103,Dumb Patrol,1964,['United States of America'],"['Animation', 'Short Film', 'Comedy', 'War film', 'Family Film']",1960,4
13330521,This Sweet Sickness,1977,['France'],"['Mystery', 'Romantic drama', 'Thriller', 'Romance Film', 'Drama']",1970,7
7455727,Scenes from the Class Struggle in Beverly Hills,1989,['United States of America'],"['LGBT', 'Indie', 'Satire', 'Comedy', 'Black comedy']",1980,9
1014242,Horse Feathers,1932,['United States of America'],"['Black-and-white', 'Screwball comedy', 'Comedy', 'Satire', 'Romance Film', 'Slapstick', 'Pre-Code', 'Absurdism', 'Parody', 'Sports']",1930,2
982199,Peter Pan,1953,['United States of America'],"['Musical', 'Animation', 'Adventure', 'Drama', 'Family Film', 'Fantasy']",1950,3
31153569,Pappy's Puppy,1955,[],"['Animation', 'Short Film', 'Comedy film', 'Family Film']",1950,5
3365103,Pope John Paul II,2005,"['Italy', 'Poland', 'United States of America']","['Television movie', 'Biographical film', 'Drama']",2000,5
17220001,Transgression,1974,['South Korea'],['Drama'],1970,4
6809364,Dil Apna Punjabi,2006,['India'],"['Romantic drama', 'Family Drama', 'World cinema', 'Romance Film', 'Drama']",2000,6
11937073,Coming Out,1989,"['Germany', 'German Democratic Republic']","['LGBT', 'Romantic drama', 'World cinema', 'Romance Film', 'Drama']",1980,9
536521,Creepshow,1982,['United States of America'],"['Animation', 'Comedy', 'Horror', 'Cult', 'Natural horror films', 'Fantasy']",1980,2
167599,Men in Black,1997,['United States of America'],"['Action', 'Action/Adventure', 'Buddy film', 'Comedy', 'Science Fiction']",1990,7
7887331,My Favorite Martian,1999,['United States of America'],"['Science Fiction', 'Comedy', 'Family Film']",1990,9
692772,Jack,1996,['United States of America'],"['Comedy', 'Comedy-drama', 'Science Fiction', 'Drama', 'Tragedy']",1990,6
3546352,The Chase,1994,['United States of America'],"['Action', 'Crime Fiction', 'Action/Adventure', 'Comedy']",1990,4
1584538,Monsieur Hulot's Holiday,1953,['France'],"['Comedy', 'World cinema']",1950,3
6916204,Big Girls Don't Cry... They Get Even,1992,['United States of America'],"['Comedy', 'Teen', ""Children's/Family"", 'Family Film']",1990,2
6103239,Gone Are the Dayes,1984,['United States of America'],"['Comedy', 'Crime Fiction']",1980,4
2569794,A Show of Force,1990,['United States of America'],"['Drama', 'Thriller', 'Political thriller']",1990,0
17475562,Gaja,2008,['India'],"['Action', 'Romance Film']",2000,8
1745339,A Lot Like Love,2005,['United States of America'],"['Comedy', 'Romance Film', 'Romantic comedy', 'Comedy-drama', 'Drama']",2000,5
9437838,Two and half letters of Love,2000,['India'],"['Romantic drama', 'World cinema', 'Romance Film', 'Drama']",2000,0
31251203,Indien,1995,['Austria'],"['Drama', 'Comedy film']",1990,5
18932875,Thunder Rock,1942,['United Kingdom'],"['War film', 'Drama', 'Fantasy']",1940,2
26392517,Crazy Moon,1987,"['Canada', 'United States of America']","['Romance Film', 'Melodrama', 'Drama']",1980,7
8711984,Something Wild,1961,['United States of America'],"['Indie', 'Drama']",1960,1
35591024,DoReMi,1996,['Philippines'],"['Musical', 'Comedy', 'Drama']",1990,6
1591883,Torch Song,1953,['United States of America'],"['Musical', 'Romantic drama', 'Romance Film', 'Drama']",1950,3
20831096,Period of Adjustment,1962,['United States of America'],"['Black-and-white', 'Drama']",1960,2
24578633,Tin Hats,1926,['United States of America'],['Silent film'],1920,6
24084221,Tokyo Tower,2005,['Japan'],['Japanese Movies'],2000,5
8537006,Hum,1991,['India'],"['Musical', 'Bollywood', 'World cinema']",1990,1
27997093,The Crooked Web,1955,['United States of America'],"['Drama', 'Crime Fiction']",1950,5
6168146,Evening in Byzantium,1978,['United States of America'],"['Drama', 'Thriller', 'Political thriller']",1970,8
2170538,Bheema,2008,['India'],"['Action', 'Tamil cinema']",2000,8
24147116,In the Name of the Son,2007,"['India', 'Bosnia and Herzegovina', 'United States of America']",['Short Film'],2000,7
18613593,The Keys of the Kingdom,1944,['United States of America'],"['Christian film', 'Black-and-white', 'Drama']",1940,4
697868,Dead Calm,1989,"['New Zealand', 'Australia', 'United States of America']","['Psychological thriller', 'Suspense', 'Thriller', 'World cinema']",1980,9
1356982,Sabrina,1995,['United States of America'],"['Comedy', 'Romance Film', 'Romantic comedy', 'Drama']",1990,5
11040532,Hamraaz,1967,['India'],"['Musical', 'Thriller', 'Bollywood', 'World cinema', 'Drama']",1960,7
10301392,Adajya,1998,['India'],['Romantic drama'],1990,8
9092660,Bordertown,1935,['United States of America'],"['Black-and-white', 'Crime Fiction']",1930,5
19457040,Sorority Row,2009,['United States of America'],"['Indie', 'Slasher', 'Thriller', 'Horror', 'Teen']",2000,9
3317623,Drawing Flies,1996,['Canada'],"['Indie', 'Comedy', 'Black comedy', 'Comedy-drama', 'Ensemble Film']",1990,6
351266,Hoop Dreams,1994,['United States of America'],"['Social issues', 'Sports', 'Biography', 'Documentary', 'Drama', 'Culture & Society']",1990,4
33002536,Ilaaka,1989,['India'],['Action'],1980,9
9669872,Akayla,1991,['India'],"['Musical', 'Romantic drama', 'Thriller', 'Bollywood', 'World cinema', 'Romance Film', 'Drama']",1990,1
14810616,Barefooted Youth,1964,['South Korea'],"['Romance Film', 'Drama']",1960,4
25431279,"Shake, Rattle & Roll XI",2009,['Philippines'],"['Filipino Movies', 'World cinema', 'Horror']",2000,9
25145506,Pravarakyudu,2009,['India'],['Family Film'],2000,9
10802159,The Emperor of Capri,1949,['Italy'],['Comedy'],1940,9
805941,The Deadly Assassin,1976,[],"['Science Fiction', 'Adventure', 'Drama']",1970,6
5998741,Aankhen,1968,['India'],"['Action', 'Bollywood']",1960,8
18487239,Vice Versa,1988,['United States of America'],"['Film adaptation', 'Fantasy', 'Comedy', 'Teen', 'Drama', 'Family Film']",1980,8
18813698,Aniyathi Pravu,1997,['India'],"['Romance Film', 'Drama']",1990,7
8420622,Invitation to the Dance,1956,['United States of America'],"['Musical', 'Animation']",1950,6
18901958,Kaos,1984,['Italy'],"['Art film', 'Comedy', 'Horror', 'World cinema', 'Drama']",1980,4
1623363,5 Fingers,1952,['United States of America'],"['Spy', 'Black-and-white', 'Thriller', 'Drama']",1950,2
5729,Chariots of Fire,1981,['United Kingdom'],"['Period piece', 'History', 'Sports', 'Drama']",1980,1
1809414,Kansas City Confidential,1952,['United States of America'],"['Crime Fiction', 'Mystery', 'Thriller', 'Film noir', 'Crime Thriller', 'Drama', 'Suspense', 'Heist', 'Caper story']",1950,2
4969708,Eagle in a Cage,1972,"['United Kingdom', 'United States of America']","['Historical drama', 'Biopic [feature]', 'Historical fiction', 'Drama']",1970,2
10140436,Winners of the West,1940,['United States of America'],"['Action', 'Black-and-white', 'Western', 'Adventure']",1940,0
253828,The Mummy,1999,['United States of America'],"['Action', 'Adventure', 'Fantasy']",1990,9
213401,No Man's Land,2001,"['Belgium', 'Slovenia', 'United Kingdom', 'France', 'Bosnia and Herzegovina', 'Italy']","['Action/Adventure', 'Satire', 'Comedy', 'World cinema', 'War film', 'Drama']",2000,1
4049296,Pooh's Heffalump Halloween Movie,2005,['United States of America'],"['Creature Film', ""Children's Fantasy"", 'Animation', ""Children's/Family"", 'Family Film']",2000,5
16913484,Sharp Shooters,1928,['United States of America'],"['Silent film', 'Black-and-white', 'Comedy']",1920,8
29405556,Snegithiye,2000,['India'],"['Musical', 'Drama', 'Thriller']",2000,0
15382421,Song of Ceylon,1934,"['United Kingdom', 'Sri Lanka']","['Short Film', 'Documentary']",1930,4
778884,Laser Mission,1990,"['Germany', 'South Africa', 'United States of America']","['Action', 'Spy', 'Action Thrillers', 'Indie', 'Action/Adventure', 'Thriller', 'Glamorized Spy Film']",1990,0
3824910,Bunshinsaba,2004,['South Korea'],"['World cinema', 'Horror']",2000,4
16555100,Khushi,2000,['India'],['Romance Film'],2000,0
5367617,They Died with Their Boots On,1941,['United States of America'],"['Black-and-white', 'Biographical film', 'Cavalry Film', 'Drama', 'Biopic [feature]', 'Historical Epic', 'Historical fiction', 'Epic', 'War film']",1940,1
2321340,Demonium,2000,['Italy'],['Horror'],2000,0
25011255,Anything Can Happen,1953,['United States of America'],"['Romance Film', 'Docudrama', 'Comedy']",1950,3
21086865,Papelucho and the Martian,2007,['Chile'],['Animation'],2000,7
1750951,Mission to Moscow,1943,['United States of America'],"['Black-and-white', 'Biopic [feature]', 'War film', 'Propaganda film', 'Drama']",1940,3
24251542,Blood and Bone,2009,['United States of America'],"['Action', 'Drama', 'Action/Adventure', 'Martial Arts Film']",2000,9
1856154,Under Suspicion,2000,['United States of America'],"['Psychological thriller', 'Suspense', 'Neo-noir', 'Mystery', 'Thriller', 'Crime Thriller']",2000,0
7518562,Whoops! I'm a Cowboy,1937,['United States of America'],"['Animation', 'Short Film', 'Comedy']",1930,7
11142742,Aaina,1977,['India'],"['Musical', 'Bollywood', 'World cinema', 'Drama']",1970,7
19680415,A Day to Remember,1953,['United Kingdom'],['Comedy'],1950,3
8628355,Al-Millionairah al-Saghirah,1948,['Egypt'],['Drama'],1940,8
4413498,Beneath the Valley of the Ultra-Vixens,1979,['United States of America'],"['Sexploitation', 'Comedy', 'Adult']",1970,9
20575760,For Eternal Hearts,2007,['South Korea'],"['Romantic drama', 'Drama', 'Fantasy']",2000,7
898561,Antwone Fisher,2002,['United States of America'],"['Biography', 'Biopic [feature]', 'Romance Film', 'Drama']",2000,2
2728573,Life is a long quiet river,1988,['France'],"['Satire', 'Comedy of manners', 'Domestic Comedy', 'Comedy-drama']",1980,8
15048916,This Man Is Mine,1934,['United States of America'],['Romantic drama'],1930,4
10772859,Bidaai,1974,['India'],"['Musical', 'Romantic drama', 'Bollywood', 'World cinema', 'Romance Film', 'Drama']",1970,4
3046234,Theodore Rex,1995,['United States of America'],"[""Children's Fantasy"", 'Buddy film', 'Comedy', 'Family Film', 'Fantasy']",1990,5
2547497,Lulu on the Bridge,1998,['United States of America'],"['Crime Fiction', 'Mystery', 'Indie', 'Romantic drama', 'Thriller', 'Romance Film', 'Crime Thriller', 'Drama', 'Supernatural']",1990,8
14765230,Yavarum Nalam,2009,['India'],"['Musical', 'Thriller', 'Horror', 'Tamil cinema', 'World cinema']",2000,9
17806123,Tarzan the Fearless,1933,['United States of America'],['Black-and-white'],1930,3
17395300,Dust Be My Destiny,1939,['United States of America'],"['Black-and-white', 'Romantic drama', 'Melodrama', 'Drama']",1930,9
29222508,Urge to Kill,1960,[],"['Drama', 'Crime Fiction']",1960,0
18849372,Chakravarthi Thirumagal,1957,['India'],['Drama'],1950,7
11381074,Rafter Romance,1933,['United States of America'],"['Black-and-white', 'Comedy', 'Romance Film', 'Romantic comedy']",1930,3
35479680,Love Story,1986,['India'],['Romance Film'],1980,6
25952444,Ma and Pa Kettle Back on the Farm,1951,['United States of America'],"['Domestic Comedy', 'Comedy']",1950,1
36814246,Eraserhead,1977,['United States of America'],"['Surrealism', 'Black-and-white', 'Indie', 'Avant-garde', 'Drama', 'Horror', 'Experimental film', 'Science Fiction', 'Cult', 'Fantasy']",1970,7
21939688,Invictus,2009,"['United States of America', 'South Africa']","['Sports', 'Film adaptation', 'History', 'Biography', 'Biopic [feature]', 'Political drama', 'Drama']",2000,9
11408406,Love Songs,2007,['France'],"['Musical', 'Romantic drama', 'World cinema', 'Romance Film', 'Drama']",2000,7
6989257,Ghostwood,2006,['Ireland'],"['Thriller', 'Horror']",2000,6
2353104,"The Karate Kid, Part III",1989,"['Japan', 'United States of America']","['Action', 'Family Drama', 'Martial Arts Film', 'Drama', 'Japanese Movies', 'Coming of age', 'Sports', 'Family Film']",1980,9
35509447,Night Eyes 3,1993,['United States of America'],"['Adult', 'Thriller', 'Erotica', 'Drama']",1990,3
2165590,Lonely are the Brave,1962,['United States of America'],"['Black-and-white', 'Western', 'Action/Adventure', 'Drama']",1960,2
4845206,Sodom and Gomorrah,1962,"['France', 'Italy', 'United States of America']","['History', 'Historical drama', 'Adventure', 'Drama']",1960,2
17101981,The Proposal,2009,['United States of America'],"['Comedy', 'Romance Film', 'Romantic comedy', 'Drama']",2000,9
10534798,A Black and White World,2005,['Australia'],"['Black-and-white', 'Short Film', 'Romance Film', 'Fantasy']",2000,5
25894531,Tora-san's Love in Osaka,1981,['Japan'],['Japanese Movies'],1980,1
12758034,Hannah Montana: The Movie,2009,['United States of America'],"['Musical', 'Comedy', 'Teen', 'Musical comedy', 'Romance Film', ""Children's/Family"", 'Drama', 'Family Film']",2000,9
12449377,Mother's Boys,1994,['United States of America'],"['Psychological thriller', 'Suspense', 'Thriller', 'Drama']",1990,4
14922808,Appointment with Danger,1951,['United States of America'],"['Detective fiction', 'Black-and-white', 'Crime Fiction', 'Thriller', 'Film noir', 'Crime Thriller', 'Drama', 'Detective', 'Crime Drama']",1950,1
17987269,Heavenly Pursuits,1987,['United Kingdom'],"['Drama', 'Comedy']",1980,7
11381533,Timid Tabby,1957,['United States of America'],"['Short Film', ""Children's/Family""]",1950,7
1059728,Deathtrap,1982,['United States of America'],"['Psychological thriller', 'Film adaptation', 'LGBT', 'Mystery', 'Comedy', 'Thriller', 'Black comedy', 'Whodunit', 'Crime Thriller', 'Drama', 'Suspense']",1980,2
5514092,Pukar,1939,['India'],['Black-and-white'],1930,9
11796087,Anna,1951,['Italy'],"['Black-and-white', 'Drama']",1950,1
27301153,Sainyam,1993,['India'],['Drama'],1990,3
9179200,Topaze,1933,['United States of America'],"['Black-and-white', 'Comedy', 'Drama']",1930,3
8666779,Ekipazh,1979,"['Russia', 'Soviet Union']","['Action/Adventure', 'World cinema', 'Disaster', 'Drama']",1970,9
14127869,Black Rainbow,1989,['United Kingdom'],"['Psychological thriller', 'Mystery', 'Thriller', 'Horror', 'Supernatural']",1980,9
31977240,Kismet,1980,['India'],"['Musical', 'Romantic drama', 'Thriller', 'Bollywood', 'World cinema', 'Romance Film', 'Drama']",1980,0
28794755,New York Confidential,1955,['United States of America'],"['Drama', 'Crime Fiction']",1950,5
6701441,Naan Thaan,2008,['India'],"['Romance Film', 'Biographical film', 'Drama']",2000,8
76310,Roman Holiday,1953,"['Italy', 'United States of America']","['Comedy', 'Romance Film', 'Romantic comedy', 'Drama']",1950,3
5643855,Barbary Coast,1935,['United States of America'],"['Black-and-white', 'Romantic drama', 'Action/Adventure', 'Romance Film', 'Adventure', 'Drama']",1930,5
4515396,Stormbreaker,2006,"['United Kingdom', 'Germany', 'United States of America']","['Action', 'Spy', 'Thriller', 'Adventure', 'Family Film']",2000,6
4306224,Devil in a Blue Dress,1995,['United States of America'],"['Film adaptation', 'Detective fiction', 'Neo-noir', 'Crime Fiction', 'Mystery', 'Thriller', 'Crime Thriller', 'Drama', 'Period piece', 'Detective']",1990,5
9459932,Allegheny Uprising,1939,['United States of America'],"['Action', 'Black-and-white', 'Action/Adventure', 'Western', 'Costume drama']",1930,9
10539751,Fighting Madam,1987,"['Hong Kong', 'Taiwan']","['Action', 'Crime Fiction', 'Thriller', 'Martial Arts Film', 'Adventure']",1980,7
12428333,Ripe,1997,['United States of America'],"['Coming of age', 'Indie', 'Drama']",1990,7
22526132,T.R. Baskin,1971,['United States of America'],"['Romantic comedy', 'Comedy-drama', 'Drama']",1970,1
685977,Sixteen Candles,1984,['United States of America'],"['Coming of age', 'Comedy', 'Teen', 'Romantic comedy', 'Romance Film', 'Cult']",1980,4
3044228,Masters of the Universe,1987,['United States of America'],"['Action', 'Fantasy Adventure', 'Superhero', 'Action/Adventure', 'Thriller', 'Adventure', 'Sword and sorcery', 'Superhero movie', 'Science Fiction', 'Fantasy']",1980,7
14734322,Sweet and Hot,1958,['United States of America'],"['Short Film', 'Black-and-white', 'Comedy']",1950,8
1693762,Willard,1971,['United States of America'],"['Horror', 'Natural horror films']",1970,1
2615493,Hitler's SS: Portrait in Evil,1985,['United States of America'],"['Romance Film', 'War film', 'Drama']",1980,5
24314500,Rope and Skin,1979,['Japan'],"['Erotica', 'Japanese Movies', 'Pornographic movie']",1970,9
4715917,Actor,1993,['Iran'],['Drama'],1990,3
7831942,Poove Unakkaga,1996,['India'],['Romance Film'],1990,6
10877732,Last Orders,2001,"['United Kingdom', 'Germany']","['Drama', 'Indie', 'Road movie', 'Ensemble Film']",2000,1
1492870,The Marrying Kind,1952,['United States of America'],"['Marriage Drama', 'Domestic Comedy', 'Comedy-drama', 'Drama']",1950,2
10531283,Khubsoorat,1980,['India'],"['Comedy', 'Bollywood']",1980,0
8635138,Prathibandh,1990,['India'],"['Bollywood', 'Crime Fiction']",1990,0
17752606,Trópico de Sangre,2009,[],"['Drama', 'Indie', 'Biographical film', 'World cinema', 'Historical Epic', 'Historical fiction']",2000,9
2599640,Rockin' in the Rockies,1945,['United States of America'],"['Musical', 'Black-and-white', 'Western', 'Comedy', 'Slapstick']",1940,5
23848702,The Double Hour,2009,['Italy'],"['Crime Fiction', 'Mystery', 'Thriller', 'Romance Film', 'Drama']",2000,9
1749629,The Honeymooners,2005,['United States of America'],['Comedy'],2000,5
8916783,Murder in the Hamptons,2005,['Canada'],"['Television movie', 'Crime Fiction', 'Drama']",2000,5
2275251,Starship Troopers 2: Hero of the Federation,2004,['United States of America'],"['Action', 'Action/Adventure', 'Thriller', 'Adventure', 'Sci-Fi Horror', 'Creature Film', 'Horror', 'Science Fiction']",2000,4
3151934,The Opposite Sex,1956,['United States of America'],"['Musical', 'Satire', 'Comedy', 'Romance Film', 'Romantic comedy', 'Drama']",1950,6
12383135,Majajan,2006,['Pakistan'],['Drama'],2000,6
34630522,Velai Kidaichuduchu,1990,['India'],[],1990,0
8208317,Shankar Dada Zindabad,2007,['India'],['Comedy'],2000,7
17020080,Marilena from P7,2006,['Romania'],"['Art film', 'Short Film', 'World cinema', 'Drama', 'Fantasy']",2000,6
7527753,The Four Feathers,2002,"['United Kingdom', 'United States of America']","['Period piece', 'Action', 'Film adaptation', 'Action/Adventure', 'War film', 'Adventure', 'Drama']",2000,2
16983451,Father Is a Bachelor,1950,['United States of America'],"['Musical', 'Black-and-white', 'Comedy', 'Musical comedy', 'Romantic comedy']",1950,0
29206378,Going Back,2001,"['Canada', 'United States of America']","['Action', 'Drama', 'Action/Adventure', 'War film']",2000,1
5734299,Arya,2004,['India'],"['Musical', 'Romantic drama', 'Comedy', 'World cinema', 'Romance Film', 'Drama', 'Romantic comedy', 'Tollywood']",2000,4
1055466,Primal Fear,1996,['United States of America'],"['Crime Fiction', 'Mystery', 'Thriller', 'Drama']",1990,6
23091399,Naked Among Wolves,1963,"['Germany', 'German Democratic Republic']","['Drama', 'World cinema']",1960,3
1615208,Forgiveness,2004,['South Africa'],['Drama'],2000,4
14538904,Hote Hote Pyar Hogaya,1999,['India'],"['Romantic drama', 'World cinema', 'Romance Film', 'Drama']",1990,9
28647615,Sing Sing,1983,['Italy'],['Comedy'],1980,3
3715795,Viva Knievel!,1977,['United States of America'],"['Action', 'Crime Fiction', 'Action Thrillers', 'Action/Adventure', 'Comedy', 'Thriller']",1970,7
19476185,Mr. Sardonicus,1961,['United States of America'],['Horror'],1960,1
21481795,London River,2009,"['United Kingdom', 'France', 'Algeria']","['Period piece', 'Indie', 'Drama']",2000,9
18347602,I Hope They Serve Beer in Hell,2009,['United States of America'],['Comedy'],2000,9
1165657,Psycho Beach Party,2000,"['United States of America', 'Australia']","['Indie', 'Parody', 'Comedy', 'Horror Comedy', 'Horror', 'Black comedy', 'Beach Film']",2000,0
4948738,If These Walls Could Talk,1996,['United States of America'],"['Social problem film', 'Drama', 'Feminist Film']",1990,6
25052421,A Dennis the Menace Christmas,2007,"['Canada', 'United States of America']","['Comedy', 'Family Film']",2000,7
10791937,Ninaithale Inikkum,1979,['India'],"['Romantic drama', 'World cinema', 'Romance Film', 'Drama']",1970,9
1844854,The Day of the Dolphin,1973,['United States of America'],"['Action', 'Film adaptation', 'Action/Adventure', 'Thriller', 'Drama', 'Animal Picture', 'Science Fiction', 'Political thriller']",1970,3
10993685,Resurrection,1927,['United States of America'],"['Black-and-white', 'Romantic drama', 'Indie']",1920,7
27556014,Chikan Densha: Suggestive Indecent Hips,2005,['Japan'],['Japanese Movies'],2000,5
5664529,Vixen!,1968,['United States of America'],"['Sexploitation', 'Softcore Porn']",1960,8
1954484,The Cat's Meow,2002,"['Canada', 'United Kingdom', 'Germany', 'United States of America']","['Period piece', 'Crime Fiction', 'Mystery', 'Thriller', 'Crime Thriller', 'Drama']",2000,2
948337,The Manchurian Candidate,2004,['United States of America'],"['Drama', 'Mystery', 'Thriller']",2000,4
6492614,The Odd Couple,1968,['United States of America'],"['Film adaptation', 'Screwball comedy', 'Comedy', 'Romance Film', 'Drama']",1960,8
1549008,Herbie: Fully Loaded,2005,['United States of America'],"['Action', 'Action/Adventure', 'Comedy', 'Romance Film', ""Children's/Family"", 'Auto racing', 'Adventure', 'Action Comedy', 'Sports', 'Family Film', 'Fantasy']",2000,5
6394904,The Whoopee Party,1932,['United States of America'],"['Musical', 'Black-and-white', 'Animation', 'Short Film', 'Comedy', 'Family Film']",1930,2
497109,Party Monster,2003,"['Netherlands', 'United States of America']","['LGBT', 'Crime Fiction', 'Biography', 'Indie', 'Black comedy', 'Crime Thriller', 'Drama', 'Period piece']",2000,3
5169883,The Hard Way,1991,['United States of America'],"['Action', 'Crime Fiction', 'Action/Adventure', 'Buddy film', 'Comedy']",1990,1
5831289,That Championship Season,1999,['United States of America'],"['Sports', 'Drama']",1990,9
29026550,Strayed,2009,[],"['Thriller', 'World cinema']",2000,9
20603201,Growing Pains: Return of the Seavers,2004,['United States of America'],['Comedy'],2000,4
21763525,Homeless to Harvard: The Liz Murray Story,2003,['United States of America'],"['Biography', 'Biopic [feature]', 'Melodrama', 'Television movie', 'Drama']",2000,3
8120397,Wild Guitar,1962,['United States of America'],"['Musical', 'Black-and-white', 'Indie', 'Melodrama', 'Drama']",1960,2
13285223,Mercy,1995,['United States of America'],"['Psychological thriller', 'Indie', 'Thriller', 'Crime Thriller']",1990,5
154635,Three Colors: Blue,1993,"['France', 'Poland']","['Music', 'Mystery', 'World cinema', 'Drama']",1990,3
430740,Blood: The Last Vampire,2000,"['Japan', 'United States of America']","['Action', 'Animation', 'Horror', 'Anime']",2000,0
9429,Young and Innocent,1937,"['United Kingdom', 'England']","['Suspense', 'Black-and-white', 'Crime Fiction', 'Thriller']",1930,7
23372087,Down to the Dirt,2008,['Canada'],['Drama'],2000,8
31299921,Murder Ordained,1987,['United States of America'],"['Crime Fiction', 'Mystery', 'Drama']",1980,7
2321684,Black Tuesday,1954,['United States of America'],"['Crime Fiction', 'Thriller', 'Film noir', 'Crime Thriller', 'Drama']",1950,4
17674906,My Father My Lord,2007,['Israel'],"['Drama', 'World cinema']",2000,7
4752795,Before Night Falls,2001,['United States of America'],"['LGBT', 'Biography', 'Drama', 'Gay Themed', 'Gay', 'Gay Interest', 'Biopic [feature]', 'Political drama']",2000,1
18200505,13 Dead Men,2003,['United States of America'],"['Action', 'Prison', 'Crime Fiction', 'Action/Adventure', 'Master Criminal Films']",2000,3
8138573,Valerie on the Stairs,2006,['United States of America'],"['Television movie', 'Cult', 'Horror']",2000,6
14738144,The Ghost Talks,1949,['United States of America'],"['Short Film', 'Black-and-white', 'Comedy']",1940,9
7275378,Lycanthropus,1962,"['Austria', 'Italy']",['Horror'],1960,2
11684516,International Khiladi,1999,['India'],"['Action', 'Action/Adventure', 'Thriller', 'World cinema', 'Crime Drama']",1990,9
27423710,Gunsmoke: Return to Dodge,1987,['United States of America'],"['Western', 'Television movie', 'Action/Adventure']",1980,7
628120,London After Midnight,1927,['United States of America'],"['Psychological thriller', 'Black-and-white', 'Indie', 'Thriller', 'Horror', 'Silent film']",1920,7
2586953,Parineeta,2005,['India'],"['Musical', 'Romantic drama', 'Bollywood', 'World cinema', 'Romance Film', 'Drama']",2000,5
7200877,Casey of the Coast Guard,1926,['United States of America'],"['Action', 'Black-and-white', 'Indie', 'Silent film', 'Adventure']",1920,6
1380383,Bébé's Kids,1992,['United States of America'],"['Animation', 'Comedy', 'Domestic Comedy', 'Family Film']",1990,2
8801073,The Snow Maiden,1969,"['Russia', 'Soviet Union']","['Fairy tale', ""Children's Fantasy"", 'World cinema', ""Children's/Family"", 'Fantasy']",1960,9
3120750,Arisan!,2003,['Indonesia'],"['LGBT', 'Comedy', 'World cinema', 'Drama', 'Gay Themed', 'Gay', 'Gay Interest', 'Comedy of manners', 'Ensemble Film']",2000,3
2079686,Mommie Dearest,1981,['United States of America'],"['Biography', 'Biographical film', 'Childhood Drama', 'Biopic [feature]', 'Docudrama', 'Drama']",1980,1
11141931,Slicked-up Pup,1951,['United States of America'],"['Animation', 'Short Film', 'Comedy', 'Family Film']",1950,1
24878469,See You in the Morning,1989,['United States of America'],['Romantic comedy'],1980,9
1853921,The Beverly Hillbillies,1993,['United States of America'],"['Slapstick', 'Comedy', 'Comedy of manners']",1990,3
4550020,Business Is Business,1971,['Netherlands'],['Comedy'],1970,1
10160111,Bullseye!,1990,"['United Kingdom', 'United States of America']","['Action', 'Spy', 'Comedy']",1990,0
35592119,Gadibidi Ganda,1993,['India'],[],1990,3
101899,Deliverance,1972,['United States of America'],"['Action', 'Film adaptation', 'LGBT', 'Action/Adventure', 'Thriller', 'Adventure', 'Drama', 'New Hollywood']",1970,2
31087585,Aaj Ka Goonda Raj,1992,['India'],"['Action', 'Thriller', 'Family Film']",1990,2
3638882,Baywatch the Movie: Forbidden Paradise,1995,['United States of America'],['Drama'],1990,5
24368825,DeUsynlige,2008,['Norway'],"['Drama', 'World cinema']",2000,8
26438397,Moonchild,1974,['United States of America'],"['Experimental film', 'Drama']",1970,4
7825684,Interview With the Assassin,2002,['United States of America'],"['Crime Fiction', 'Thriller', 'Crime Thriller', 'Mockumentary', 'Drama', 'Suspense', 'Political drama', 'Political thriller']",2000,2
348994,Beethoven,1992,['United States of America'],"['Comedy', 'Drama', 'Family Film']",1990,2
11143052,Kaadhal Parisu,1987,['India'],"['Romance Film', 'Family Drama', 'Drama']",1980,7
5649829,Winter Passing,2005,['United States of America'],"['Indie', 'Comedy', 'Drama']",2000,5
1268226,Pot Luck,2002,"['France', 'Spain']","['Romantic drama', 'Comedy', 'Romance Film', 'Drama']",2000,2
2594890,Phantasm II,1988,['United States of America'],"['Zombie Film', 'Supernatural', 'Horror']",1980,8
2369122,Sex is Zero,2002,['South Korea'],"['Gross out', 'Gross-out film', 'Comedy', 'World cinema', 'Comedy-drama']",2000,2
7092652,True Confessions,1981,['United States of America'],"['Film adaptation', 'Crime Fiction', 'Mystery', 'Thriller', 'Crime Thriller', 'Drama']",1980,1
31377570,Why Men Don't Listen and Women Can't Read Maps,2007,[],"['Romance Film', 'Comedy']",2000,7
14888486,Man on the Flying Trapeze,1935,['United States of America'],"['Black-and-white', 'Slapstick', 'Comedy']",1930,5
7445831,A Thief in Paradise,1925,['United States of America'],"['Black-and-white', 'Drama', 'Indie', 'Silent film']",1920,5
32312987,The Set,1970,[],['Drama'],1970,0
5851777,That Summer Day,2006,['United Kingdom'],"['Drama', 'Documentary']",2000,6
23014490,Satan in High Heels,1962,[],"['Sexploitation', 'Thriller', 'Crime Thriller', 'Drama']",1960,2
5844480,Donovan's Brain,1953,"['United Kingdom', 'United States of America']","['Psychological thriller', 'Film adaptation', 'Black-and-white', 'Horror', 'Science Fiction', 'Drama']",1950,3
26372971,Hold That Baby!,1949,['United States of America'],"['Melodrama', 'Comedy-drama']",1940,9
11733144,D-War,2007,['South Korea'],"['Action', 'Thriller', 'World cinema', 'Drama', 'Creature Film', 'Monster movie', 'Horror', 'Science Fiction', 'Fantasy']",2000,7
24167447,The Glass Menagerie,1950,['United States of America'],['Drama'],1950,0
3223932,Bridesmaids,1989,['United States of America'],['Drama'],1980,9
24888803,Beyond the Door III,1989,"['Yugoslavia', 'Italy', 'United States of America']","['Teen', 'Horror']",1980,9
3985480,Perfect,1985,['United States of America'],"['Romance Film', 'Romantic drama', 'Drama']",1980,5
165794,In & Out,1997,['United States of America'],"['LGBT', 'Comedy', 'Romance Film', 'Romantic comedy']",1990,7
20904377,Muqaddar,1996,['India'],[],1990,6
5656662,Nuvvostanante Nenoddantana,2005,['India'],"['Romantic drama', 'World cinema', 'Romance Film', 'Drama']",2000,5
2523059,Christmas Every Day,1996,['United States of America'],['Christmas movie'],1990,6
21451283,Kurulu Bedda,1961,['Sri Lanka'],['Drama'],1960,1
22345813,I Love Trouble,1948,['United States of America'],"['Film noir', 'Black-and-white']",1940,8
17653116,Me and My Brother,1969,['United States of America'],['Drama'],1960,9
31312227,Redwood Curtain,1995,['United States of America'],['Drama'],1990,5
23729853,Balibo,2009,"['New Zealand', 'Australia']","['Thriller', 'World cinema', 'Drama', 'Political thriller']",2000,9
3861685,Fearless,2006,"['Hong Kong', 'China', 'United States of America']","['Action', 'Action/Adventure', 'Biographical film', 'World cinema', 'Chinese Movies', 'Martial Arts Film', 'Drama', 'Period piece', 'Sports']",2000,6
7292022,Waxwork,1988,"['Germany', 'United States of America']","['Comedy', 'Horror Comedy', 'Black comedy', 'Zombie Film', 'Haunted House Film', 'Creature Film', 'Monster movie', 'Horror', 'Cult', 'Fantasy']",1980,8
1369312,Galaxina,1980,['United States of America'],"['Parody', 'Western', 'Comedy', 'Adventure', 'Space western', 'Science Fiction']",1980,0
20967001,Dash and Lilly,1999,"['United Kingdom', 'United States of America']","['Period piece', 'Romantic drama', 'Biopic [feature]', 'Romance Film', 'Drama']",1990,9
4971260,Ring of Darkness,2004,['United States of America'],"['Slasher', 'Horror', 'B-movie', 'Zombie Film']",2000,4
2540713,Phileine Says Sorry,2003,['Netherlands'],"['Romantic comedy', 'Drama']",2000,3
5961695,Thief of Hearts,1984,['United States of America'],"['Psychological thriller', 'Suspense', 'Thriller', 'Erotic thriller', 'Romance Film', 'Erotica']",1980,4
15371010,Be a Wicked Woman,1990,['South Korea'],"['Crime Fiction', 'Mystery', 'Drama']",1990,0
14481268,There Goes the Neighborhood,1992,['United States of America'],"['Heist', 'Crime Fiction', 'Comedy', 'Black comedy']",1990,2
1897341,The Pianist,2002,"['United Kingdom', 'France', 'Germany', 'Poland']","['History', 'Biographical film', 'War film', 'Drama']",2000,2
12609759,Dance Dance,1987,['India'],['Musical'],1980,7
10791819,Bhuvana Oru Kelvi Kuri,1977,['India'],['Drama'],1970,7
5016299,Honkytonk Man,1982,['United States of America'],"['Musical', 'Musical Drama', 'Comedy', 'Road movie', 'Drama']",1980,2
4932114,Knight Moves,1992,"['Germany', 'United States of America']","['Psychological thriller', 'Suspense', 'Mystery', 'Thriller', 'Crime Thriller']",1990,2
2182788,Shopgirl,2005,['United States of America'],"['Film adaptation', 'Romantic drama', 'Comedy', 'Romance Film', 'Drama', 'Coming of age', 'Romantic comedy', 'Comedy-drama']",2000,5
1996624,Other People's Money,1991,['United States of America'],"['Parody', 'Comedy', 'Drama']",1990,1
9945439,Nargess,1992,['Iran'],"['Crime Fiction', 'Crime Drama', 'Romance Film', 'Drama']",1990,2
13716643,Rock 'n' Roll Nightmare,1987,['Canada'],"['Horror', 'B-movie', 'Supernatural', 'Cult']",1980,7
25204669,Meet Boston Blackie,1941,['United States of America'],"['Detective fiction', 'Mystery', 'Detective']",1940,1
2679502,What Time Is It There?,2001,"['France', 'Taiwan', 'China']","['Romantic drama', 'World cinema', 'Romance Film', 'Chinese Movies', 'Drama']",2000,1
20253903,The Lollipop Generation,2008,['Canada'],['LGBT'],2000,8
18908881,Train of Events,1949,['United Kingdom'],"['Action', 'Drama', 'Romance Film', 'Disaster']",1940,9
1067527,Infernal Affairs II,2003,"['Hong Kong', 'Singapore']","['Crime Fiction', 'Action/Adventure', 'World cinema', 'Crime Thriller', 'Chinese Movies']",2000,3
452767,Underworld,2003,"['United Kingdom', 'Germany', 'Hungary', 'United States of America']","['Action', 'Action/Adventure', 'Werewolf fiction', 'Thriller', 'Horror', 'Fantasy']",2000,3
3706395,Eros + Massacre,1969,['Japan'],"['Japanese Movies', 'Biographical film', 'Erotica', 'Drama']",1960,9
32808620,Hatchetman,2003,['United States of America'],"['Slasher', 'Horror']",2000,3
44752,Grand Hotel,1932,['United States of America'],"['Black-and-white', 'Crime Fiction', 'Romantic drama', 'Melodrama', 'Pre-Code', 'Drama', 'Ensemble Film']",1930,2
5007560,"Bright Lights, Big City",1988,"['Japan', 'United States of America']","['Japanese Movies', 'Drama']",1980,8
28412870,Mutharamkunnu P.O.,1985,['India'],"['Romance Film', 'Drama', 'Comedy film']",1980,5
11376450,Tarana,1951,['India'],"['Romantic drama', 'World cinema', 'Romance Film', 'Drama']",1950,1
24479482,Yellowknife,2002,['Canada'],['Drama'],2000,2
4470790,Mother,1996,['United States of America'],"['Screwball comedy', 'Comedy-drama', 'Comedy']",1990,6
6178986,Lover Come Back,1961,['United States of America'],"['Romance Film', 'Romantic comedy', 'Comedy']",1960,1
33307777,Porky and Gabby,1937,['United States of America'],"['Animation', 'Short Film', 'Comedy film', 'Family Film']",1930,7
21703124,Crazy Gopalan,2008,['India'],['Comedy'],2000,8
2418347,Rise: Blood Hunter,2007,['United States of America'],"['Action', 'Crime Fiction', 'Mystery', 'Indie', 'Vampire movies', 'Thriller', 'Horror']",2000,7
1164538,Darkness Falls,2003,"['United States of America', 'Australia']","['Thriller', 'Horror', 'Teen', 'Supernatural']",2000,3
403051,Run,2002,['India'],"['Musical', 'Romantic drama', 'Bollywood', 'World cinema', 'Romance Film', 'Drama']",2000,2
4733466,Sometimes They Come Back… for More,1999,['United States of America'],"['Suspense', 'Thriller', 'Horror', 'Supernatural']",1990,9
1243901,Creep,2004,"['United Kingdom', 'Germany']","['Mystery', 'Slasher', 'Thriller', 'Horror', 'Natural horror films']",2000,4
8885378,Fallen Angel,1981,['United States of America'],['Drama'],1980,1
9713100,Love Story,1981,['India'],"['Romance Film', 'Bollywood']",1980,1
5047484,Fatal Contact: Bird Flu in America,2006,['United States of America'],"['Action', 'Action/Adventure', 'Thriller', 'Television movie', 'Disaster']",2000,6
5170162,Roti,1974,['India'],"['Thriller', 'Romance Film', 'Adventure', 'Drama', 'Family Film']",1970,4
19379236,Wendy and Lucy,2008,['United States of America'],"['Road movie', 'Indie', 'Drama']",2000,8
10622166,The Duel,2000,"['China', 'Hong Kong']","['Action', 'Action/Adventure', 'Comedy', 'World cinema', 'Chinese Movies', 'Martial Arts Film', 'Adventure', 'Wuxia', 'Science Fiction', 'Fantasy']",2000,0
44457,Green Card,1990,"['France', 'United States of America', 'Australia']","['Romance Film', 'Romantic comedy', 'Comedy']",1990,0
29596128,Un'estate ai Caraibi,2009,[],['Comedy film'],2000,9
75259,Nashville,1975,['United States of America'],"['Musical', 'Musical Drama', 'Media Satire', 'Black comedy', 'Americana', 'Drama', 'New Hollywood', 'Political drama', 'Ensemble Film']",1970,5
26669004,Saviour of the Soul,1993,['Hong Kong'],"['Action', 'Drama', 'World cinema', 'Romance Film', 'Chinese Movies']",1990,3
4680612,Mulan II,2005,['United States of America'],"['Animated cartoon', 'Animation', 'Comedy', 'Family-Oriented Adventure', ""Children's/Family"", 'Family Film']",2000,5
15738234,Love Happens,2009,"['United Kingdom', 'United States of America', 'Canada']","['Romance Film', 'Romantic drama', 'Drama']",2000,9
29481480,Drohi,1992,['India'],"['Action', 'Drama', 'Crime Fiction', 'Thriller']",1990,2
20358409,Enter Laughing,1967,['United States of America'],"['Romance Film', 'Comedy']",1960,7
5096899,Wild Country,2004,['United Kingdom'],"['Monster movie', 'Suspense', 'Thriller', 'Horror', 'Supernatural']",2000,4
23179688,Phir Subha Hogi,1958,['India'],['Bollywood'],1950,8
14746778,Shot in the Frontier,1954,['United States of America'],"['Short Film', 'Black-and-white', 'Comedy']",1950,4
7417696,A Little Soap and Water,1935,['United States of America'],"['Animation', 'Short Film', 'Comedy', 'Family Film']",1930,5
19360183,When the Wind Blows,1930,['United States of America'],"['Short Film', 'Black-and-white', 'Comedy']",1930,0
33537258,Letters from Three Lovers,1973,['United States of America'],"['Romance Film', 'Drama']",1970,3
24397165,Vairam: Fight For Justice,2009,['India'],['Drama'],2000,9
1611338,Fun in Acapulco,1963,['United States of America'],"['Musical', 'Comedy', 'Romance Film', 'Romantic comedy', 'Drama']",1960,3
12744633,"Parlor, Bedroom and Bath",1931,['United States of America'],"['Black-and-white', 'Comedy', 'Romance Film', 'Romantic comedy']",1930,1
4837641,Pyar Hi Pyar Mein,2003,['Pakistan'],"['Romance Film', 'Drama']",2000,3
2935585,Snapdragon,1993,['United States of America'],"['Psychological thriller', 'Thriller', 'Erotic thriller', 'Crime Thriller']",1990,3
76357,Snow White,1933,['United States of America'],"['Black-and-white', 'Animation', 'Short Film']",1930,3
23780135,Blood Vows: The Story of a Mafia Wife,1987,['United States of America'],"['Crime Fiction', 'Gangster Film', 'Television movie', 'Drama']",1980,7
26429203,Invisible Strangler,1984,['United States of America'],"['Psychological thriller', 'Mystery', 'Thriller', 'Crime Thriller', 'Supernatural', 'Science Fiction']",1980,4
8949502,The Virginian,1946,['United States of America'],"['Western', 'Romance Film']",1940,6
9347378,Corazón iluminado,1998,"['Brazil', 'Argentina', 'France']","['Indie', 'Romantic drama', 'Drama']",1990,8
19437594,Lal Ronger Duniya,2008,['India'],['Drama'],2000,8
2572817,A Gathering of Eagles,1963,['United States of America'],"['Cold War', 'War film', 'Drama']",1960,3
8737296,Andre's Mother,1990,['United States of America'],"['Gay Themed', 'Film adaptation', 'LGBT', 'Gay', 'Family Drama', 'Gay Interest', 'Drama']",1990,0
781321,Temptress Moon,1996,"['Hong Kong', 'Taiwan', 'China']","['Period piece', 'Marriage Drama', 'World cinema', 'Chinese Movies', 'Drama']",1990,6
12572118,The Bros.,2007,['United States of America'],"['Crime Fiction', 'Parody', 'Comedy', 'Crime Comedy', 'Black comedy', 'Hip hop movies']",2000,7
20637087,Call of the Sea,1930,['Israel'],['Adventure'],1930,0
961777,Mermaids,1990,['United States of America'],"['Drama', 'Comedy', 'Teen']",1990,0
1673495,Stay Tuned,1992,['United States of America'],"['Musical', 'Comedy', 'Satire', 'Thriller', 'Black comedy', 'Adventure', 'Parody', 'Horror', 'Science Fiction', 'Family Film', 'Fantasy']",1990,2
6883275,Let's Make Love,1960,['United States of America'],"['Musical', 'Comedy', 'Musical comedy', 'Romance Film', 'Romantic comedy']",1960,0
16182808,Firestarter,1984,['United States of America'],"['Action', 'Psychological thriller', 'Film adaptation', 'Action/Adventure', 'Thriller', 'Horror', 'Supernatural', 'Science Fiction']",1980,4
4013248,Superman: Brainiac Attacks,2006,['United States of America'],"['Animation', 'Superhero', 'Superhero movie', 'Adventure']",2000,6
5068093,The Last Kiss,2006,"['Italy', 'United States of America']","['Romantic drama', 'Comedy', 'Romance Film', 'Drama']",2000,6
7672162,My Life In Ruins,2008,"['Spain', 'Greece', 'United States of America']","['Indie', 'Comedy', 'Romance Film', 'Romantic comedy']",2000,8
25142650,I Corrupt All Cops,2009,['Hong Kong'],"['Action', 'Period piece', 'Crime Fiction', 'Thriller', 'World cinema', 'Crime Drama', 'Chinese Movies']",2000,9
13793582,An Inspector Calls,1954,['United Kingdom'],"['Black-and-white', 'Mystery', 'Drama']",1950,4
22317779,Blind Venus,1941,['France'],"['Black-and-white', 'Drama']",1940,1
14029190,Viyyalavari Kayyalu,2007,['India'],['Drama'],2000,7
18852166,Tree Cornered Tweety,1956,['United States of America'],"['Animation', 'Short Film', 'Family Film']",1950,6
7123113,The Adventures of Baron Munchausen,1943,['Germany'],"['Fantasy', 'Comedy', 'Adventure']",1940,3
28189517,Raktha Sambandham,1962,['India'],['Drama'],1960,2
31111046,The Truth,1998,[],['Thriller'],1990,8
17180952,A Film With Me In It,2008,['United Kingdom'],"['Mystery', 'Indie', 'Comedy', 'Thriller', 'Black comedy']",2000,8
25722295,"Faith, Hope and Charity",1974,['Mexico'],"['Drama', 'Comedy film']",1970,4
3077087,Home for the Holidays,1995,['United States of America'],"['Screwball comedy', 'Comedy', 'Romance Film', 'Romantic comedy', 'Comedy-drama', 'Drama']",1990,5
690131,Bad Girls,1994,['United States of America'],"['Western', 'Action/Adventure', 'Satire', 'Buddy film', 'Costume drama']",1990,4
32752081,Abnormal Family: Older Brother's Bride,1984,[],['Comedy film'],1980,4
25231528,Princess of Mars,2009,['United States of America'],"['Science Fiction', 'Adventure', 'Fantasy']",2000,9
20191846,The Lost Treasure of the Grand Canyon,2008,['Canada'],"['Action', 'Thriller', 'Adventure', 'Period piece', 'Horror', 'Television movie', 'Science Fiction', 'Fantasy']",2000,8
30809,The Thing,1982,['United States of America'],"['Mystery', 'Thriller', 'Horror', 'Science Fiction']",1980,2
7158428,The Unruly Hare,1945,[],"['Animation', 'Short Film', 'Family Film']",1940,5
16595579,Were the World Mine,2008,['United States of America'],"['Musical', 'LGBT', 'Comedy', 'Musical comedy', 'Romance Film', 'Adventure', 'Gay Themed', 'Gay', 'Gay Interest', 'Feature film', 'Fantasy']",2000,8
9543722,Full of It,2007,"['United States of America', 'South Africa', 'Italy']","['Fantasy Comedy', 'Comedy', 'Teen']",2000,7
13848388,The Impossible Kid,1982,['Philippines'],"['Action', 'Filipino Movies', 'Spy', 'Martial Arts Film']",1980,2
2249633,The Flying Saucer,1950,['United States of America'],"['Action', 'Spy', 'Adventure', 'Science Fiction']",1950,0
14953996,Where Are The Children?,1986,['United States of America'],"['Crime Fiction', 'Mystery', 'Drama']",1980,6
12303811,Los Locos,1997,['Canada'],['Western'],1990,7
2688769,Quigley Down Under,1990,"['United States of America', 'Australia']","['Hybrid Western', 'Action/Adventure', 'Western', 'Drama']",1990,0
18242046,Book of Love,2002,['United States of America'],"['Drama', 'Indie', 'Comedy', 'Romance Film', 'Romantic comedy', 'Mockumentary']",2000,2
24553685,Trishna,1978,['India'],['Bollywood'],1970,8
27422332,The Three Men of Melita Žganjer,1998,['Croatia'],"['Romance Film', 'Comedy']",1990,8
3273634,Daughter of the Dragon,1931,['United States of America'],"['Black-and-white', 'Crime Fiction', 'Mystery', 'Master Criminal Films', 'Drama']",1930,1
2052329,Santa Who?,2000,['United States of America'],"['Comedy', ""Children's/Family"", 'Fantasy Comedy', 'Family Film']",2000,0
14737054,G.I. Wanna Home,1946,['United States of America'],"['Short Film', 'Black-and-white', 'Comedy']",1940,6
26735500,All the Kind Strangers,1974,['United States of America'],"['Thriller', 'Television movie']",1970,4
5148210,Cheeni Kum,2007,['India'],"['Musical', 'Romantic drama', 'Bollywood', 'World cinema', 'Romance Film', 'Romantic comedy', 'Drama']",2000,7
24344249,Tomorrow,1972,['United States of America'],"['Drama', 'Crime Fiction', 'Romantic drama', 'Indie', 'Romance Film', 'Courtroom Drama']",1970,2
23805580,The Cremator,1969,"['Czech Republic', 'Czechoslovakia']","['Comedy', 'Horror', 'World cinema', 'Drama']",1960,9
463519,Impromptu,1991,"['United Kingdom', 'France', 'United States of America']","['Music', 'Musical', 'Biography', 'Romantic drama', 'Comedy', 'Romance Film', 'Costume drama', 'Drama', 'Period piece', 'Biopic [feature]', 'Romantic comedy', 'Comedy of manners']",1990,1
27692986,Daughter of the Mind,1969,['United States of America'],"['Thriller', 'Horror']",1960,9
264851,Marnie,1964,['United States of America'],"['Psychological thriller', 'Film adaptation', 'Mystery', 'Thriller', 'Romance Film', 'Drama', 'Suspense', 'Melodrama']",1960,4
24009449,Airborne,1962,['United States of America'],"['Black-and-white', 'Drama']",1960,2
2411513,Indian,1996,['India'],"['Action', 'Musical', 'Tamil cinema', 'World cinema', 'Crime Thriller']",1990,6
4257402,Lavoura Arcaica,2001,['Brazil'],"['Family Drama', 'Drama', 'World cinema']",2000,1
2553318,Scandal,1950,['Japan'],"['Japanese Movies', 'Comedy', 'World cinema', 'Drama']",1950,0
1482832,Freebie and The Bean,1974,['United States of America'],"['Action', 'Action Comedy', 'Buddy film', 'Comedy', 'Adventure']",1970,4
3541699,Life Without Dick,2001,['United States of America'],"['Crime Fiction', 'Indie', 'Satire', 'Comedy', 'Romantic comedy', 'Black comedy', 'Romance Film']",2000,1
2140002,Amityville II: The Possession,1982,"['Mexico', 'United States of America']","['Film adaptation', 'Indie', 'Thriller', 'Horror', 'Supernatural', 'Haunted House Film']",1980,2
1128463,Paparazzi,2004,['United States of America'],"['Indie', 'Thriller', 'Crime Thriller', 'Drama']",2000,4
21352057,I huvet på en gammal gubbe,1968,['Sweden'],['Animation'],1960,8
9246624,Chronicle of an Escape,2005,['Argentina'],"['Drama', 'Indie', 'Thriller', 'World cinema', 'Political thriller']",2000,5
25932995,Arachnid,2001,"['Spain', 'United States of America']","['Science Fiction', 'World cinema', 'Horror']",2000,1
11020906,Aversion,2009,['United States of America'],"['Crime Fiction', 'Thriller', 'Zombie Film', 'Detective', 'Horror', 'Supernatural', 'Science Fiction', 'Fantasy']",2000,9
2309020,Act of Violence,1948,['United States of America'],"['Black-and-white', 'Crime Fiction', 'Thriller', 'Film noir', 'Drama']",1940,8
5892729,Re-cycle,2006,"['Thailand', 'Hong Kong', 'United States of America']","['Chinese Movies', 'World cinema', 'Horror', 'Supernatural']",2000,6
4867859,How the Grinch Stole Christmas!,2000,"['Germany', 'United States of America']","['Comedy', 'Family Film', 'Fantasy']",2000,0
10280524,KAW,2007,"['Canada', 'United States of America']","['Television movie', 'Natural horror films', 'Horror']",2000,7
26065869,Girls' Dormitory,1936,['United States of America'],"['Romance Film', 'Romantic drama', 'Drama']",1930,6
5222282,Peaceful Warrior,2006,"['Germany', 'United States of America']","['Sports', 'Film adaptation', 'Drama', 'Indie', 'Biography', 'Romance Film']",2000,6
26842900,Kash Aap Hamare Hote,2003,[],"['Musical', 'Romance Film', 'Family Film']",2000,3
1343327,Ben-Hur,1925,['United States of America'],"['Drama', 'Indie', 'Silent film', 'Epic']",1920,5
17355803,The Blackbird,1926,['United States of America'],"['Silent film', 'Black-and-white', 'Drama']",1920,6
2555548,The Baxter,2005,['United States of America'],"['Indie', 'Comedy', 'Satire', 'Romance Film', 'Romantic comedy']",2000,5
1255098,Grendizer,1975,['Japan'],"['Action', 'Animation', 'Romance Film', 'Anime', 'Science Fiction']",1970,5
25036694,The Big Cat,1949,['United States of America'],"['Action', 'Drama', 'Action/Adventure', 'Western', 'Adventure']",1940,9
14210860,Encounters of the Spooky Kind,1980,['Hong Kong'],"['Chinese Movies', 'Action/Adventure', 'Horror', 'World cinema', 'Martial Arts Film']",1980,0
3524152,The Daytrippers,1997,"['Canada', 'United States of America']","['Indie', 'Family Drama', 'Mystery', 'Comedy', 'Drama', 'Domestic Comedy', 'Comedy-drama', 'Ensemble Film']",1990,7
407178,The Day After Tomorrow,2004,['United States of America'],"['Action', 'Action/Adventure', 'Thriller', 'Natural disaster', 'Apocalyptic and post-apocalyptic fiction', 'Disaster', 'Drama', 'Doomsday film', 'Science Fiction']",2000,4
4999528,Lily C.A.T.,1987,['Japan'],['Animation'],1980,7
2841422,Skin Deep,1989,['United States of America'],"['Indie', 'Comedy', 'Romance Film', 'Romantic comedy', 'Slapstick']",1980,9
7998882,Gold Raiders,1951,['United States of America'],"['Action', 'Black-and-white', 'Western', 'Comedy', 'Adventure']",1950,1
9122950,The Mission,1999,"['China', 'Hong Kong']","['Crime Fiction', 'Action/Adventure', 'Thriller', 'World cinema', 'Chinese Movies']",1990,9
1226841,Penn & Teller Get Killed,1989,['United States of America'],"['Black comedy', 'Comedy']",1980,9
5883171,S.O.S. Coast Guard,1937,['United States of America'],"['Action', 'Black-and-white', 'Action/Adventure', 'Detective', 'Adventure']",1930,7
35485998,Porky's Five and Ten,1938,['United States of America'],"['Animation', 'Short Film', 'Comedy film', 'Family Film']",1930,8
14625799,Booky and the Secret Santa,2007,['Canada'],"['Period piece', 'Family Drama', 'Television movie', 'Family Film', 'Drama']",2000,7
14047780,Battle Beneath the Earth,1967,['United Kingdom'],"['Action', 'Spy', 'Thriller', 'Science Fiction']",1960,7
17998525,Circle of Friends,1995,"['United Kingdom', 'Ireland', 'United States of America']","['Period piece', 'Film adaptation', 'Drama', 'Indie', 'Romantic drama', 'Teen', 'Romance Film']",1990,5
1322542,Grande École,2004,['France'],"['LGBT', 'Erotic Drama', 'World cinema', 'Romance Film', 'Drama', 'Gay Themed', 'Gay', 'Gay Interest', 'Ensemble Film']",2000,4
5664582,Sea of Sand,1958,"['United Kingdom', 'Germany']",['War film'],1950,8
2318516,The Magic Serpent,1966,['Japan'],"['Japanese Movies', 'Fantasy', 'Adventure']",1960,6
9499387,Lottovoittaja UKK Turhapuro,1976,['Finland'],['Comedy'],1970,6
20518356,Bedtime Bedlam,1955,['United States of America'],"['Animation', 'Short Film', 'Family Film']",1950,5
16179581,Kana Kandaen,2005,['India'],"['Romance Film', 'Thriller']",2000,5
3130501,Two Can Play That Game,2001,['United States of America'],"['Comedy', 'Romance Film', 'Romantic comedy', 'Sex comedy']",2000,1
13075853,Kabzaa,1988,['India'],"['Action', 'Thriller']",1980,8
893465,Shrooms,2007,"['United Kingdom', 'Denmark', 'Ireland']","['Indie', 'Slasher', 'Horror', 'Cult']",2000,7
31270171,The Wild Women of Chastity Gulch,1982,['United States of America'],"['Western', 'Comedy']",1980,2
5873118,Convention City,1933,['United States of America'],"['Black-and-white', 'Pre-Code', 'Comedy']",1930,3
5878445,X2000,1998,['France'],['Short Film'],1990,8
4131836,Wired,1989,['United States of America'],"['Biographical film', 'Biography']",1980,9
9497635,Justine,1969,['United States of America'],"['Romance Film', 'Film adaptation', 'Drama']",1960,9
21094917,Evil Streets,1998,['United States of America'],"['Horror', 'B-movie']",1990,8
13772818,Ek Chadar Maili Si,1986,['India'],"['Drama', 'World cinema']",1980,6
407351,Rushmore,1998,['United States of America'],"['Coming of age', 'Comedy', 'Comedy-drama', 'Drama']",1990,8
10610452,The Man Who Changed His Mind,1936,['United Kingdom'],"['Science Fiction', 'Sci-Fi Horror', 'Horror']",1930,6
24200166,The Night of the Party,1935,['United Kingdom'],"['Crime Fiction', 'Mystery', 'Thriller', 'Detective']",1930,5
19410544,Five Golden Hours,1961,"['United Kingdom', 'Italy']","['Romance Film', 'Comedy']",1960,1
3096374,The Bad News Bears Go to Japan,1978,"['Japan', 'United States of America']","['Japanese Movies', 'Comedy', 'Baseball', 'Sports', 'Family Film']",1970,8
32656116,Thoroughbred,1936,[],"['Crime Fiction', 'Sports', 'Drama']",1930,6
5224973,Night Flight from Moscow,1973,"['France', 'Germany', 'Italy']","['Psychological thriller', 'Spy', 'Thriller', 'World cinema']",1970,3
13578324,Love 86,1986,['India'],['Drama'],1980,6
16904693,Shishkabugs,1962,['United States of America'],"['Animation', 'Short Film', 'Comedy', 'Family Film']",1960,2
4673173,Barbie: Fairytopia,2005,['United States of America'],"['Computer Animation', ""Children's Fantasy"", 'Animation', ""Children's/Family"", ""Children's"", 'Family Film', 'Fantasy']",2000,5
1609543,Zanjeer,1973,['India'],"['Musical', 'Bollywood', 'World cinema']",1970,3
4730,Batman Forever,1995,"['United Kingdom', 'United States of America']","['Action', 'Crime Fiction', 'Superhero', 'Action/Adventure', 'Buddy film', 'Thriller', 'Master Criminal Films', 'Superhero movie', 'Fantasy']",1990,5
29836920,Family Plan,1997,['United States of America'],"['Family Film', 'Comedy film']",1990,7
17136700,Silk,2006,"['China', 'Taiwan']","['Chinese Movies', 'World cinema', 'Horror']",2000,6
10731548,Pati Patni Aur Woh,1978,['India'],"['Romantic drama', 'Comedy', 'Bollywood', 'World cinema', 'Romance Film', 'Romantic comedy', 'Drama']",1970,8
23768447,"Paris, Not France",2008,['United States of America'],['Documentary'],2000,8
2009848,Cannery Row,1982,['United States of America'],"['Film adaptation', 'Comedy', 'Romance Film', 'Americana', 'Drama']",1980,2
2021218,Safe,1995,"['United Kingdom', 'United States of America']","['Psychological thriller', 'Indie', 'Thriller', 'Drama']",1990,5
27285438,Uncertain Glory,1944,['United States of America'],"['War film', 'Drama']",1940,4
24975131,Turn on to Love,1969,['United States of America'],['Drama'],1960,9
25725289,Single White Female 2: The Psycho,2005,['United States of America'],"['Psychological thriller', 'Suspense', 'Thriller', 'Crime Thriller']",2000,5
14143625,Perils of the Royal Mounted,1942,['United States of America'],"['Adventure', 'Black-and-white']",1940,2
26589389,Sivakamiyin Selvan,1974,[],[],1970,4
15048299,Brigadoon,1954,['United States of America'],"['Musical', 'Romance Film', 'Fantasy']",1950,4
92580,Friendly Persuasion,1956,['United States of America'],"['War film', 'Christian film', 'Epic', 'Costume drama', 'Drama', 'Family Film']",1950,6
11508746,The Fourth Angel,2001,"['Canada', 'United Kingdom']","['Action', 'Psychological thriller', 'Drama', 'Action/Adventure', 'Thriller']",2000,1
3893312,Knights of the South Bronx,2005,['United States of America'],"['Drama', 'Television movie']",2000,5
17122121,Without a Trace,1983,['United States of America'],"['Crime Fiction', 'Mystery', 'Drama']",1980,3
3861321,Dead Friend,2004,['South Korea'],"['Mystery', 'Thriller', 'Horror', 'World cinema', 'Crime Thriller', 'Supernatural']",2000,4
5632768,A Case of Rape,1974,['United States of America'],"['Courtroom Drama', 'Crime Fiction', 'Mystery', 'Social problem film', 'Drama', 'Feminist Film']",1970,4
6967547,Tarzan in Manhattan,1989,['United States of America'],"['Action', 'Drama', 'Action/Adventure', 'Thriller', 'Adventure']",1980,9
212265,Alice in Wonderland,1985,['United States of America'],"['Television movie', 'Adventure', 'Family Film', 'Fantasy']",1980,5
157173,Last Year at Marienbad,1961,"['France', 'Italy']","['Surrealism', 'Art film', 'Romantic drama', 'Avant-garde', 'World cinema', 'Romance Film', 'Drama', 'Experimental film']",1960,1
26765141,Sound of Horror,1964,['Spain'],"['Monster movie', 'B-movie', 'Horror']",1960,4
34666430,Lies of the Twins,1991,['United States of America'],['Thriller'],1990,1
4527849,We Are the Marines,1942,['United States of America'],"['History', 'Documentary', 'War film', 'Propaganda film']",1940,2
2217354,She's the One,1996,['United States of America'],"['Romance Film', 'Romantic comedy', 'Comedy']",1990,6
20964295,Her Cardboard Lover,1942,['United States of America'],"['Musical', 'Black-and-white', 'Comedy', 'Romance Film', 'Romantic comedy']",1940,2
6717398,Aarzoo,1999,['India'],"['Musical', 'Drama', 'World cinema']",1990,9
19293270,The Forgotten,2003,['United States of America'],"['Period piece', 'War film', 'Drama']",2000,3
5026744,Air Bud: Spikes Back,2003,"['Canada', 'United States of America']","['Comedy', 'Sports', ""Children's"", 'Family Film']",2000,3
3691494,Oxygen,1999,['United States of America'],"['Suspense', 'Mystery', 'Thriller', 'Crime Thriller']",1990,9
5375637,Princess Iron Fan,1941,['China'],['Animation'],1940,1
23141724,The Burning Hills,1956,['United States of America'],['Western'],1950,6
92540,Love Is a Many-Splendored Thing,1955,['United States of America'],"['Biography', 'Romantic drama', 'Romance Film', 'Melodrama', 'War film', 'Drama']",1950,5
6256750,My Big Fat Independent Movie,2005,['United States of America'],"['Indie', 'Comedy', 'Parody']",2000,5
30173794,The Stars Shine,1938,['Germany'],"['Musical', 'Propaganda film']",1930,8
210231,The Unsinkable Molly Brown,1964,['United States of America'],"['Musical', 'Comedy', 'Musical comedy', 'Docudrama', 'Feminist Film']",1960,4
8848464,Friends Forever,1987,['Denmark'],"['LGBT', 'Coming of age', 'World cinema', 'Drama']",1980,7
5105482,Stormy Monday,1988,"['United Kingdom', 'United States of America']","['Suspense', 'Neo-noir', 'Crime Fiction', 'Thriller', 'Crime Thriller', 'Drama']",1980,8
24665719,Deadgirl,2008,['United States of America'],"['Thriller', 'Cult', 'Horror']",2000,8
5566878,Tortilla Soup,2001,['United States of America'],"['Indie', 'Family Drama', 'Romantic drama', 'Comedy', 'Romance Film', 'Drama', 'Slice of life story', 'Romantic comedy', 'Comedy-drama']",2000,1
7120916,Dil Vil Pyar Vyar,2002,['India'],"['Musical', 'Romantic drama', 'Bollywood', 'World cinema', 'Romance Film', 'Drama']",2000,2
17093305,Hormones,2008,['Thailand'],['Comedy'],2000,8
3450620,Infinity,1996,['United States of America'],"['Period piece', 'Romantic drama', 'Biography', 'Biographical film', 'Romance Film', 'Drama']",1990,6
3447064,Jack and the Beanstalk,1952,['United States of America'],"['Black-and-white', 'Parody', 'Comedy', 'Adventure', 'Drama', 'Family Film', 'Fantasy']",1950,2
1449256,Point Blank,1967,['United States of America'],"['Crime Fiction', 'Gangster Film', 'Mystery', 'Thriller', 'Film noir', 'Crime Thriller', 'Drama', 'New Hollywood']",1960,7
1802219,Escape to Victory,1981,['United States of America'],"['Action/Adventure', 'War film', 'Drama']",1980,1
340276,The Waterboy,1998,['United States of America'],"['Sports', 'Slapstick', 'Comedy']",1990,8
20611596,Dead Snow,2009,['Norway'],"['Comedy', 'Satire', 'Horror Comedy', 'World cinema', 'Horror', 'Zombie Film']",2000,9
5638447,The Hitman,1991,"['Canada', 'United States of America']","['Action', 'Crime Fiction', 'Action/Adventure', 'Thriller', 'Martial Arts Film']",1990,1
11436273,Love in the Time of Cholera,2007,"['Colombia', 'United States of America']","['Period piece', 'Film adaptation', 'Romantic drama', 'Romance Film', 'Drama']",2000,7
2462597,The Stepford Wives,1975,['United States of America'],"['Psychological thriller', 'Thriller', 'Horror', 'Black comedy', 'Science Fiction', 'Cult']",1970,5
26226480,Romantic Comedy 101,2002,['Canada'],"['Romance Film', 'Comedy']",2000,2
1005010,Nam's Angels,1970,['United States of America'],"['Action', 'Action/Adventure', 'Thriller', 'Outlaw biker film']",1970,0
19081314,Arn - The Kingdom at Road's End,2008,"['Denmark', 'Sweden', 'United Kingdom', 'Norway', 'Germany', 'Finland']","['Action/Adventure', 'Historical fiction', 'Epic', 'War film', 'Drama']",2000,8
15780467,The 7th Dawn,1964,['United Kingdom'],"['Action', 'Film adaptation', 'Drama', 'Action/Adventure', 'War film']",1960,4
22276971,Shades of Ray,2008,['United States of America'],"['Indie', 'Comedy', 'Romance Film', 'Romantic comedy']",2000,8
24706815,Craig's Wife,1936,['United States of America'],['Drama'],1930,6
23726874,Spy School,2008,['United States of America'],"['Indie', 'Comedy', 'Teen', 'Adventure', ""Children's"", 'Family Film']",2000,8
30635702,Akhiyon Se Goli Maare,2002,['India'],['Comedy film'],2000,2
2564610,The Way Home,2002,['South Korea'],"['Drama', 'World cinema']",2000,2
2518695,Malcolm,1986,"['New Zealand', 'Australia']","['Action', 'Heist', 'Crime Fiction', 'Action/Adventure', 'Comedy', 'Crime Comedy', 'World cinema']",1980,6
5929740,My Little Girl,1987,['United States of America'],['Drama'],1980,7
401059,Rebel Rabbit,1949,['United States of America'],"['Animation', 'Short Film', 'Comedy', 'Family Film']",1940,9
14110961,L'Effrontée,1985,['France'],"['Music', 'Romantic drama', 'Comedy', 'World cinema', 'Teen', 'Romance Film', 'Drama', 'Coming of age', 'Comedy-drama']",1980,5
3690283,Transylvania 6-5000,1985,"['Yugoslavia', 'United States of America']","['Parody', 'Monster', 'Comedy', 'Horror']",1980,5
31419348,Last Assassins,1997,[],"['Action', 'Crime Fiction', 'Drama']",1990,7
3511234,Cat on a Hot Tin Roof,1958,['United States of America'],"['Film adaptation', 'LGBT', 'Drama']",1950,8
19440655,Pentathlon,1994,['United States of America'],"['Action', 'Action Thrillers', 'Action/Adventure', 'Thriller', 'Sports']",1990,4
10640601,Farishtay,1991,['India'],['Action'],1990,1
366111,Shallow Hal,2001,"['Germany', 'United States of America']","['Comedy', 'Romance Film', 'Romantic comedy', 'Comedy of Errors', 'Fantasy Comedy', 'Drama', 'Fantasy']",2000,1
24232379,Cruelty: Black Rose Torture,1975,['Japan'],"['Erotica', 'Japanese Movies', 'Pornographic movie']",1970,5
4276011,Goku Sidestory! The Proof of His Courage Is the Si Xing Qiu,1997,['Japan'],['Japanese Movies'],1990,7
1012582,Sacred Silence,1996,['Italy'],"['LGBT', 'Drama', 'World cinema']",1990,6
17646903,Poison Ivy,1985,['United States of America'],"['Romantic comedy', 'Comedy']",1980,5
2677828,The Invisible Man Returns,1940,['United States of America'],"['Black-and-white', 'Horror', 'Sci-Fi Horror', 'Science Fiction']",1940,0
77665,The More the Merrier,1943,['United States of America'],"['Black-and-white', 'Comedy', 'Romance Film', 'Romantic comedy']",1940,3
980977,The Secret of My Success,1987,['United States of America'],"['Romance Film', 'Romantic comedy', 'Comedy']",1980,7
984020,What the #$*! Do We Know!?,2004,['United States of America'],"['Drama', 'Mystery', 'Indie', 'Comedy', 'Documentary', 'Science Fiction', 'Fantasy']",2000,4
26405590,Twelve Hours to Kill,1960,['United States of America'],"['Crime Fiction', 'Crime Thriller']",1960,0
21606259,Whiplash,1948,['United States of America'],"['Film noir', 'Black-and-white', 'Drama']",1940,8
18711572,Kidnap,2008,['India'],"['Musical', 'Thriller', 'Bollywood', 'World cinema']",2000,8
35277263,Desert Fury,1947,['United States of America'],"['Crime Fiction', 'Thriller', 'Film noir', 'Drama']",1940,7
23492730,Two Gophers from Texas,1948,['United States of America'],"['Animation', 'Short Film', 'Family Film']",1940,8
5913765,Lion of Oz and the Badge of Courage,2000,"['Canada', 'United Kingdom']","['Animation', 'Family Film', 'Fantasy']",2000,0
14228344,Dangerous Summer,2000,[],"['Period piece', 'Drama']",2000,0
35785261,Beloved/Friend,1999,['Spain'],"['LGBT', 'Drama', 'World cinema']",1990,9
28925509,Oomappenninu Uriyadappayyan,2002,['India'],"['Action', 'Drama', 'Comedy']",2000,2
3535700,A Little Trip to Heaven,2005,"['Iceland', 'United States of America']","['Detective fiction', 'Crime Fiction', 'Indie', 'Thriller', 'Black comedy', 'Drama', 'Detective', 'Comedy-drama', 'Ensemble Film']",2000,5
1858763,Dark Star,1974,['United States of America'],"['Indie', 'Comedy', 'Thriller', 'Adventure', 'Drama', 'Parody', 'Science Fiction', 'Cult']",1970,4
26019122,Tora-san's Bluebird Fantasy,1986,['Japan'],['Japanese Movies'],1980,6
2025204,The Wrong Box,1966,['United Kingdom'],"['Black comedy', 'Comedy', 'Comedy of Errors']",1960,6
10511883,Storm Warning,1951,['United States of America'],"['Black-and-white', 'Drama']",1950,1
28504645,Ein Job,2008,[],['Crime Fiction'],2000,8
424829,Maborosi,1995,['Japan'],"['Mystery', 'Japanese Movies', 'Thriller', 'World cinema', 'Drama']",1990,5
187086,Caged,1950,['United States of America'],"['LGBT', 'Crime Fiction', 'Film noir', 'Drama']",1950,0
17918821,Come Let's See,2008,['India'],"['Social issues', 'Musical', 'Bollywood', 'World cinema', 'Science Fiction', 'Culture & Society']",2000,8
5083366,Johnny Handsome,1989,['United States of America'],"['Drama', 'Crime Fiction', 'Thriller']",1980,9
21497313,The Singing Princess,1967,[],"['Fairy tale', ""Children's Fantasy"", 'Animation', ""Children's/Family"", 'Adventure', 'Drama', 'Family Film']",1960,7
9049407,Souls at Sea,1937,['United States of America'],"['Black-and-white', 'Adventure', 'Drama']",1930,7
164387,...And Justice for All,1979,['United States of America'],"['Crime Fiction', 'Mystery', 'Comedy', 'Satire', 'Thriller', 'Drama', 'Courtroom Drama', 'Suspense', 'New Hollywood', 'Comedy-drama', 'Legal drama']",1970,9
74971,The Music Box,1932,['United States of America'],"['Short Film', 'Black-and-white', 'Comedy']",1930,2
5601645,Marjorie Morningstar,1958,['United States of America'],"['Romance Film', 'Romantic drama', 'Drama']",1950,8
19718236,Oblivion 2: Backlash,1996,['United States of America'],"['Hybrid Western', 'Action/Adventure', 'Western', 'Science Fiction']",1990,6
28287644,Jail Busters,1955,['United States of America'],['Comedy film'],1950,5
1369060,Roller Boogie,1979,['United States of America'],"['Musical', 'Romantic drama', 'Comedy', 'Teen', 'Romance Film', 'Drama', 'Dance', 'Romantic comedy', 'Comedy-drama']",1970,9
1187057,The Longest Yard,1974,['United States of America'],"['Drama', 'Prison film', 'Comedy', 'New Hollywood', 'Sports']",1970,4
8067034,Hukkle,2002,['Hungary'],"['Crime Fiction', 'Mystery', 'Art film', 'World cinema', 'Crime Drama', 'Drama']",2000,2
2059734,Silent Warnings,2003,['United States of America'],"['Suspense', 'Thriller', 'Horror', 'Alien Film', 'Science Fiction']",2000,3
15937192,Cargo 200,2007,['Russia'],"['Thriller', 'World cinema', 'Crime Thriller', 'Political drama', 'Drama']",2000,7
4376322,Miles from Home,1988,['United States of America'],"['Action', 'Crime Fiction', 'Drama']",1980,8
817905,Bubba Ho-tep,2002,['United States of America'],"['Parody', 'Comedy', 'Horror Comedy', 'Horror', 'Black comedy', 'Cult']",2000,2
13252654,Ghost Ship,1952,['United Kingdom'],"['Black-and-white', 'Thriller', 'Horror', 'Supernatural']",1950,2
12815804,Small Voices,2002,['Philippines'],"['Filipino Movies', 'Drama', 'World cinema']",2000,2
4333441,The Journals of Knud Rasmussen,2006,"['Canada', 'Denmark']",['Drama'],2000,6
5747189,Canción de juventud,1962,['Spain'],"['Musical', 'Drama', 'Comedy film']",1960,2
12586991,Telstar: The Joe Meek Story,2008,['United Kingdom'],"['Musical', 'LGBT', 'Biography', 'Drama']",2000,8
13564723,Crossing the Line,2008,['New Zealand'],"['Drama', 'Indie', 'Short Film', 'War film']",2000,8
14722381,Fear City,1984,['United States of America'],"['Crime Fiction', 'Mystery', 'Thriller', 'Crime Thriller']",1980,4
14942228,Another Cinderella Story,2008,"['Canada', 'United States of America']","['Musical', 'Comedy', 'Teen', 'Romance Film', 'Romantic comedy', ""Children's""]",2000,8
5091175,Aan,1952,['India'],"['Costume Adventure', 'Adventure', 'Bollywood']",1950,2
9064244,Scorpio,1973,['United States of America'],"['Action', 'Spy', 'Action Thrillers', 'Action/Adventure', 'Thriller', 'Crime Thriller', 'Drama', 'Suspense', 'Erotic thriller']",1970,3
4916371,Sung horn,2003,['Thailand'],"['Supernatural', 'Thriller', 'World cinema']",2000,3
3524875,Taste the Blood of Dracula,1970,['United Kingdom'],"['Costume Horror', 'Horror']",1970,0
2629975,The Old Dark House,1932,['United States of America'],"['Black-and-white', 'Comedy', 'Thriller', 'Horror', 'Drama']",1930,2
4143733,The Muse,1999,['United States of America'],"['Parody', 'Satire', 'Comedy']",1990,9
17298868,Ip Man,2008,"['China', 'Hong Kong']","['Action', 'Action/Adventure', 'Biography', 'Biographical film', 'World cinema', 'Chinese Movies', 'Martial Arts Film', 'Drama', 'Period piece', 'History', 'Biopic [feature]', 'Historical fiction']",2000,8
34026023,Pasumpon,1995,['India'],['Drama'],1990,5
6781919,Penrod and Sam,1937,['United States of America'],['Black-and-white'],1930,7
8772252,Tridev,1989,['India'],"['Musical', 'Action/Adventure', 'Bollywood', 'World cinema', 'Crime Drama', 'Drama']",1980,9
143809,The Fifth Element,1997,"['France', 'United States of America']","['Action', 'Thriller', 'Adventure', 'Science Fiction', 'Fantasy']",1990,7
16654243,Future Cops,1993,['Hong Kong'],"['Action', 'Thriller', 'Chinese Movies', 'Martial Arts Film']",1990,3
5178822,Majboor,1974,['India'],"['Musical', 'Bollywood', 'World cinema']",1970,4
496299,The Appointments of Dennis Jennings,1988,['United States of America'],"['Black comedy', 'Short Film', 'Comedy']",1980,8
1767518,Pixote,1981,['Brazil'],"['LGBT', 'Crime Fiction', 'Coming of age', 'Indie', 'Drama', 'Childhood Drama', 'Juvenile Delinquency Film']",1980,1
19919895,Cold Prey 2,2008,['Norway'],"['Slasher', 'Thriller', 'Horror', 'World cinema', 'Drama']",2000,8
7831972,The Chimp,1932,['United States of America'],"['Short Film', 'Black-and-white', 'Comedy']",1930,2
1679152,Insignificance,1985,['United Kingdom'],"['Period piece', 'Parody', 'Satire', 'Comedy', 'Comedy-drama', 'Drama']",1980,5
8460547,Whoops I'm an Indian,1936,['United States of America'],"['Short Film', 'Black-and-white', 'Comedy']",1930,6
4967070,She,1965,['United Kingdom'],"['Fantasy', 'Adventure', 'Horror']",1960,5
12014701,Billi,2000,['Pakistan'],['Horror'],2000,0
4095638,Things You Can Tell Just by Looking at Her,2000,['United States of America'],"['LGBT', 'Drama', 'Indie', 'Romantic drama', 'Romance Film', 'Comedy-drama', 'Ensemble Film']",2000,0
3746,Blade Runner,1982,"['Hong Kong', 'United States of America']","['Neo-noir', 'Cyberpunk', 'Thriller', 'Film noir', 'Crime Thriller', 'Chinese Movies', 'Drama', 'Dystopia', 'Future noir', 'Existentialism', 'Science Fiction', 'Cult']",1980,2
20935816,Rajkumar,2008,['India'],"['Romance Film', 'Drama']",2000,8
12784721,No Sleep Til Shanghai,2007,['United States of America'],"['Rockumentary', 'Indie', 'Documentary', 'Hip hop movies']",2000,7
24004409,Angel John,2009,['India'],['Drama'],2000,9
9233692,Tareeq al-Amal,1957,['Egypt'],"['Romance Film', 'Drama']",1950,7
12514898,The Mountain Men,1980,['United States of America'],"['Action', 'Drama', 'Revisionist Western', 'Action/Adventure', 'Western']",1980,0
23389321,Such Good Friends,1971,['United States of America'],"['Romance Film', 'Romantic comedy', 'Comedy']",1970,1
29288065,High Finance,1933,['United Kingdom'],['Drama'],1930,3
18017481,Fools for Scandal,1938,['United States of America'],"['Black-and-white', 'Comedy', 'Romance Film', 'Romantic comedy']",1930,8
202140,The 400 Blows,1959,['France'],"['Film à clef', 'Black-and-white', 'Crime Fiction', 'Art film', 'Childhood Drama', 'World cinema', 'Drama', 'Coming of age']",1950,9
31227417,Boogie-Woogie Dream,1944,[],['Short Film'],1940,4
905906,Empire Records,1995,['United States of America'],"['Indie', 'Comedy', 'Teen', 'Drama', 'Coming of age', 'Comedy-drama', 'Workplace Comedy', 'Cult', 'Ensemble Film']",1990,5
2174599,The Siege,1998,['United States of America'],"['Action', 'Crime Fiction', 'Action/Adventure', 'Thriller', 'Political drama', 'War film', 'Drama']",1990,8
10792024,Adutha Varisu,1983,['India'],"['Romance Film', 'Drama']",1980,3
13273588,Yellowstone,1936,['United States of America'],"['Action', 'Black-and-white', 'Crime Fiction', 'Mystery', 'Action/Adventure', 'Thriller', 'Crime Thriller', 'Drama']",1930,6
6081002,St Helens,1981,['United States of America'],"['Action', 'Action/Adventure', 'Thriller', 'Disaster']",1980,1
4510808,Farce of the Penguins,2006,['United States of America'],"['Adventure Comedy', 'Parody', 'Comedy', 'Mockumentary']",2000,6
7047921,Little Miss Sunshine,2006,['United States of America'],"['LGBT', 'Indie', 'Comedy', 'Adventure', 'Drama', 'Domestic Comedy', 'Comedy-drama', 'Road movie', 'Ensemble Film']",2000,6
499431,The Music Lovers,1970,['United Kingdom'],"['LGBT', 'Biography', 'Romantic drama', 'Biographical film', 'Romance Film', 'Drama', 'Period piece', 'Biopic [feature]']",1970,0
859101,Boris and Natasha: The Movie,1992,['United States of America'],"['Action', 'Spy', 'Adventure Comedy', 'Action/Adventure', 'Comedy']",1990,2
16166605,Thavasi,2001,['India'],"['Action', 'Drama', 'Comedy']",2000,1
5144797,The Horror Show,1989,['United States of America'],"['Slasher', 'Horror']",1980,9
2325404,Nang Nak,1999,['Thailand'],"['Romantic drama', 'Thriller', 'World cinema', 'Romance Film', 'Drama', 'Period piece', 'Supernatural', 'Fantasy']",1990,9
27958292,Foolin' Around,1980,['United States of America'],['Romantic comedy'],1980,0
26606942,Najma,1943,[],"['Romance Film', 'Drama']",1940,3
697246,The Cat Returns,2002,['Japan'],"['Animation', ""Children's/Family"", ""Children's"", 'Adventure', 'Drama', ""Children's Fantasy"", 'Japanese Movies', 'Anime', 'Family Film', 'Fantasy']",2000,2
4520654,Cobra,1925,['United States of America'],"['Black-and-white', 'Drama', 'Romantic drama', 'Indie', 'Silent film', 'Romance Film']",1920,5
101943,The Goodbye Girl,1977,['United States of America'],"['Comedy', 'New Hollywood', 'Romance Film', 'Romantic comedy', 'Drama']",1970,7
10275047,Fifty Million Frenchmen,1931,['United States of America'],"['Musical', 'Romance Film', 'Comedy']",1930,1
2033359,Ju-on: The Grudge,2002,['Japan'],"['Mystery', 'Japanese Movies', 'Horror', 'World cinema', 'Supernatural']",2000,2
1113205,Bedazzled,2000,"['Germany', 'United States of America']","['Comedy', 'Black comedy', 'Romantic comedy', 'Romance Film', 'Fantasy']",2000,0
25255778,Where the River Runs Black,1986,['United States of America'],['Adventure'],1980,6
23967515,Azhagar Malai,2009,['India'],"['Action', 'Comedy']",2000,9
1602075,Revolution,1985,"['Norway', 'United Kingdom', 'United States of America']","['Period piece', 'War film', 'Costume drama', 'Drama']",1980,5
11570453,Female,1933,['United States of America'],"['Pre-Code', 'Comedy', 'Drama']",1930,3
4836350,A Man for All Seasons,1966,['United Kingdom'],"['Period piece', 'Courtroom Drama', 'Film adaptation', 'Biographical film', 'Christian film', 'Costume drama', 'Drama']",1960,6
11140775,Indrudu Chandrudu,1990,['India'],"['Drama', 'Comedy']",1990,0
5350147,It Seemed Like a Good Idea at the Time,1976,['Canada'],"['Romance Film', 'Romantic comedy', 'Comedy']",1970,6
2194915,Clash by Night,1952,['United States of America'],"['Black-and-white', 'Family Drama', 'Film noir', 'Melodrama', 'Drama']",1950,2
20553214,Mon Mane Na,2008,['India'],"['Action', 'Drama', 'Comedy', 'Romance Film']",2000,8
29960215,"Magdalena, the Unholy Saint",2004,['Philippines'],"['Filipino Movies', 'Romantic drama', 'World cinema', 'Drama']",2000,4
75984,Ran,1985,"['France', 'Japan']","['Action', 'Samurai cinema', 'Art film', 'Family Drama', 'World cinema', 'Drama', 'Tragedy', 'Japanese Movies', 'Historical Epic', 'Epic', 'War film']",1980,5
31032955,Ek Saudagar,1985,[],['Drama'],1980,5
17856211,Choose Your Own Adventure The Abominable Snowman,2006,['United States of America'],"['Adventure', 'Family-Oriented Adventure', ""Children's/Family"", ""Children's"", 'Family Film']",2000,6
26837743,"Totò, Peppino e la malafemmina",1956,[],"['Music', 'Romance Film', 'Comedy film']",1950,6
34286225,Arangetra Velai,1990,['India'],"['Drama', 'Comedy film']",1990,0
5409973,Pigs and Battleships,1961,['Japan'],"['Crime Fiction', 'Art film', 'Gangster Film', 'Satire', 'World cinema', 'Drama', 'Japanese Movies', 'Crime Drama']",1960,1
4451206,The Hillz,2004,['United States of America'],"['Action', 'Crime Fiction', 'Action/Adventure', 'Comedy', 'Teen', 'Black comedy', 'Drama', 'Coming of age', 'Comedy-drama']",2000,4
11142318,The Valiant,1929,['United States of America'],"['Black-and-white', 'Drama']",1920,9
25586078,The Last Flight,2009,['France'],"['World cinema', 'Romance Film', 'Adventure', 'Drama']",2000,9
10638405,Raja Rani,1973,['India'],"['Romantic drama', 'World cinema', 'Romance Film', 'Drama']",1970,3
5006280,Padosan,1968,['India'],"['Musical', 'Comedy', 'Bollywood', 'World cinema']",1960,8
31156641,Nariman,2001,[],"['Action', 'Crime Fiction', 'Drama']",2000,1
20923628,Hurt,2009,['United States of America'],"['Drama', 'Thriller', 'Horror']",2000,9
6134853,Zorro's Black Whip,1944,['United States of America'],"['Action', 'Black-and-white', 'Action/Adventure', 'Western', 'Superhero movie', 'Swashbuckler films', 'Adventure']",1940,4
14899108,Splice,2009,"['France', 'United States of America', 'Canada']","['Thriller', 'Horror', 'Sci-Fi Horror', 'Science Fiction', 'Drama']",2000,9
20766014,Stiletto,2008,['United States of America'],"['Action', 'Crime Fiction', 'Gangster Film', 'Action/Adventure', 'Thriller']",2000,8
7376595,Durval discos,2002,['Brazil'],"['Musical', 'Comedy', 'Thriller', 'World cinema', 'Black comedy', 'Comedy-drama', 'Drama']",2000,2
4146919,Society Dog Show,1939,['United States of America'],"['Animation', 'Short Film', 'Comedy', 'Family Film']",1930,9
14577660,Pride of the Marines,1945,['United States of America'],"['Black-and-white', 'Biographical film', 'War film', 'Drama']",1940,5
18998943,Glory Glory,2000,['United Kingdom'],"['Crime Fiction', 'Western', 'Action/Adventure', 'Drama']",2000,0
7197997,Plunder and Lightning,1990,['United States of America'],"['Animation', 'Mystery', 'Comedy', 'Adventure', 'Family Film']",1990,0
13764296,Last Stop for Paul,2006,['United States of America'],"['Adventure Comedy', 'Indie', 'Action/Adventure', 'Comedy', 'Road movie', 'Adventure']",2000,6
616805,Kiss of Death,1947,['United States of America'],"['Psychological thriller', 'Black-and-white', 'Crime Fiction', 'Thriller', 'Film noir', 'Crime Thriller', 'Drama']",1940,7
8917454,Agent X44,2007,['Philippines'],"['Action', 'Filipino Movies', 'Action Comedy', 'Action/Adventure', 'Comedy', 'Thriller', 'World cinema']",2000,7
19160892,No Kidding,1960,['United Kingdom'],['Comedy'],1960,0
3087739,Taboo,1999,"['United Kingdom', 'France', 'Japan']","['LGBT', 'Japanese Movies', 'Action/Adventure', 'World cinema', 'Drama']",1990,9
32806663,Git Along Little Dogies,1937,['United States of America'],"['Action/Adventure', 'Western']",1930,7
20670254,"Clarence, the Cross-Eyed Lion",1965,['United States of America'],"['Action', 'Comedy', 'Animal Picture', 'Adventure']",1960,5
5458357,PTU,2003,"['China', 'Hong Kong']","['Action', 'Action Comedy', 'Comedy', 'Thriller', 'Chinese Movies', 'Comedy of Errors']",2000,3
5109871,Nayak: The Real Hero,2001,['India'],"['Romantic drama', 'Musical Drama', 'World cinema', 'Political drama', 'Drama']",2000,1
7148032,Ride 'Em Cowboy,1942,['United States of America'],"['Black-and-white', 'Comedy', 'Family Film']",1940,2
3518352,The Bachelor and the Bobby-Soxer,1947,['United States of America'],"['Black-and-white', 'Screwball comedy', 'Comedy', 'Romance Film', 'Slapstick', 'Drama', 'Romantic comedy', 'Family Film']",1940,7
15034372,Hercule et Sherlock,1996,['France'],['Mystery'],1990,6
975403,Heroism,1958,['Poland'],"['World cinema', 'Black comedy', 'War film', 'Drama']",1950,8
3520815,Don't Look Under the Bed,1999,['United States of America'],"['Fantasy', 'Teen', 'Horror']",1990,9
11492691,Rumors,1943,['United States of America'],"['Short Film', 'Animation']",1940,3
7533367,Freaky Friday,1995,['United States of America'],"['Drama', 'Comedy']",1990,5
1884508,Rascal,1969,['United States of America'],"['Family Drama', 'Animal Picture', ""Children's/Family"", 'Adventure', 'Drama', 'Family Film']",1960,9
325206,The Little Shop of Horrors,1960,['United States of America'],"['Musical', 'Black-and-white', 'Indie', 'Comedy', 'Black comedy', 'Cult']",1960,0
9974147,"One Potato, Two Potato",1964,['United States of America'],"['Black-and-white', 'Indie', 'Drama']",1960,4
18737099,Ehsaan,1967,['Pakistan'],['Musical'],1960,7
18500449,Edward and Caroline,1951,['France'],"['Comedy', 'Black-and-white']",1950,1
13902110,Corrupt,1999,['United States of America'],"['Action', 'Drama', 'Crime Fiction', 'Crime Thriller']",1990,9
23738867,My Ex,2009,[],['Horror'],2000,9
9776671,Nuestra tierra de paz,1939,['Argentina'],"['Black-and-white', 'Biographical film']",1930,9
2692284,Monster House,2006,['United States of America'],"['Animation', 'Mystery', 'Comedy', ""Children's/Family"", 'Haunted House Film', 'Creature Film', ""Children's Fantasy"", 'Family Film', 'Fantasy']",2000,6
20406138,Junior High School,1978,['United States of America'],"['Short Film', 'Romance Film']",1970,8
7189363,Sirf Tum,1999,['India'],"['Romance Film', 'Drama']",1990,9
899255,Evolution,2001,['United States of America'],"['Action', 'Parody', 'Action/Adventure', 'Comedy', 'Science Fiction']",2000,1
32862492,More than Puppy Love,2000,['United States of America'],"['Family Drama', 'Childhood Drama', 'Animal Picture', ""Children's/Family"", 'Drama', 'Family Film']",2000,0
560511,Stripes,1981,['United States of America'],"['Action', 'Parody', 'Action/Adventure', 'Buddy film', 'Comedy']",1980,1
25473369,The Book of Ruth: Journey of Faith,2009,['United States of America'],['Drama'],2000,9
14356696,Paw,1959,['Denmark'],['Drama'],1950,9
3660626,Coming Soon,2000,['United States of America'],"['Comedy', 'Sex comedy']",2000,0
19666807,The World Unseen,2007,"['United Kingdom', 'South Africa']","['LGBT', 'Romance Film', 'Drama', 'Period piece', 'Gay Themed', 'Gay', 'Gay Interest', 'Feature film']",2000,7
25202200,Anything for Her,2008,['France'],"['Thriller', 'World cinema']",2000,8
32098506,Karm Yudh,1985,['India'],['Action'],1980,5
31452882,La Schiava Io Ce L'Ho e Tu No,1972,['Italy'],[],1970,2
31582706,Wrong Number,2004,['Bangladesh'],"['Drama', 'Comedy film']",2000,4
26797868,Prema,1952,['India'],['Drama'],1950,2
25529226,The Sister-in-Law,1974,['United States of America'],['Drama'],1970,4
32634697,Sky Pirates,1986,"['United States of America', 'Australia']","['Science Fiction', 'Adventure']",1980,6
14812319,Good Dick,2008,['United States of America'],"['Indie', 'Comedy', 'Black comedy', 'Romantic comedy', 'Romance Film']",2000,8
25664496,Ash Wednesday,1958,['Mexico'],"['War film', 'Drama']",1950,8
25090637,Bulldog Drummond's Peril,1938,['United States of America'],"['Action', 'Action/Adventure', 'Thriller', 'Crime Thriller']",1930,8
228274,The Last Samurai,2003,['United States of America'],"['Period piece', 'Action', 'Action/Adventure', 'Historical drama', 'War film', 'Costume drama', 'Drama']",2000,3
27465640,Popatopolis,2009,['United States of America'],['Documentary'],2000,9
149113,Wayne's World 2,1993,['United States of America'],"['Buddy film', 'Satire', 'Comedy', 'Absurdism']",1990,3
871056,White Chicks,2004,['United States of America'],"['Action', 'LGBT', 'Action/Adventure', 'Slapstick', 'Buddy film', 'Comedy', 'Comedy of Errors']",2000,4
8915914,Lucien Brouillard,1983,['Canada'],"['Drama', 'Political drama']",1980,3
16092323,Peculiarities of National Hunt,1995,['Russia'],['Comedy'],1990,5
9757596,The Milky Way,1969,"['Spain', 'France', 'Germany', 'West Germany', 'Italy']","['Surrealism', 'Art film', 'Satire', 'Comedy', 'World cinema', 'Drama', 'Comedy-drama', 'Road movie']",1960,9
12917337,Time Out for Rhythm,1941,['United States of America'],"['Musical', 'Slapstick', 'Comedy']",1940,1
33931510,Kalyug,2005,['India'],"['Musical', 'Thriller', 'Bollywood', 'World cinema']",2000,5
8900620,Rio Conchos,1964,['United States of America'],"['Action', 'Western', 'Action/Adventure']",1960,4
2061620,Cherry Falls,2000,['United States of America'],"['Indie', 'Slasher', 'Satire', 'Comedy', 'Horror', 'Horror Comedy']",2000,0
31427360,Samooham,1993,[],['Drama'],1990,3
36232890,Robotrix,1997,['Hong Kong'],"['Science Fiction', 'Comedy film']",1990,7
23432280,Park Benches,2009,[],"['Comedy', 'World cinema']",2000,9
2826890,Snakes on a Plane,2006,"['Germany', 'United States of America', 'Canada']","['Action', 'Action Thrillers', 'Action/Adventure', 'Horror Comedy', 'Thriller', 'Comedy', 'Airplanes and airports', 'Horror', 'Natural horror films']",2000,6
4692753,Garam Hawa,1973,['India'],"['Bollywood', 'Drama']",1970,3
28909668,At the Edge of the World,2008,['United States of America'],"['Action', 'Adventure', 'Documentary']",2000,8
6008033,The Warlord: Battle for the Galaxy,1998,['United States of America'],"['Science Fiction', 'Adventure']",1990,8
11431731,The Boob,1926,['United States of America'],"['Black-and-white', 'Indie', 'Comedy', 'Silent film', 'Romantic comedy']",1920,6
22835483,Propala Hramota,1972,"['Ukrainian SSR', 'Soviet Union']",['Musical comedy'],1970,2
24090103,Planet Raptor,2009,"['Germany', 'United States of America', 'Romania']",['Horror'],2000,9
1761301,The Rite,1969,['Sweden'],['Black-and-white'],1960,9
31065513,Blondie Plays Cupid,1940,['United States of America'],"['Screwball comedy', 'Comedy', 'Comedy of manners', 'Domestic Comedy']",1940,0
2687112,The Bet,1997,['France'],['Comedy'],1990,7
3673942,The Christmas Toy,1986,"['Canada', 'United States of America']","[""Children's Fantasy"", ""Children's/Family"", 'Holiday Film']",1980,6
3412648,Harold & Kumar Escape from Guantanamo Bay,2008,['United States of America'],"['Stoner film', 'Buddy film', 'Comedy', 'Adventure', 'Slapstick', 'Cult']",2000,8
17265823,Bad Ol' Putty Tat,1949,['United States of America'],"['Comedy', 'Animation']",1940,9
3787332,Storm,2005,"['Sweden', 'Norway']","['Psychological thriller', 'Mystery', 'Thriller', 'World cinema', 'Drama', 'Fantasy']",2000,5
29397844,Crescendo,1970,['England'],['Horror'],1970,0
18849356,Alibabavum Narpadhu Thirudargalum,1956,['India'],"['Swashbuckler films', 'Adventure']",1950,6
10498826,Five on the Black Hand Side,1973,['United States of America'],"['Blaxploitation', 'Family Drama', 'Comedy', 'Comedy-drama', 'Drama']",1970,3
16166559,The Taking of Pelham 1 2 3,2009,"['United Kingdom', 'United States of America']","['Action', 'Crime Fiction', 'Action/Adventure', 'Thriller', 'Remake', 'Crime Thriller', 'Suspense', 'Heist', 'Caper story']",2000,9
14743458,Transcendent Man,2009,['United States of America'],"['Inventions & Innovations', 'Culture & Society', 'Documentary']",2000,9
25519452,Glen and Randa,1970,['United States of America'],"['Science Fiction', 'Drama']",1970,0
1788713,Fire,1996,"['Canada', 'India']","['LGBT', 'Art film', 'Indie', 'Romantic drama', 'Bollywood', 'World cinema', 'Romance Film', 'Drama']",1990,6
17338471,Art of the Devil,2004,['Thailand'],"['Horror', 'Supernatural', 'World cinema']",2000,4
21464946,Will You Cross the Skies for Me?,2009,['India'],"['Romance Film', 'Drama']",2000,9
11242,Final Fantasy: The Spirits Within,2001,"['Japan', 'United States of America']","['Action', 'Animation', 'Adventure', 'Computer Animation', 'Japanese Movies', 'Anime', 'Alien Film', 'Science Fiction', 'Fantasy']",2000,1
2310825,The Rage: Carrie 2,1999,['United States of America'],"['Teen', 'Thriller', 'Horror']",1990,9
6666561,Family Plan,2005,['United States of America'],"['Comedy', 'Television movie']",2000,5
9907431,Soultaker,1990,['United States of America'],"['Heaven-Can-Wait Fantasies', 'Teen', 'Horror', 'Fantasy']",1990,0
5413813,Daisy Kenyon,1947,['United States of America'],"['Black-and-white', 'Romantic drama', 'Film noir', 'Romance Film', 'Drama']",1940,7
1791382,Attack the Gas Station,1999,['South Korea'],"['Action', 'Crime Fiction', 'Action/Adventure', 'Comedy', 'World cinema']",1990,9
8325860,Dust in the Wind,1986,['Taiwan'],"['Coming of age', 'Family Drama', 'Teen', 'Drama']",1980,6
19991665,The Beast with a Million Eyes,1955,['United States of America'],"['Black-and-white', 'Horror', 'Alien Film', 'Sci-Fi Horror', 'Science Fiction', 'Natural horror films']",1950,5
11784192,Cops and Robbers,1951,['Italy'],"['Black-and-white', 'Crime Fiction', 'Comedy']",1950,1
3588990,Northanger Abbey,2000,[],"['Period piece', 'Romantic drama', 'Romance Film', 'Costume drama', 'Drama']",2000,0
3371654,The Killers,1956,['Soviet Union'],['Short Film'],1950,6
20333594,Ride Beyond Vengeance,1966,['United States of America'],"['Action', 'Western', 'Action/Adventure']",1960,6
357525,Bedknobs and Broomsticks,1971,['United States of America'],"['Musical', 'Fantasy Adventure', 'Animation', 'Animated Musical', 'Comedy', 'Family-Oriented Adventure', ""Children's/Family"", 'War film', 'Adventure', 'Drama', 'Family Film', 'Fantasy']",1970,1
16285552,The Best of Everything,1959,['United States of America'],"['Film adaptation', 'Romantic drama', 'Romance Film', 'Melodrama', 'Drama']",1950,9
447255,The Icicle Thief,1990,['Italy'],"['Satire', 'Comedy', 'Media Satire', 'Fantasy']",1990,0
3356331,Shankar Dada MBBS,2004,['India'],['Comedy'],2000,4
940668,The Pleasure Garden,1925,"['Weimar Republic', 'United Kingdom', 'Germany', 'Italy']","['Black-and-white', 'Crime Fiction', 'Indie', 'Silent film', 'Drama']",1920,5
106357,Missing,1982,['United States of America'],"['History', 'Mystery', 'Thriller', 'Drama', 'Political thriller']",1980,2
5695707,The Dancing Masters,1943,['United States of America'],"['Buddy film', 'Black-and-white', 'Comedy']",1940,3
18790870,Insaniyat,1967,['Pakistan'],"['Romance Film', 'Drama']",1960,7
26464662,Big Trouble,1986,['United States of America'],"['Screwball comedy', 'Parody', 'Comedy']",1980,6
2203406,Fright Night II,1988,['United States of America'],"['Comedy', 'Teen', 'Horror']",1980,8
2560729,Jägarna,1996,['Sweden'],"['Thriller', 'Crime Fiction']",1990,6
3550357,Abbott and Costello Meet the Mummy,1955,['United States of America'],"['Black-and-white', 'Screwball comedy', 'Comedy', 'Horror Comedy', 'Cult', 'Slapstick', 'Parody', 'Horror', 'Archaeology', 'Family Film']",1950,5
20210450,Playing Mona Lisa,2000,['United States of America'],['Comedy film'],2000,0
34904443,Time Table,1956,['United States of America'],"['Drama', 'Crime Fiction']",1950,6
5257678,The Sandpiper,1965,['United States of America'],"['Romance Film', 'Melodrama', 'Drama']",1960,5
291610,Drugstore Cowboy,1989,['United States of America'],"['Period piece', 'Drama', 'Crime Fiction', 'Indie', 'Crime Drama', 'Road movie', 'Addiction Drama']",1980,9
6065705,Doctor Mordrid,1992,['United States of America'],"['Fantasy Adventure', 'Thriller', 'Supernatural', 'Science Fiction', 'Fantasy']",1990,2
4180145,Alien Dead,1980,['United States of America'],"['Zombie Film', 'Science Fiction', 'Horror']",1980,0
8264802,Blithe Spirit,1945,"['United Kingdom', 'England']","['Film adaptation', 'Comedy', 'World cinema', 'Black comedy', 'Romance Film', 'Drama', 'Romantic comedy', 'Fantasy']",1940,5
8208221,Poster Boy,2004,['United States of America'],"['LGBT', 'Family Drama', 'Drama', 'Gay Themed', 'Gay', 'Gay Interest', 'Comedy-drama', 'Political drama']",2000,4
20958639,Trailer Park of Terror,2008,['United States of America'],"['Creature Film', 'Slasher', 'Teen', 'Horror', 'Zombie Film']",2000,8
3906958,Good Luck,2000,['India'],"['Buddy film', 'Comedy-drama']",2000,0
16593308,American Cousins,2003,['United Kingdom'],"['Action', 'Crime Fiction', 'Gangster Film', 'Action/Adventure', 'Comedy', 'Drama', 'Crime Drama', 'Romantic comedy', 'Family Film']",2000,3
26588721,Nadiya Kollappetta Rathri,2007,['India'],['Mystery'],2000,7
1964078,Crash Dive,1943,['United States of America'],"['Romantic drama', 'Romance Film', 'War film', 'Drama']",1940,3
26364940,Trapped by Television,1936,['United States of America'],"['Screwball comedy', 'Romance Film', 'Comedy-drama', 'Science Fiction', 'Drama']",1930,6
2015043,A Fine Madness,1966,['United States of America'],"['Romance Film', 'Comedy', 'Drama']",1960,6
14144031,Jack Armstrong,1947,['United States of America'],"['Movie serial', 'Black-and-white', 'Adventure']",1940,7
23467446,Ek Second... Jo Zindagi Badal De?,2009,['India'],"['Musical', 'Bollywood', 'World cinema', 'Drama']",2000,9
9313808,A Killer Within,2004,['United States of America'],"['Psychological thriller', 'Mystery', 'Thriller', 'Drama']",2000,4
5579651,Bad Company,2002,['United States of America'],"['Action', 'Spy', 'Action/Adventure', 'Comedy', 'Thriller']",2000,2
18098163,Donkey Punch,2008,['United Kingdom'],"['Psychological thriller', 'Suspense', 'Indie', 'Thriller', 'Erotic thriller', 'Crime Thriller']",2000,8
7602265,13 Beloved,2006,['Thailand'],"['Psychological thriller', 'Thriller', 'Horror', 'World cinema']",2000,6
1413265,Fat Albert,2004,['United States of America'],"['Comedy', 'Romance Film', ""Children's/Family"", 'Fantasy Comedy', 'Family Film', 'Fantasy']",2000,4
1979044,"Grandview, U.S.A.",1984,['United States of America'],"['Indie', 'Romantic drama', 'Comedy', 'Romance Film', 'Americana', 'Drama', 'Coming of age', 'Ensemble Film']",1980,4
2142304,Ram Jaane,1995,['India'],"['Drama', 'World cinema']",1990,5
14705923,The Threepenny Opera,1931,"['Germany', 'United States of America', 'Weimar Republic']","['Musical', 'Drama', 'Comedy film']",1930,1
23663192,The Glass Menagerie,1987,['United States of America'],['Drama'],1980,7
2631898,The Scarlet Claw,1944,['United States of America'],"['Black-and-white', 'Detective fiction', 'Mystery', 'Thriller', 'Crime Thriller', 'Suspense', 'Detective', 'Supernatural']",1940,4
7388449,Goal 3,2008,['Germany'],"['Action', 'Drama', 'Romance Film', 'Sports']",2000,8
12824433,Like Two Crocodiles,1994,"['United Kingdom', 'France', 'Italy']","['Drama', 'World cinema']",1990,4
11766557,The Landlady,2000,['India'],"['Drama', 'Art film']",2000,0
412476,The Bodyguard,1992,['United States of America'],"['Musical', 'Crime Fiction', 'Romantic drama', 'Thriller', 'Romance Film', 'Crime Thriller', 'Drama', 'Suspense']",1990,2
13497997,"Oily to Bed, Oily to Rise",1939,['United States of America'],"['Short Film', 'Black-and-white', 'Comedy']",1930,9
22541174,Conjurer,2008,['United States of America'],"['Indie', 'Thriller', 'Horror', 'Supernatural']",2000,8
4717651,Distant Lights,2003,"['Germany', 'Poland']",['Drama'],2000,3
21876111,Doctor Blood's Coffin,1961,['United Kingdom'],"['Monster movie', 'Horror', 'B-movie', 'Zombie Film', 'Science Fiction']",1960,1
3027145,Little Boy Lost,1978,['Australia'],['Drama'],1970,8
36567252,Crazy Joe,1974,"['Italy', 'United States of America']","['Drama', 'Crime Fiction', 'Biopic [feature]']",1970,4
27814939,The Flying Scotsman,1929,['Crime'],"['Drama', 'Crime Fiction']",1920,9
14488825,He Cooked His Goose,1952,['United States of America'],"['Short Film', 'Black-and-white', 'Comedy']",1950,2
7692070,Exodus,2007,['United Kingdom'],['Drama'],2000,7
7662191,The Chance of a Lifetime,1943,['United States of America'],"['Prison', 'Crime Fiction', 'Mystery', 'Crime Drama', 'Adventure']",1940,3
9231856,Cocaine Wars,1985,"['Argentina', 'United States of America']","['Action', 'Spy', 'Drama']",1980,5
16968512,Hero Hindustani,1998,['India'],"['Action', 'Drama', 'Comedy']",1990,8
28900288,The Rat,1925,['United Kingdom'],['Silent film'],1920,5
2648735,Jane Eyre,1996,"['United Kingdom', 'France', 'Italy', 'United States of America']","['Period piece', 'Film adaptation', 'Romantic drama', 'World cinema', 'Romance Film', 'Costume drama', 'Drama']",1990,6
17044747,Who's Who in the Zoo,1942,['United States of America'],"['Animation', 'Short Film', 'Family Film']",1940,2
21795704,Day of the Evil Gun,1968,['United States of America'],"['Action', 'Western']",1960,8
4061041,The Magic Box,1951,['United Kingdom'],"['Drama', 'Biographical film']",1950,1
4143719,I'll Do Anything,1994,['United States of America'],"['Domestic Comedy', 'Comedy', 'Drama']",1990,4
33534917,Beastie Boys,2008,['South Korea'],['Drama'],2000,8
3208449,Separate Lies,2005,['United Kingdom'],"['Film adaptation', 'Crime Fiction', 'Mystery', 'Romantic drama', 'Thriller', 'Romance Film', 'Crime Thriller', 'Drama', 'Marriage Drama']",2000,5
11890652,Memory,2006,['United States of America'],"['Psychological thriller', 'Mystery', 'Thriller', 'Crime Thriller', 'Drama', 'Horror', 'Supernatural', 'Science Fiction']",2000,6
13523311,Homo Sapiens 1900,1998,['Sweden'],"['Documentary', 'History', 'World cinema']",1990,8
9862787,Genuine,1920,"['Weimar Republic', 'Germany']","['Silent film', 'Indie', 'Horror']",1920,0
6212119,The Toxic Avenger Part III: The Last Temptation of Toxie,1989,['United States of America'],"['Action', 'Superhero', 'Action/Adventure', 'Comedy', 'Horror Comedy', 'Monster movie', 'Parody', 'Horror', 'Superhero movie', 'B-movie', 'Cult']",1980,9
24166065,Money Movers,1979,"['United States of America', 'Australia']","['Crime Fiction', 'Crime Thriller', 'Caper story']",1970,9
1271476,Southern Fried Rabbit,1953,['United States of America'],['Comedy'],1950,3
993867,By Dawn's Early Light,1990,['United States of America'],"['Action', 'Cold War', 'Film adaptation', 'Thriller', 'Disaster', 'Drama', 'Television movie', 'Doomsday film', 'Science Fiction', 'Political thriller']",1990,0
9618696,The Frozen Ghost,1945,['United States of America'],"['Mystery', 'Horror']",1940,5
29542980,Vachanam,1989,['India'],['Drama'],1980,9
1441031,High Art,1998,"['Canada', 'United States of America']","['LGBT', 'Indie', 'Romantic drama', 'Romance Film', 'Addiction Drama', 'Drama', 'Gay Themed', 'Gay', 'Gay Interest']",1990,8
31652234,No Minor Vices,1948,['United States of America'],"['Comedy', 'Comedy film']",1940,8
4206673,Black Caesar,1973,['United States of America'],"['Action', 'Blaxploitation', 'Drama', 'Crime Fiction', 'Indie', 'Action/Adventure', 'Crime Drama']",1970,3
212671,So I Married an Axe Murderer,1993,['United States of America'],"['Comedy', 'Crime Comedy', 'Romance Film', 'Romantic comedy', 'Comedy of Errors', 'Cult']",1990,3
27842523,Don't Answer the Phone,1980,['United States of America'],"['Psychological thriller', 'Slasher', 'Thriller', 'Horror']",1980,0
11557479,Dream of Love,1928,['United States of America'],"['Black-and-white', 'Indie', 'Biographical film', 'Silent film', 'Drama']",1920,8
4223800,"10,000 BC",2008,"['South Africa', 'New Zealand', 'United States of America']","['Action', 'Action/Adventure', 'Thriller', 'Romance Film', 'Costume drama', 'Adventure', 'Fantasy']",2000,8
5672172,Lone Wolf and Cub: Baby Cart to Hades,1972,['Japan'],"['Japanese Movies', 'Action/Adventure', 'World cinema', 'Martial Arts Film']",1970,2
5766332,The Times of Harvey Milk,1984,['United States of America'],"['Gender Issues', 'LGBT', 'Biography', 'Documentary', 'Law & Crime', 'Political cinema', 'History', 'Television movie']",1980,4
16166163,Kandha Kadamba Kathir Vela,2000,['India'],[],2000,0
30201577,18 Year Old Virgin,2009,['United States of America'],"['Coming of age', 'Indie', 'Comedy', 'Sex comedy']",2000,9
27067766,Rahul,2001,['India'],"['Drama', 'World cinema']",2000,1
22518656,The Next Big Thing,2002,['United States of America'],"['Indie', 'Comedy', 'Romance Film', 'Romantic comedy']",2000,2
6415441,New,2004,['India'],"['Musical', 'Comedy', 'Drama']",2000,4
17188716,My Mother's Castle,1990,['France'],"['Film adaptation', 'Drama', 'World cinema']",1990,0
3653768,Le Corbeau,1943,['France'],"['Psychological thriller', 'Black-and-white', 'Mystery', 'Thriller', 'World cinema', 'Film noir', 'Drama']",1940,3
5033651,Barney's Great Adventure,1998,"['Canada', 'United States of America']","['Musical', ""Children's Fantasy"", 'Family-Oriented Adventure', ""Children's/Family"", ""Children's"", 'Fantasy']",1990,8
26293600,Agni Parvatam,1985,['India'],"['Action', 'Drama']",1980,5
15477513,Dunia Baru: The Movie,2008,['Malaysia'],['Comedy'],2000,8
67419,Out for Justice,1991,['United States of America'],"['Action', 'Action Thrillers', 'Gangster Film', 'Action/Adventure', 'Thriller', 'Martial Arts Film']",1990,1
22930465,Occupation in 26 Pictures,1978,"['Yugoslavia', 'Socialist Federal Republic of Yugoslavia']","['War film', 'Drama']",1970,8
1398260,Roadkill,1989,['Canada'],"['Action', 'Indie', 'Action/Adventure', 'Comedy', 'Thriller', 'Crime Thriller', 'Adventure', 'Drama']",1980,9
18002411,Thenmavin Kombath,2004,['India'],"['Musical', 'Romance Film', 'Drama']",2000,4
1720953,Last Woman on Earth,1960,['United States of America'],"['Dystopia', 'Indie', 'Science Fiction', 'Drama', 'Cult']",1960,0
14480034,Mon beau-frère a tué ma sœur,1986,['France'],"['Comedy', 'Thriller']",1980,6
6074576,The Living End,1992,['United States of America'],"['LGBT', 'Indie', 'Romantic drama', 'Romance Film', 'Tragicomedy', 'Drama', 'Gay Themed', 'Gay', 'Gay Interest', 'Road movie']",1990,2
2543730,The Satanic Rites of Dracula,1974,['United Kingdom'],"['Thriller', 'Horror']",1970,4
24455246,Little Rural Riding Hood,1949,['United States of America'],"['Animated cartoon', 'Short Film', 'Comedy film']",1940,9
24065239,For the Cause,2000,['United States of America'],"['Science Fiction', 'Drama']",2000,0
129295,Fatal Attraction,1987,['United States of America'],"['Psychological thriller', 'Mystery', 'Thriller', 'Drama', 'Suspense', 'Slasher', 'Horror', 'Erotic thriller']",1980,7
6288335,Cannon for Cordoba,1970,['United States of America'],"['Action', 'Action/Adventure', 'Western', 'Adventure']",1970,0
4235749,Narcosatánicos Asesinos,1989,['Mexico'],['Comedy'],1980,9
2506370,Royal Flash,1975,['United Kingdom'],"['Film adaptation', 'Comedy', 'Historical fiction', 'Swashbuckler films', 'Adventure', 'Drama']",1970,5
8066629,Angel,1937,['United States of America'],"['Black-and-white', 'Comedy', 'Romance Film', 'Drama']",1930,7
22301502,Boo to You Too! Winnie the Pooh,1996,['United States of America'],"['Animation', 'Short Film', 'Comedy']",1990,6
15693150,Stars in My Crown,1950,['United States of America'],"['Western', 'Drama']",1950,0
33916241,Unconquered,1989,['United States of America'],['Drama'],1980,9
12679879,Pukar,2000,['India'],"['Action/Adventure', 'Thriller', 'Bollywood', 'World cinema', 'Romance Film', 'Drama']",2000,0
14018582,High School Hellcats,1958,['United States of America'],"['Black-and-white', 'Crime Fiction', 'Teen', 'Drama']",1950,8
972970,Waiting to Exhale,1995,['United States of America'],"['Female buddy film', 'Romantic drama', 'Comedy', 'Romance Film', 'Comedy-drama', 'Drama', 'Ensemble Film']",1990,5
23454959,Stork,1971,['Australia'],['Comedy film'],1970,1
18804314,Shabana,1976,['Pakistan'],['Drama'],1970,6
2254715,Groom Lake,2002,['United States of America'],"['Horror', 'Alien Film', 'Science Fiction', 'Drama']",2000,2
4038173,The Mirror,1999,['Hong Kong'],"['Chinese Movies', 'Crime Fiction', 'Mystery', 'Horror']",1990,9
7553781,Rome Adventure,1962,['United States of America'],"['Film adaptation', 'Romantic drama', 'Romance Film', 'Road movie', 'Drama']",1960,2
5274154,Storm Boy,1976,['Australia'],"['Drama', 'Family Film']",1970,6
17998333,Never Say Die,1939,['United States of America'],"['Romantic comedy', 'Black-and-white']",1930,9
11537723,I Eat Your Skin,1964,['United States of America'],"['Monster movie', 'Black-and-white', 'Horror', 'B-movie', 'Supernatural', 'Science Fiction']",1960,4
34289848,Hollywood Hot Tubs,1984,[],"['Comedy film', 'Adult', 'Pornographic movie']",1980,4
24564673,Qué Hombre tan Sin Embargo,1967,['Mexico'],['Comedy'],1960,7
639796,Desperado,1995,['United States of America'],"['Action', 'Crime Fiction', 'Gangster Film', 'Western', 'Comedy', 'Thriller', 'Drama']",1990,5
23552035,I Hate Valentine's Day,2009,['United States of America'],"['Romance Film', 'Romantic comedy', 'Comedy']",2000,9
22645038,Het 14e kippetje,1998,['Netherlands'],"['Romance Film', 'Comedy', 'Drama']",1990,8
2434423,Party at Kitty and Stud's,1970,['United States of America'],"['Drama', 'Softcore Porn', 'Romantic drama', 'Pornographic movie', 'Romance Film', 'Erotica', 'Adult']",1970,0
23070193,The Gangsters,1956,['France'],['Comedy film'],1950,6
23789920,A Friend's Betrayal,1996,['United States of America'],"['Melodrama', 'Drama']",1990,6
9013788,Kōshōnin,2003,['Japan'],"['Action', 'Crime Fiction', 'Japanese Movies', 'Action/Adventure', 'Thriller', 'World cinema', 'Drama']",2000,3
26855091,Teaserama,1955,['United States of America'],"['Documentary', 'Sexploitation', 'Comedy']",1950,5
9856437,Redline,2007,['United States of America'],"['Action', 'Auto racing', 'Action/Adventure', 'Thriller', 'Sports']",2000,7
26140367,Sweet Hours,1982,"['France', 'Spain']",['Drama'],1980,2
13201636,Honky Tonk Freeway,1981,['United States of America'],"['Parody', 'Comedy', 'Ensemble Film']",1980,1
30209823,Pazhassi Raja,1964,[],['Biographical film'],1960,4
25532494,The White Angel,2007,['Turkey'],['Drama'],2000,7
27334628,Iodine,2009,['Canada'],"['Mystery', 'Science Fiction', 'Drama']",2000,9
2420966,Tenacious D in The Pick of Destiny,2006,"['Germany', 'United States of America']","['Stoner film', 'Parody', 'Comedy', 'Musical comedy', 'Cult']",2000,6
14058109,The Strange Case of the End of Civilization as We Know It,1977,['United Kingdom'],"['Mystery', 'Comedy', 'Detective', 'Crime']",1970,7
29667339,Wake Up Jeff,1996,[],['Short Film'],1990,6
6559084,Loch Ness,1996,"['United Kingdom', 'United States of America']","['Family Drama', 'Family-Oriented Adventure', 'Adventure', 'Drama', 'Family Film', 'Fantasy']",1990,6
2838120,Vaali,1999,['India'],"['Romance Film', 'Thriller']",1990,9
15438742,Anjathe,2008,['India'],['Drama'],2000,8
21472992,Black Day Blue Night,1995,['United States of America'],"['Suspense', 'Crime Fiction', 'Thriller', 'Crime Thriller']",1990,5
3071676,Peau d'Âne,1970,['France'],"['Musical', 'Romantic drama', 'Comedy', 'World cinema', 'Romance Film', 'Drama', 'Family Film', 'Fantasy']",1970,0
33489565,Lies Before Kisses,1991,['United States of America'],"['Thriller', 'Drama']",1990,1
919005,Swing Time,1936,['United States of America'],"['Musical', 'Black-and-white']",1930,6
8687544,The Big Steal,1990,['Australia'],['Comedy'],1990,0
32087923,Boxer,1984,[],"['Action', 'Drama', 'Crime Fiction', 'Adventure']",1980,4
432236,Pee-wee's Big Adventure,1985,['United States of America'],"['Adventure Comedy', 'Comedy', ""Children's/Family"", 'Road movie', 'Cult', 'Adventure', 'Family Film']",1980,5
3010079,Flesh Feast,1970,['United States of America'],"['Science Fiction', 'Thriller', 'Horror']",1970,0
15739716,Les Ambassadeurs,1977,"['France', 'Tunisia', 'Libya']",['Drama'],1970,7
4568987,Dukh Bhanjan Tera Naam,1974,['India'],[],1970,4
24526226,Albino Farm,2008,[],"['Slasher', 'Horror']",2000,8
1853855,They Saved Hitler's Brain,1966,['United States of America'],"['Action', 'Spy', 'Action Thrillers', 'Action/Adventure', 'Thriller', 'Science Fiction', 'Drama']",1960,6
26006495,Puzzle of a Downfall Child,1970,['United States of America'],['Drama'],1970,0
17478415,Bi the Way,2008,['United States of America'],"['Social issues', 'LGBT', 'Family & Personal Relationships', 'Indie', 'Documentary', 'Culture & Society']",2000,8
4841603,Dead Man's Letters,1987,['Soviet Union'],['Science Fiction'],1980,7
4457831,The Mists of Avalon,2001,"['Germany', 'United States of America', 'Czech Republic']","['Fantasy Adventure', 'Feminist Film', 'Costume drama', 'Fantasy']",2000,1
7144878,Riding the Rails,1938,['United States of America'],"['Short Film', 'Animation']",1930,8
11096570,De Sade,1969,"['West Germany', 'United States of America']","['Erotic Drama', 'Biography', 'Indie', 'Thriller', 'Biographical film', 'Romance Film', 'Drama', 'Period piece', 'Biopic [feature]', 'Erotic thriller', 'Erotica']",1960,9
8636215,Cruise of the Jasper B,1926,['United States of America'],"['Black-and-white', 'Indie', 'Silent film', 'Adventure']",1920,6
10658755,Naan Sigappu Manithan,1985,['India'],"['Action', 'Drama']",1980,5
3615779,Deep jele jai,1959,['India'],[],1950,9
4598057,The Blue Bird,1976,"['Soviet Union', 'United States of America']","['Drama', ""Children's"", 'Fantasy']",1970,6
24356631,The Great Bank Robbery,1969,['United States of America'],"['Parody', 'Caper story', 'Western', 'Comedy', 'Slapstick']",1960,9
6032362,Angels in the Endzone,1997,['United States of America'],"['Family Drama', 'Comedy', ""Children's/Family"", 'Sports', 'Fantasy Comedy', 'Drama', 'Family Film']",1990,7
7758136,The Unbearable Lightness of Being,1988,['United States of America'],"['Film adaptation', 'Erotic Drama', 'Romantic drama', 'Romance Film', 'Drama', 'Marriage Drama', 'Erotica', 'Political drama']",1980,8
24879053,OSS 117 - Lost in Rio,2009,['France'],"['Spy', 'Action/Adventure', 'Comedy', 'World cinema', 'Adventure']",2000,9
29268574,You Live and Learn,1937,['United Kingdom'],['Comedy film'],1930,7
3740276,Mohra,1994,['India'],"['Bollywood', 'World cinema']",1990,4
4205176,The Body,2001,"['Israel', 'Germany', 'United States of America']","['Film adaptation', 'Drama', 'Mystery', 'Indie', 'Political thriller', 'Thriller', 'Political drama']",2000,1
20964770,Attack of the 5 Ft. 2 In. Women,1994,['United States of America'],['Parody'],1990,4
21926710,White on Rice,2009,['United States of America'],"['Indie', 'Comedy', 'Romance Film', 'Romantic comedy']",2000,9
23779762,Close to My Heart,1951,['United States of America'],"['Black-and-white', 'Melodrama', 'Drama']",1950,1
16949071,Kung Fu Tootsie,2007,['Thailand'],"['Action', 'Comedy']",2000,7
26213151,Remote Control,1988,['United States of America'],"['Science Fiction', 'Comedy film', 'Horror']",1980,8
15905726,They Drive by Night,1938,['United Kingdom'],"['Black-and-white', 'Thriller']",1930,8
2998375,The Mark of Zorro,1974,['United States of America'],"['Action/Adventure', 'Adventure', 'Superhero movie', 'Television movie', 'Swashbuckler films']",1970,4
3814521,Another Public Enemy,2005,['South Korea'],"['Crime Fiction', 'Action/Adventure', 'Thriller', 'World cinema']",2000,5
2466773,The Godfather,1972,['United States of America'],"['Film adaptation', 'Crime Fiction', 'Gangster Film', 'Family Drama', 'Drama', 'Period piece', 'New Hollywood', 'Crime Drama']",1970,2
22849661,Ashes and Blood,2009,['France'],"['Drama', 'World cinema']",2000,9
19270772,Bajimaat,2008,['India'],"['Musical', 'Romance Film', 'Drama']",2000,8
10486289,Summer Palace,2006,"['China', 'France']","['Romantic drama', 'World cinema', 'Romance Film', 'Chinese Movies', 'Drama', 'Period piece', 'Coming of age', 'Political drama']",2000,6
5317465,SSSSSSS,1973,['United States of America'],"['Horror', 'B-movie', 'Sci-Fi Horror', 'Science Fiction', 'Natural horror films']",1970,3
25977954,No Man Is an Island,1962,['United States of America'],"['Action', 'Biography', 'Action/Adventure', 'Adventure', 'War film', 'Drama']",1960,2
4037152,They Call Me Bruce?,1982,['United States of America'],"['Action', 'Gangster Film', 'Parody', 'Action/Adventure', 'Comedy', 'Martial Arts Film']",1980,2
3987041,Planet of the Vampires,1965,"['Spain', 'Italy']","['Horror', 'World cinema', 'Adventure', 'Alien Film', 'Sci-Fi Horror', 'Science Fiction']",1960,5
10386612,The Third Generation,1979,"['Germany', 'West Germany']","['Crime Fiction', 'Comedy', 'World cinema', 'Political drama', 'Drama']",1970,9
2995145,April Story,1998,['Japan'],['Japanese Movies'],1990,8
2394082,The Incredible Shrinking Woman,1981,['United States of America'],"['Comedy', 'Satire', 'Science Fiction', 'Family Film']",1980,1
19305207,Shaitani Ilaaka,1990,['India'],['Horror'],1990,0
31410989,Charlie On Parole,2009,['United States of America'],['Short Film'],2000,9
570258,Invasion of Astro-Monster,1965,"['Japan', 'United States of America']","['Japanese Movies', 'Action/Adventure', 'Monster', 'World cinema', 'Science Fiction', 'Fantasy']",1960,5
31165097,The Second Greatest Sex,1955,['United States of America'],"['Musical', 'Adventure']",1950,5
9383602,The Naked Edge,1961,"['United Kingdom', 'United States of America']","['Psychological thriller', 'Black-and-white', 'Thriller']",1960,1
2461592,Casino Royale,1967,"['United Kingdom', 'United States of America']","['Action', 'Spy', 'Parody', 'Action/Adventure', 'Satire', 'Comedy']",1960,7
5639686,Casper's First Christmas,1979,['United States of America'],"[""Children's Fantasy"", 'Short Film', ""Children's/Family"", 'Fantasy']",1970,9
15242361,A Moment of Innocence,1996,"['France', 'Iran']","['Biography', 'Satire', 'Comedy', 'World cinema', 'Romance Film', 'Drama', 'Parody', 'Comedy-drama']",1990,6
25841008,Con Express,2002,['United States of America'],"['Action', 'Suspense', 'Crime Fiction', 'Action/Adventure', 'Thriller']",2000,2
24856664,Kompull Boros Mok 2,1972,['Cambodia'],"['Romance Film', 'Drama']",1970,2
692836,The Official Story,1985,['Argentina'],"['Drama', 'Indie', 'World cinema', 'Political drama']",1980,5
13258593,Tokyo 10+01,2003,['Japan'],"['Action', 'Japanese Movies', 'Parody', 'Action/Adventure', 'World cinema']",2000,3
8002658,I Know Who Killed Me,2007,['United States of America'],"['Psychological thriller', 'Mystery', 'Thriller', 'Horror', 'Erotica', 'Drama']",2000,7
31839313,Driving Me Crazy,1991,"['Germany', 'United States of America']","['Indie', 'Comedy']",1990,1
25506,Raging Bull,1980,['United States of America'],"['Boxing', 'Black-and-white', 'Neo-noir', 'Biography', 'Biographical film', 'Drama', 'Period piece', 'Biopic [feature]', 'New Hollywood', 'Sports']",1980,0
4017383,The Wind That Shakes the Barley,2006,"['Spain', 'United Kingdom', 'France', 'Germany', 'Ireland', 'Italy']","['Period piece', 'Action', 'Political drama', 'Romance Film', 'War film', 'Drama']",2000,6
28919836,The Lost Squadron,1932,['United States of America'],"['Action', 'Drama', 'War film']",1930,2
905533,The Bedford Incident,1965,"['United Kingdom', 'United States of America']","['Film adaptation', 'Thriller', 'War film', 'Drama', 'Political thriller']",1960,5
10997890,The Butterfly,2002,['France'],"['Comedy', 'Drama', 'World cinema']",2000,2
27254000,Springtime for Henry,1934,['United States of America'],['Comedy'],1930,4
142465,The Thin Red Line,1998,['United States of America'],"['Drama', 'Indie', 'Existentialism', 'War film']",1990,8
32018157,"Milice, film noir",1997,['France'],['Documentary'],1990,7
16248850,Dancing in the Dark,1986,['Canada'],['Drama'],1980,6
4983197,Ennavale,2004,['India'],['World cinema'],2000,4
22739944,And The Beat Goes On,2009,['United Kingdom'],['Music'],2000,9
12162055,I Spit on Your Corpse,1974,['United States of America'],"['Action', 'Crime Fiction', 'Indie', 'Adventure', 'Softcore Porn', 'Horror', 'Adult', 'Cult']",1970,4
16400283,Water Lilies,2007,['France'],"['LGBT', 'Coming of age', 'Romantic drama', 'World cinema', 'Romance Film', 'Drama']",2000,7
106359,The Verdict,1982,['United States of America'],"['Film adaptation', 'Drama', 'Courtroom Drama']",1980,2
16639443,Reckless,1995,['United States of America'],"['Black comedy', 'Comedy-drama', 'Fantasy']",1990,5
17352897,Oranges,2007,['United States of America'],['Drama'],2000,7
2206376,Son of Frankenstein,1939,['United States of America'],"['Creature Film', 'Black-and-white', 'Monster', 'Horror']",1930,9
28778357,Right America: Feeling Wronged - Some Voices from the Campaign Trail,2009,['United States of America'],['Documentary'],2000,9
20145389,The Drivetime,1995,['United States of America'],['Science Fiction'],1990,5
14053036,Aitaré da Praia,1925,['Brazil'],"['Indie', 'Silent film', 'Romance Film', 'Drama']",1920,5
13919407,One More Chance,2007,['Philippines'],"['Dogme 95', 'Filipino Movies', 'Romantic drama', 'World cinema', 'Romance Film', 'Drama']",2000,7
2902089,Faithless,2000,['Sweden'],"['Romantic drama', 'World cinema', 'Romance Film', 'Drama']",2000,0
33347419,India Song,1975,['France'],"['Experimental film', 'Avant-garde', 'Feminist Film']",1970,5
694482,Firefox,1982,['United States of America'],"['Action', 'Suspense', 'Airplanes and airports', 'Action Thrillers', 'Action/Adventure', 'Thriller', 'War film']",1980,2
3451115,You Natzy Spy!,1940,['United States of America'],"['Black-and-white', 'Short Film', 'Satire', 'Comedy']",1940,0
12144099,The Christmas Kid,1967,"['Spain', 'United States of America']","['Indie', 'Western', 'Drama']",1960,7
32538811,The Room Upstairs,1987,[],"['Film adaptation', 'Television movie', 'Drama']",1980,7
10800145,The Missing Mouse,1953,['United States of America'],"['Animation', 'Short Film', 'Family Film']",1950,3
21544868,Red Canvas,2008,['United States of America'],"['Action/Adventure', 'Martial Arts Film']",2000,8
2687106,Bollywood/Hollywood,2002,['Canada'],"['Musical', 'Comedy', 'Bollywood', 'Romance Film', 'Romantic comedy']",2000,2
1700148,The One-Armed Swordsman,1967,['Hong Kong'],"['Action/Adventure', 'World cinema', 'Wuxia', 'Chinese Movies', 'Martial Arts Film', 'Drama']",1960,7
20906960,When Taekwondo Strikes,1973,"['Hong Kong', 'South Korea']","['Action/Adventure', 'World cinema', 'Chinese Movies', 'Martial Arts Film']",1970,3
168597,Big,1988,['United States of America'],"['Comedy', 'Romance Film', 'Drama', 'Coming of age', 'Romantic comedy', 'Fantasy Comedy', 'Family Film', 'Fantasy']",1980,8
21725564,Gacy,2003,['United States of America'],"['Biography', 'Slasher', 'Biographical film', 'Horror', 'Drama']",2000,3
14689488,Rock n' Roll Cops 2: The Adventure Begins,2003,['United States of America'],['Action'],2000,3
11718158,But Forever in My Mind,1999,['Italy'],"['Coming of age', 'Comedy', 'Teen', 'World cinema', 'Comedy-drama', 'Drama']",1990,9
24551438,Tickling Leo,2009,['United States of America'],"['Mystery', 'Family Drama', 'Indie', 'Drama']",2000,9
2071706,Robin and Marian,1976,"['United Kingdom', 'United States of America']","['Action', 'Romantic drama', 'Action/Adventure', 'Romance Film', 'Costume drama', 'Drama', 'Adventure', 'Swashbuckler films', 'Period piece', 'War film']",1970,6
8841918,Bulat-Batır,1928,['Soviet Union'],"['Indie', 'Silent film']",1920,8
14334714,Hawaiian Aye Aye,1964,['United States of America'],['Short Film'],1960,4
11806522,Hitler's Children,1943,['United States of America'],"['Black-and-white', 'Romance Film', 'Propaganda film', 'Drama']",1940,3
23221130,Teito Monogatari Gaiden,1995,['Japan'],"['Japanese Movies', 'Horror', 'Adventure', 'Science Fiction', 'Fantasy']",1990,5
31193,THX 1138,1971,['United States of America'],"['Mystery', 'Thriller', 'Science Fiction', 'Drama']",1970,1
7639512,Hamlet A.D.D.,2009,['United States of America'],"['Animation', 'Science Fiction', 'Comedy']",2000,9
17030766,The Incident,1990,['United States of America'],"['Crime Fiction', 'Drama', 'Courtroom Drama']",1990,0
5610546,Lost Souls,2000,['United States of America'],"['Supernatural', 'Thriller', 'Horror']",2000,0
542202,Strictly Ballroom,1992,['Australia'],"['Romantic drama', 'Comedy', 'World cinema', 'Dance', 'Romance Film', 'Romantic comedy', 'Drama']",1990,2
11470344,Antikiller,2002,['Russia'],"['Action', 'Crime Fiction']",2000,2
19063107,First to Fight,1967,['United States of America'],"['War film', 'Drama']",1960,7
25614987,Villon's Wife,2009,['Japan'],['Japanese Movies'],2000,9
11180975,Abbott of Shaolin,1979,['Hong Kong'],"['Action', 'Chinese Movies', 'Martial Arts Film', 'Adventure']",1970,9
6243001,Les Misérables,1982,['France'],['Drama'],1980,2
20479465,Oye Lucky! Lucky Oye!,2008,['India'],"['Musical', 'Comedy', 'Bollywood', 'World cinema']",2000,8
12587026,Spy Girl,2004,['South Korea'],"['Action', 'Spy', 'Action/Adventure', 'World cinema', 'Romantic comedy']",2000,4
20903439,Black Mail,1973,['India'],['Thriller'],1970,3
16658874,"20,000 Leagues Under the Sea",1985,['Australia'],['Animation'],1980,5
1855272,Green Tea,2003,"['China', 'Hong Kong']","['Romantic drama', 'World cinema', 'Romance Film', 'Chinese Movies', 'Drama']",2000,3
9070689,Risk,2007,['India'],"['Action/Adventure', 'World cinema']",2000,7
23270611,Third Dimensional Murder,1941,['United States of America'],"['Crime Fiction', 'Short Film', 'Comedy film', 'Horror']",1940,1
22600796,Suvarna Sundari,1957,['India'],"['Musical', 'Drama']",1950,7
1600825,Thunderbirds Are GO,1966,['United Kingdom'],"['Supermarionation', 'Adventure', ""Children's/Family"", 'Science Fiction', 'Drama', 'Family Film']",1960,6
1192112,The Cockleshell Heroes,1955,['United Kingdom'],['War film'],1950,5
5179089,Kasme Vaade,1978,['India'],"['Drama', 'Bollywood', 'World cinema']",1970,8
19259226,Tolly Lights,2008,['India'],['Drama'],2000,8
28526527,Spellbound,1941,['United Kingdom'],['Drama'],1940,1
5883086,A Chorus Line,1985,['United States of America'],"['Musical', 'Backstage Musical', 'Musical Drama', 'Drama']",1980,5
7317257,Jukti Takko Aar Gappo,1974,['India'],[],1970,4
11691760,The Desert of the Tartars,1976,['Italy'],"['War film', 'Drama', 'World cinema']",1970,6
18595351,Sands of Oblivion,2007,['United States of America'],"['History', 'Horror', 'Television movie', 'Science Fiction']",2000,7
21226360,Avenging Angel,2007,['United States of America'],"['Action', 'Drama', 'Action/Adventure', 'Western', 'Thriller', 'Television movie']",2000,7
7811236,Just the Ticket,1999,['United States of America'],"['Romance Film', 'Romantic comedy', 'Comedy']",1990,9
17099246,Two Weeks in Another Town,1962,['United States of America'],"['Melodrama', 'Drama']",1960,2
10068900,Daffy The Commando,1943,['United States of America'],"['Propaganda film', 'Comedy']",1940,3
24789247,Half-Fare Hare,1956,[],"['Animation', 'Short Film', 'Family Film']",1950,6
11327579,The Bells Go Down,1943,['United Kingdom'],"['Black-and-white', 'Comedy-drama', 'War film', 'Drama']",1940,3
5083763,Family Business,1989,['United States of America'],"['Heist', 'Crime Fiction', 'Gangster Film', 'Comedy', 'Drama']",1980,9
21408046,The Love Letters from Teralba Road,1977,['Australia'],"['Short Film', 'Drama']",1970,7
12232008,Year of the Gun,1991,['United States of America'],"['Suspense', 'Mystery', 'Thriller', 'Political drama', 'Drama', 'Political thriller']",1990,1
2125486,The Eagle,1925,['United States of America'],"['Action', 'Black-and-white', 'Indie', 'Action/Adventure', 'Romantic drama', 'Comedy', 'Romance Film', 'Drama', 'Adventure', 'Silent film']",1920,5
14545761,17 Again,2009,['United States of America'],"['Comedy', 'Teen', 'Romance Film', 'Drama', 'Coming of age', 'Romantic comedy', 'Fantasy Comedy', 'Fantasy']",2000,9
6569213,Moonnamathoral,2006,['India'],['Horror'],2000,6
10785221,Crossing the Line,2006,['United Kingdom'],"['Political cinema', 'History', 'Documentary', 'War film']",2000,6
6742321,You're Never Too Young,1955,['United States of America'],"['Chase Movie', 'Comedy', 'Crime Comedy', 'Slapstick']",1950,5
20716485,The Battle of the Sexes,1928,['United States of America'],"['Silent film', 'Black-and-white']",1920,8
1085443,Dünyayı Kurtaran Adam,1982,['Turkey'],"['Action', 'Science Fiction', 'Adventure']",1980,2
12637837,Mad City,1997,['United States of America'],"['Action/Adventure', 'Thriller', 'Crime Thriller', 'Political drama', 'Drama']",1990,7
3085027,Ramrod,1947,['United States of America'],['Western'],1940,7
5445288,Girls' Night Out,1998,['South Korea'],"['Drama', 'Comedy']",1990,8
8627714,The Living Hell,2008,['United States of America'],"['Suspense', 'Science Fiction', 'Horror']",2000,8
30430079,Dead And Deader,2006,[],"['Action', 'Horror', 'Television movie', 'Zombie Film', 'Sci-Fi Horror', 'Science Fiction']",2000,6
27667647,Pelli Naati Pramanalu,1958,['India'],"['Drama', 'Comedy film']",1950,8
68124,American Graffiti,1973,['United States of America'],"['Comedy', 'Teen', 'Romance Film', 'Americana', 'Drama', 'Period piece', 'Coming of age', 'New Hollywood', 'Comedy-drama', 'Ensemble Film']",1970,3
10497486,A-Lad-In His Lamp,1948,['United States of America'],"['Comedy', 'Family Film']",1940,8
11896870,A Lousy Ten Grand,2004,['United States of America'],"['Romantic comedy', 'Indie', 'Comedy']",2000,4
145631,Penny Serenade,1941,['United States of America'],"['Black-and-white', 'Romantic drama', 'Marriage Drama', 'Romance Film', 'Melodrama', 'Drama']",1940,1
3818454,Brannigan,1975,['United Kingdom'],"['Action', 'Crime Fiction', 'Mystery', 'Action Thrillers', 'Action/Adventure', 'Thriller', 'Crime Thriller', 'Suspense']",1970,5
8688768,Aradhana,1962,['India'],"['Musical', 'Romance Film', 'Drama']",1960,2
16186514,Fanny by Gaslight,1944,['United Kingdom'],['Black-and-white'],1940,4
1466817,Men with Brooms,2002,['Canada'],"['Romantic comedy', 'Sports', 'Comedy']",2000,2
32450888,Onnu Muthal Poojyam Vare,1986,[],['Drama'],1980,6
1124348,Taxi 3,2003,['France'],"['Action', 'Chase Movie', 'Buddy film', 'Comedy']",2000,3
7564146,Black Sheep,2006,"['Germany', 'New Zealand', 'Australia']","['Comedy', 'Horror', 'Black comedy', 'Zombie Film', 'Cult', 'Natural horror films']",2000,6
1754987,Girls! Girls! Girls!,1962,['United States of America'],"['Musical', 'Comedy', 'Romance Film', 'Romantic comedy']",1960,2
2058829,Clara's Heart,1988,['United States of America'],"['Film adaptation', 'Coming of age', 'Family Drama', 'Drama']",1980,8
14832630,SS,2008,['Japan'],"['Japanese Movies', 'Auto racing', 'Drama']",2000,8
8633398,Thru the Moebius Strip,2005,"['China', 'United States of America']","['Computer Animation', 'Animation', 'Adventure', 'Chinese Movies', 'Science Fiction', 'Family Film']",2000,5
5507511,The Brady Bunch in the White House,2002,['United States of America'],"['Political cinema', 'Political satire', 'Parody', 'Comedy', 'Domestic Comedy', 'Television movie', 'Comedy of Errors']",2000,2
30863940,Night of the Lepus,1972,['United States of America'],"['Thriller', 'Horror', 'B-movie', 'Science Fiction', 'Natural horror films']",1970,2
13100513,Calypso Cat,1962,['United States of America'],"['Animation', 'Short Film', 'Comedy', 'Family Film']",1960,2
30332098,Universal Soldiers,2007,['United States of America'],"['Action', 'Action/Adventure', 'Science Fiction', 'Thriller']",2000,7
10890335,Swami,1977,['India'],"['Bollywood', 'World cinema']",1970,7
22461941,Santa Baby 2,2009,"['Canada', 'United States of America']","['Television movie', 'Comedy', 'Family Film']",2000,9
18250955,Jubal,1956,['United States of America'],"['Action/Adventure', 'Western']",1950,6
24816891,Night Call Nurses,1972,['United States of America'],"['Romance Film', 'Comedy']",1970,2
3088107,Left Behind II: Tribulation Force,2002,"['Canada', 'United States of America']","['Film adaptation', 'Thriller', 'Christian film', 'Supernatural', 'Drama', 'Family Film', 'Fantasy']",2000,2
5969984,The Sixth Man,1997,['United States of America'],"['Sports', 'Comedy', 'Fantasy']",1990,7
15094763,King of Thieves,2004,"['Slovak Republic', 'Slovenia', 'France', 'Czech Republic', 'Austria', 'Belgium', 'Germany', 'Netherlands']","['Drama', 'World cinema']",2000,4
1852381,Il Mare,2000,['South Korea'],"['Romantic drama', 'World cinema', 'Romance Film', 'Drama', 'Fantasy']",2000,0
2124810,Dus,2005,['India'],"['Action', 'Action/Adventure', 'Thriller', 'Bollywood', 'World cinema']",2000,5
22276849,Come Play with Me,1968,['Italy'],"['Black-and-white', 'Drama']",1960,8
11350697,Sherlock Holmes and the Secret Weapon,1943,['United States of America'],"['Action', 'Spy', 'Film adaptation', 'Detective fiction', 'Black-and-white', 'Mystery', 'Thriller', 'Crime Thriller', 'Drama', 'Detective']",1940,3
4362903,Back Roads,1981,['United States of America'],"['Romantic drama', 'Comedy', 'Romance Film', 'Romantic comedy', 'Comedy-drama', 'Road movie', 'Drama']",1980,1
26022711,Tora-San Goes to Vienna,1989,['Japan'],"['Comedy', 'Japanese Movies']",1980,9
6878047,The Return,2006,['United States of America'],"['Psychological thriller', 'Supernatural', 'Thriller']",2000,6
3861537,Virgin Stripped Bare by Her Bachelors,2000,['South Korea'],"['Romantic drama', 'World cinema', 'Romance Film', 'Drama']",2000,0
6465674,Devdas,1953,['India'],"['Tollywood', 'Drama']",1950,3
6214495,Aap Ki Khatir,2006,['India'],"['Romantic drama', 'Bollywood', 'World cinema', 'Romance Film', 'Drama']",2000,6
5923472,Allari Pidugu,2005,['India'],"['Action', 'World cinema', 'Tollywood', 'Drama']",2000,5
25112887,Malayan,2009,['India'],['Drama'],2000,9
11625173,The Shining Hour,1938,['United States of America'],"['Black-and-white', 'Romantic drama', 'Marriage Drama', 'Melodrama', 'Drama']",1930,8
3859677,Wise Blood,1979,['United States of America'],"['Film adaptation', 'Drama', 'Crime Fiction', 'Indie', 'Comedy-drama', 'Tragicomedy']",1970,9
342692,Charlie's Angels,2000,"['Germany', 'United States of America']","['Action', 'Crime Fiction', 'Action/Adventure', 'Buddy film', 'Comedy', 'Martial Arts Film', 'Parody', 'Action Comedy']",2000,0
187616,The Final Countdown,1980,['United States of America'],"['Time travel', 'Action/Adventure', 'Adventure', 'War film', 'Science Fiction']",1980,0
946305,What About Bob?,1991,['United States of America'],['Comedy'],1990,1
27662471,Innocent Lies,1995,"['United Kingdom', 'France']","['Detective fiction', 'Crime Fiction', 'Mystery', 'Thriller', 'Crime Thriller', 'Drama', 'Period piece', 'Detective']",1990,5
27379728,The Strange Affair of Uncle Harry,1945,['United States of America'],"['Thriller', 'Film noir', 'Crime Drama', 'Drama']",1940,5
5305513,Critical Condition,1987,['United States of America'],"['Slapstick', 'Comedy']",1980,7
4294005,The Believers,1987,['United States of America'],"['Psychological thriller', 'Mystery', 'Slasher', 'Thriller', 'Horror']",1980,7
4941734,Geraldine's Fortune,2004,['Canada'],"['Drama', 'Comedy']",2000,4
4006045,The Ghoul,1933,['United Kingdom'],"['Film adaptation', 'Black-and-white', 'Horror', 'Drama']",1930,3
8308697,On Borrowed Time,1939,['United States of America'],"['Heaven-Can-Wait Fantasies', 'Drama', 'Fantasy']",1930,9
18144378,Anthimanthaarai,1996,['India'],['Drama'],1990,6
3720684,Murderers' Row,1966,['United States of America'],"['Action', 'Spy', 'Action/Adventure', 'Adventure', 'Glamorized Spy Film', 'Science Fiction']",1960,6
18156507,Unstoppable Marriage,2007,['South Korea'],"['Comedy', 'Comedy film']",2000,7
25972799,The Last Days of Pompeii,1960,"['Spain', 'Germany', 'Italy']","['Action', 'Action/Adventure', 'World cinema', 'Adventure', 'Drama', 'Fantasy']",1960,0
12931416,The Curse of the Faceless Man,1958,['United States of America'],"['Comedy', 'Horror', 'Science Fiction', 'Cult']",1950,8
4113991,Perfect Creature,2006,"['New Zealand', 'Australia']","['Horror', 'World cinema', 'Steampunk', 'Science Fiction']",2000,6
8950238,Case Closed: Jolly Rogers in the Deep Azure,2007,['Japan'],"['Japanese Movies', 'Mystery', 'Anime', 'Fantasy']",2000,7
10997623,The Swiss Conspiracy,1976,"['Germany', 'United States of America']","['Action', 'Crime Fiction', 'Thriller', 'World cinema', 'Crime Thriller', 'Drama']",1970,6
1546725,Returner,2002,['Japan'],"['Japanese Movies', 'Action/Adventure', 'Science Fiction', 'World cinema', 'Doomsday film', 'Alien Film']",2000,2
52055,Mars Needs Women,1967,['United States of America'],"['Science Fiction', 'Comedy', 'Television movie', 'Alien Film', 'Cult']",1960,7
10776188,Secret Rivals,1976,['Hong Kong'],"['Action', 'Drama']",1970,6
3459329,Lady Frankenstein,1971,['Italy'],"['Creature Film', 'Black-and-white', 'Monster', 'Horror', 'Costume Horror', 'Science Fiction']",1970,1
6909569,Piya Ka Ghar,1972,['India'],['Comedy'],1970,2
910628,Bob Roberts,1992,"['United Kingdom', 'United States of America']","['Political satire', 'Satire', 'Comedy', 'Mockumentary', 'Drama', 'Political cinema', 'Parody', 'Political drama']",1990,2
7238588,Unholy,2007,['United States of America'],"['Psychological thriller', 'Thriller', 'Horror', 'Science Fiction']",2000,7
13632911,Dastak,1970,['India'],"['Musical', 'Black-and-white', 'Romantic drama', 'Bollywood', 'World cinema', 'Romance Film', 'Drama']",1970,0
17759980,Otis,2008,['United States of America'],"['Slasher', 'Horror Comedy', 'Teen', 'Horror', 'Comedy', 'Cult']",2000,8
12224576,Street of Chance,1930,['United States of America'],"['Black-and-white', 'Crime Fiction', 'Drama']",1930,0
5052220,Krakatoa: The Last Days,2006,['United Kingdom'],['Drama'],2000,6
8775362,A Modern Twain Story: The Prince and the Pauper,2007,['United States of America'],"[""Children's"", 'Comedy', 'Family Film']",2000,7
9753596,Little Sister,1992,['United States of America'],['Comedy'],1990,2
15107077,The Helen Morgan Story,1957,['United States of America'],"['Musical', 'Black-and-white', 'Biography', 'Musical Drama', 'Biographical film', 'Romance Film', 'Drama', 'Biopic [feature]']",1950,7
2642623,Alila,2003,"['Israel', 'France']","['Ensemble Film', 'Drama', 'World cinema']",2000,3
4432823,Daibyonin,1993,['Japan'],['Japanese Movies'],1990,3
1826422,Richie Rich's Christmas Wish,1998,['United States of America'],"['Comedy', ""Children's/Family"", 'Holiday Film', 'Family Film']",1990,8
9395068,Wanted,2008,"['Germany', 'United States of America']","['Action', 'Fantasy Adventure', 'Crime Fiction', 'Action Thrillers', 'Action/Adventure', 'Thriller', 'Adventure', 'Superhero movie']",2000,8
25875068,"Tora-san, the Matchmaker",1979,['Japan'],['Japanese Movies'],1970,9
1755675,Old Yeller,1957,['United States of America'],"['Coming of age', 'Animal Picture', ""Children's/Family"", 'Drama', 'Family Film']",1950,7
10036225,Prophecies of Nostradamus,1974,['Japan'],"['Action', 'Japanese Movies', 'Disaster', 'Science Fiction']",1970,4
12695008,"Welcome Home, Roscoe Jenkins",2008,['United States of America'],"['Comedy', 'Comedy of manners', 'Domestic Comedy', 'Drama']",2000,8
24069301,One Thrilling Night,1942,['United States of America'],"['Crime Fiction', 'Mystery', 'Comedy film']",1940,2
17981954,Bart Got a Room,2008,['United States of America'],"['Coming of age', 'Indie', 'Comedy', 'Teen']",2000,8
3170435,The Boatniks,1970,['United States of America'],"['Crime Fiction', 'Slapstick', 'Comedy', 'Romance Film', 'Drama', 'Family Film']",1970,0
28475942,Squadron Leader X,1943,['United Kingdom'],"['War film', 'Drama']",1940,3
8808257,Alias Gardelito,1961,['Argentina'],"['Black-and-white', 'Crime Fiction', 'Drama']",1960,1
22902086,Dirt,1994,['China'],"['Chinese Movies', 'Drama']",1990,4
851800,Air America,1990,['United States of America'],"['Action', 'Action/Adventure', 'Comedy', 'Adventure', 'Period piece', 'Airplanes and airports', 'Action Comedy', 'War film']",1990,0
4648834,Pokémon: Spell Of The Unown,2001,"['Japan', 'United States of America']","['Animated cartoon', 'Animation', 'Action/Adventure', 'World cinema', ""Children's"", 'Japanese Movies', 'Anime', 'Family Film', 'Fantasy']",2000,1
20604092,Anbu Thozhi,2007,['India'],['Romance Film'],2000,7
7005188,Johnny Concho,1956,['United States of America'],"['Western', 'Drama']",1950,6
19747667,Dad for a Day,1939,['United States of America'],"['Short Film', 'Black-and-white', 'Comedy']",1930,9
859556,The Singing Detective,2003,"['United Kingdom', 'United States of America']","['Musical', 'Crime Fiction', 'Mystery', 'Indie', 'Comedy', 'Thriller', 'Film noir', 'Crime Thriller', 'Drama', 'Period piece']",2000,3
1456429,Main Hoon Na,2004,['India'],"['Action', 'Musical', 'Comedy', 'Thriller', 'Bollywood', 'World cinema', 'Romance Film', 'Drama', 'Coming of age']",2000,4
5012700,The White Balloon,1995,['Iran'],"['Childhood Drama', 'Family-Oriented Adventure', ""Children's/Family"", 'Drama', 'Family Film']",1990,5
2647998,The Human Tornado,1976,['United States of America'],"['Action', 'Blaxploitation', 'Martial Arts Film', 'Action Comedy', 'Action/Adventure', 'Comedy', 'Cult']",1970,6
6600698,Rainbow War,1985,['Canada'],"['Short Film', 'Comedy', 'Adventure', 'Science Fiction', 'Fantasy']",1980,5
4147240,"Goodbye, New York",1985,"['Israel', 'United States of America']","['Black comedy', 'Satire', 'Comedy']",1980,5
13998901,Roxy Hunter and the Secret of the Shaman,2008,['United States of America'],"['Adventure', 'Family Film']",2000,8
21193706,Samaya,1975,['India'],"['Musical', 'Drama']",1970,5
25397132,Ourselves Alone,1936,[],['Drama'],1930,6
667194,American Gigolo,1980,['United States of America'],"['Crime Fiction', 'Erotic Drama', 'Thriller', 'Romance Film', 'Drama', 'New Hollywood', 'Erotic thriller', 'Crime Drama', 'Erotica']",1980,0
11644655,Raja Bersiong,1968,['Malaysia'],"['Drama', 'Horror']",1960,8
2253773,Inside the Walls of Folsom Prison,1951,['United States of America'],"['Prison', 'Drama']",1950,1
1267018,Mean Machine,2001,"['United Kingdom', 'United States of America']","['Prison', 'Comedy', 'Sports', 'Drama']",2000,1
4034973,Deathstalker and the Warriors from Hell,1988,"['Mexico', 'United States of America']","['Fantasy', 'Adventure', 'Sword and sorcery']",1980,8
19502541,"Merry Christmas, Drake & Josh",2008,['United States of America'],"['Comedy', 'Television movie', ""Children's/Family"", 'Holiday Film']",2000,8
16347901,Chaindance,1991,['Canada'],['Drama'],1990,1
5983350,Conquering Power,1921,['United States of America'],"['Silent film', 'Black-and-white', 'Indie']",1920,1
6809394,Periyanna,1999,['India'],['Drama'],1990,9
5456952,My Second Brother,1959,['Japan'],"['Japanese Movies', 'Drama']",1950,9
7731039,I Love You,1979,['India'],"['Romance Film', 'Drama']",1970,9
3273263,Return to Paradise,1998,['United States of America'],"['Suspense', 'Crime Fiction', 'Thriller', 'Romance Film', 'Crime Thriller', 'Political drama', 'Drama']",1990,8
26179719,Escape,1948,"['United Kingdom', 'United States of America']",['Thriller'],1940,8
4485137,Larger Than Life,1996,['United States of America'],"['Comedy', 'Family Film', 'Adventure']",1990,6
8993730,Big Boss,1995,['India'],"['Action/Adventure', 'World cinema']",1990,5
748923,Kids Return,1996,['Japan'],"['Japanese Movies', 'Coming of age', 'Teen', 'World cinema', 'Crime Drama', 'Comedy-drama', 'Drama']",1990,6
1198018,Rules of Engagement,2000,"['Canada', 'United Kingdom', 'Germany', 'United States of America']","['Action', 'Drama', 'Thriller', 'War film', 'Courtroom Drama']",2000,0
15173081,Purple Heart,2006,['United States of America'],"['Action', 'Drama', 'Action/Adventure', 'Thriller']",2000,6
25685825,Out of Sight,1966,['United States of America'],['Spy'],1960,6
9032648,The Drum,1938,['United Kingdom'],"['British Empire Film', 'War film', 'Adventure']",1930,8
17228730,The Loneliness of the Long Distance Runner,1962,['United Kingdom'],"['Film adaptation', 'British New Wave', 'Kitchen sink realism', 'Drama']",1960,2
8852763,The Vengeance of Fu Manchu,1967,"['Hong Kong', 'United Kingdom', 'Ireland', 'West Germany']","['Action', 'Drama', 'Horror', 'Crime']",1960,7
9205349,Hob wa Dumoo`,1955,['Egypt'],"['Romance Film', 'Drama']",1950,5
7277626,El Retorno del Hombre Lobo,1980,['Spain'],"['Zombie Film', 'World cinema', 'Horror']",1980,0
163894,Heavenly Creatures,1994,"['Australia', 'United Kingdom', 'Germany', 'New Zealand']","['LGBT', 'Crime Fiction', 'Indie', 'World cinema', 'Drama', 'Period piece', 'Gay Themed', 'Gay', 'Coming of age', 'Gay Interest', 'Crime Drama', 'Cult', 'Fantasy']",1990,4
15311074,Hounds of Notre Dame,1980,['Canada'],['Drama'],1980,0
14030436,BloodRayne II: Deliverance,2007,"['Germany', 'United States of America', 'Canada']","['Action', 'Western', 'Science fiction Western', 'Horror', 'Fantasy']",2000,7
16393302,Death's Requiem,2007,['Australia'],"['Short Film', 'Drama', 'Horror']",2000,7
27100903,Killer Flood: The Day the Dam Broke,2003,['United States of America'],"['Action', 'Drama', 'Action/Adventure', 'Television movie', 'Disaster']",2000,3
16833930,The Most Distant Course,2007,['Taiwan'],"['Romantic drama', 'World cinema', 'Romance Film', 'Drama']",2000,7
21138997,Ore wa matteru ze,1957,['Japan'],"['Black-and-white', 'Crime Fiction', 'Japanese Movies', 'Thriller', 'World cinema', 'Crime Thriller', 'Drama']",1950,7
23995219,Affairs of Cappy Ricks,1937,['United States of America'],"['Drama', 'Comedy film']",1930,7
10404370,Slap Her... She's French,2002,"['United Kingdom', 'Germany', 'United States of America']","['Romance Film', 'Comedy film']",2000,2
28133007,Romance on the Orient Express,1985,[],"['Romance Film', 'Drama']",1980,5
1126992,I'm Not Scared,2003,"['United Kingdom', 'Spain', 'Italy']","['Psychological thriller', 'Crime Fiction', 'Mystery', 'Thriller', 'Childhood Drama', 'World cinema', 'Drama']",2000,3
5451497,Strange Wilderness,2008,['United States of America'],"['Adventure Comedy', 'Stoner film', 'Comedy', 'Adventure']",2000,8
5906203,Seasons of the Heart,1993,['United States of America'],"['Period piece', 'Family Drama', 'Christian film', 'Drama', 'Family Film']",1990,3
1767696,Extreme Battle!! The Three Great Super Saiyans,1992,['Japan'],['Japanese Movies'],1990,2
11564856,Jake Speed,1986,['United States of America'],"['Adventure Comedy', 'Action', 'Action/Adventure', 'Comedy', 'Thriller', 'Adventure']",1980,6
14895549,Dark Horse,1992,['United States of America'],['Drama'],1990,2
14092400,Last Train from Gun Hill,1959,['United States of America'],"['Action/Adventure', 'Western']",1950,9
12620385,Spivs,2004,['United Kingdom'],"['Heist', 'Crime Fiction', 'Comedy', 'Crime Thriller', 'Drama']",2000,4
14437776,All the World's a Stooge,1941,['United States of America'],"['Black-and-white', 'Screwball comedy', 'Short Film', 'Comedy', 'Comedy of Errors']",1940,1
67442,Exit Wounds,2001,"['United States of America', 'Australia']","['Action', 'Crime Fiction', 'Mystery', 'Action/Adventure', 'Thriller', 'Martial Arts Film']",2000,1
939561,Suspect Zero,2004,['United States of America'],"['Psychological thriller', 'Mystery', 'Slasher', 'Thriller', 'Crime Thriller', 'Supernatural']",2000,4
14143807,The Desert Hawk,1944,['United States of America'],"['Adventure', 'Black-and-white']",1940,4
8430685,Flesh and Fantasy,1943,['United States of America'],"['Drama', 'Fantasy']",1940,3
13869989,"Rich, Young and Pretty",1951,['United States of America'],"['Musical', 'Romance Film']",1950,1
6480357,Alice's spooky adventure,1924,['United States of America'],"['Animation', 'Indie', 'Short Film', 'Comedy', 'Silent film']",1920,4
30136288,Return of the Lucky Stars,1989,['Hong Kong'],"['Chinese Movies', 'Comedy']",1980,9
5208126,Vivah,2006,['India'],"['Musical', 'Romantic drama', 'World cinema', 'Romance Film', 'Drama', 'Family Film']",2000,6
31913252,Professional Soldier,1935,[],['Adventure'],1930,5
34187456,Operazione Goldman,1965,[],"['Science Fiction', 'Adventure']",1960,5
692670,Dead Presidents,1995,['United States of America'],"['Action', 'Crime Fiction', 'Thriller', 'Adventure', 'Drama', 'Period piece', 'Heist', 'Crime Drama', 'War film']",1990,5
27548546,Panikos sta scholeia,1981,['Greece'],"['Action', 'Crime Fiction', 'Drama']",1980,1
61182,The Broadway Melody,1929,['United States of America'],"['Musical', 'Backstage Musical', 'Romance Film', 'Pre-Code', 'Drama']",1920,9
3831834,The Freshman,1990,['United States of America'],"['Crime Fiction', 'Gangster Film', 'Parody', 'Comedy']",1990,0
26695603,Kottayam Kunjachan,1990,['India'],"['Action', 'Drama']",1990,0
76307,Road to Morocco,1942,['United States of America'],"['Action', 'Musical', 'Black-and-white', 'Screwball comedy', 'Action/Adventure', 'Buddy film', 'Comedy']",1940,2
16793507,Blondie Johnson,1933,['United States of America'],"['Black-and-white', 'Crime Fiction', 'Drama']",1930,3
22808535,Great World of Sound,2007,['United States of America'],['Comedy film'],2000,7
5835745,Say It Isn't So,2001,['United States of America'],"['Gross out', 'Gross-out film', 'Slapstick', 'Comedy', 'Romance Film', 'Romantic comedy', 'Comedy of Errors']",2000,1
24549492,The Hills Run Red,2009,['United States of America'],"['Thriller', 'Horror']",2000,9
11470887,Sınav,2006,['Turkey'],"['Crime Fiction', 'Action Comedy', 'Caper story', 'Comedy', 'Drama']",2000,6
26624753,Kanmazha Peyyum Munpe,2009,['India'],['Romance Film'],2000,9
15833916,Unborn But Forgotten,2002,['South Korea'],"['Mystery', 'World cinema', 'Horror']",2000,2
730819,Soldier,1998,"['United Kingdom', 'United States of America']","['Action', 'Dystopia', 'Action/Adventure', 'Adventure', 'Science Fiction']",1990,8
30500916,Primary Suspect,2000,['United States of America'],['Action'],2000,0
12675477,Dhamaal,2007,['India'],['Comedy'],2000,7
3550323,Things to Do in Denver When You're Dead,1995,['United States of America'],"['Suspense', 'Crime Fiction', 'Gangster Film', 'Comedy', 'Thriller', 'Crime Comedy', 'Crime Thriller']",1990,5
13293808,Aashiq Hoon Baharon Ka,1977,['India'],['Romance Film'],1970,7
20327613,Barbarian Queen II: The Empress Strikes Back,1989,"['Mexico', 'United States of America']","['Action/Adventure', 'Fantasy']",1980,9
8576453,Bremenskie muzykanty,1969,['Soviet Union'],"['Animated cartoon', 'Short Film', 'Musical comedy']",1960,9
909947,Casualties of Love: The Long Island Lolita Story,1993,['United States of America'],"['Romance Film', 'Crime Fiction', 'Drama']",1990,3
31508047,Infidelity,1987,['United States of America'],"['Romance Film', 'Drama']",1980,7
10776050,Born Invincible,1978,['Hong Kong'],"['Action', 'Action/Adventure', 'World cinema', 'Chinese Movies', 'Martial Arts Film']",1970,8
17436123,Dhokha,2007,['India'],"['Musical', 'Bollywood', 'World cinema', 'Drama']",2000,7
1731662,Vamp,1986,['United States of America'],"['Comedy', 'Horror Comedy', 'Horror', 'Black comedy', 'Albino bias']",1980,6
5828821,The Gendarme in New York,1965,"['France', 'Italy', 'United States of America']",['Comedy'],1960,5
33628294,Body Armour,2007,"['Spain', 'Australia', 'United Kingdom', 'Germany', 'United States of America']","['Action', 'Action/Adventure', 'Thriller', 'Crime Thriller']",2000,7
3038177,Bluffmaster,2005,['India'],"['Musical', 'Crime Fiction', 'Romantic drama', 'Comedy', 'Bollywood', 'World cinema', 'Romance Film', 'Drama', 'Romantic comedy']",2000,5
4860193,Minnesota Cuke and the Search for Samson's Hairbrush,2005,['United States of America'],"['Musical', 'Animation', ""Children's""]",2000,5
6967795,Esther... The Girl Who Became Queen,2000,['United States of America'],"['Musical', 'Animation', 'Short Film', ""Children's""]",2000,0
10624500,Party,1995,['United States of America'],"['Indie', 'Short Film', 'Comedy']",1990,5
12615952,Wild Side,2004,"['United Kingdom', 'France', 'Belgium']","['LGBT', 'Erotic Drama', 'Romantic drama', 'World cinema', 'Romance Film', 'Drama', 'Gay Themed', 'Gay', 'Gay Interest']",2000,4
26859059,He Snoops to Conquer,1944,['United Kingdom'],['Comedy'],1940,4
20622279,Memsahab,2008,['India'],['Drama'],2000,8
14574346,Circus Angel,1965,['France'],"['Black-and-white', 'Comedy', ""Children's"", 'Fantasy']",1960,5
13331154,Sebastian,1968,['United Kingdom'],"['Romance Film', 'Drama']",1960,8
27484718,Jaanam,1992,['India'],['Romance Film'],1990,2
11143220,Manmatha Leelai,1976,['India'],"['Musical', 'Comedy', 'Bollywood', 'Romance Film']",1970,6
2370658,Southern Comfort,1981,"['United Kingdom', 'Switzerland', 'United States of America']","['Action', 'Drama', 'Indie', 'Action/Adventure', 'Thriller']",1980,1
338869,The Emperor's New Groove,2000,['United States of America'],"['Animation', 'Animated Musical', 'Comedy', ""Children's/Family"", 'Adventure', ""Children's Fantasy"", 'Family Film', 'Fantasy']",2000,0
3676087,A Yank at Oxford,1938,['United Kingdom'],"['Black-and-white', 'Comedy', 'Comedy-drama', 'Drama']",1930,8
19947800,Timestalkers,1987,['United States of America'],"['Action', 'Film adaptation', 'Drama', 'Adventure', 'Television movie', 'Science Fiction']",1980,7
9405704,Taj Mahal,1999,['India'],['Romance Film'],1990,9
8056967,Madhoshi,2004,['India'],"['Romantic drama', 'World cinema', 'Romance Film', 'Drama']",2000,4
12979849,Privilege,1967,['United Kingdom'],"['Musical', 'Satire', 'Comedy', 'Political drama', 'Science Fiction', 'Drama']",1960,7
25788981,Sombras de gloria,1930,[],['War film'],1930,0
10394093,Misleading Lady,1932,['United States of America'],"['Comedy', 'Black-and-white']",1930,2
5841657,Bhagam Bhag,2006,['India'],"['Romantic drama', 'Comedy', 'Thriller', 'World cinema', 'Romance Film', 'Romantic comedy', 'Drama']",2000,6
12101704,Domingo de carnaval,1945,['Spain'],"['Black-and-white', 'Crime Fiction']",1940,5
8312012,Labu Dan Labi,1962,"['Singapore', 'Malaysia']","['Musical', 'Black-and-white', 'Comedy']",1960,2
4647498,Aberration,1997,"['New Zealand', 'Australia']","['Science Fiction', 'World cinema', 'Horror']",1990,7
6733074,Guys and Dolls,1955,['United States of America'],"['Musical', 'Gangster Film', 'Comedy', 'Musical comedy', 'Romance Film']",1950,5
22810256,The Time That Remains,2009,"['Belgium', 'United Kingdom', 'France', 'Israel', 'Italy']","['History', 'World cinema', 'Black comedy', 'Comedy-drama', 'Political drama', 'Drama']",2000,9
6904082,Yahudi,1958,['India'],"['Musical', 'Bollywood', 'World cinema', 'Drama']",1950,8
2049045,Mr. Arkadin,1955,"['France', 'Spain', 'Switzerland']","['Psychological thriller', 'Spy', 'Crime Fiction', 'Mystery', 'Thriller', 'Film noir', 'Drama', 'Epic']",1950,5
18510113,Faces of Children,1925,['France'],"['Black-and-white', 'World cinema', 'Silent film', 'Drama']",1920,5
1822067,The Fugitive,1993,['United States of America'],"['Action', 'Crime Fiction', 'Mystery', 'Thriller', 'Adventure', 'Drama']",1990,3
1029262,The Man in the White Suit,1951,"['United Kingdom', 'United States of America']","['Ealing Comedies', 'Film adaptation', 'Parody', 'Satire', 'Comedy', 'Drama']",1950,1
2017211,Bolt,2008,['United States of America'],"['Computer Animation', 'Animation', 'Comedy', 'Adventure', 'Family Film', 'Fantasy']",2000,8
10644609,Me and the Colonel,1958,['United States of America'],"['Black-and-white', 'War film', 'Comedy']",1950,8
28855797,Callan,1974,['United Kingdom'],['Thriller'],1970,4
2534051,"Good Men, Good Women",1995,"['Taiwan', 'China', 'Japan']","['Japanese Movies', 'Family Drama', 'Thriller', 'World cinema', 'Chinese Movies', 'Political drama', 'Drama']",1990,5
24133684,Cowboy Holiday,1934,['United States of America'],"['Action', 'B-Western', 'Action/Adventure', 'Western', 'Comedy film', 'Romance Film', 'Drama']",1930,4
11669853,Above Suspicion,1943,['United States of America'],"['Black-and-white', 'Drama']",1940,3
24931095,Ezhai Padum Padu,1950,['India'],['Drama'],1950,0
161974,A Shock to the System,1990,['United States of America'],"['Comedy Thriller', 'Thriller', 'Satire', 'Comedy', 'Black comedy', 'Comedy-drama', 'Crime Thriller']",1990,0
24109010,Coming Home,1998,"['United Kingdom', 'Germany']","['Romance Film', 'War film', 'Drama']",1990,8
28271896,The Net,1953,['United Kingdom'],['Drama'],1950,3
277148,My Best Friend's Wedding,1997,['United States of America'],"['Screwball comedy', 'Comedy', 'Comedy of manners', 'Romance Film', 'Romantic comedy']",1990,7
12789158,Lonely Street,2009,['United States of America'],"['Action', 'Detective fiction', 'Crime Fiction', 'Indie', 'Action/Adventure', 'Comedy', 'Thriller', 'Drama', 'Detective']",2000,9
22751516,The Frozen Limits,1939,['United Kingdom'],"['Slapstick', 'Comedy']",1930,9
25960460,Daddy and Them,2001,"['Netherlands', 'United States of America']","['Black comedy', 'Comedy']",2000,1
5125735,Haeckel's Tale,2006,[],"['Television movie', 'Cult', 'Horror']",2000,6
1254263,Shivers,1975,['Canada'],"['Psychological thriller', 'Indie', 'Satire', 'Sci-Fi Horror', 'Horror', 'Erotica', 'Science Fiction', 'Cult']",1970,5
298566,Perfect Blue,1997,['Japan'],"['Psychological thriller', 'Animation', 'Mystery', 'Thriller', 'World cinema', 'Crime Thriller', 'Drama', 'Japanese Movies', 'Anime']",1990,7
2159349,Mom's Got a Date With a Vampire,2000,['United States of America'],"['Comedy', ""Children's/Family"", 'Family Film', 'Fantasy']",2000,0
8637935,Tutto l'amore che c'è,2000,['Italy'],['Drama'],2000,0
24143924,Uno,2004,['Norway'],"['Drama', 'World cinema']",2000,4
14205601,"Ready, Woolen and Able",1960,['United States of America'],"['Animation', 'Short Film', 'Comedy', 'Family Film']",1960,0
12745510,The Princess Academy,1987,"['France', 'Yugoslavia', 'United States of America']","['Indie', 'Comedy']",1980,7
18139826,Boeing Boeing,1985,['India'],['Comedy film'],1980,5
9658561,Mosaic,2007,['United States of America'],"['Superhero movie', 'Animation']",2000,7
18849278,Iru Sahodarargal,1936,['India'],"['Family Drama', 'Drama']",1930,6
3143693,Nora's Hair Salon,2004,['United States of America'],"['Drama', 'Indie', 'Comedy', 'Comedy-drama', 'Workplace Comedy', 'Ensemble Film']",2000,4
3191002,The Ambulance,1990,['United States of America'],"['Psychological thriller', 'Thriller']",1990,0
19700783,She's 19 and Ready,1979,"['Germany', 'West Germany']","['Romantic drama', 'Comedy', 'World cinema', 'Romance Film', 'Romantic comedy', 'Drama']",1970,9
3523874,The Mummy's Curse,1944,['United States of America'],"['Creature Film', 'Monster movie', 'Horror']",1940,4
19411089,The Awful Tooth,1938,['United States of America'],"['Black-and-white', 'Short Film', 'Comedy', 'Family Film']",1930,8
2298338,Welcome to the Dollhouse,1995,['United States of America'],"['Drama', 'Coming of age', 'Indie', 'Comedy', 'Black comedy', 'Domestic Comedy', 'Cult']",1990,5
1273586,The Tales of Hoffmann,1951,['United Kingdom'],"['Musical', 'Film-Opera', 'Dance', 'Romance Film', 'Fantasy']",1950,1
9854621,Cake: A Wedding Story,2007,['United States of America'],"['Indie', 'Comedy', 'Romance Film', 'Romantic comedy']",2000,7
17182535,Intimate Confessions Of A Chinese Courtesan,1972,['Hong Kong'],"['Action', 'World cinema', 'Erotica', 'Chinese Movies', 'Martial Arts Film', 'Drama']",1970,2
3478537,Jodhaa Akbar,2008,['India'],"['Action', 'Musical', 'Romantic drama', 'Biographical film', 'Bollywood', 'World cinema', 'Romance Film', 'Drama', 'Adventure', 'Historical fiction']",2000,8
2833573,Fear of the Dark,2002,['United States of America'],"['Psychological thriller', 'Mystery', 'Indie', 'Thriller', 'Teen', 'Drama', 'Tragedy', 'Horror', 'Supernatural']",2000,2
23037955,Absolutely Secret: Girl Torture,1968,['Japan'],"['Erotica', 'Japanese Movies', 'Pornographic movie']",1960,8
14302403,Dadnapped,2008,"['Canada', 'United States of America']","['Action', ""Children's"", 'Comedy', 'Teen', 'Television movie', 'Adventure', 'Family Film']",2000,8
8693812,Chutney Popcorn,2000,['United States of America'],"['LGBT', 'Family Drama', 'Indie', 'Romantic drama', 'Comedy', 'Romance Film', 'Drama', 'Gay Themed', 'Gay', 'Gay Interest', 'Comedy-drama', 'Comedy of manners', 'Ensemble Film']",2000,0
26735714,People Are Funny,1946,['United States of America'],"['Musical', 'Comedy']",1940,6
31668021,Amma,1952,[],['Drama'],1950,2
19522049,Nana,2005,['Japan'],"['Japanese Movies', 'Drama', 'World cinema']",2000,5
13198008,The Man from Snowy River: Arena Spectacular,2003,['Australia'],"['Musical', 'Western', 'Romance Film', 'Comedy-drama']",2000,3
29900532,The Guns of Fort Petticoat,1957,['United States of America'],"['Action', 'Western']",1950,7
3736525,The Half-Naked Truth,1932,['United States of America'],"['Parody', 'Comedy', 'Media Satire', 'Romance Film']",1930,2
8417343,Going Greek,2001,['United States of America'],"['Gross out', 'Gross-out film', 'Coming of age', 'Indie', 'Comedy', 'Comedy of manners']",2000,1
5667692,The Dancer Upstairs,2002,"['Spain', 'United States of America']","['Film adaptation', 'Crime Fiction', 'Indie', 'Romantic drama', 'Thriller', 'Romance Film', 'Drama', 'Suspense', 'Political drama', 'Political thriller']",2000,2
12305754,The Adventures of Tartu,1943,['United Kingdom'],"['Spy', 'Black-and-white']",1940,3
154684,Sitting Pretty,1948,['United States of America'],['Comedy'],1940,8
27611605,Man in the Moon,1960,['United Kingdom'],"['Comedy', 'Satire']",1960,0
5601344,Ancient Evil: Scream of the Mummy,2000,['United States of America'],"['Creature Film', 'Monster movie', 'Teen', 'Horror', 'B-movie']",2000,0
35755831,Duniya,1984,['India'],[],1980,4
27947072,Sh'Chur,1994,['Israel'],['Drama'],1990,4
11151781,Swarg Narak,1978,['India'],"['Musical', 'Bollywood', 'World cinema', 'Drama']",1970,8
18033447,The Beautiful Blonde from Bashful Bend,1949,['United States of America'],"['Comedy Western', 'Action/Adventure', 'Western', 'Comedy', 'Romance Film', 'Romantic comedy']",1940,9
1357504,Igby Goes Down,2002,['United States of America'],"['Drama', 'Indie', 'Coming of age', 'Comedy', 'Comedy of manners', 'Black comedy', 'Comedy-drama']",2000,2
5035585,At Land,1944,['United States of America'],"['Surrealism', 'Black-and-white', 'Short Film', 'Avant-garde', 'Experimental film', 'Silent film']",1940,4
10599593,Aan Milo Sajna,1970,['India'],"['Musical', 'World cinema', 'Drama', 'Family Film']",1970,0
7583011,Incubus,2006,"['United Kingdom', 'Romania']","['Mystery', 'Slasher', 'Thriller', 'Horror']",2000,6
23995373,Ghost Patrol,1936,['United States of America'],"['Western', 'Black-and-white', 'Action/Adventure']",1930,6
981105,State of Grace,1990,"['United Kingdom', 'United States of America']","['Crime Fiction', 'Gangster Film', 'Thriller', 'Crime Thriller', 'Drama']",1990,0
14730870,Twenty:20,2008,['India'],"['Action', 'Drama', 'Crime Fiction', 'Mystery', 'Thriller']",2000,8
26120493,A Sight for Sore Eyes,2005,['United States of America'],"['Short Film', 'Drama']",2000,5
2028217,Inland Empire,2006,"['France', 'Poland', 'United States of America']","['Surrealism', 'Psychological thriller', 'Mystery', 'Indie', 'Avant-garde', 'Thriller', 'Drama', 'Horror', 'Experimental film', 'Ensemble Film']",2000,6
8057560,Hilda Crane,1956,['United States of America'],"['Romance Film', 'Romantic drama', 'Drama']",1950,6
5051407,Virumandi,2004,['India'],"['Action/Adventure', 'Drama', 'World cinema']",2000,4
3371045,Army Daze,1996,['Singapore'],"['Comedy', 'LGBT']",1990,6
19849373,Baby Sister,1983,['United States of America'],"['Romance Film', 'Melodrama', 'Drama']",1980,3
9673169,Green Grass of Wyoming,1948,['United States of America'],"['Western', 'Animal Picture', 'Romance Film', 'Drama']",1940,8
5289480,Docks of New York,1945,['United States of America'],['Comedy film'],1940,5
1381639,Private's Progress,1956,['United Kingdom'],['Comedy'],1950,6
2832604,The Desert Fox: The Story of Rommel,1951,['United States of America'],"['Action', 'Black-and-white', 'Biography', 'Action/Adventure', 'Biographical film', 'War film', 'Drama']",1950,1
9034031,Hathkadi,1995,['India'],"['Action', 'Crime Thriller']",1990,5
14166634,Press for Time,1966,['United Kingdom'],"['Screwball comedy', 'Comedy', 'Comedy of Errors']",1960,6
8407902,Devil May Hare,1954,['United States of America'],"['Animation', 'Short Film', 'Family Film']",1950,4
7733654,Night Warning,1983,['United States of America'],"['Slasher', 'Gothic Film', 'Horror']",1980,3
13377238,Dreamkeeper,2003,"['Germany', 'United States of America', 'Canada']","['Family-Oriented Adventure', 'Road movie', 'Drama']",2000,3
146709,Darby O'Gill and the Little People,1959,['United States of America'],"['Adventure', 'Drama', 'Family Film', 'Fantasy']",1950,9
726161,The Jungle Book,1994,['United States of America'],"['Adventure', 'Family Film']",1990,4
2192765,Eye for an Eye,1996,['United States of America'],"['Psychological thriller', 'Film adaptation', 'Crime Fiction', 'Thriller', 'Crime Thriller', 'Drama']",1990,6
2464201,Chronicle of a Disappearance,1997,"['Israel', 'France', 'Germany', 'Mandatory Palestine', 'United States of America']","['Political drama', 'Drama', 'World cinema']",1990,7
8159372,The Last Sunset,1961,['United States of America'],"['Action', 'Short Film', 'Western', 'Action/Adventure']",1960,1
9509953,Slaughter Studios,2002,['United States of America'],"['Slasher', 'Comedy', 'Horror']",2000,2
7166853,The Witch Affair,2003,['Spain'],"['Psychological thriller', 'Mystery', 'Thriller', 'Horror', 'World cinema', 'Drama']",2000,3
1397142,Key Largo,1948,['United States of America'],"['Black-and-white', 'Crime Fiction', 'Gangster Film', 'Thriller', 'Film noir', 'Crime Thriller', 'Drama']",1940,8
7626259,Passion of Mind,2000,['United States of America'],"['Mystery', 'Indie', 'Romantic drama', 'Romance Film', 'Drama']",2000,0
12636214,Eyewitness,1981,['United States of America'],"['Crime Fiction', 'Mystery', 'Thriller', 'Crime Thriller']",1980,1
26378027,How to Meet the Lucky Stars,1996,['Hong Kong'],['Chinese Movies'],1990,6
375183,Enemy at the Gates,2001,"['United Kingdom', 'Germany', 'Ireland', 'United States of America']","['Combat Films', 'Action', 'Thriller', 'Romance Film', 'Drama', 'Period piece', 'Suspense', 'Historical fiction', 'War film']",2000,1
54160,Leaving Las Vegas,1995,"['United Kingdom', 'France', 'United States of America']","['Film adaptation', 'Romantic drama', 'Indie', 'World cinema', 'Romance Film', 'Addiction Drama', 'Drama', 'Tragedy', 'Erotica']",1990,5
12569818,Khwahish,2003,['India'],"['Romantic drama', 'World cinema', 'Romance Film', 'Drama']",2000,3
17437489,American Heart,1992,['United States of America'],"['Indie', 'Family Drama', 'Drama']",1990,2
10873994,Mano Po III: My Love,2004,['Philippines'],"['Filipino Movies', 'Drama', 'World cinema']",2000,4
11481753,Sri,2005,['India'],['Action'],2000,5
3723140,Army of Shadows,1969,"['France', 'Italy']","['War film', 'Drama']",1960,9
13254862,The Vagrant,1992,['United States of America'],"['Mystery', 'Indie', 'Comedy', 'Thriller', 'Horror', 'Black comedy']",1990,2
6665962,Gypsy,1962,['United States of America'],"['Musical', 'Biographical film', 'Comedy', 'Comedy-drama', 'Drama']",1960,2
1407389,Bastard Out of Carolina,1996,['United States of America'],"['Film adaptation', 'Family Drama', 'Television movie', 'Drama']",1990,6
18962686,It's Nice to Have a Mouse Around the House,1965,['United States of America'],"['Animation', 'Short Film', 'Family Film']",1960,5
5969295,Time and Tide,2000,['Hong Kong'],"['Action', 'Action/Adventure', 'Thriller', 'World cinema', 'Chinese Movies', 'Martial Arts Film']",2000,0
33323507,Big Bullet,1996,['Hong Kong'],"['Action', 'Crime Fiction', 'Action/Adventure', 'World cinema', 'Crime Thriller', 'Chinese Movies', 'Martial Arts Film']",1990,6
24505170,Claire Dolan,1998,"['United States of America', 'France']","['Adult', 'Indie', 'Drama']",1990,8
13807049,Shoot On Sight,2008,['United Kingdom'],"['Mystery', 'Crime Fiction', 'Thriller', 'Crime Thriller', 'Drama']",2000,8
13166704,Camping del terrore,1997,"['Italy', 'United States of America']","['Giallo', 'Slasher', 'Horror']",1990,7
8451541,Adiós problemas,1955,"['Argentina', 'Spain']","['Romance Film', 'Black-and-white']",1950,5
919477,Dinosaur,2000,['United States of America'],"['Computer Animation', 'Animation', 'Thriller', 'Costume drama', 'Fantasy', 'Adventure', 'Family Film']",2000,0
5306078,Chori Chori,2003,['India'],"['Musical', 'Romantic drama', 'Comedy', 'Bollywood', 'World cinema', 'Romance Film', 'Drama', 'Romantic comedy']",2000,3
33041730,The Dingo,1923,[],['Silent film'],1920,3
3531556,Wife vs. Secretary,1936,['United States of America'],"['Black-and-white', 'Screwball comedy', 'Comedy', 'Comedy of manners', 'Romance Film', 'Romantic comedy', 'Comedy of Errors']",1930,6
14841680,Five Marines,1961,['South Korea'],['War film'],1960,1
10241580,Get to Know Your Rabbit,1972,['United States of America'],"['Comedy', 'Satire']",1970,2
27408296,Tahmina,1993,['Azerbaijan'],['Drama'],1990,3
20175156,Why the Cuckoo Cries,1967,['South Korea'],"['Drama', 'Horror']",1960,7
27369778,High Noon part II: The Return of Will Kane,1980,['United States of America'],"['Western', 'Television movie', 'Action/Adventure']",1980,0
32254946,Ek Tho Chance,2009,['India'],"['Thriller', 'Drama']",2000,9
1297472,Vera Drake,2004,['United Kingdom'],"['Period piece', 'Social problem film', 'Drama']",2000,4
3091469,G.I. Joe: The Movie,1987,"['Japan', 'United States of America']","['Action', 'Animation', 'Japanese Movies', 'Family Film', ""Children's Entertainment""]",1980,7
4028951,Trapped in a Purple Haze,2000,['United States of America'],"['Crime Fiction', 'Television movie', 'Sports', 'Drama']",2000,0
18974432,Lady in a Cage,1964,['United States of America'],"['Psychological thriller', 'Psycho-biddy', 'Thriller', 'Crime Thriller']",1960,4
2330126,Bionicle 2: Legends of Metru Nui,2004,['United States of America'],"['Fantasy Adventure', 'Animation', ""Children's/Family"", 'Adventure', 'Computer Animation', ""Children's Fantasy"", 'Science Fiction', 'Family Film', 'Fantasy']",2000,4
31231394,Fighting Man of the Plains,1949,['United States of America'],"['Action', 'Romance Film', 'Western']",1940,9
789978,A Summer Dress,1996,['France'],['Short Film'],1990,6
11791510,Il Camorrista,1986,['Italy'],"['Crime Fiction', 'Gangster Film', 'Crime Drama', 'Drama']",1980,6
9358924,Dr. Strange,1978,['United States of America'],"['Superhero', 'Horror', 'Superhero movie', 'Drama', 'Fantasy']",1970,8
25455416,In the high attention area,1977,['Soviet Union'],['Action'],1970,7
1710927,Pervirella,1997,['United Kingdom'],"['Sexploitation', 'Parody', 'Comedy', 'Comedy film', 'Fantasy', 'Adventure', 'Sex comedy']",1990,7
10459622,The Squeeze,1987,['United States of America'],"['Comedy', 'Thriller']",1980,7
14415654,Waterland,1992,"['United Kingdom', 'United States of America']","['Psychological thriller', 'Film adaptation', 'Drama', 'Indie']",1990,2
12594455,Rosebud,1975,['United States of America'],"['Action', 'Adventure', 'Thriller']",1970,5
3461278,City Heat,1984,['United States of America'],"['Action', 'Crime Fiction', 'Gangster Film', 'Mystery', 'Action/Adventure', 'Comedy', 'Thriller', 'Buddy film', 'Crime Thriller', 'Detective']",1980,4
2967520,Stick,1985,['United States of America'],"['Action', 'Drama', 'Crime Fiction', 'Action/Adventure', 'Albino bias']",1980,5
4949692,Désirée,1954,['United States of America'],"['Drama', 'Biographical film']",1950,4
842825,The Iron Giant,1999,['United States of America'],"['Action', 'Animation', ""Children's/Family"", 'Adventure', ""Children's Fantasy"", 'Science Fiction', 'Family Film', 'Fantasy']",1990,9
4939826,Zona Zamfirova,2002,['Federal Republic of Yugoslavia'],"['Romantic drama', 'Comedy', 'Comedy-drama', 'Drama']",2000,2
9989119,Smitten Kitten,1952,['United States of America'],"['Animation', 'Short Film', 'Comedy', 'Romance Film', 'Family Film']",1950,2
9062631,Loose Loot,1953,['United States of America'],"['Black-and-white', 'Short Film', 'Comedy', 'Slapstick']",1950,3
5831493,Ebenezer,1997,['Canada'],"['Holiday Film', 'Hybrid Western', 'Drama']",1990,7
23080180,Saat Paake Bandha,2009,['India'],"['Action', 'Romance Film', 'Drama']",2000,9
18375567,Soo,2007,['South Korea'],"['Crime Fiction', 'Action/Adventure', 'World cinema', 'Crime Thriller', 'Martial Arts Film']",2000,7
22863682,California Dreaming,1979,['United States of America'],['Comedy'],1970,9
61481,Captain Blood,1935,['United States of America'],"['Action', 'Black-and-white', 'Action/Adventure', 'Romance Film', 'Swashbuckler films', 'Adventure']",1930,5
18531165,Heart,2006,['Indonesia'],['Drama'],2000,6
22247268,Lekhayude Maranam Oru Flashback,1983,['India'],"['Drama', 'Biographical film']",1980,3
554858,Four Rooms,1995,['United States of America'],['Comedy'],1990,5
23928471,Forever Fabulous,1999,['United States of America'],"['Parody', 'Comedy', 'Drama']",1990,9
2905745,Kya Kehna,2000,['India'],"['Drama', 'Bollywood', 'World cinema']",2000,0
4245926,Ishq Vishk,2003,['India'],['Coming of age'],2000,3
5986582,Kiss Me Quick!,1964,['United States of America'],"['Creature Film', 'Sexploitation', 'Horror', 'Science Fiction', 'Adult']",1960,4
976512,Shock Treatment,1981,['United States of America'],"['Musical', 'Indie', 'Parody', 'Comedy', 'Black comedy', 'Cult']",1980,1
14739499,Merry Mavericks,1951,['United States of America'],"['Black-and-white', 'Comedy Western', 'Action/Adventure', 'Short Film', 'Western', 'Comedy', 'Slapstick']",1950,1
32142542,The Last Homecoming,2008,['Greece'],"['Romance Film', 'Drama', 'World cinema']",2000,8
16714097,The Tell-Tale Heart,1941,['United States of America'],"['Black-and-white', 'Crime Fiction', 'Short Film', 'Drama']",1940,1
7122662,Quality Street,1937,['United States of America'],['Black-and-white'],1930,7
173944,The Lord of the Rings: The Two Towers,2002,"['New Zealand', 'United States of America']","['Action', 'Fantasy Adventure', 'Film adaptation', 'Action/Adventure', 'Adventure', 'Drama', 'Sword and sorcery films', 'Epic', 'Fantasy']",2000,2
7025464,Like It Is,1998,['United Kingdom'],"['LGBT', 'Indie', 'Romantic drama', 'Romance Film', 'Drama', 'Gay Themed', 'Gay', 'Gay Interest', 'Sports']",1990,8
10989569,Once Were Warriors,1994,"['New Zealand', 'Australia']","['Film adaptation', 'Drama', 'Family Drama', 'Indie', 'Marriage Drama', 'World cinema']",1990,4
22833808,Nymph,2009,['Thailand'],"['Fantasy', 'Drama', 'World cinema']",2000,9
19929867,Devaki,2005,['India'],"['Drama', 'World cinema']",2000,5
29661508,Seenu,2000,[],['Drama'],2000,0
3213906,Wicked Stepmother,1989,['United States of America'],"['Horror', 'Comedy', 'Horror Comedy']",1980,9
23290050,Mayumi,1990,['South Korea'],"['Thriller', 'Drama']",1990,0
33195656,Anyay Abichar,1985,[],['Action'],1980,5
1784755,The Swarm,1978,['United States of America'],"['Action', 'Action/Adventure', 'Horror', 'Disaster', 'Natural horror films', 'Ensemble Film']",1970,8
6179287,The Return of Swamp Thing,1989,['United States of America'],"['Monster movie', 'Comedy', 'Horror', 'Superhero movie', 'B-movie', 'Science Fiction']",1980,9
4857391,Bullet Boy,2004,['United Kingdom'],"['Action', 'Drama', 'Crime Fiction', 'Indie', 'Action/Adventure', 'Thriller', 'Crime Drama']",2000,4
8531241,Lair of the White Worm,1988,['United Kingdom'],"['Comedy', 'Cult', 'Horror']",1980,8
26362281,Park Row,1952,['United States of America'],['Drama'],1950,2
18764957,Night at the Museum: Battle of the Smithsonian,2009,"['Canada', 'United States of America']","['Adventure Comedy', 'Fantasy Adventure', 'Action', 'Action/Adventure', 'Comedy', 'Adventure', 'Family Film', 'Fantasy']",2000,9
17513934,With a Friend Like Harry...,2000,['France'],"['Psychological thriller', 'Comedy Thriller', 'Thriller', 'World cinema', 'Black comedy', 'Crime Thriller']",2000,0
2509831,The Box,2009,['United States of America'],"['Mystery', 'Thriller', 'Crime Thriller', 'Science Fiction', 'Drama']",2000,9
23773341,The September Issue,2009,['United States of America'],"['Biography', 'Documentary', 'Graphic & Applied Arts', 'Business', 'Journalism']",2000,9
28661161,Breath of Life,1990,['Italy'],['Drama'],1990,0
25757091,The Duel at Silver Creek,1952,['United States of America'],"['Action', 'Western', 'Action/Adventure']",1950,2
26122983,Hollow Reed,1996,"['United Kingdom', 'Spain', 'Germany']","['Gay Themed', 'Gay', 'Family Drama', 'Gay Interest', 'Drama', 'Courtroom Drama']",1990,6
5676452,The Marksman,2005,['United States of America'],"['Action', 'Action/Adventure', 'Thriller', 'Adventure', 'War film']",2000,5
1613731,Brush with Fate,2003,['United States of America'],"['Period piece', 'Mystery', 'Thriller', 'Television movie', 'Drama']",2000,3
3146483,The Glass House,2001,['United States of America'],"['Action', 'Psychological thriller', 'Crime Fiction', 'Mystery', 'Action/Adventure', 'Thriller', 'Teen', 'Crime Thriller', 'Drama', 'Suspense']",2000,1
4018958,Copying Beethoven,2006,"['Germany', 'Hungary', 'United States of America']","['Period piece', 'Romantic drama', 'Musical Drama', 'Biographical film', 'Biopic [feature]', 'Costume drama', 'Drama']",2000,6
15073672,Charlie Chan at the Circus,1936,['United States of America'],"['Detective fiction', 'Crime Fiction', 'Mystery', 'Thriller', 'Detective', 'Comedy film']",1930,6
9042000,"Fly, Daddy, Fly",2006,['South Korea'],['Drama'],2000,6
1458752,Muppet Treasure Island,1996,['United States of America'],"['Music', 'Musical', 'Comedy', 'Family-Oriented Adventure', ""Children's/Family"", ""Children's"", 'Adventure', 'Family Film']",1990,6
2238856,Me and You and Everyone We Know,2005,"['United Kingdom', 'United States of America']","['Indie', 'Romantic drama', 'Comedy', 'Romance Film', 'Drama', 'Romantic comedy', 'Comedy-drama', 'Comedy of manners']",2000,5
13249791,Snowball Express,1972,['United States of America'],"['Slapstick', 'Comedy', 'Family Film']",1970,2
29590145,Mickey's Warriors,1930,['United States of America'],['Short Film'],1930,0
11311970,I Yam What I Yam,1933,[],"['Animation', 'Short Film', 'Comedy film', 'Family Film']",1930,3
22576411,Symptoms,1974,"['United Kingdom', 'Belgium']",['Horror'],1970,4
22059060,John and Yoko: A Love Story,1985,['United States of America'],"['Music', 'Biographical film', 'Romance Film', 'Drama']",1980,5
6090070,Yagnam,2004,['India'],['World cinema'],2000,4
4943699,Issues 101,2002,['United States of America'],"['Gay Themed', 'LGBT', 'Gay', 'Gay Interest', 'Romance Film', 'Drama']",2000,2
1653220,Hearts in Atlantis,2001,['United States of America'],"['Period piece', 'Film adaptation', 'Thriller', 'Childhood Drama', 'Americana', 'Supernatural', 'Drama']",2000,1
15328157,Opera Jawa,2006,"['Austria', 'Indonesia']","['Musical', 'Art film', 'World cinema', 'Drama', 'Tragedy']",2000,6
19869058,31 North 62 East,2009,['United Kingdom'],"['Psychological thriller', 'Thriller', 'Political drama', 'Drama', 'Political thriller']",2000,9
22399894,Agony,1985,['Russia'],"['Music', 'Biography', 'World cinema', 'Concert film', 'Political drama', 'Drama']",1980,5
16168067,Devathayai Kanden,2004,['India'],"['Romantic drama', 'World cinema', 'Romance Film', 'Drama']",2000,4
35016653,Dangerous for Your Life!,1985,['Soviet Union'],['Comedy film'],1980,5
8545989,A Christmas Carol,2000,['United Kingdom'],"['Drama', 'Family Film', 'Fantasy']",2000,0
27653033,Widow Apartment: Big Tits' Aching Night,2007,['Japan'],['Japanese Movies'],2000,7
4500801,Munchies,1987,['United States of America'],"['Horror Comedy', 'Comedy', 'Slapstick', 'Creature Film', 'Monster movie', 'Parody', 'Horror', 'B-movie', 'Science Fiction']",1980,7
26016836,A Sip of Love,1984,['Turkey'],"['Romance Film', 'Drama']",1980,4
26847622,Revathikkoru Pavakkutty,1986,[],"['Drama', 'Comedy film']",1980,6
12130717,Love Love Love,1989,['India'],"['Musical', 'Romantic drama', 'World cinema', 'Romance Film', 'Drama']",1980,9
15971178,The Lucky Star,1980,['Canada'],"['Historical fiction', 'War film', 'Drama']",1980,0
17696695,Heatstroke,2008,['United States of America'],"['Action', 'Science Fiction', 'Horror']",2000,8
18612913,Doraemon: Nobita and Galactic Express,1996,['Japan'],['Japanese Movies'],1990,6
22263750,Games Men Play,2006,['Nigeria'],['Drama'],2000,6
3383231,Reefer Madness,2005,"['Germany', 'United States of America']","['Musical', 'Stoner film', 'Indie', 'Satire', 'Comedy', 'Black comedy', 'Zombie Film', 'Parody']",2000,5
6308032,Child Bride,1938,['United States of America'],"['Black-and-white', 'Drama']",1930,8
1613987,Hairspray,1988,['United States of America'],"['Musical', 'Comedy', 'Teen', 'Cult']",1980,8
25080803,Bad Karma,2002,['United States of America'],"['Psychological thriller', 'Slasher', 'Thriller', 'Horror']",2000,2
14529359,Nightmare Sisters,1987,['United States of America'],"['Comedy', 'Horror']",1980,7
23896772,Back to Back,1996,['United States of America'],"['Action', 'Crime Fiction', 'Action/Adventure', 'Thriller', 'Television movie', 'Crime Thriller']",1990,6
25544716,Jaya Ganga,1998,"['India', 'France', 'United States of America']",['Romantic drama'],1990,8
1693395,Varsity Blues,1999,['United States of America'],"['Coming of age', 'Comedy', 'Teen', 'Sports', 'Drama']",1990,9
6826256,Choodalani Vundi,1998,['India'],"['Action', 'Family Film']",1990,8
25559186,The Gruffalo,2009,"['United Kingdom', 'Germany']","['Animation', 'Short Film', 'Family Film', 'Fantasy']",2000,9
5606938,Jitterbugs,1943,['United States of America'],"['Black-and-white', 'Crime Fiction', 'Comedy', 'Slapstick']",1940,3
18593306,Fair Game,2005,['United States of America'],"['Romance Film', 'Romantic comedy', 'Comedy']",2000,5
7595825,Billy the Kid vs. Dracula,1966,['United States of America'],"['Hybrid Western', 'Action/Adventure', 'Western', 'Comedy', 'Horror', 'Cult']",1960,6
5561269,The Haunted House,1921,['United States of America'],"['Black-and-white', 'Short Film', 'Comedy', 'Silent film']",1920,1
31347856,Alkitrang dugo,1976,[],"['Drama', 'Mystery', 'Thriller']",1970,6
27737919,Love Song,2000,['United States of America'],"['Romance Film', 'Drama']",2000,0
46757,Black Narcissus,1947,"['United Kingdom', 'England', 'Italy']","['Period piece', 'Melodrama', 'Drama']",1940,7
937670,Side Out,1990,['United States of America'],"['Comedy', 'Romance Film', 'Comedy-drama', 'Sports']",1990,0
8280078,Paper Soldiers,2002,['United States of America'],"['Action', 'Crime Fiction', 'Indie', 'Action/Adventure', 'Comedy', 'Crime Comedy']",2000,2
6194015,A Child Is Waiting,1963,['United States of America'],"['Black-and-white', 'Drama']",1960,3
9082335,Kid Galahad,1937,['United States of America'],"['Boxing', 'Black-and-white', 'Crime Fiction', 'Sports', 'Drama']",1930,7
16113840,Second Sight: A Love Story,1984,['United States of America'],"['Romance Film', 'Drama']",1980,4
2482275,Bob le flambeur,1956,['France'],"['Crime Fiction', 'Caper story', 'Drama']",1950,6
8907743,Fudoh: The New Generation,1996,['Japan'],"['Surrealism', 'Crime Fiction', 'Gangster Film', 'Action/Adventure', 'Thriller', 'World cinema', 'Crime Thriller', 'Japanese Movies']",1990,6
12782740,Before the Fall,2004,['Germany'],"['World cinema', 'Sports', 'War film', 'Drama']",2000,4
22222419,Mother Was a Rooster,1962,['United States of America'],"['Animation', 'Short Film', 'Comedy', 'Family Film']",1960,2
4602698,Young and Dangerous 5,1998,['Hong Kong'],"['Action', 'Gangster Film', 'Chinese Movies']",1990,8
20977469,Our Betters,1933,['United States of America'],"['Black-and-white', 'Comedy', 'Satire', 'Comedy of manners']",1930,3
10677545,2000 AD,2000,"['Hong Kong', 'Singapore']","['Action', 'Gangster Film', 'Action/Adventure', 'Thriller', 'World cinema', 'Chinese Movies', 'Martial Arts Film', 'Science Fiction']",2000,0
13183808,Hälsoresan - En smal film av stor vikt,1999,['Sweden'],['Comedy'],1990,9
32342193,"Leslie, My Name Is Evil",2009,['Canada'],"['Period piece', 'Crime Fiction', 'Comedy', 'Black comedy', 'Drama', 'Courtroom Drama']",2000,9
6804649,The Big Mouth,1967,['United States of America'],"['Comedy', 'Satire']",1960,7
8921059,Guimba the Tyrant,1995,"['Mali', 'Burkina Faso', 'France', 'Germany']","['Action/Adventure', 'Comedy', 'World cinema', 'Political drama', 'Adventure', 'Drama', 'Fantasy']",1990,5
18302135,Share Bazaar,1997,['India'],['Drama'],1990,7
4901019,Pullet Surprise,1997,['United States of America'],"['Animated cartoon', 'Comedy', 'Family Film']",1990,7
35621613,Kaun Hai Jo Sapno Mein Aaya,2004,"['United Kingdom', 'India']","['Musical', 'Romance Film']",2000,4
3264802,"Wayward, Crazy, Insane",2002,['India'],"['Action', 'Musical', 'Crime Fiction', 'Comedy', 'Bollywood', 'World cinema']",2000,2
5660641,The Magic Sword,1962,['United States of America'],"['Action/Adventure', 'Sword and sorcery', 'Costume drama', 'Adventure', 'Family Film', 'Fantasy']",1960,2
27906904,The Night of the Hunted,1980,['France'],"['Thriller', 'Horror', 'World cinema', 'Crime Thriller', 'Science Fiction']",1980,0
2835630,Hope Springs,2003,"['United Kingdom', 'United States of America']","['Romance Film', 'Romantic comedy', 'Comedy']",2000,3
23880976,The Chinese Stuntman,1982,"['Hong Kong', 'Taiwan']","['Action', 'Martial Arts Film', 'Adventure']",1980,2
30166370,Comin' Thro the Rye,1923,['United Kingdom'],['Silent film'],1920,3
7852430,London Belongs to Me,1948,['United Kingdom'],"['Drama', 'Comedy']",1940,8
3923568,Painting the Clouds with Sunshine,1951,['United States of America'],['Musical'],1950,1
19915657,Jackson,2008,['United States of America'],"['Musical', 'Drama', 'Comedy film']",2000,8
19933483,Death Smiles at a Murderer,1973,['Italy'],['Horror'],1970,3
36057866,Aval Sumangalithan,1985,['India'],['Drama'],1980,5
2266430,Ace High,1968,['Italy'],"['Action/Adventure', 'Western', 'World cinema', 'Spaghetti Western']",1960,8
4933146,My Super Ex-Girlfriend,2006,['United States of America'],"['Sci-Fi Thriller', 'Crime Fiction', 'Superhero', 'Comedy', 'Romance Film', 'Drama', 'Superhero movie', 'Romantic comedy', 'Fantasy']",2000,6
23374344,Deadline,2001,['Sweden'],"['Thriller', 'Drama']",2000,1
30726799,Angaaray,1986,['India'],['Romance Film'],1980,6
3191060,Q,1982,['United States of America'],"['Indie', 'Monster', 'Thriller', 'Detective', 'Horror', 'B-movie', 'Stop motion']",1980,2
6673533,The Monster Walks,1932,['United States of America'],"['Creature Film', 'Black-and-white', 'Indie', 'Thriller', 'Horror']",1930,2
11003730,Scarred,1984,['United States of America'],['Drama'],1980,4
8477556,A Railway Station for Two,1982,"['Russia', 'Soviet Union']","['Romantic drama', 'World cinema', 'Romance Film', 'Drama']",1980,2
21879067,Cho Kamen Rider Den-O & Decade NEO Generations: The Onigashima Battleship,2009,['Japan'],['Japanese Movies'],2000,9
710094,The Peacemaker,1997,['United States of America'],"['Action', 'Action/Adventure', 'Thriller', 'Disaster']",1990,7
25952581,Thacholi Varghese Chekavar,1995,['India'],"['Action', 'Drama']",1990,5
25741513,Hidden,2009,['Norway'],"['World cinema', 'Horror']",2000,9
4566088,The Great Macarthy,1975,['Australia'],['Comedy'],1970,5
11790945,The Night Train to Kathmandu,1988,['United States of America'],"['Mystery', 'Action/Adventure', 'Thriller', 'Adventure', 'Romance Film', 'Family-Oriented Adventure', 'Drama']",1980,8
31666128,Nellu,1974,[],"['Romance Film', 'Drama']",1970,4
20904503,Aangan Ki Kali,1979,['India'],['Drama'],1970,9
11350840,Sherlock Holmes in Washington,1943,['United States of America'],"['Spy', 'Detective fiction', 'Crime Fiction', 'Black-and-white', 'Mystery', 'Thriller', 'Crime Thriller', 'Drama', 'Detective']",1940,3
4300418,The Hero: Love Story of a Spy,2003,['India'],"['Action', 'Musical', 'Action Thrillers', 'Musical Drama', 'Action/Adventure', 'Thriller', 'World cinema', 'Adventure', 'Drama']",2000,3
242821,The Diary of Anne Frank,1959,"['Netherlands', 'United States of America']","['Film adaptation', 'Black-and-white', 'Biographical film', 'War film', 'Drama']",1950,9
10568132,Nahr al-Hob,1960,['Egypt'],['Romance Film'],1960,0
28967735,The Ups and Downs of a Handyman,1976,['United States of America'],['Comedy'],1970,6
6727805,Josh and the Big Wall!,1997,[],"['Musical', 'Animation', 'Short Film', ""Children's""]",1990,7
20934648,Krabat,2008,['Germany'],"['Action/Adventure', 'World cinema', 'Adventure', 'Fantasy']",2000,8
25357930,Sherlock Holmes,2009,"['United Kingdom', 'United States of America']","['Crime Fiction', 'Mystery', 'Action/Adventure', 'Thriller', 'Crime Thriller', 'Drama', 'Monster movie', 'Suspense', 'Period piece', 'Supernatural']",2000,9
5305319,Pyaar Diwana Hota Hai,2002,['India'],['Romance Film'],2000,2
21539399,Final Impact,1991,['United States of America'],"['Action', 'Martial Arts Film', 'Adventure']",1990,1
6473465,The Wog Boy,2000,['Australia'],['Comedy'],2000,0
558578,"Merry Christmas, Mr. Lawrence",1983,"['United Kingdom', 'New Zealand', 'Japan']","['Film adaptation', 'LGBT', 'Drama', 'Period piece', 'Japanese Movies', 'Homoeroticism', 'Prison film', 'War film']",1980,3
10388058,"Arise, My Love",1940,['United States of America'],"['Black-and-white', 'Comedy', 'Romance Film', 'Adventure', 'Drama']",1940,0
424391,Stardust Memories,1980,['United States of America'],"['Satire', 'Comedy', 'Romance Film', 'Romantic comedy', 'Comedy-drama', 'Drama']",1980,0
6642464,Stand Up and Cheer!,1934,['United States of America'],"['Musical', 'Comedy', 'Drama', 'Family Film']",1930,4
4486246,Pushpak,1988,['India'],"['Silent film', 'Black comedy', 'Indie']",1980,8
2605689,The Waterdance,1992,['United States of America'],"['Ensemble Film', 'Drama', 'Medical fiction']",1990,2
101384,Party Girl,1995,['United States of America'],"['Libraries and librarians', 'Indie', 'Comedy']",1990,5
222534,Fierce Creatures,1997,"['United Kingdom', 'United States of America']","['Screwball comedy', 'Comedy', 'Comedy of manners']",1990,7
32251576,Dakota Incident,1956,['United States of America'],"['Action', 'Western', 'Action/Adventure']",1950,6
13144612,Silent Lies,1996,['United States of America'],['Drama'],1990,6
13161775,I Think I Do,1997,['United States of America'],"['LGBT', 'Indie', 'Comedy', 'Romance Film', 'Gay Themed', 'Gay', 'Gay Interest', 'Romantic comedy']",1990,7
7405392,Eloise at the Plaza,2003,['United States of America'],"['Comedy', 'Television movie', ""Children's/Family"", ""Children's"", 'Family Film']",2000,3
22121173,Gunahon Ka Sheher,2006,['Pakistan'],[],2000,6
7394823,The Steel Helmet,1951,['United States of America'],"['Anti-war', 'Action', 'Anti-war film', 'Action/Adventure', 'War film', 'Drama']",1950,1
21252039,Windfall in Athens,1954,['Greece'],"['Romance Film', 'Black-and-white', 'Comedy']",1950,4
551753,Rapid Fire,1992,"['Austria', 'United Kingdom', 'Germany', 'United States of America']","['Action', 'Action/Adventure', 'Thriller', 'Martial Arts Film']",1990,2
4565249,The Mummy's Shroud,1967,['United Kingdom'],"['Creature Film', 'Monster movie', 'Horror', 'Archaeology', 'Costume Horror']",1960,7
7483515,Doing Time,2002,['Japan'],"['Japanese Movies', 'Comedy', 'World cinema', 'Drama']",2000,2
4803480,The Cat in the Hat,2003,['United States of America'],"['Musical', 'Comedy', 'Adventure', 'Family Film', 'Fantasy']",2000,3
26009491,Kid Blue,1973,['United States of America'],"['Western', 'Comedy']",1970,3
14007371,The Balloonatic,1923,['United States of America'],"['Black-and-white', 'Short Film', 'Comedy', 'Silent film', 'Slapstick']",1920,3
7891946,Badri,2000,['India'],['Romance Film'],2000,0
5506291,Bikini Cavegirl,2004,['United States of America'],"['Pornographic movie', 'Fantasy']",2000,4
704097,Box Office Bunny,1990,['United States of America'],"['Animation', 'Short Film', 'Comedy', 'Family Film']",1990,0
98019,The Swan,1956,['United States of America'],"['Romantic drama', 'Comedy', 'Comedy of manners', 'Romance Film']",1950,6
10428696,The Deal,2004,"['Canada', 'United States of America']","['Crime Fiction', 'Gangster Film', 'Thriller', 'Crime Thriller', 'Drama', 'Suspense', 'Political drama', 'Political thriller']",2000,4
23917355,Paris Trout,1991,['United States of America'],['Drama'],1990,1
75255,The Naked Spur,1953,['United States of America'],"['Action', 'Western', 'Action/Adventure']",1950,3
21913863,One Flew Over the Cuckoo's Nest,1975,['United States of America'],"['Film adaptation', 'Indie', 'Comedy', 'Tragicomedy', 'Drama', 'Tragedy', 'Existentialism', 'Comedy-drama']",1970,5
20073140,The Plot to Kill Hitler,1990,"['Yugoslavia', 'United States of America']","['Period piece', 'Television movie', 'Docudrama', 'Political drama', 'Drama', 'Political thriller']",1990,0
16372026,Dead On: The Life and Cinema of George A. Romero,2008,['United States of America'],['Documentary'],2000,8
23645970,Running Free,1999,['United States of America'],"['History', 'War film', 'Adventure', 'Drama', 'Family Film']",1990,9
13947064,The Wackness,2008,['United States of America'],"['Drama', 'Stoner film', 'Indie', 'Comedy', 'Romance Film', 'Romantic comedy']",2000,8
15537999,Murder on the Blackboard,1934,['United States of America'],"['Black-and-white', 'Mystery', 'Comedy', 'Whodunit']",1930,4
3309050,Želary,2003,['Czech Republic'],"['Romantic drama', 'World cinema', 'Romance Film', 'War film', 'Drama']",2000,3
17890259,The Sleeping Tiger,1954,['United Kingdom'],['Drama'],1950,4
2768210,Scorchers,1991,"['United Kingdom', 'United States of America']","['Indie', 'Romantic drama', 'Comedy', 'Black comedy', 'Romance Film', 'Drama']",1990,1
24276207,The Beach Girls and the Monster,1965,['United States of America'],"['Creature Film', 'Monster movie', 'Horror', 'B-movie', 'Beach Film']",1960,5
5561003,The Lion Has Wings,1939,['United Kingdom'],"['War film', 'Black-and-white']",1930,9
11095312,Frankenstein 1970,1958,['United States of America'],"['Creature Film', 'Horror', 'Sci-Fi Horror', 'Science Fiction']",1950,8
15721714,Last Rites,1988,['United States of America'],"['Action', 'Gangster Film', 'Action/Adventure', 'Thriller', 'Crime Thriller']",1980,8
25716852,Tarot,2009,['Philippines'],"['Filipino Movies', 'Thriller', 'World cinema']",2000,9
17024723,The Book of Stars,2000,['United States of America'],['Drama'],2000,0
9613711,Strength and Honour,2007,['Ireland'],"['Boxing', 'Drama', 'Family Drama', 'Indie', 'World cinema', 'Sports']",2000,7
3509677,Ivan Vasilievich: Back to the Future,1973,"['Russia', 'Soviet Union']","['Satire', 'Comedy', 'World cinema', 'Science Fiction', 'Fantasy Comedy', 'Comedy of Errors']",1970,3
77672,The Song of Bernadette,1943,['United States of America'],"['Period piece', 'Black-and-white', 'Biography', 'Christian film', 'Hagiography', 'Roadshow theatrical release', 'Drama']",1940,3
6309266,Hot Water,1924,['United States of America'],"['Black-and-white', 'Indie', 'Comedy', 'Silent film']",1920,4
8845429,Baby Puss,1943,['United States of America'],"['Animation', 'Short Film', 'Comedy', 'Family Film']",1940,3
13041324,Killer Diller,1948,['United States of America'],"['Musical', 'Black-and-white', 'Comedy']",1940,8
11881682,Tiempo de silencio,1986,['Spain'],['Drama'],1980,6
20895821,New York Nights,1928,['United States of America'],"['Drama', 'Crime Fiction']",1920,8
579127,The Trouble with Harry,1955,['United States of America'],"['Suspense', 'Mystery', 'Comedy', 'Thriller', 'Black comedy']",1950,5
23541198,Killer Hair,2009,['Canada'],"['Crime Fiction', 'Mystery', 'Comedy', 'Comedy film', 'Television movie', 'Drama']",2000,9
1107070,Police Academy 2: Their First Assignment,1985,['United States of America'],"['Action', 'Action/Adventure', 'Comedy', 'Slapstick']",1980,5
1938914,Three Times,2005,"['France', 'Taiwan', 'China']","['Period piece', 'Romantic drama', 'World cinema', 'Romance Film', 'Chinese Movies', 'Drama', 'Slice of life story']",2000,5
2928949,Die Straße,1923,"['Weimar Republic', 'Germany']","['Black-and-white', 'Crime Fiction', 'Indie', 'Silent film']",1920,3
23171807,The Card,1952,['United Kingdom'],"['Film adaptation', 'Comedy', 'Drama']",1950,2
14773122,Amy,1981,"['New Zealand', 'Australia', 'United States of America']","['Drama', 'Indie', 'Comedy', 'World cinema']",1980,1
1968680,Spacehunter: Adventures in the Forbidden Zone,1983,['United States of America'],"['Adventure', 'Space western', 'Science Fiction', 'Family Film']",1980,3
3991335,The Strong Man,1926,['United States of America'],"['Black-and-white', 'Indie', 'Comedy', 'Silent film', 'Romance Film', 'Slapstick']",1920,6
3244410,The Crooked Way,1949,['United States of America'],"['Psychological thriller', 'Black-and-white', 'Thriller', 'Film noir', 'Drama']",1940,9
5117656,Scarecrow,2002,['United States of America'],"['Monster movie', 'Slasher', 'Teen', 'Horror', 'B-movie']",2000,2
8455372,The Tattooist,2007,"['Singapore', 'New Zealand', 'Netherlands']","['Thriller', 'Horror']",2000,7
8026532,Gabbia,2003,['Italy'],"['Indie', 'Short Film', 'Thriller']",2000,3
32048260,Young Guns of Texas,1962,[],['Western'],1960,2
31934171,Irakal,1985,[],['Psychological thriller'],1980,5
3454713,Racing with the Moon,1984,['United States of America'],"['Period piece', 'Romantic drama', 'Comedy', 'Romance Film', 'Romantic comedy', 'Drama']",1980,4
8593082,Crimes of the Heart,1986,['United States of America'],"['Family Drama', 'Comedy', 'Black comedy', 'Drama', 'Family Film']",1980,6
11945073,Hera Pheri,1976,['India'],"['Action', 'Crime Fiction', 'Comedy', 'Bollywood', 'World cinema']",1970,6
9614420,Love Affair; Or The Case of the Missing Switchboard Operator,1967,['Yugoslavia'],"['Crime Fiction', 'Satire', 'World cinema', 'Black comedy', 'Political drama', 'Drama']",1960,7
3145210,"Yes, Giorgio",1982,['United States of America'],"['Romance Film', 'Comedy']",1980,2
2566582,Zandalee,1991,['United States of America'],"['Erotic Drama', 'Thriller', 'Erotic thriller', 'Romance Film', 'Drama']",1990,1
14359816,The Truce,1974,['Argentina'],"['Romance Film', 'Drama']",1970,4
28075609,Mozambique,1966,['United Kingdom'],"['Action', 'Crime Fiction', 'Drama']",1960,6
2010173,Return to the Batcave: The Misadventures of Adam and Burt,2003,['United States of America'],"['Action', 'Superhero', 'Action/Adventure', 'Buddy film', 'Comedy', 'Superhero movie']",2000,3
15403744,Barakat!,2006,"['France', 'Algeria']","['Drama', 'World cinema']",2000,6
27586307,Public Lavatory: I've Been Loitering,1999,['Japan'],['Japanese Movies'],1990,9
293165,Gigli,2003,['United States of America'],"['Crime Fiction', 'Comedy', 'Romance Film', 'Romantic comedy', 'Crime Thriller']",2000,3
2893701,The Sheriff of Fractured Jaw,1958,"['United Kingdom', 'United States of America']","['Comedy Western', 'Parody', 'Action/Adventure', 'Western', 'Comedy']",1950,8
21576027,From Time to Time,2009,['United Kingdom'],"[""Children's Fantasy"", 'Family Drama', 'Time travel', 'Adventure', 'Drama', 'Family Film', 'Fantasy']",2000,9
16207552,Levitation,1998,['United States of America'],"['Road movie', 'Indie', 'Drama']",1990,8
21287649,Too Many Kisses,1925,[],"['Black-and-white', 'Comedy', 'Silent film', 'Comedy-drama']",1920,5
20953257,Kangaroo,1987,['Australia'],['Drama'],1980,7
642694,Beethoven's 2nd,1993,['United States of America'],"['Comedy', 'Animal Picture', 'Family-Oriented Adventure', ""Children's/Family"", 'Family Film']",1990,3
14023727,El Sur,1986,"['France', 'Spain']",['Drama'],1980,6
13407499,Asfaltevangeliet,2004,['Norway'],['Religious Film'],2000,4
33624127,Patrani,1956,['India'],['Drama'],1950,6
26838950,Possessed II,1984,['Hong Kong'],"['Chinese Movies', 'Crime Fiction', 'Mystery', 'Horror']",1980,4
5671197,The Screaming Skull,1958,['United States of America'],"['Psychological thriller', 'Black-and-white', 'Thriller', 'Horror']",1950,8
3819855,Intervista,1987,['Italy'],"['Satire', 'Comedy', 'Biographical film', 'World cinema', 'Mockumentary', 'Drama', 'Comedy-drama', 'Fantasy']",1980,7
16983442,Where's Marlowe?,1999,['United States of America'],"['Mystery', 'Comedy', 'Thriller', 'Crime Thriller', 'Mockumentary']",1990,9
20907157,All Through the Night,1942,['United States of America'],"['Action', 'Action/Adventure', 'Comedy', 'Thriller']",1940,2
6146022,"Tarzan, the Ape Man",1959,['United States of America'],"['Action', 'Adventure']",1950,9
26049132,Maya Mayuram,1993,['India'],['Romance Film'],1990,3
24408850,Mossane,1997,"['Germany', 'Senegal']",['Drama'],1990,7
31156629,Karumadikkuttan,2001,[],['Drama'],2000,1
20430909,You Changed My Life,2009,['Philippines'],"['Filipino Movies', 'Romantic drama', 'World cinema', 'Romance Film', 'Romantic comedy', 'Drama']",2000,9
2114517,The Sasquatch Gang,2006,['United States of America'],"['Indie', 'Comedy', 'Teen', 'Fantasy']",2000,6
6978596,Born Yesterday,1993,['United States of America'],"['Political cinema', 'Comedy', 'Romance Film', 'Romantic comedy']",1990,3
19238278,The Stoning of Soraya M.,2008,['United States of America'],"['Social problem film', 'Drama', 'World cinema']",2000,8
8380395,They Call Her Cleopatra Wong,1978,['Singapore'],['Martial Arts Film'],1970,8
26694159,Shakespeare M.A. Malayalam,2008,['India'],"['Drama', 'Comedy film']",2000,8
30356467,Laila Majnu,1949,[],"['Musical', 'Historical drama']",1940,9
7833777,Une belle fille comme moi,1972,['France'],"['Crime Fiction', 'Comedy', 'Drama']",1970,2
32198848,Behind the Wall,2008,"['Canada', 'United States of America']","['Indie', 'Thriller', 'Horror', 'Supernatural']",2000,8
30747288,Annadammula Savaal,1978,['India'],['Drama'],1970,8
20997705,The Note,2007,['United States of America'],"['Film adaptation', 'Inspirational Drama', 'Romantic drama', 'Romance Film', 'Television movie', 'Drama']",2000,7
27043529,The Shuttered Room,1967,['United Kingdom'],['Horror'],1960,7
4476914,The Number 23,2007,['United States of America'],"['Psychological thriller', 'Suspense', 'Mystery', 'Thriller', 'Drama']",2000,7
19159578,Castle in the Air,1952,['United Kingdom'],"['Musical', 'Drama']",1950,2
1556078,Snake Eyes,1998,['United States of America'],"['Suspense', 'Crime Fiction', 'Mystery', 'Thriller', 'Crime Thriller', 'Drama']",1990,8
2867492,You Lucky Dog,1998,['United States of America'],"['Animal Picture', 'Comedy']",1990,8
9075293,World on a Wire,1973,['Germany'],"['Crime Fiction', 'Science Fiction', 'World cinema']",1970,3
24496628,Endangered Species,1982,['United States of America'],['Science Fiction'],1980,2
10885307,The Mercenary,1968,['Italy'],"['Action/Adventure', 'Western', 'World cinema', 'Spaghetti Western']",1960,8
24817379,Love Is My Profession,1958,"['France', 'Italy']","['Romance Film', 'Crime Fiction', 'Drama']",1950,8
15739815,My Sister's Keeper,2009,['United States of America'],['Drama'],2000,9
2488691,Arsene Lupin,2004,"['Spain', 'United Kingdom', 'France', 'Italy']","['Action', 'Crime Fiction', 'Mystery', 'Romance Film', 'Adventure']",2000,4
5386594,The Climax,1944,['United States of America'],['Horror'],1940,4
17062305,On the Job Training,2007,['United States of America'],"['Indie', 'Comedy', 'Drama']",2000,7
2501528,Airborne,1993,['United States of America'],"['Action', 'Drama', 'Action/Adventure', 'Comedy', 'Adventure']",1990,3
2071291,Handle With Care,1977,['United States of America'],"['Indie', 'Comedy']",1970,7
19689367,Third Time Lucky,1948,['United Kingdom'],"['Black-and-white', 'Crime Fiction', 'Drama']",1940,8
10388154,The Planter's Wife,1952,['United Kingdom'],"['Black-and-white', 'Drama']",1950,2
9514127,Snehamante Idera,2001,['India'],['Drama'],2000,1
30469268,Six Bridges to Cross,1955,['United States of America'],"['Drama', 'Crime Fiction']",1950,5
16305195,Flight From Glory,1937,['United States of America'],"['Action', 'Black-and-white', 'Adventure', 'Drama']",1930,7
384209,Play Misty for Me,1971,['United States of America'],"['Psychological thriller', 'Crime Fiction', 'Thriller', 'Romance Film', 'Crime Thriller', 'Drama', 'Suspense', 'Slasher']",1970,1
33506410,The Legend of Bloody Mary,2008,[],['Horror'],2000,8
10738117,Senso,1954,['Italy'],"['Romantic drama', 'World cinema', 'Romance Film', 'Drama', 'Period piece', 'History', 'Melodrama', 'War film']",1950,4
620034,Predator 2,1990,['United States of America'],"['Creature Film', 'Action', 'Thriller', 'Horror', 'Alien Film', 'Science Fiction']",1990,0
27858537,The Mangler 2,2002,['Canada'],"['Horror', 'Science Fiction']",2000,2
1968060,Pray for the Wildcats,1974,['United States of America'],['Adventure'],1970,4
8122485,Offers,2005,['Netherlands'],"['Thriller', 'Drama']",2000,5
7955522,The Cat in the Hat,1971,['United States of America'],"['Short Film', 'Animation']",1970,1
960657,The Life and Death of Colonel Blimp,1943,"['United Kingdom', 'England']","['Romance Film', 'War film', 'Drama']",1940,3
11783565,Il grido,1957,"['Italy', 'United States of America']","['Black-and-white', 'Art film', 'World cinema', 'Romance Film', 'Drama']",1950,7
17125190,Arjun,1985,['India'],"['Romantic drama', 'Action/Adventure', 'Bollywood', 'World cinema', 'Romance Film', 'Drama']",1980,5
2098557,Waqt: The Race Against Time,2005,['India'],"['Drama', 'World cinema']",2000,5
811602,"He's a Woman, She's a Man",1994,['Hong Kong'],"['Romantic drama', 'Comedy', 'World cinema', 'Romance Film', 'Chinese Movies', 'Drama', 'Romantic comedy', 'Sex comedy']",1990,4
1046470,Ocean's Twelve,2004,['United States of America'],"['Action', 'Crime Fiction', 'Action/Adventure', 'Comedy', 'Thriller', 'Heist', 'Caper story', 'Crime Comedy', 'Ensemble Film']",2000,4
2457899,Kaala Patthar,1979,['India'],"['Action', 'Musical', 'Action Thrillers', 'Action/Adventure', 'Thriller', 'Bollywood', 'World cinema', 'Drama']",1970,9
9752176,Bang Rajan,2004,['Thailand'],"['Action/Adventure', 'World cinema', 'Historical Epic', 'Epic', 'War film', 'Drama']",2000,4
5063528,Arirang geuhu iyagi,1930,['Korea'],"['Silent film', 'Black-and-white', 'Indie']",1930,0
9956444,My Dinner with Jimi,2003,['United States of America'],"['Period piece', 'Drama', 'Indie', 'Biography', 'Biographical film', 'Biopic [feature]', 'Documentary']",2000,3
24355152,Joysticks,1983,['United States of America'],"['Indie', 'Comedy']",1980,3
5789454,Bullet,1996,['United States of America'],"['Action', 'Drama', 'Crime Fiction', 'Crime Thriller']",1990,6
353369,Bonsoir,1994,['France'],['Comedy'],1990,4
16470745,Tongan Ninja,2002,['New Zealand'],"['Action', 'Martial Arts Film', 'Action Comedy', 'Action/Adventure', 'Comedy', 'World cinema']",2000,2
34051815,Romance of Celluloid,1937,[],"['Short Film', 'Documentary']",1930,7
2480188,C.R.A.Z.Y.,2005,['Canada'],"['LGBT', 'Indie', 'Drama', 'Period piece', 'Gay Themed', 'Gay', 'Coming of age', 'Gay Interest', 'Comedy-drama']",2000,5
15879572,Bindaas,2008,['India'],"[""Children's/Family""]",2000,8
20853333,Happy Ever Afters,2009,"['Ireland', 'United Kingdom']","['Screwball comedy', 'Comedy', 'Romance Film', 'Romantic comedy']",2000,9
10633286,Frankenstein Meets the Space Monster,1965,['United States of America'],"['Creature Film', 'Horror', 'Alien Film', 'Science Fiction', 'Fantasy']",1960,5
2688210,Rapa Nui,1994,['United States of America'],"['Action', 'Romantic drama', 'Action/Adventure', 'Romance Film', 'Adventure', 'Drama', 'Period piece', 'Political drama']",1990,4
22670461,Dim Sum: A Little Bit of Heart,1985,['United States of America'],"['Family Drama', 'Indie', 'Comedy', 'Comedy-drama']",1980,5
10823448,Surveillance,2007,"['Germany', 'United States of America']","['Crime Thriller', 'Indie', 'Thriller']",2000,7
4469522,James' Journey to Jerusalem,2004,['Israel'],"['Satire', 'Comedy', 'Comedy of manners', 'World cinema', 'Comedy-drama', 'Drama']",2000,4
143483,Mrs. Brown,1997,"['United Kingdom', 'Ireland', 'United States of America']","['British Empire Film', 'Indie', 'Biography', 'Romantic drama', 'Romance Film', 'Costume drama', 'Drama', 'Period piece', 'History', 'Historical fiction']",1990,7
12419811,Tobor The Great,1954,['United States of America'],"['Black-and-white', 'Science Fiction', 'Sci-Fi Adventure']",1950,4
6000991,Climates,2006,"['Turkey', 'France']","['Drama', 'World cinema']",2000,6
848836,La Noche de los Brujos,1973,['Spain'],"['Horror', 'World cinema', 'Zombie Film', 'Supernatural', 'Adventure']",1970,3
276076,Iznogoud,2005,[],['Comedy film'],2000,5
26394441,Cover Story,2000,['India'],"['Crime Fiction', 'Romantic drama', 'Thriller', 'World cinema', 'Romance Film', 'Crime Thriller', 'Drama']",2000,0
22112974,The Honorary Consul,1983,['United Kingdom'],['Drama'],1980,3
2268509,Wish You Were Here,1987,['United Kingdom'],"['Indie', 'Romantic drama', 'Comedy', 'Romance Film', 'Drama', 'Period piece', 'Coming of age', 'Romantic comedy']",1980,7
1951984,FUBAR,2002,['Canada'],"['Indie', 'Buddy film', 'Comedy', 'Mockumentary', 'Drama']",2000,2
8711818,The Next Man,1976,['United States of America'],"['Action', 'Spy', 'Action Thrillers', 'Action/Adventure', 'Thriller', 'Glamorized Spy Film', 'Political thriller']",1970,6
30489553,The Young and The Brave,1963,[],"['War film', 'Drama']",1960,3
11722716,Lo squadrone bianco,1936,"['Kingdom of Italy', 'Italy']","['Black-and-white', 'Neorealism', 'War film', 'Propaganda film']",1930,6
2200926,Light Years,1988,"['France', 'South Korea']","['Animation', 'Indie', 'Adventure', 'Science Fiction', 'Fantasy']",1980,8
3725044,Les Sorcières de Salem,1957,"['France', 'German Democratic Republic']","['Period piece', 'Drama']",1950,7
19398992,Shrimps for a Day,1934,['United States of America'],"['Black-and-white', 'Short Film', 'Comedy', 'Family Film']",1930,4
8249978,Yamudiki Mogudu,1988,['India'],"['Musical', 'Comedy', 'Bollywood', 'World cinema', 'Romance Film', 'Drama']",1980,8
32420907,Groove Room 3D,1975,"['Sweden', 'United States of America']","['Comedy film', 'World cinema', 'Romance Film', 'Drama']",1970,5
15119799,On Golden Pond,1981,"['United Kingdom', 'United States of America']","['Romance Film', 'Drama']",1980,1
16171195,"Think Fast, Mr. Moto",1937,['United States of America'],"['Action', 'Detective fiction', 'Black-and-white', 'Mystery', 'Thriller', 'Crime Thriller', 'Drama', 'Detective']",1930,7
28668320,The Last Post,1929,['United Kingdom'],['Silent film'],1920,9
11784534,Journey to Italy,1953,"['France', 'Italy']","['Black-and-white', 'Drama']",1950,3
2003184,Cup-tie Honeymoon,1948,['United Kingdom'],['Comedy'],1940,8
22941497,Haeundae,2009,['South Korea'],"['Action', 'Action/Adventure', 'World cinema', 'Disaster']",2000,9
35376659,Hamateur Night,1939,['United States of America'],"['Animation', 'Short Film', 'Comedy film', 'Family Film']",1930,9
3412440,Made in America,1993,['United States of America'],"['Romance Film', 'Romantic comedy', 'Comedy']",1990,3
2609169,The Pink Panther,1963,['United States of America'],"['Crime Fiction', 'Parody', 'Slapstick', 'Comedy', 'Comedy-drama', 'Family Film']",1960,3
10932053,Vengeful Beauty,1978,['Hong Kong'],"['Chinese Movies', 'Martial Arts Film']",1970,8
3610087,The Virgin Suicides,1999,['United States of America'],"['Film adaptation', 'Mystery', 'Indie', 'Teen', 'Romance Film', 'Drama', 'Period piece', 'Coming of age']",1990,9
1367502,A Dry White Season,1989,"['United States of America', 'South Africa']","['Courtroom Drama', 'Mystery', 'Thriller', 'Political drama', 'Drama', 'Political thriller']",1980,9
1485591,Perfect Strangers,2004,"['United Kingdom', 'England']",['Comedy'],2000,4
11876652,The Bubble,2006,['Israel'],"['LGBT', 'Romantic drama', 'World cinema', 'Romance Film', 'Drama']",2000,6
9215946,Movie Movie,1978,['United States of America'],"['Musical', 'Comedy']",1970,8
21339336,The Reader,1988,['France'],"['Drama', 'Comedy']",1980,8
14069079,Made for Each Other,1971,['United States of America'],"['Romance Film', 'Romantic comedy', 'Comedy']",1970,1
31091026,The Trespassers,1976,[],['Drama'],1970,6
29302015,Kutsal Damacana,2007,['Turkey'],"['Comedy film', 'Fantasy']",2000,7
19419882,The Passage,1979,['United Kingdom'],"['Action', 'Drama', 'War film']",1970,9
7082486,Aadavari Matalaku Ardhalu Verule,2007,['India'],"['Romance Film', 'Comedy', 'Drama']",2000,7
14079871,Sea Monsters: A Prehistoric Adventure,2007,['United States of America'],"['Animals', 'Short Film', 'World History', 'Documentary', 'Nature']",2000,7
31021585,The Milkman,1950,['United States of America'],['Comedy film'],1950,0
4578206,"Torrente, el brazo tonto de la ley",1998,['Spain'],"['Comedy Thriller', 'Comedy', 'Crime Comedy']",1990,8
17571858,Never Let Go,1960,"['United Kingdom', 'England']","['Crime Fiction', 'Thriller', 'Crime Thriller', 'Drama']",1960,0
29084714,Bang! You're Dead,1954,[],['Drama'],1950,4
399725,Orgazmo,1997,['United States of America'],"['Parody', 'Indie', 'Comedy', 'Superhero movie', 'Science Fiction', 'Cult', 'Sex comedy']",1990,7
26484626,Runaway,2009,['Canada'],"['Animation', 'Short Film', 'Comedy']",2000,9
23346792,Die Jungfrau auf dem Dach,1954,"['Austria', 'United States of America']","['Comedy', 'Black-and-white']",1950,4
26735616,SM Teacher: Tied Up by Students,1996,['Japan'],['Japanese Movies'],1990,6
644385,You Can Count on Me,2000,['United States of America'],"['Indie', 'Family Drama', 'Drama']",2000,0
4372787,Nero,2004,"['United Kingdom', 'Spain', 'Italy']","['Action', 'Drama', 'Biography', 'World cinema', 'Television movie']",2000,4
189088,A Perfect Murder,1998,['United States of America'],"['Suspense', 'Crime Thriller', 'Thriller']",1990,8
26048076,Mannar Mathai Speaking,1995,['India'],['Comedy'],1990,5
2864621,Click,2006,['United States of America'],"['Time travel', 'Comedy', 'Romance Film', 'Comedy-drama', 'Science Fiction', 'Drama', 'Fantasy']",2000,6
2364320,2x4,1998,['United States of America'],"['Gay Themed', 'LGBT', 'Indie', 'Drama']",1990,8
20906246,Bamboo Gods and Iron Men,1972,"['Hong Kong', 'Philippines']","['Action', 'Filipino Movies', 'Blaxploitation', 'Action/Adventure', 'Chinese Movies', 'Martial Arts Film']",1970,2
10821331,Dance of the Drunk Mantis,1979,['Hong Kong'],"['Action', 'Action/Adventure', 'Comedy', 'World cinema', 'Chinese Movies', 'Martial Arts Film', 'Dogme 95', 'Action Comedy']",1970,9
30865068,Bride of Chucky,1998,"['Canada', 'United States of America']","['Horror Comedy', 'Thriller', 'Comedy', 'Black comedy', 'Romance Film', 'Slasher', 'Horror', 'Supernatural', 'Cult']",1990,8
657809,The Next Karate Kid,1994,['United States of America'],"['Action', 'Coming of age', 'Teen', 'Martial Arts Film', 'Drama']",1990,4
15316964,The She Creature,1956,['United States of America'],"['Horror', 'Fantasy']",1950,6
16510955,Peter Pan,1988,['Australia'],"['Animation', 'Adventure', 'Family Film', 'Fantasy']",1980,8
7379134,Man of La Mancha,1972,"['Italy', 'United States of America']","['Musical', 'Film adaptation', 'Musical Drama', 'Action/Adventure', 'Musical comedy', 'Adventure', 'Drama']",1970,2
21363754,47 Rojulu,1981,['India'],['Drama'],1980,1
15264095,Springfield Rifle,1952,['United States of America'],"['Action', 'Western', 'Action/Adventure']",1950,2
6459226,Mrs. Palfrey at the Clarmemont,2005,['United Kingdom'],"['Film adaptation', 'Drama', 'Indie', 'Comedy-drama']",2000,5
23856720,Merantau,2009,['Indonesia'],"['Action', 'Action/Adventure', 'Thriller', 'World cinema', 'Martial Arts Film', 'Adventure']",2000,9
3520805,Genius,1999,['United States of America'],['Comedy'],1990,9
4301557,City on Fire,1979,"['Canada', 'United States of America']","['Action', 'Drama', 'Thriller', 'Disaster']",1970,9
142469,The Insider,1999,['United States of America'],"['Biographical film', 'Thriller', 'Docudrama', 'Political drama', 'Drama']",1990,9
6610209,The Education Of Charlie Banks,2009,['United States of America'],"['Crime Fiction', 'Coming of age', 'Indie', 'Drama']",2000,9
6664903,The World Gone Mad,1933,['United States of America'],"['Black-and-white', 'Thriller', 'Political drama', 'Drama']",1930,3
2280353,Cemetery Man,1994,"['France', 'Germany', 'Italy']","['Comedy', 'Horror', 'Black comedy', 'Zombie Film', 'Cult']",1990,4
9443272,Boog and Elliot's Midnight Bun Run,2007,['United States of America'],"['Computer Animation', 'Animation', 'Short Film']",2000,7
62111,Dark Victory,1939,['United States of America'],"['Black-and-white', 'Romantic drama', 'Romance Film', 'Drama', 'Tragedy']",1930,9
3390263,15 Minutes,2001,"['Germany', 'United States of America']","['Action', 'Psychological thriller', 'Crime Fiction', 'Action/Adventure', 'Thriller', 'Media Satire', 'Crime Thriller', 'Drama']",2000,1
11107075,Bats,1999,['United States of America'],"['Action', 'Thriller', 'Horror', 'Natural horror films']",1990,9
6311923,The Egyptian,1954,['United States of America'],"['Period piece', 'Historical fiction', 'Drama']",1950,4
171555,Gods and Monsters,1998,"['United Kingdom', 'United States of America']","['Film adaptation', 'LGBT', 'Biography', 'Indie', 'Biographical film', 'Drama', 'Period piece', 'Gay Themed', 'Gay', 'Gay Interest']",1990,8
17767507,Apa Kata Hati,2008,['Malaysia'],['Comedy'],2000,8
5841787,Partner,2007,['India'],"['Musical', 'Comedy', 'Bollywood', 'World cinema']",2000,7
1599541,Bewitched,2005,['United States of America'],"['Comedy', 'Romance Film', 'Romantic comedy', 'Fantasy']",2000,5
24710266,Bhargavi Nilayam,1964,[],['Horror'],1960,4
6131232,Godavari,2006,['India'],"['Romantic drama', 'World cinema', 'Romance Film', 'Romantic comedy', 'Tollywood', 'Drama']",2000,6
21761120,Three Men in a Boat,1956,"['United Kingdom', 'England']","['Romance Film', 'Animation', 'Comedy']",1950,6
27544609,The End of the Line,1957,['United Kingdom'],"['Drama', 'Crime Fiction']",1950,7
23180627,One Tough Bastard,1996,['United States of America'],"['Action', 'Crime Fiction', 'Action Thrillers', 'Action/Adventure', 'Thriller']",1990,6
12297466,Homecoming,1928,['Germany'],"['Romance Film', 'War film', 'Drama']",1920,8
12276238,The Heist,2001,['United States of America'],"['Action', 'Crime Fiction', 'Thriller']",2000,1
18243294,The Great Moment,1944,['United States of America'],"['Black-and-white', 'Biography', 'Biographical film', 'Drama']",1940,4
307158,Bugsy Malone,1976,"['United Kingdom', 'United States of America']","['Music', 'Musical', 'Crime Fiction', 'Gangster Film', 'Comedy', 'Musical comedy', ""Children's"", 'Parody', 'Family Film']",1970,6
8915540,Batman,1943,['United States of America'],"['Superhero movie', 'Black-and-white', 'Propaganda film']",1940,3
12025545,Gasoline,2002,['Italy'],"['Psychological thriller', 'LGBT', 'Crime Fiction', 'Romantic drama', 'Thriller', 'World cinema', 'Romance Film', 'Drama', 'Gay Themed', 'Gay', 'Chase Movie', 'Gay Interest', 'Erotic thriller']",2000,2
25946368,Hard Promises,1991,['United States of America'],"['Indie', 'Comedy', 'Romance Film', 'Romantic comedy', 'Domestic Comedy']",1990,1
2853352,Aayitha Ezhuthu,2004,['India'],"['Political cinema', 'Action/Adventure', 'Thriller', 'World cinema', 'Tamil cinema', 'Drama', 'Political thriller']",2000,4
6036963,Familia,2005,['Canada'],"['Indie', 'Drama']",2000,5
1233576,Twins,1988,['United States of America'],"['Buddy film', 'Comedy']",1980,8
7407098,Home Sweet Home,2005,['Hong Kong'],"['Chinese Movies', 'World cinema', 'Horror', 'Drama']",2000,5
10988261,Shaolin Handlock,1978,['Hong Kong'],"['Action', 'Action/Adventure', 'Thriller', 'World cinema', 'Chinese Movies', 'Martial Arts Film']",1970,8
35249672,Kankan De Ole,1970,['India'],"['Romance Film', 'Drama']",1970,0
4650848,Nine Lives,2005,['United States of America'],['Drama'],2000,5
13838662,Miracle at St. Anna,2008,"['Italy', 'United States of America']","['Period piece', 'Film adaptation', 'Crime Fiction', 'War film', 'Drama']",2000,8
32035973,The Empty Star,1960,[],['Drama'],1960,0
1127093,Mean Creek,2004,['United States of America'],"['Suspense', 'Drama', 'Crime Fiction', 'Coming of age', 'Indie', 'Tragedy']",2000,4
6647928,Slumber Party Massacre 2,1987,['United States of America'],"['Slasher', 'Teen', 'Horror']",1980,7
12042846,Spirit Bear: The Simon Jackson Story,2005,['Canada'],"['Family Drama', 'Childhood Drama', ""Children's/Family"", 'Drama', 'Coming of age', 'Biopic [feature]', 'Animal Picture', 'Television movie', 'Family Film']",2000,5
30044742,Draupadi Vastrapaharanam,1936,['India'],['Drama'],1930,6
18630754,Revive! Ultraman,1996,['Japan'],"['Short Film', 'Japanese Movies']",1990,6
20989785,100 Million BC,2008,['United States of America'],"['Action', 'Indie', 'Horror', 'Adventure', 'Science Fiction', 'Fantasy']",2000,8
30863353,"Mumsy, Nanny, Sonny and Girly",1969,['United Kingdom'],"['Crime Fiction', 'Slasher', 'Comedy film', 'Horror']",1960,9
23396344,Blood: The Last Vampire,2009,"['France', 'Hong Kong', 'China']","['Action', 'Chinese Movies', 'Action/Adventure', 'Thriller', 'Remake', 'Horror', 'World cinema']",2000,9
23140704,Lelam,1997,['India'],"['Action', 'Thriller', 'Bollywood']",1990,7
1004972,Black Sabbath,1963,['Italy'],"['Horror', 'Supernatural', 'World cinema']",1960,3
896237,The Wrong Trousers,1993,['United Kingdom'],"['Crime Fiction', 'Animation', 'Comedy', ""Children's/Family"", 'Parody', 'Short Film', 'Crime Comedy', 'Stop motion', 'Fantasy']",1990,3
1367442,Cross Creek,1983,['United States of America'],"['Period piece', 'Biography', 'Romantic drama', 'Biopic [feature]', 'Romance Film', 'Docudrama', 'Drama']",1980,3
8577671,Absurdistan,2008,"['Azerbaijan', 'Germany']","['Comedy', 'World cinema', 'Romance Film', 'Romantic comedy', 'Slice of life story']",2000,8
25366718,Buried Secrets,1996,[],"['Mystery', 'Drama', 'Horror']",1990,6
145046,The Affairs of Cellini,1934,['United States of America'],"['Black-and-white', 'Screwball comedy', 'Comedy', 'Biopic [feature]', 'Costume drama', 'Adventure', 'Drama']",1930,4
15920311,Who's Your Daddy?,2004,['United States of America'],"['Comedy', 'Teen', 'Sex comedy']",2000,4
5028212,Murder on the Orient Express,2001,['United States of America'],"['Film adaptation', 'Mystery', 'Thriller', 'Television movie', 'Crime Thriller', 'Drama']",2000,1
29112615,Thalaivan Irukkiraan,2009,['India'],['Thriller'],2000,9
25849360,Manasu Palike Mouna Raagam,2006,[],"['Romance Film', 'Drama', 'Family Film']",2000,6
27350714,Texas,1941,['United States of America'],"['Action', 'Drama', 'Action/Adventure', 'Western']",1940,1
5352769,Chellamae,2004,['India'],"['Romance Film', 'Tamil cinema']",2000,4
20869430,Two: An Amazing Couple,2003,"['France', 'Belgium']","['Romantic drama', 'Comedy', 'Comedy film', 'World cinema', 'Romance Film', 'Romantic comedy', 'Drama']",2000,3
223268,The Royal Tenenbaums,2001,['United States of America'],"['Comedy', 'Comedy of manners', 'Black comedy', 'Comedy-drama', 'Drama', 'Cult']",2000,1
2051678,Bunty Aur Babli,2005,['India'],"['Musical', 'Comedy', 'Bollywood', 'World cinema', 'Romance Film']",2000,5
8691247,The Baker's Wife,1938,['France'],"['Black-and-white', 'Marriage Drama', 'Comedy', 'Comedy-drama', 'Drama']",1930,8
23689509,The Three-Day Reign,1973,['South Korea'],['Drama'],1970,3
31441995,Deathstalker IV: Match of Titans,1990,['United States of America'],"['Action/Adventure', 'Fantasy']",1990,0
142049,Minority Report,2002,['United States of America'],"['Action', 'Film adaptation', 'Crime Fiction', 'Mystery', 'Action/Adventure', 'Thriller', 'Film noir', 'Drama', 'Dystopia', 'Future noir', 'Chase Movie', 'Science Fiction']",2000,2
705756,The Mask of Zorro,1998,"['Germany', 'United States of America']","['Action', 'Costume Adventure', 'Action/Adventure', 'Romance Film', 'Costume drama', 'Adventure', 'Swashbuckler films', 'Western', 'Superhero movie']",1990,8
2636985,Dressed to Kill,1941,['United States of America'],"['Black-and-white', 'Crime Fiction', 'Mystery', 'Thriller', 'Film noir', 'Drama']",1940,1
23494455,Hôtel des Amériques,1981,['France'],"['Romantic drama', 'Drama']",1980,1
2245886,Mousehunt,1997,['United States of America'],"['Slapstick', 'Comedy', 'Black comedy', 'Family Film']",1990,7
17063281,The Simple-Minded Murder,1981,['Sweden'],['Drama'],1980,1
22005771,An American Girl: Chrissa Stands Strong,2009,['United States of America'],"['Family Drama', 'Drama', 'Family Film']",2000,9
6618875,Box of Moonlight,1997,['United States of America'],"['Drama', 'Indie', 'Comedy', 'Comedy of manners', 'Black comedy', 'Comedy-drama', 'Cult']",1990,7
3645663,Il Posto,1961,['Italy'],"['Black-and-white', 'Comedy', 'World cinema', 'Drama']",1960,1
22661371,The Foursome,2006,"['Canada', 'United States of America']","['Sports', 'Comedy film', 'Sex comedy']",2000,6
31213113,Look,2009,[],"['Short Film', 'Drama', 'Fantasy']",2000,9
1799076,Pecker,1998,['United States of America'],"['LGBT', 'Indie', 'Comedy', 'Media Satire', 'Domestic Comedy', 'Comedy-drama', 'Cult']",1990,8
31530345,Jamai Shashur,2003,['Bangladesh'],"['Drama', 'Comedy film']",2000,3
4419809,Andre,1994,['United States of America'],"['Family Drama', ""Children's"", 'Drama', 'Family Film']",1990,4
4123826,H. G. Wells' The Shape of Things to Come,1979,['Canada'],"['Film adaptation', 'Adventure', 'Science Fiction', 'Drama']",1970,9
1336467,Pursued,1947,['United States of America'],"['Psychological thriller', 'Black-and-white', 'Action/Adventure', 'Western', 'Thriller', 'Film noir']",1940,7
12267883,He Was a Quiet Man,2007,['United States of America'],"['Drama', 'Indie', 'Comedy', 'Black comedy']",2000,7
217776,"They Shoot Horses, Don't They?",1969,['United States of America'],"['Period piece', 'Psychological thriller', 'Existentialism', 'Melodrama', 'Drama']",1960,9
24274120,Videocracy,2009,"['Denmark', 'Sweden', 'Finland', 'United Kingdom', 'Italy']","['Film & Television History', 'World cinema', 'Documentary', 'Film', 'War film', 'Culture & Society', 'Social issues', 'Political drama']",2000,9
9842738,Unveiled,2005,"['Austria', 'Germany']","['LGBT', 'Drama', 'World cinema']",2000,5
7233728,Demon Hunter,2005,['United States of America'],"['Action', 'Supernatural', 'Horror']",2000,5
21977717,The Cake Eaters,2007,['United States of America'],"['Romantic drama', 'Indie', 'Romance Film', 'Drama']",2000,7
14810742,Aap Ke Saath,1986,['India'],"['Romantic drama', 'World cinema', 'Romance Film', 'Drama']",1980,6
4343453,Slumber Party Massacre,1982,['United States of America'],"['Indie', 'Slasher', 'Teen', 'Horror']",1980,2
3142340,A Very Brady Sequel,1996,['United States of America'],"['Parody', 'Comedy']",1990,6
22989382,Kodiyettam,1977,['India'],['Drama'],1970,7
1748388,Sanshiro Sugata Part II,1945,['Japan'],"['Japanese Movies', 'World cinema']",1940,5
1871167,Welcome to Mooseport,2004,"['Germany', 'United States of America']","['Political cinema', 'Comedy', 'Romance Film', 'Americana']",2000,4
3492397,Slipstream,2005,"['Zambia', 'Germany', 'South Africa', 'United States of America']","['Heist', 'Science Fiction', 'Thriller']",2000,5
35813673,Satellite in the Sky,1956,['United Kingdom'],"['Science Fiction', 'Drama']",1950,6
20826924,Strictly Sinatra,2001,['United Kingdom'],"['Drama', 'Crime Fiction', 'Gangster Film', 'Indie', 'Crime Drama', 'Comedy-drama', 'Comedy of Errors']",2000,1
13261740,Raving,2007,['United States of America'],"['Short Film', 'Drama']",2000,7
12507175,The Duchess,2008,"['United Kingdom', 'France', 'Italy', 'United States of America']","['Film adaptation', 'Romantic drama', 'Biographical film', 'Romance Film', 'Costume drama', 'Drama', 'Period piece', 'History']",2000,8
11482732,The Understanding Heart,1927,['United States of America'],"['Black-and-white', 'Drama', 'Indie', 'Silent film', 'Adventure']",1920,7
7213804,Submarine Attack,1954,['Italy'],"['Action', 'Action/Adventure', 'World cinema', 'Adventure', 'War film']",1950,4
6025604,The Grey Fox,1982,['Canada'],"['Period piece', 'Biography', 'Action/Adventure', 'Western', 'Biopic [feature]', 'Crime Drama', 'Drama']",1980,2
349874,The Inn of the Sixth Happiness,1958,"['United Kingdom', 'United States of America']","['Period piece', 'Biography', 'Biopic [feature]', 'Epic', 'War film', 'Drama']",1950,8
15235501,The Student Boarder,1966,['South Korea'],"['Romance Film', 'Drama', 'Thriller']",1960,6
5614046,Trauma,1993,"['Italy', 'United States of America']","['Psychological thriller', 'Mystery', 'Slasher', 'Thriller', 'Horror']",1990,3
36415448,"Droopy's \\""Double Trouble\\""",1951,['United States of America'],"['Animation', 'Short Film', 'Comedy film', 'Family Film']",1950,1
2696597,Soldier of Fortune,1955,['United States of America'],"['Action', 'Drama', 'Action/Adventure', 'Adventure']",1950,5
14478278,Planet 51,2009,"['United Kingdom', 'Spain', 'United States of America']","['Animation', 'Satire', 'Comedy', 'Adventure', 'Computer Animation', 'Alien Film', 'Science Fiction', 'Family Film']",2000,9
15098674,The Accused,1949,['United States of America'],"['Black-and-white', 'Thriller', 'Film noir', 'Drama']",1940,9
17771198,Devilwood,2006,['United Kingdom'],"['History', 'Short Film', 'Thriller', 'Horror']",2000,6
18497116,Anak,2000,['Philippines'],"['Filipino Movies', 'Drama', 'World cinema']",2000,0
3846858,It's Great to Be Alive,1933,['United States of America'],"['Musical', 'Black-and-white', 'Comedy', 'Science Fiction']",1930,3
22065787,Childhood Days,1990,['Japan'],"['Japanese Movies', 'Drama']",1990,0
14605691,Man-Trap,1961,['United States of America'],"['Crime Fiction', 'Thriller', 'Film noir', 'Crime Thriller', 'Drama']",1960,1
1240693,Gold Rush Daze,1939,['United States of America'],"['Animation', 'Western', 'Short Film', 'Comedy', 'Family Film']",1930,9
23501520,Dolan's Cadillac,2009,"['Canada', 'United Kingdom']","['Crime Fiction', 'Crime Thriller', 'Thriller']",2000,9
739259,Blind Date,1987,['United States of America'],"['Comedy', 'Romance Film', 'Romantic comedy', 'Slapstick']",1980,7
4773885,Chatrapati,2005,['India'],"['Action', 'World cinema', 'Tollywood', 'Drama']",2000,5
21320194,The Old Fashioned Way,1934,['United States of America'],"['Slapstick', 'Comedy']",1930,4
4986149,Troll 3,1990,['Italy'],"['Horror', 'B-movie']",1990,0
706863,Bordello of Blood,1996,['United States of America'],"['Black comedy', 'Comedy', 'Horror']",1990,6
5394916,Seeing Double,2003,['United Kingdom'],"['Musical', 'Family & Personal Relationships', 'Comedy', 'Teen', 'Culture & Society']",2000,3
4062150,Tanin no kao,1966,['Japan'],"['Surrealism', 'Psychological thriller', 'Black-and-white', 'Japanese Movies', 'Science Fiction', 'Drama']",1960,6
5529883,A Guide to Recognizing Your Saints,2006,['United States of America'],"['Crime Fiction', 'Coming of age', 'Indie', 'Drama']",2000,6
8269287,Forced Vengeance,1982,['United States of America'],"['Action', 'Action Thrillers', 'Action/Adventure', 'Thriller', 'Adventure', 'Martial Arts Film']",1980,2
42313,The Wicker Man,1973,['United Kingdom'],"['Crime Fiction', 'Mystery', 'Thriller', 'Horror']",1970,3
21516811,Big Fella,1937,['United Kingdom'],"['Black-and-white', 'Musical Drama', 'Melodrama', 'Drama']",1930,7
27490108,A Tiger's Tale,1987,['United States of America'],"['Drama', 'Comedy film']",1980,7
14197936,The Whole Town's Talking,1935,['United States of America'],"['Black-and-white', 'Crime Fiction', 'Comedy', 'Crime Comedy', 'Comedy of Errors']",1930,5
23752458,Personal Affair,1953,['United Kingdom'],"['Suspense', 'Film adaptation', 'Crime Fiction', 'Mystery', 'Thriller', 'Drama']",1950,3
24050726,Dreaming Out Loud,1940,['United States of America'],['Comedy film'],1940,0
11570146,The Object of Beauty,1991,"['United Kingdom', 'United States of America']","['Crime Fiction', 'Comedy', 'Crime Comedy', 'Comedy of manners', 'Drama']",1990,1
31397954,Sasneham,1990,[],"['Drama', 'Comedy film']",1990,0
8367659,Visible Secret,2001,['Hong Kong'],"['Horror Comedy', 'World cinema', 'Horror', 'Chinese Movies']",2000,1
14738984,Studio Stoops,1950,['United States of America'],"['Short Film', 'Black-and-white', 'Comedy']",1950,0
5805854,Last Exit,2003,['Denmark'],"['Psychological thriller', 'Crime Fiction', 'Mystery', 'Thriller', 'World cinema', 'Crime Thriller', 'Drama']",2000,3
13259400,Cutaway,2000,['United States of America'],"['Action', 'Crime Fiction', 'Indie', 'Action/Adventure', 'Thriller']",2000,0
841309,Belly of the Beast,2003,"['United Kingdom', 'Hong Kong', 'Canada']","['Action', 'Action Thrillers', 'Action/Adventure', 'Thriller', 'Crime Thriller', 'Chinese Movies', 'Martial Arts Film', 'Political thriller']",2000,3
3710785,National Treasure: Book of Secrets,2007,['United States of America'],"['Action', 'Action Thrillers', 'Mystery', 'Action/Adventure', 'Thriller', 'Archives and records', 'Adventure', 'Caper story']",2000,7
24083596,Desperate Remedies,1993,['New Zealand'],['Drama'],1990,3
1962913,The Three Musketeers,1993,"['United Kingdom', 'Austria', 'United States of America']","['Action', 'Action/Adventure', 'Comedy', 'Romance Film', 'Swashbuckler films', 'Costume drama', 'Adventure', 'Family Film']",1990,3
5716877,The Chamber,1996,['United States of America'],"['Courtroom Drama', 'Film adaptation', 'Crime Fiction', 'Family Drama', 'Thriller', 'Drama']",1990,6
24507654,Chirag,1969,['India'],"['Romantic drama', 'Bollywood', 'World cinema', 'Romance Film', 'Drama']",1960,9
6942006,Iron Eagle II,1988,"['Canada', 'Israel']","['Action', 'Action Thrillers', 'Action/Adventure', 'Thriller', 'Adventure']",1980,8
1118829,Parenthood,1989,['United States of America'],"['Comedy', 'Domestic Comedy', 'Comedy-drama', 'Drama', 'Ensemble Film']",1980,9
16168330,Varnajaalam,2004,['India'],"['Action/Adventure', 'Drama', 'World cinema']",2000,4
21513056,Son-Rise: A Miracle of Love,1979,['United States of America'],['Drama'],1970,9
6210832,Blackbeard the Pirate,1952,['United States of America'],"['Action', 'Action/Adventure', 'Adventure', 'Swashbuckler films']",1950,2
6590278,Thamiraparani,2007,['India'],"['Action', 'Musical', 'Drama', 'Bollywood', 'World cinema']",2000,7
919392,The Recruit,2003,['United States of America'],"['Action', 'Psychological thriller', 'Spy', 'Crime Fiction', 'Action/Adventure', 'Thriller', 'Drama', 'Suspense']",2000,3
26109955,Deli Yürek: Bumerang Cehennemi,2001,['Turkey'],"['Action', 'Drama']",2000,1
36151270,Agneekaal,1990,['India'],"['Action', 'Crime Fiction', 'Drama']",1990,0
474556,Le Divorce,2003,"['United States of America', 'France']","['Film adaptation', 'Comedy', 'Comedy of manners', 'Romance Film', 'Romantic comedy', 'Comedy-drama', 'Drama']",2000,3
3403739,Flaxy Martin,1949,['United States of America'],"['Black-and-white', 'Crime Fiction', 'Mystery', 'Thriller', 'Film noir', 'Drama', 'Chase Movie', 'Crime Drama']",1940,9
13035093,Silsilay,2005,['India'],['Drama'],2000,5
21141431,Thanassakis o politevomenos,1954,['Greece'],['Comedy'],1950,4
1373745,London Voodoo,2004,['United Kingdom'],"['Supernatural', 'Thriller', 'Horror']",2000,4
5185489,God of Gamblers III: Back to Shanghai,1991,"['China', 'Hong Kong']","['Action/Adventure', 'Comedy', 'World cinema', 'Chinese Movies', 'Fantasy']",1990,1
28773683,Meenathil Thalikettu,1998,['India'],['Drama'],1990,8
20533141,What's Sweepin',1953,['United States of America'],"['Animation', 'Short Film', 'Family Film']",1950,3
24620315,Confessions of an Action Star,2008,"['Austria', 'United States of America']","['Action', 'Musical', 'Action/Adventure', 'Comedy', 'Media Satire', 'Mockumentary', 'Martial Arts Film']",2000,8
3653924,I Vitelloni,1953,"['France', 'Italy']","['Black-and-white', 'Drama', 'Indie', 'Satire', 'Comedy', 'World cinema', 'Comedy-drama']",1950,3
2265148,Without a Clue,1988,['United Kingdom'],"['Mystery', 'Parody', 'Comedy Thriller', 'Thriller', 'Satire', 'Comedy']",1980,8
650540,Dracula: Dead and Loving It,1995,"['France', 'United States of America']","['Parody', 'Comedy', 'Horror Comedy', 'Horror', 'Slapstick', 'Absurdism']",1990,5
34573784,The Royal African Rifles,1953,['United States of America'],['Adventure'],1950,3
21222076,The Annunciation of Marie,1991,"['Canada', 'France']","['Romance Film', 'Drama']",1990,1
21651467,Cyclone,1987,['United States of America'],"['Action', 'Spy', 'Crime Fiction', 'Action/Adventure', 'Thriller', 'Science Fiction']",1980,7
13596002,Beyond the Border,1925,['United States of America'],"['B-Western', 'Black-and-white', 'Indie', 'Western', 'Silent film']",1920,5
9973292,Cell Phone,2003,['China'],"['Comedy', 'Comedy-drama', 'Chinese Movies', 'Drama']",2000,3
1243485,Mockingbird Don't Sing,2001,['United States of America'],"['Indie', 'Biography', 'Biographical film', 'Childhood Drama', 'Drama']",2000,1
28140856,The Penthouse,2009,['United States of America'],"['Indie', 'Comedy']",2000,9
5565692,House Party 4: Down to the Last Minute,2001,['United States of America'],"['Coming of age', 'Comedy', 'Teen', 'Cult']",2000,1
20915811,Dad and Dave Come to Town,1938,['Australia'],['Comedy'],1930,8
3906544,The Devil Bat,1940,['United States of America'],"['Black-and-white', 'Natural horror films', 'Horror']",1940,0
6145345,La Noche de Walpurgis,1971,['Spain'],['Horror'],1970,1
20955374,The Cry,2007,['United States of America'],"['Thriller', 'Horror']",2000,7
1246454,Born Innocent,1974,['United States of America'],"['Prison', 'Crime Fiction', 'Melodrama', 'Television movie', 'Drama']",1970,4
2406759,Santa Claus: The Movie,1985,"['United Kingdom', 'United States of America']","['Family-Oriented Adventure', ""Children's/Family"", 'Holiday Film', ""Children's"", 'Adventure', ""Children's Fantasy"", 'Family Film', 'Fantasy']",1980,5
23170940,Asylum of the Damned,2003,['United States of America'],"['Horror', 'B-movie']",2000,3
1247973,Open Range,2003,['United States of America'],"['Action', 'Period piece', 'Action/Adventure', 'Western', 'Romance Film', 'Drama']",2000,3
30515944,Bhakta Kuchela,1961,['India'],[],1960,1
2423462,One Fine Day,1996,['United States of America'],"['Romance Film', 'Comedy']",1990,6
31351236,Totally Blonde,2001,['United States of America'],"['Romance Film', 'Romantic comedy', 'Comedy']",2000,1
3391405,Noriko's Dinner Table,2005,['Japan'],"['Japanese Movies', 'Horror', 'World cinema', 'Drama']",2000,5
26674376,Kalisundam Raa,2000,['India'],['Family Film'],2000,0
4867662,Atomic Twister,2002,['United States of America'],"['Action', 'Disaster']",2000,2
24498032,Seven Thunders,1957,['United Kingdom'],"['War film', 'Drama']",1950,7
12566479,Xtro 3: Watch the Skies,1995,"['United Kingdom', 'United States of America']","['B-movie', 'Science Fiction', 'Horror']",1990,5
8060080,Malone,1987,['United States of America'],"['Action', 'Crime Fiction', 'Western', 'Action/Adventure', 'Thriller']",1980,7
8436483,Girl with Hyacinths,1950,['Sweden'],"['Mystery', 'Drama']",1950,0
5735526,Xica,1996,['Brazil'],"['Drama', 'Political drama', 'Biopic [feature]']",1990,6
625714,The Big Kahuna,2000,['United States of America'],"['Indie', 'Comedy', 'Black comedy', 'Comedy-drama', 'Drama']",2000,0
3861623,Waikiki Brothers,2001,['South Korea'],['Drama'],2000,1
1495388,The Many Adventures of Winnie the Pooh,1977,['United States of America'],"['Musical', 'Animation', 'Animated Musical', 'Comedy', ""Children's/Family"", 'Drama', 'Family Film']",1970,7
23745306,Crocodile Gena,1969,['Soviet Union'],"['Animation', 'Short Film', 'Stop motion', 'Family Film']",1960,9
1355085,The Golden Compass,2007,"['United Kingdom', 'United States of America']","['Fantasy Adventure', 'Film adaptation', 'Action/Adventure', 'Adventure', 'Steampunk', 'Drama', 'Fantasy']",2000,7
6790254,The Blossoming of Maximo Oliveros,2005,['Philippines'],"['Filipino Movies', 'LGBT', 'Comedy', 'World cinema', 'Drama']",2000,5
1222278,Vincent,1982,['United States of America'],"['Animation', 'Biography', 'Short Film', 'Stop motion', 'Drama', 'Family Film', 'Fantasy']",1980,2
2660232,The Burmese Harp,1956,['Japan'],"['Music', 'Black-and-white', 'Japanese Movies', 'World cinema', 'War film', 'Drama']",1950,6
6729640,Raaz,2002,['India'],"['Bollywood', 'Thriller', 'Horror', 'World cinema']",2000,2
15211401,A Price Above Rubies,1998,"['United Kingdom', 'United States of America']","['Drama', 'Indie', 'Romantic drama', 'Marriage Drama', 'Romance Film', 'Feminist Film']",1990,8
3059075,Brain Donors,1992,['United States of America'],"['Buddy film', 'Comedy', 'Slapstick', 'Absurdism']",1990,2
20979004,An American Daughter,2001,['United States of America'],"['Drama', 'Political drama']",2000,1
4724358,Gangster Wars,1981,['United States of America'],"['Crime Fiction', 'Gangster Film', 'Biopic [feature]', 'Drama']",1980,1
1252250,"Godzilla, Mothra and King Ghidorah: Giant Monsters All-Out Attack",2001,['Japan'],"['Action', 'Monster', 'Action/Adventure', 'World cinema', 'Creature Film', 'Japanese Movies', 'Science Fiction', 'Cult', 'Fantasy']",2000,1
6361585,The Red Baron,2008,"['United Kingdom', 'Germany', 'United States of America']","['Action', 'Biographical film', 'World cinema', 'Romance Film', 'Adventure', 'Drama', 'Period piece', 'War film']",2000,8
11335489,Our Man in Marrakesh,1966,"['United Kingdom', 'United States of America']","['Action', 'Spy', 'Comedy Thriller', 'Thriller', 'Comedy']",1960,6
28963115,Bowery Champs,1944,['United States of America'],"['Action', 'Crime Fiction', 'Comedy']",1940,4
19947505,Commando Leopard,1985,['Italy'],['War film'],1980,5
5135802,Eaten Alive,1977,['United States of America'],"['Slasher', 'Horror', 'B-movie', 'Cult']",1970,7
2325197,Toolbox Murders,2003,['United States of America'],"['Slasher', 'Horror', 'Supernatural', 'Cult']",2000,3
9424543,The Island,2006,['Russia'],"['Art film', 'Biographical film', 'World cinema', 'Christian film', 'Drama']",2000,6
26087436,Panduranga Mahathyam,1957,['India'],"['Drama', 'World cinema']",1950,7
17381108,Never Cry Werewolf,2008,['Canada'],['Horror'],2000,8
5386187,Vampires Vs. Zombies,2004,['United States of America'],"['Indie', 'Slasher', 'Horror', 'B-movie', 'Zombie Film']",2000,4
7014694,Ernest Goes to Africa,1997,['United States of America'],"['Adventure Comedy', 'Slapstick', 'Comedy', 'Family Film', 'Comedy of Errors']",1990,7
31572654,Paris in Spring,1935,['United States of America'],"['Musical', 'Comedy', 'Comedy film']",1930,5
14645904,Love Walked In,1997,"['Argentina', 'United States of America']","['Thriller', 'Drama']",1990,7
25049137,Jaali Note,1960,['India'],"['Romantic drama', 'World cinema', 'Romance Film', 'Drama']",1960,0
12971929,Raqeeb,2007,['India'],"['Romantic drama', 'Thriller', 'World cinema', 'Romance Film', 'Drama']",2000,7
31316923,Leif,1987,[],['Comedy film'],1980,7
4461403,"Hey, Hey, It's Esther Blueburger",2008,"['New Zealand', 'Australia']","['Drama', 'Coming of age', 'Indie', 'Comedy', 'Teen', 'World cinema', 'Black comedy']",2000,8
11682192,Contraband,1980,['Italy'],"['Action', 'Crime Fiction', 'Action/Adventure', 'Thriller', 'World cinema', 'Crime Thriller']",1980,0
21924668,The Hypnotic Eye,1960,['United States of America'],['Horror'],1960,0
19715,Miss Congeniality,2000,"['United States of America', 'Australia']","['Action', 'Crime Fiction', 'Action/Adventure', 'Comedy', 'Thriller', 'Romantic comedy', 'Romance Film']",2000,0
14861958,Shaheed-E-Mohabbat,1999,['India'],['Historical drama'],1990,9
5084872,The Anderson Tapes,1971,['United States of America'],"['Heist', 'Crime Fiction', 'Caper story', 'Thriller', 'Crime Comedy', 'Crime Thriller']",1970,1
12639467,The Boost,1988,['United States of America'],"['Melodrama', 'Addiction Drama', 'Drama']",1980,8
28788717,The Gift of Love,1958,['United States of America'],"['Romance Film', 'Drama']",1950,8
5873064,Summer of Fear,1978,['United States of America'],"['Thriller', 'Horror', 'Teen', 'Supernatural']",1970,8
3151094,Blue Denim,1959,['United States of America'],['Drama'],1950,9
13472401,The Last of the High Kings,1996,"['United Kingdom', 'Denmark', 'Ireland']","['Drama', 'Coming of age', 'Indie', 'Comedy', 'Romantic comedy', 'Romance Film']",1990,6
10131299,There They Go-Go-Go!,1956,['United States of America'],"['Animation', 'Short Film', 'Comedy', 'Family Film']",1950,6
18841979,The Blair Witch Project,1999,['United States of America'],"['Mystery', 'Indie', 'Documentary', 'Archives and records', 'Point of view shot', 'Horror', 'Supernatural', 'Cult']",1990,9
982180,Robin Hood,1973,['United States of America'],"['Animation', 'Romance Film', 'Adventure', 'Drama', 'Family Film']",1970,3
26361837,Housekeeping,1988,['United States of America'],"['Drama', 'Comedy']",1980,8
25223490,Fjols til fjells,1957,['Norway'],['Comedy'],1950,7
32109549,Raman Abdullah,1997,[],[],1990,7
21908394,More of Me,2007,['United States of America'],"['Comedy', 'Television movie']",2000,7
473212,Alice,1990,['United States of America'],"['Drama', 'Indie', 'Romantic drama', 'Comedy', 'Romance Film', 'Romantic comedy']",1990,0
454812,Night of Dark Shadows,1971,['United States of America'],"['Mystery', 'Gothic Film', 'Thriller', 'Horror', 'Romance Film', 'Costume Horror', 'Drama']",1970,1
8178551,Abbott and Costello in the Foreign Legion,1950,['United States of America'],"['Black-and-white', 'Slapstick', 'Comedy', 'Family Film']",1950,0
14727189,Killer Movie,2008,['United States of America'],"['Slasher', 'Thriller', 'Horror', 'Media Satire']",2000,8
36091940,Up Goes Maisie,1946,['United States of America'],['Comedy film'],1940,6
10699255,Kora Kagaz,1974,['India'],"['Musical', 'Bollywood', 'World cinema', 'Drama']",1970,4
490101,Never Say Never Again,1983,"['United Kingdom', 'Germany', 'United States of America']","['Action', 'Spy', 'Action Thrillers', 'Action/Adventure', 'Thriller', 'Glamorized Spy Film']",1980,3
2899225,The Associate,1996,['United States of America'],['Comedy'],1990,6
17008751,Amelia,2009,"['Canada', 'United States of America']","['Period piece', 'Biography', 'Biographical film', 'Romance Film', 'Adventure', 'Drama']",2000,9
10185281,Martin Luther,1953,['United States of America'],"['Biography', 'Biographical film', 'Christian film', 'Drama']",1950,3
4445572,Jonah: A VeggieTales Movie,2002,['United States of America'],"['Music', 'Musical', 'Animation', 'Comedy', 'Family-Oriented Adventure', 'Christian film', ""Children's/Family"", ""Children's"", 'Family Film']",2000,2
12265808,Juken Sentai Gekiranger: Nei-Nei! Hō-Hō! Hong Kong Decisive Battle,2007,['Japan'],"['Short Film', 'Japanese Movies']",2000,7
7115730,"Go, See, and Become",2005,"['Belgium', 'Israel', 'France', 'Italy']","['Drama', 'Political drama']",2000,5
4110795,Fay Grim,2006,"['France', 'Germany', 'United States of America']","['Action', 'Indie', 'Comedy', 'Thriller', 'Crime Thriller', 'Drama', 'Comedy Thriller', 'Political thriller']",2000,6
10095235,Caramuru - A Invenção do Brasil,2001,['Brazil'],"['Romantic comedy', 'Comedy']",2000,1
2331662,Hostel,2005,['United States of America'],"['Mystery', 'Thriller', 'Horror']",2000,5
24414639,Lady Gangster,1942,['United States of America'],"['Black-and-white', 'Crime Fiction', 'Drama']",1940,2
28694354,The Battle of Rogue River,1954,['United States of America'],"['Action/Adventure', 'Western']",1950,4
26220146,Ladies' Choice,1980,['Bulgaria'],['Comedy film'],1980,0
13135874,The Moonshine War,1970,['United States of America'],"['Crime Fiction', 'Comedy', 'Comedy-drama', 'Drama']",1970,0
4693134,Lord Jim,1965,"['United Kingdom', 'United States of America']","['Action', 'Film adaptation', 'Drama', 'Action/Adventure', 'Adventure']",1960,5
2554585,Arthur and the Invisibles,2006,['France'],"['Computer Animation', ""Children's Fantasy"", 'Animation', ""Children's/Family"", 'Adventure', 'Family Film', 'Fantasy']",2000,6
10641008,Sri Raghavendra,1985,['India'],['Drama'],1980,5
29686641,S M S,2008,[],['Crime Fiction'],2000,8
12893065,Descent,2005,['Canada'],"['Action', 'Action/Adventure', 'Thriller', 'Television movie', 'Disaster', 'Science Fiction']",2000,5
14384703,Storm Center,1956,['United States of America'],"['Black-and-white', 'Libraries and librarians', 'Drama']",1950,6
21878601,Charas: A Joint Operation,2004,['India'],"['Action/Adventure', 'Drama', 'World cinema']",2000,4
26069230,C.H.O.M.P.S,1979,['United States of America'],"['Comedy', 'Animal Picture', 'Adventure', 'Family Film']",1970,9
164365,The China Syndrome,1979,['United States of America'],"['Suspense', 'Action/Adventure', 'Thriller', 'Disaster']",1970,9
3894257,Le Corniaud,1965,"['France', 'Italy']","['Comedy', 'Crime Fiction']",1960,5
3747264,Cain and Mabel,1936,['United States of America'],"['Musical', 'Black-and-white', 'Comedy', 'Romance Film', 'Romantic comedy']",1930,6
18480168,The Story of Marie and Julien,2003,"['France', 'Italy']","['Mystery', 'Romantic drama', 'World cinema', 'Romance Film', 'Drama']",2000,3
1740881,"Krakatoa, East of Java",1969,['United States of America'],"['Action', 'Period piece', 'Action/Adventure', 'Natural disaster', 'Disaster', 'Adventure', 'Drama']",1960,9
8623704,Loco Boy Makes Good,1942,['United States of America'],"['Black-and-white', 'Short Film', 'Comedy', 'Slapstick']",1940,2
2294047,Things Are Tough All Over,1982,['United States of America'],"['Comedy', 'Cult', 'Comedy of Errors']",1980,2
8093491,Restless Knights,1935,['United States of America'],"['Short Film', 'Black-and-white', 'Comedy']",1930,5
9980173,Vizontele,2001,['Turkey'],"['Media Satire', 'Drama', 'Comedy']",2000,1
434089,The Man Who Shot Liberty Valance,1962,['United States of America'],"['Action', 'Black-and-white', 'Revisionist Western', 'Action/Adventure', 'Western']",1960,2
664006,Guilty as Sin,1993,['United States of America'],"['Psychological thriller', 'Thriller', 'Erotic thriller', 'Crime Thriller', 'Courtroom Drama']",1990,3
9668048,Bose,2004,['India'],"['Musical', 'Action/Adventure', 'Bollywood', 'World cinema', 'Drama']",2000,4
5348407,Lights in the Dusk,2006,"['France', 'Finland', 'Germany']","['Crime Fiction', 'Comedy', 'World cinema', 'Drama']",2000,6
14010407,Seven Waves Away,1957,['United Kingdom'],"['Black-and-white', 'Drama']",1950,7
5960713,Amblin,1968,['United States of America'],['Short Film'],1960,8
33270548,Hi Honey - I'm Dead,1991,['United States of America'],['Comedy'],1990,1
11965902,Asesinato en el Comité Central,1982,['Spain'],['Thriller'],1980,2
171588,Sweet and Lowdown,1999,['United States of America'],"['Music', 'Comedy']",1990,9
19437772,Raaz 2,2009,['India'],['Horror'],2000,9
10993005,Love's Unending Legacy,2007,['United States of America'],"['Period piece', 'Film adaptation', 'Romantic drama', 'Romance Film', 'Christian film', 'Television movie', 'Drama']",2000,7
24870348,Stan Helsing,2009,"['Canada', 'United States of America']","['Creature Film', 'Comedy horror', 'Parody', 'Slasher', 'Comedy']",2000,9
15593618,Taken,2009,"['United Kingdom', 'France', 'United States of America']","['Action', 'Psychological thriller', 'Suspense', 'Crime Fiction', 'Action/Adventure', 'Thriller', 'Martial Arts Film']",2000,9
27863907,An easy life,1964,['Soviet Union'],"['Comedy', 'Satire']",1960,4
11759979,Hell to Eternity,1961,['United States of America'],"['Drama', 'War film', 'Biopic [feature]']",1960,1
2669177,Vai que é Mole,1960,['Brazil'],['Comedy'],1960,0
1267713,The Others,2001,"['Spain', 'France', 'Italy', 'United States of America']","['Suspense', 'Period piece', 'Mystery', 'Thriller', 'Horror', 'Supernatural', 'Drama']",2000,1
14790667,The Paperboy,1994,"['Canada', 'United States of America']","['Psychological thriller', 'Indie', 'Thriller', 'Horror']",1990,4
9231313,Desperate Journey,1942,['United States of America'],"['Action', 'Combat Films', 'Black-and-white', 'Action/Adventure', 'Propaganda film', 'War film', 'Drama']",1940,2
6499171,Down Among the Z Men,1952,['United Kingdom'],['Comedy'],1950,2
27437950,Curtain Call,1998,['United States of America'],"['Comedy', 'Romance Film', 'Romantic comedy', 'Fantasy']",1990,8
16558535,Ayan,2009,['India'],['Action'],2000,9
8821816,An All Dogs Christmas Carol,1998,['United States of America'],"['Animation', 'Animated Musical', 'Buddy film', 'Comedy', 'Family-Oriented Adventure', ""Children's/Family"", 'Family Film']",1990,8
1631192,Billy the Kid and the Green Baize Vampire,1985,['United Kingdom'],"['Musical', 'Melodrama', 'Drama']",1980,5
24085945,Doctor at Sea,1955,['United Kingdom'],"['Film adaptation', 'Comedy', 'Drama']",1950,5
249838,Bound,1996,['United States of America'],"['Neo-noir', 'Crime Fiction', 'LGBT', 'Gangster Film', 'Indie', 'Thriller', 'Crime Thriller', 'Drama', 'Erotic thriller']",1990,6
33644955,Canadian Can-Can,1967,[],"['Short Film', 'Animation']",1960,7
20120174,Tomar Jonyo,2008,['India'],['Romance Film'],2000,8
16368684,The Babysitter,1995,['United States of America'],"['Psychological thriller', 'Suspense', 'Film adaptation', 'Drama', 'Indie', 'Thriller', 'Erotic thriller']",1990,5
12313925,A Dandy in Aspic,1968,['United Kingdom'],"['Spy', 'Drama', 'Thriller']",1960,8
508458,Bandit Queen,1994,"['United Kingdom', 'India']","['Art film', 'Bollywood', 'World cinema', 'Political drama', 'Drama']",1990,4
1397876,Spawn,1997,['United States of America'],"['Action', 'Fantasy Adventure', 'Superhero', 'Thriller', 'Superhero movie', 'Fantasy']",1990,7
27759205,Dishonour Bright,1936,['United Kingdom'],['Comedy'],1930,6
6398892,The Saint Takes Over,1940,['United States of America'],"['Black-and-white', 'Detective fiction', 'Crime Fiction', 'Mystery', 'Detective', 'Crime Thriller', 'Adventure']",1940,0
3862395,Princess Aurora,2005,['South Korea'],"['Crime Fiction', 'Mystery', 'Drama']",2000,5
15630167,Clubbed,2009,['United Kingdom'],"['Action', 'Crime Fiction', 'Action/Adventure', 'Thriller', 'Crime Thriller', 'Drama', 'Period piece', 'Crime Drama']",2000,9
2804212,Life In A... Metro,2007,['India'],"['Musical', 'Romantic drama', 'Bollywood', 'World cinema', 'Romance Film', 'Romantic comedy', 'Drama']",2000,7
24410494,America,1924,['United States of America'],"['Silent film', 'Romance Film', 'War film']",1920,4
34954248,Le sourire du serpent,2006,"['France', 'Guinea']",['Drama'],2000,6
686033,Cradle Will Rock,1999,['United States of America'],"['Period piece', 'Political drama', 'Drama']",1990,9
2819679,Rare Melodies,1975,['India'],"['Drama', 'Tamil cinema']",1970,5
18097901,One Rainy Afternoon,1936,['United States of America'],"['Black-and-white', 'Comedy', 'Romance Film', 'Romantic comedy']",1930,6
1478417,Portrait of Jennie,1948,['United States of America'],"['Romantic fantasy', 'Romantic drama', 'Romance Film', 'Drama', 'Fantasy']",1940,8
20401025,Evolution: The Musical!,2008,['United States of America'],"['Musical', 'Short Film', 'Satire', 'Comedy', 'Black comedy']",2000,8
28177876,Memories of Murder,1990,['United States of America'],"['Action', 'Crime Fiction', 'Thriller']",1990,0
23352330,Silip Daughters of Eve,1985,['Philippines'],"['Filipino Movies', 'Sexploitation', 'Horror', 'World cinema', 'Romance Film', 'Erotica', 'Drama']",1980,5
5785156,Say Uncle,2006,['United States of America'],"['Black comedy', 'LGBT', 'Comedy']",2000,6
2679338,Aranyer Din Ratri,1970,['India'],"['Musical', 'Comedy', 'Bengali Cinema', 'World cinema', 'Drama']",1970,0
23239530,Separation City,2009,['New Zealand'],"['Comedy', 'Romance Film', 'Romantic comedy', 'Comedy-drama']",2000,9
34130,WarGames,1983,['United States of America'],"['Science Fiction', 'Thriller']",1980,3
19679859,Checkpoint,1956,['United Kingdom'],"['Action', 'Auto racing', 'Crime Fiction', 'Action/Adventure', 'Thriller', 'Sports', 'Drama']",1950,6
14586918,The Adventures of Tom Sawyer,1938,['United States of America'],['Drama'],1930,8
15341941,The Woman in White,1997,['United Kingdom'],"['Suspense', 'Film adaptation', 'Mystery', 'Thriller', 'Television movie', 'Supernatural', 'Drama']",1990,7
27989945,Swarmed,2005,[],"['Action', 'Action/Adventure', 'Thriller', 'Horror', 'Television movie', 'Natural horror films']",2000,5
6895434,Heat,1972,['United States of America'],"['LGBT', 'Indie', 'Comedy', 'Romance Film', 'Drama']",1970,2
28946576,Living on Velvet,1935,['United States of America'],"['Romantic drama', 'Romance Film', 'Melodrama', 'Drama']",1930,5
11028635,Magma: Volcanic Disaster,2006,['United States of America'],"['Action', 'Drama', 'Action/Adventure', 'Thriller', 'Disaster']",2000,6
19400316,Teacher's Beau,1935,['United States of America'],"['Black-and-white', 'Short Film', 'Comedy', 'Family Film']",1930,5
8367437,A Sangre Fría,1947,['Argentina'],"['Crime Fiction', 'Thriller']",1940,7
4108752,A Stranger Is Watching,1982,['United States of America'],"['Psychological thriller', 'Suspense', 'Film adaptation', 'Crime Fiction', 'Mystery', 'Thriller', 'Crime Thriller']",1980,2
14144161,Roar of the Iron Horse,1951,['United States of America'],"['Adventure', 'Black-and-white']",1950,1
4871852,The Tracey Fragments,2007,['Canada'],"['Film adaptation', 'Indie', 'Drama']",2000,7
921865,Beyond the Valley of the Dolls,1970,['United States of America'],"['Sexploitation', 'Parody', 'Satire', 'Comedy', 'Musical comedy', 'Cult']",1970,0
26883454,Wagon Train,1940,['United States of America'],"['Romance Film', 'History', 'Western']",1940,0
23371007,La Gran Aventura Del Zorro,1976,['Mexico'],"['Action', 'Swashbuckler films', 'Adventure']",1970,6
2880425,The Best Man,1999,['United States of America'],"['Drama', 'Comedy']",1990,9
401610,Static Shock,2003,[],[],2000,3
22253674,Suor Emanuelle,1977,['Italy'],"['Softcore Porn', 'Sexploitation', 'World cinema', 'Erotica', 'Adult']",1970,7
3759313,Day of the Dead,2008,['United States of America'],"['Splatter film', 'Thriller', 'Horror', 'Zombie Film', 'Doomsday film', 'Cult']",2000,8
12867966,Dhol,2007,['India'],"['Musical', 'Romantic drama', 'Comedy', 'Bollywood', 'World cinema', 'Romance Film', 'Drama', 'Romantic comedy']",2000,7
12517509,Muay Thai Chaiya,2007,['Thailand'],"['Action', 'Action Thrillers', 'Action/Adventure', 'Thriller', 'World cinema', 'Martial Arts Film']",2000,7
3966243,The Legend of Shenlong: Curse of the Blood Rubies,1986,['Japan'],"['Action', 'Animation', 'Japanese Movies', 'Anime', 'Science Fiction']",1980,6
14109092,Noëlle,2007,['United States of America'],"['Drama', 'Indie', 'Family Drama', 'Christian film', 'Comedy-drama', 'Holiday Film']",2000,7
3044685,The Spider and the Fly,1949,['United Kingdom'],"['Drama', 'Crime Fiction']",1940,9
25304427,Tirugu Leni Manishi,1981,['India'],"['Action', 'Drama', 'Family Film']",1980,1
548259,Van Helsing,2004,"['Czech Republic', 'United States of America']","['Action', 'Monster', 'Action/Adventure', 'Mystery', 'Thriller', 'Costume Horror', 'Costume drama', 'Swashbuckler films', 'Adventure', 'Drama', 'Creature Film', 'Horror', 'Superhero movie', 'Steampunk', 'Fantasy']",2000,4
183575,Querelle,1982,"['France', 'Germany', 'West Germany']","['LGBT', 'Erotic Drama', 'Romantic drama', 'World cinema', 'Romance Film', 'Drama', 'Gay Themed', 'Gay', 'Gay Interest']",1980,2
24944411,Lembing Awang Pulang Ke Dayang,2009,[],['Drama'],2000,9
142327,Groundhog Day,1993,['United States of America'],"['Romantic fantasy', 'Comedy', 'Romance Film', 'Drama', 'Time travel', 'Romantic comedy', 'Fantasy Comedy', 'Fantasy']",1990,3
21737016,Eagle's Wing,1979,['United Kingdom'],"['Action/Adventure', 'Western']",1970,9
2728874,Happiness Is in the Field,1995,['France'],['Comedy film'],1990,5
28253644,Sinners' Holiday,1930,['United States of America'],"['Romance Film', 'Crime Fiction']",1930,0
30891735,Life Is a Bed of Roses,1983,['France'],"['Musical', 'Art film', 'Comedy film', 'World cinema', 'Drama']",1980,3
10825132,Changeling,2008,['United States of America'],"['History', 'Mystery', 'LGBT', 'Thriller', 'Drama']",2000,8
12988101,L' Homme du large,1920,['France'],"['Silent film', 'Black-and-white', 'Indie']",1920,0
10932167,Emperor and His Brother,1981,['Hong Kong'],"['Wuxia', 'Chinese Movies', 'Martial Arts Film']",1980,1
2683330,The Invisible Woman,1940,['United States of America'],"['Black-and-white', 'Comedy', 'Thriller', 'Science Fiction']",1940,0
4633307,Dům pro dva,1987,['Czechoslovakia'],['Drama'],1980,7
22397441,Paper Heart,2009,['United States of America'],"['Indie', 'Comedy', 'Romance Film', 'Romantic comedy', 'Mockumentary']",2000,9
3340222,Day of Wrath,1943,['Denmark'],"['Black-and-white', 'Drama']",1940,3
23321343,Murderer,2009,"['Hong Kong', 'United States of America']","['Crime Fiction', 'Mystery', 'Thriller', 'World cinema', 'Chinese Movies', 'Drama']",2000,9
11453110,Dinotopia: Quest for the Ruby Sunstone,2005,['United States of America'],"['Fantasy Adventure', ""Children's Fantasy"", 'Animation', ""Children's/Family"", 'Family Film', 'Fantasy']",2000,5
6098817,Scram,1932,['United States of America'],"['Short Film', 'Black-and-white', 'Comedy']",1930,2
4691511,Lassie,2005,"['United Kingdom', 'France', 'Ireland', 'United States of America']","['Family Drama', 'Comedy', 'Adventure', 'Drama', 'Family Film']",2000,5
6421844,Hollywood Boulevard,1976,['United States of America'],"['Parody', 'Comedy']",1970,6
1072763,Making Mr. Right,1987,['United States of America'],"['Comedy', 'Romance Film', 'Romantic comedy', 'Science Fiction']",1980,7
16002873,Nine,2009,"['Italy', 'United States of America']","['Musical', 'Romantic drama', 'Romance Film', 'Drama']",2000,9
1800351,Cyrano de Bergerac,1990,['France'],"['World cinema', 'Romance Film', 'Costume drama', 'Drama']",1990,0
13082491,Jaadugar,1989,['India'],"['Comedy', 'Fantasy']",1980,9
217824,Diary of a Mad Housewife,1970,['United States of America'],"['Marriage Drama', 'Comedy-drama', 'Drama', 'Feminist Film']",1970,0
24451306,Exploring the Reef,2003,['United States of America'],"['Animation', 'Short Film', 'Comedy', 'Documentary']",2000,3
2142721,The Juror,1996,['United States of America'],"['Psychological thriller', 'Film adaptation', 'Gangster Film', 'Thriller', 'Crime Thriller', 'Drama', 'Courtroom Drama', 'Suspense']",1990,6
11253233,The Snows of Kilimanjaro,1952,['United States of America'],"['Film adaptation', 'Romance Film', 'Adventure', 'Drama']",1950,2
68092,Chinatown,1974,['United States of America'],"['Crime Fiction', 'Mystery', 'Thriller', 'Drama']",1970,4
611432,Yodha,1992,['India'],"['Action', 'World cinema']",1990,2
2158983,The Brady Bunch Movie,1995,['United States of America'],"['Domestic Comedy', 'Parody', 'Comedy']",1990,5
1332901,Hollow Man,2000,"['Germany', 'United States of America']","['Action', 'Suspense', 'Thriller', 'Horror', 'Sci-Fi Horror', 'Science Fiction']",2000,0
113451,A Soldier's Story,1984,['United States of America'],"['Period piece', 'Film adaptation', 'Courtroom Drama', 'Crime Fiction', 'Ensemble Film', 'Drama']",1980,4
13621335,Streets of Gold,1986,['United States of America'],['Drama'],1980,6
23215210,Death Drums Along the River,1963,"['United Kingdom', 'Germany', 'South Africa', 'West Germany']","['Crime Fiction', 'Adventure', 'Thriller']",1960,3
12242917,The Day Silence Died,1999,['Bolivia'],"['Drama', 'Comedy film']",1990,9
7829229,Bobbili Raja,1990,['India'],"['Romantic comedy', 'Drama']",1990,0
25979945,Suren Suror Putek,2005,[],['Adventure'],2000,5
44218,San Francisco,1936,['United States of America'],"['Black-and-white', 'Romance Film', 'Natural disaster', 'Disaster', 'Drama']",1930,6
15394431,The Return of Doctor X,1939,['United States of America'],"['Black-and-white', 'Horror', 'Sci-Fi Horror', 'Science Fiction']",1930,9
33508913,Ustadi Ustad Se,1982,['India'],"['Action', 'Crime Fiction', 'Drama']",1980,2
13715121,A Gruesome Twosome,1945,[],"['Comedy', 'Splatter film']",1940,5
673274,The Devil's Advocate,1997,"['Germany', 'United States of America']","['Suspense', 'Psychological thriller', 'Mystery', 'Thriller', 'Horror', 'Supernatural', 'Courtroom Drama']",1990,7
12118683,"Augusta, Gone",2006,['United States of America'],"['Coming of age', 'Drama']",2000,6
24751323,We Were Once a Fairytale,2009,['United States of America'],['Short Film'],2000,9
14797743,Gaalipata,2008,['India'],"['Musical', 'Ensemble Film']",2000,8
847589,Guinevere,1999,['United States of America'],"['Romantic drama', 'Indie', 'Romance Film', 'Drama']",1990,9
25495146,Booky Makes Her Mark,2006,"['Canada', 'United States of America']","['Period piece', 'Film adaptation', 'Family Drama', 'Comedy', 'Drama', 'Family Film']",2000,6
11692875,Now Hear This,1963,['United States of America'],"['Animation', 'Short Film', 'Comedy', 'Family Film']",1960,3
18752872,Where There's Life,1947,['United States of America'],"['Comedy', 'Black-and-white']",1940,7
13273342,Underworld U.S.A.,1961,['United States of America'],"['Action', 'Black-and-white', 'Crime Fiction', 'Thriller', 'Film noir', 'Crime Thriller', 'Drama']",1960,1
5685826,The Aviary,2005,['United States of America'],"['Indie', 'Comedy', 'Romance Film', 'Romantic comedy']",2000,5
165379,Wild River,1960,['United States of America'],"['Romance Film', 'Drama']",1960,0
10507180,Heading Home,1920,['United States of America'],"['Black-and-white', 'Drama', 'Indie', 'Comedy', 'Silent film', 'Sports']",1920,0
22933438,Meteor,2009,[],"['Action/Adventure', 'Science Fiction', 'Television movie', 'Disaster']",2000,9
2662367,Two for the Money,2005,['United States of America'],"['Crime Fiction', 'Thriller', 'Sports', 'Drama']",2000,5
23968297,Wharf Angel,1934,['United States of America'],"['Romance Film', 'Drama']",1930,4
29584842,Burned at the Stake,1981,[],['Horror'],1980,1
5838045,Hellboy: Blood and Iron,2007,['United States of America'],"['Action', 'Animation', 'Superhero', 'Action/Adventure', 'Thriller', 'Creature Film', 'Horror', 'Superhero movie', 'Anime', 'Fantasy']",2000,7
2048766,Iron Monkey,1993,['Hong Kong'],"['Action', 'Crime Fiction', 'Action/Adventure', 'Comedy', 'World cinema', 'Chinese Movies', 'Martial Arts Film', 'Adventure']",1990,3
9524972,French Twist,1995,['France'],"['LGBT', 'Romantic drama', 'Satire', 'Comedy', 'World cinema', 'Romance Film', 'Drama', 'Gay Themed', 'Gay', 'Gay Interest', 'Domestic Comedy', 'Romantic comedy', 'Sex comedy']",1990,5
18875447,For the First Time,2008,['Philippines'],"['Filipino Movies', 'Romantic drama', 'World cinema', 'Romance Film', 'Romantic comedy', 'Drama']",2000,8
8682800,The Children of the Century,1999,['France'],"['Period piece', 'Romantic drama', 'Biography', 'World cinema', 'Romance Film', 'Drama']",1990,9
1191435,American Ninja,1985,['United States of America'],"['Action', 'Action/Adventure', 'Martial Arts Film']",1980,5
22231747,The Lemon Sisters,1990,['United States of America'],"['Drama', 'Buddy film', 'Comedy']",1990,0
21159898,Jashnn: The Music Within,2009,['India'],"['Musical', 'Romance Film', 'Drama']",2000,9
1197756,The Long and the Short and the Tall,1960,"['Kingdom of Great Britain', 'United Kingdom']","['War film', 'Drama']",1960,0
22528658,La France,2007,['France'],"['Musical', 'World cinema', 'War film', 'Drama']",2000,7
6446071,From Russia with Love,1963,['United Kingdom'],"['Action', 'Spy', 'Action/Adventure', 'Thriller', 'Glamorized Spy Film']",1960,3
3731073,Ducking the Devil,1957,['United States of America'],"['Animation', 'Short Film', 'Comedy film', 'Family Film']",1950,7
26081596,"Run Wild, Run Free",1969,['United Kingdom'],"['Drama', 'Family Film']",1960,9
284525,Chicken Run,2000,['United Kingdom'],"['Adventure Comedy', 'Animation', 'Comedy', 'Stop motion', 'Family-Oriented Adventure', ""Children's/Family"", 'Escape Film', 'Adventure', 'Family Film', 'Fantasy']",2000,0
4024830,Amma Ariyan,1986,['India'],"['Drama', 'Bollywood', 'Documentary']",1980,6
10004330,Halls of Montezuma,1950,['United States of America'],"['Action', 'Action/Adventure', 'War film']",1950,0
28492310,Cosi,1996,"['New Zealand', 'Australia']","['Music', 'Drama', 'Indie', 'Comedy', 'World cinema', 'Romance Film']",1990,6
2198135,Henry & June,1990,['United States of America'],"['LGBT', 'Erotic Drama', 'Biography', 'Romantic drama', 'Indie', 'Romance Film', 'Drama', 'Marriage Drama', 'Biopic [feature]', 'Erotica']",1990,0
4613077,The Inner Circle,1991,"['Russia', 'Italy', 'United States of America']",['Drama'],1990,1
19353900,Amal,2007,['Canada'],['Drama'],2000,7
31357666,Amelia and Michael,2007,"['United Kingdom', 'Germany']","['Mystery', 'Short Film', 'Romance Film', 'Drama']",2000,7
22100242,Scary Godmother: The Revenge Of Jimmy,2005,['United States of America'],['Animation'],2000,5
27652105,Loose in London,1953,['United States of America'],"['Action', 'Adventure', 'Comedy film']",1950,3
9743605,From Hell It Came,1957,['United States of America'],"['Creature Film', 'Black-and-white', 'Horror']",1950,7
20836034,To Catch a Killer,1992,"['Canada', 'United States of America']","['Mystery', 'Thriller', 'Television movie', 'Crime Thriller', 'Drama']",1990,2
5030108,Lesa Lesa,2002,['India'],"['Musical', 'Romantic drama', 'Bollywood', 'World cinema', 'Romance Film', 'Drama']",2000,2
26456866,The Fakir of Venice,2008,['India'],['Drama'],2000,8
162386,Jerky Boys: The Movie,1995,['United States of America'],"['Drama', 'Comedy', 'Thriller']",1990,5
7987074,Spooks!,1953,['United States of America'],"['Short Film', 'Black-and-white', 'Comedy']",1950,3
15085856,La Chamade,1968,['France'],['Drama'],1960,8
10868409,Fanny Foley Herself,1931,['United States of America'],['Comedy'],1930,1
9001894,Silver Hawk,2004,['Hong Kong'],"['Action', 'Action Thrillers', 'Superhero', 'Action/Adventure', 'Thriller', 'World cinema', 'Chinese Movies', 'Martial Arts Film', 'Adventure', 'Superhero movie']",2000,4
2555226,Hold That Lion!,1947,['United States of America'],"['Short Film', 'Black-and-white', 'Comedy']",1940,7
7566281,Vallarasu,2000,['India'],['Action'],2000,0
18997171,Hijack,2008,['India'],"['Action', 'Musical', 'Action/Adventure', 'Thriller', 'Bollywood', 'World cinema', 'Drama']",2000,8
7444251,Love and Other Catastrophes,1996,['Australia'],"['LGBT', 'Indie', 'Romantic comedy', 'Comedy-drama', 'Ensemble Film']",1990,6
196923,Napoléon,1927,['France'],"['Silent film', 'Indie', 'Drama']",1920,7
2198058,The China Lake Murders,1991,['United States of America'],"['Crime Fiction', 'Crime Thriller', 'Thriller']",1990,1
3644538,Fear,1946,['United States of America'],['Film noir'],1940,6
3441475,X-15,1961,['United States of America'],"['Action', 'Drama', 'Action/Adventure', 'Adventure']",1960,1
21432813,Philadelphia Experiment II,1993,['United States of America'],"['Science Fiction', 'Thriller']",1990,3
33370610,Mookie's Law,2008,['Canada'],"['Romance Film', 'Short Film', 'Comedy film']",2000,8
2202963,Passenger 57,1992,['United States of America'],"['Action', 'Action Thrillers', 'Action/Adventure', 'Thriller', 'Martial Arts Film']",1990,2
23219350,Flakes,2007,['United States of America'],"['Indie', 'Comedy', 'Romance Film', 'Romantic comedy', 'Drama']",2000,7
2885391,Welcome To Sarajevo,1997,"['United Kingdom', 'United States of America']","['Film adaptation', 'Drama', 'Indie', 'War film']",1990,7
5463918,Sailors Beware,1927,['United States of America'],"['Black-and-white', 'Indie', 'Short Film', 'Comedy', 'Silent film', 'Slapstick']",1920,7
23694127,Anarchy in Japansuke,1999,['Japan'],"['Erotica', 'Japanese Movies', 'Pornographic movie']",1990,9
27679393,Paying the Price: Killing the Children of Iraq,2000,['United Kingdom'],"['War film', 'Documentary']",2000,0
24703055,Fall Time,1995,['United States of America'],"['Crime Fiction', 'Indie', 'Comedy', 'Thriller', 'Crime Thriller', 'Drama', 'Period piece', 'Crime Drama']",1990,5
16023743,The Gold Diggers,1923,['United States of America'],['Black-and-white'],1920,3
1903318,Only Angels Have Wings,1939,['United States of America'],"['Action', 'Black-and-white', 'Action/Adventure', 'Buddy film', 'Romance Film', 'Adventure', 'Drama', 'Airplanes and airports']",1930,9
27757283,Where the Bullets Fly,1966,['United Kingdom'],"['Action', 'Spy', 'Parody', 'Satire', 'Comedy']",1960,6
3260822,Haggard: The Movie,2003,"['Canada', 'United States of America']","['Indie', 'Comedy']",2000,3
14474699,Wunschkonzert,1940,"['Nazi Germany', 'Germany']","['Black-and-white', 'War film', 'Propaganda film', 'Drama']",1940,0
15257713,Killshot,2008,['United States of America'],"['Action', 'Crime Fiction', 'Action/Adventure', 'Thriller', 'Crime Thriller', 'Drama']",2000,8
6878966,"Sister, Sister",1987,['United States of America'],"['Psychological thriller', 'Suspense', 'Mystery', 'Thriller', 'Horror']",1980,7
92642,The Defiant Ones,1958,['United States of America'],"['Crime Fiction', 'Buddy film', 'Thriller', 'Drama']",1950,8
1590113,Iria: Zeiram the Animation,1993,[],"['Action', 'Animation', 'Thriller', 'Horror', 'Science Fiction']",1990,3
10440670,Winged Creatures,2008,['United States of America'],"['Film adaptation', 'Crime Fiction', 'Drama']",2000,8
9362221,The Soul of Nigger Charley,1973,['United States of America'],"['Action', 'Blaxploitation', 'Drama', 'Western']",1970,3
10385636,A Room with a View,2007,['United Kingdom'],"['Period piece', 'Film adaptation', 'Romantic drama', 'Romance Film', 'Drama']",2000,7
7514868,Huckleberry Finn,1974,"['United Kingdom', 'United States of America']","['Musical', 'Costume drama', 'Adventure', 'Drama', 'Family Film']",1970,4
235418,Lethal Weapon,1987,['United States of America'],"['Action', 'Crime Fiction', 'Action/Adventure', 'Buddy film', 'Thriller', 'Comedy', 'Buddy cop', 'Albino bias']",1980,7
2622639,Iceman,1984,['United States of America'],"['Science Fiction', 'Drama', 'Fantasy']",1980,4
22280291,Comedian Harmonists,1997,"['Austria', 'Germany']","['Music', 'Musical', 'Biography', 'Romantic drama', 'World cinema', 'Romance Film', 'Drama']",1990,7
558970,The Secret of NIMH,1982,['United States of America'],"['Fantasy Adventure', 'Animation', ""Children's/Family"", 'Adventure', 'Drama', ""Children's Fantasy"", 'Science Fiction', 'Family Film', 'Fantasy']",1980,2
4408863,Renaissance,2006,"['United Kingdom', 'France', 'Luxembourg']","['Action', 'Black-and-white', 'Animation', 'Future noir', 'Thriller', 'Science Fiction']",2000,6
15697462,American Hustle,2007,['United States of America'],['Comedy'],2000,7
11858827,The Black Castle,1952,['United States of America'],"['Action', 'Mystery', 'Gothic Film', 'Thriller', 'Crime Thriller', 'Costume Horror', 'Drama', 'Period piece', 'Horror']",1950,2
2116383,The Quest,1996,['United States of America'],"['Action', 'Period piece', 'Action/Adventure', 'Thriller', 'Martial Arts Film']",1990,6
13139418,Tehzeeb,2003,['India'],"['Drama', 'Bollywood', 'World cinema']",2000,3
9678739,Coimbatore Maaple,1996,['India'],['Drama'],1990,6
34210518,War of the Planets,1966,['Italy'],['Science Fiction'],1960,6
8884873,It Was I Who Drew the Little Man,1960,['Soviet Union'],['Animation'],1960,0
193845,The Three Faces of Eve,1957,['United States of America'],"['Drama', 'Medical fiction']",1950,7
33459318,I Love You,1992,[],['Romance Film'],1990,2
733836,Posse,1993,"['United Kingdom', 'United States of America']","['Action', 'Western', 'Action/Adventure']",1990,3
1553207,Major Payne,1995,['United States of America'],"['Comedy', 'Family Film']",1990,5
14734879,Rusty Romeos,1957,['United States of America'],"['Short Film', 'Black-and-white', 'Comedy']",1950,7
32867874,The Twist,1976,[],['Comedy film'],1970,6
12535736,Mega Snake,2007,['United States of America'],"['B-movie', 'Science Fiction', 'Horror']",2000,7
14580095,Wild Boys of the Road,1933,['United States of America'],"['Adventure', 'Drama']",1930,3
4143048,36 Fillette,1988,['France'],"['Erotic Drama', 'Coming of age', 'Romantic drama', 'World cinema', 'Romance Film', 'Drama']",1980,8
1126979,Japanese Story,2003,"['New Zealand', 'Australia']","['Drama', 'Indie', 'Romantic drama', 'World cinema', 'Adventure', 'Romance Film']",2000,3
8001424,Without Words,2006,['Hong Kong'],"['Romance Film', 'Chinese Movies', 'Fantasy']",2000,6
3980891,Hare Tonic,1945,['United States of America'],"['Short Film', 'Comedy']",1940,5
999394,Pirates of the Caribbean: Dead Man's Chest,2006,['United States of America'],"['Adventure Comedy', 'Fantasy Adventure', 'Action', 'Swashbuckler films', 'Adventure', 'Fantasy']",2000,6
295973,Stage Fright,1950,"['United Kingdom', 'United States of America']","['Psychological thriller', 'Thriller']",1950,0
25992848,A Wicked Ghost II: The Fear,2000,['Hong Kong'],"['Chinese Movies', 'Horror']",2000,0
25248197,Hardwired,2009,['United States of America'],"['Action', 'Action/Adventure', 'Science Fiction', 'Thriller']",2000,9
9286119,Premanthe Inthe,2006,['India'],"['Romantic drama', 'World cinema', 'Romance Film', 'Drama']",2000,6
3177982,The Flesh Eaters,1964,['United States of America'],"['Black-and-white', 'Indie', 'Horror Comedy', 'Horror', 'B-movie', 'Science Fiction']",1960,4
10469675,Caprice,1967,['United States of America'],"['Crime Fiction', 'Mystery', 'Comedy', 'Thriller', 'Romantic comedy', 'Romance Film']",1960,7
14794631,A Pure Formality,1994,"['France', 'Italy']","['Psychological thriller', 'Crime Fiction', 'Mystery', 'Thriller']",1990,4
6243417,The Green Butchers,2003,['Denmark'],"['Comedy', 'World cinema', 'Black comedy', 'Drama']",2000,3
3564280,The Road Home,1999,['China'],"['Romantic drama', 'World cinema', 'Romance Film', 'Chinese Movies', 'Drama']",1990,9
19509640,Whose Life Is It Anyway?,1981,['United States of America'],"['Drama', 'Medical fiction']",1980,1
18599377,There's Always Tomorrow,1956,['United States of America'],"['Romance Film', 'Drama']",1950,6
5329439,Platoon Leader,1988,['United States of America'],"['War film', 'Drama']",1980,8
3117056,Saagar,1985,['India'],"['Musical', 'Bollywood', 'World cinema', 'Romance Film', 'Drama']",1980,5
734207,Oldboy,2003,"['Korea', 'South Korea']","['Action', 'Mystery', 'Thriller', 'Kafkaesque', 'World cinema', 'Martial Arts Film', 'Drama']",2000,3
63504,Touch of Evil,1958,['United States of America'],"['Psychological thriller', 'Crime Fiction', 'Mystery', 'Thriller', 'Film noir']",1950,8
770128,Music Box,1989,['United States of America'],"['Crime Fiction', 'Thriller', 'Crime Thriller', 'Drama', 'Courtroom Drama']",1980,9
42106,Crossfire,1947,['United States of America'],"['Suspense', 'Black-and-white', 'Crime Fiction', 'Thriller', 'Film noir', 'Crime Thriller', 'Drama']",1940,7
28136271,Dangerous Nan McGrew,1930,['United States of America'],"['Romance Film', 'Western', 'Comedy film']",1930,0
25375464,Super Spy,2004,['United States of America'],['Comedy'],2000,4
13137113,Eyes of an Angel,1991,['United States of America'],"['Crime Drama', 'Drama']",1990,1
2385671,Trash,1970,['United States of America'],"['Gay Themed', 'LGBT', 'Crime Fiction', 'Indie', 'Drama']",1970,0
10809839,The Mother and the Whore,1973,['France'],"['Black-and-white', 'Drama']",1970,3
17767428,Warning Sign,1985,['United States of America'],"['Action', 'Action/Adventure', 'Thriller', 'Horror', 'Disaster', 'Sci-Fi Horror', 'Science Fiction']",1980,5
1666667,The Place Promised in Our Early Days,2004,['Japan'],"['Action', 'Animation', 'Japanese Movies', 'Coming of age', 'Anime', 'Drama', 'Fantasy']",2000,4
1179306,"White Hunter, Black Heart",1990,['United States of America'],"['Action', 'Film à clef', 'Adventure', 'Drama']",1990,0
4186631,The Man with One Red Shoe,1985,['United States of America'],"['Action', 'Action/Adventure', 'Comedy Thriller', 'Thriller', 'Comedy', 'Comedy of Errors']",1980,5
8077187,Rakht: What If You Can See the Future,2004,['India'],"['World cinema', 'Thriller', 'Horror']",2000,4
1567200,The Saint,1997,['United States of America'],"['Action', 'Spy', 'Crime Fiction', 'Action/Adventure', 'Thriller']",1990,7
10640978,Jeevana Poratam,1986,['India'],"['Drama', 'Family Film']",1980,6
11347793,Persepolis,2007,"['France', 'United States of America']","['Film adaptation', 'Animation', 'Biography', 'Comedy', 'Biographical film', 'World cinema', 'Drama', 'Period piece', 'Coming of age', 'Biopic [feature]', 'War film']",2000,7
21970745,Saved by the Belles,2003,['Canada'],['LGBT'],2000,3
8009481,The Live Ghost,1934,['United States of America'],"['Short Film', 'Black-and-white', 'Comedy']",1930,4
18577105,The Russia House,1990,"['United Kingdom', 'United States of America']","['Spy', 'Film adaptation', 'Political thriller', 'Thriller', 'Political drama', 'Drama']",1990,0
22568371,Dhaya,2002,['India'],"['Drama', 'World cinema']",2000,2
8231713,Bagong Buwan,2001,['Philippines'],"['Action', 'Filipino Movies', 'War film', 'Drama']",2000,1
12297130,Two Hearts in ¾ Time,1930,['Germany'],"['Musical', 'Drama']",1930,0
2307930,Bionicle: Mask of Light: The Movie,2003,['United States of America'],"['Fantasy Adventure', 'Animation', ""Children's/Family"", 'Adventure', 'Computer Animation', ""Children's Fantasy"", 'Science Fiction', 'Family Film', 'Fantasy']",2000,3
5281893,The Science of Sleep,2006,"['France', 'Italy']","['Romantic fantasy', 'Romantic drama', 'Comedy', 'World cinema', 'Romance Film', 'Drama', 'Comedy-drama', 'Stop motion', 'Science Fiction', 'Fantasy Comedy', 'Fantasy']",2000,6
23952807,Kurt & Courtney,1998,['United Kingdom'],"['Music', 'Rockumentary', 'Biography', 'Documentary']",1990,8
561226,Risky Business,1983,['United States of America'],"['Satire', 'Comedy', 'Comedy-drama', 'Sex comedy']",1980,3
513090,All Dogs Go to Heaven,1989,"['United Kingdom', 'Ireland', 'United States of America']","['Music', 'Action', 'Musical', 'Animation', 'Animated Musical', 'Comedy', 'Family-Oriented Adventure', ""Children's/Family"", 'Adventure', 'Drama', 'Heaven-Can-Wait Fantasies', 'Family Film', 'Fantasy']",1980,9
30137970,Hey DJ,2003,[],"['Music', 'Drama', 'Comedy film']",2000,3
24567800,Marrakech Express,1989,['Italy'],"['Comedy', 'Adventure']",1980,9
3043429,Record,2000,['South Korea'],"['Thriller', 'Horror']",2000,0
26227694,News Hounds,1947,['United States of America'],"['Comedy', 'Crime Fiction']",1940,7
4950989,The Lost Empire,2001,['United States of America'],['Adventure'],2000,1
2434743,I Love a Man in Uniform,1994,['Canada'],['Drama'],1990,4
24583367,Becky,1927,['United States of America'],"['Romantic drama', 'Silent film']",1920,7
13504095,'If Only' Jim,1920,['United States of America'],"['Black-and-white', 'Indie', 'Western', 'Silent film']",1920,0
1942885,Madadayo,1993,['Japan'],"['Japanese Movies', 'Drama', 'World cinema']",1990,3
10031018,El Poder de las tinieblas,1979,['Argentina'],"['Drama', 'Mystery', 'Thriller']",1970,9
9691493,Sparsh,1980,['India'],"['Drama', 'Art film', 'Bollywood']",1980,0
7087007,The Miniver Story,1950,['United States of America'],"['Black-and-white', 'Melodrama', 'Drama', 'Family Film']",1950,0
31706716,The Swinger,1966,['United States of America'],"['Comedy', 'Satire']",1960,6
25210318,Closer to Heaven,2009,['South Korea'],['Drama'],2000,9
34014813,A Short Stay in Switzerland,2009,[],"['Drama', 'Biographical film']",2000,9
8423598,Prisoner of the Mountains,1996,['Russia'],"['Anti-war', 'Anti-war film', 'World cinema', 'War film', 'Drama']",1990,6
6961461,The Other Boleyn Girl,2008,"['United Kingdom', 'United States of America']","['Film adaptation', 'Romantic drama', 'Biographical film', 'Romance Film', 'Costume drama', 'Drama', 'Period piece', 'History']",2000,8
2312056,Pride & Prejudice,2005,"['United Kingdom', 'France']","['Period piece', 'Film adaptation', 'Romantic drama', 'Romance Film', 'Costume drama', 'Drama']",2000,5
5637628,Art of the Devil 2,2005,['Thailand'],"['Slasher', 'Horror', 'World cinema', 'Supernatural']",2000,5
10791908,Thappu Thalangal,1978,['India'],['Drama'],1970,8
20535192,Polytechnique,2009,['Canada'],"['Crime Fiction', 'Historical drama', 'Drama']",2000,9
5856565,Illegal Aliens,2007,['United States of America'],"['Action', 'Parody', 'Comedy', 'Television movie', 'Science Fiction']",2000,7
1991818,Cry of the City,1948,['United States of America'],"['Crime Fiction', 'Thriller', 'Film noir', 'Crime Thriller']",1940,8
26549967,Tom & Jerry,1996,['India'],"['Action', 'Comedy film']",1990,6
9613521,"Now You See Him, Now You Don't",1972,['United States of America'],"['Comedy', ""Children's/Family"", 'Science Fiction', 'Drama', 'Family Film']",1970,2
33083106,Mere Naam Hai Mohabbat,1975,['Pakistan'],"['Romance Film', 'Drama']",1970,5
18903759,Buscando a Miguel,2007,['Colombia'],['Drama'],2000,7
606121,A Day at the Races,1937,['United States of America'],"['Black-and-white', 'Screwball comedy', 'Slapstick', 'Comedy', 'Comedy of Errors']",1930,7
22767958,La journée de la jupe,2009,"['France', 'Belgium']","['Drama', 'World cinema']",2000,9
21606793,Direct Contact,2009,"['Germany', 'United States of America']","['Action', 'Action Thrillers', 'Action/Adventure', 'Thriller']",2000,9
10165697,Day of Independence,2003,['United States of America'],['Short Film'],2000,3
16686522,Dark Journey,1937,['United Kingdom'],"['Spy', 'Black-and-white', 'Horror', 'Romance Film', 'War film']",1930,7
5164462,Uuno Epsanjassa,1985,['Finland'],['Comedy'],1980,5
14873897,Nim's Island,2008,"['United States of America', 'Australia']","[""Children's"", 'Family-Oriented Adventure', ""Children's/Family"", 'Adventure', 'Family Film', 'Fantasy']",2000,8
5105411,Forest Warrior,1996,['United States of America'],"['Action', 'Action/Adventure', 'Comedy', 'Family-Oriented Adventure', ""Children's/Family"", 'Adventure', ""Children's Fantasy"", 'Fantasy']",1990,6
8972061,Sahasa Veerudu Sagara Kanya,1996,['India'],"['Fantasy Adventure', 'Adventure']",1990,6
5396711,Nate and Hayes,1983,"['New Zealand', 'United States of America']","['Action/Adventure', 'Adventure', 'Swashbuckler films', 'Drama']",1980,3
12199089,Premaku Velayara,1999,['India'],['Romance Film'],1990,9
2891090,Daud,1997,['India'],"['Musical', 'Action/Adventure', 'Bollywood', 'World cinema']",1990,7
30872649,The Thief and the Cobbler,1995,"['United Kingdom', 'United States of America', 'Canada']","['Fairy tale', 'Animation', ""Children's/Family"", 'Family Film', 'Fantasy']",1990,5
348292,The Dark Crystal,1982,"['United Kingdom', 'United States of America']","['Fantasy Adventure', ""Children's Fantasy"", 'Animation', ""Children's/Family"", 'Adventure', 'Family Film', 'Fantasy']",1980,2
24343349,"Chengdu, I Love You",2009,['China'],"['Chinese Movies', 'Science Fiction', 'World cinema']",2000,9
9226340,"Thunderhead, Son of Flicka",1945,['United States of America'],"['Film adaptation', 'Family Drama', 'Animal Picture', 'Adventure', 'Drama', 'Family Film']",1940,5
5144617,House II: The Second Story,1987,['United States of America'],"['Comedy', 'Horror', 'Black comedy', 'Adventure']",1980,7
5082629,The Great Riviera Bank Robbery,1979,['United Kingdom'],"['Crime Fiction', 'Crime Thriller', 'Docudrama']",1970,9
21080572,Falling in Love with the Girl Next Door,2006,['United States of America'],['Comedy'],2000,6
9873387,Alone in the Dark II,2009,"['Germany', 'United States of America']","['Creature Film', 'Horror']",2000,9
2208130,La Joven,1960,"['Mexico', 'United States of America']","['Adventure', 'Drama', 'World cinema']",1960,0
5320225,The Apple Dumpling Gang Rides Again,1979,['United States of America'],"['Comedy Western', 'Comedy', ""Children's/Family"", 'Slapstick', 'Drama', 'Family Film']",1970,9
19114320,One Day in the Life of Andrei Arsenevich,2000,['France'],['Documentary'],2000,0
993532,Broken Arrow,1950,['United States of America'],"['Action', 'Western', 'Action/Adventure']",1950,0
4400660,Sardar,1993,['India'],"['Historical fiction', 'Drama']",1990,3
9732383,Making of a Male Model,1983,['United States of America'],['Drama'],1980,3
25885754,Premonition,1972,['United States of America'],['Horror'],1970,2
6941316,Sleeping Car to Trieste,1948,['United Kingdom'],"['Action', 'Spy', 'Black-and-white', 'Mystery']",1940,8
24585123,The Viking,1931,['United States of America'],"['Romance Film', 'Adventure', 'Drama']",1930,1
11564619,The Brass Bottle,1964,['United States of America'],"['Comedy', 'Fantasy Comedy', 'Fantasy']",1960,4
147697,Castle in the Sky,1986,['Japan'],"['Action', 'Animation', 'World cinema', 'Romance Film', ""Children's"", 'Adventure', 'Airplanes and airports', 'Japanese Movies', 'Anime', 'Steampunk', 'Family Film', 'Fantasy']",1980,6
12130575,Les Feux de la Chandeleur,1972,['France'],"['Romance Film', 'Melodrama', 'Drama']",1970,2
832232,10,1979,['United States of America'],"['Comedy', 'Romance Film', 'Romantic comedy', 'Slapstick', 'Sex comedy']",1970,9
18656678,With or Without You,2003,['United States of America'],"['Romance Film', 'Romantic comedy', 'Comedy']",2000,3
19248083,Tamanna,1998,['India'],['Drama'],1990,8
6649732,Rudraveena,1988,['India'],['Musical'],1980,8
1901270,Dirigible,1931,['United States of America'],"['Action', 'Black-and-white', 'Adventure', 'Drama']",1930,1
3471403,I'm No Angel,1933,['United States of America'],"['Musical', 'Black-and-white', 'Comedy', 'Romance Film', 'Romantic comedy']",1930,3
675574,Rat Race,2001,"['Canada', 'United States of America']","['Action', 'Parody', 'Action/Adventure', 'Comedy', 'Slapstick', 'Adventure']",2000,1
25992458,A Wicked Ghost,1999,['Hong Kong'],"['Chinese Movies', 'Horror']",1990,9
17058062,A Thousand Years of Good Prayers,2007,"['Japan', 'United States of America']","['Japanese Movies', 'Family Drama', 'Indie', 'Drama']",2000,7
31136582,The Doll Squad,1973,[],"['Action', 'Crime Fiction', 'Action/Adventure', 'Thriller']",1970,3
629209,L'Homme de Rio,1964,"['France', 'Italy']","['Adventure Comedy', 'Action', 'Action Comedy', 'Comedy', 'Adventure']",1960,4
31152766,Umma,1960,[],['Drama'],1960,0
14504416,Gang War,1928,['United States of America'],['Crime Fiction'],1920,8
4289049,The Flower of My Secret,1995,"['France', 'Spain']","['Romantic drama', 'World cinema', 'Romance Film', 'Drama']",1990,5
8850105,Because I Said So,2007,['United States of America'],"['Comedy', 'Romance Film', 'Romantic comedy', 'Domestic Comedy', 'Drama']",2000,7
1499348,Happy Feet,2006,"['United States of America', 'Australia']","['Adventure Comedy', 'Music', 'Animation', 'Comedy', 'Romance Film', ""Children's/Family"", 'Adventure', 'Computer Animation', 'Family Film']",2000,6
8548898,Music and Lyrics,2007,['United States of America'],"['Musical', 'Comedy', 'Romance Film', 'Romantic comedy']",2000,7
30485390,Rosalie,1937,['United States of America'],"['Musical', 'Black-and-white']",1930,7
21388576,Death Weekend,1976,['Canada'],"['Crime Fiction', 'Thriller', 'Horror']",1970,6
2558588,Fire and Ice,1983,['United States of America'],"['Animation', 'Adventure', 'Sword and sorcery']",1980,3
24158953,So Fine,1981,['United States of America'],['Comedy'],1980,1
3898603,Docking the Boat,1965,['Sweden'],"['Romance Film', 'Comedy', 'Drama']",1960,5
2708736,The Day of the Beast,1995,"['Spain', 'Italy']","['Comedy', 'Horror Comedy', 'Horror', 'Black comedy']",1990,5
838119,Kolberg,1945,['Germany'],"['Historical fiction', 'War film', 'Propaganda film', 'Drama']",1940,5
212090,Young Bess,1953,['United States of America'],"['Biographical film', 'Biopic [feature]', 'Historical fiction', 'Costume drama', 'Drama']",1950,3
13300563,Another Gay Sequel: Gays Gone Wild,2008,"['United States of America', 'Australia']","['Gay Themed', 'LGBT', 'Coming of age', 'Parody', 'Comedy', 'Sex comedy']",2000,8
3119257,Doomsday,2008,"['United Kingdom', 'Germany', 'South Africa', 'United States of America']","['Action', 'Action/Adventure', 'Thriller', 'Plague', 'Doomsday film', 'Disaster', 'Science Fiction']",2000,8
17407003,Union Depot,1932,['United States of America'],"['Black-and-white', 'Melodrama', 'Comedy-drama', 'Ensemble Film']",1930,2
12178761,Hungama,2005,['India'],['Comedy film'],2000,5
36057878,Sigaram,1991,['India'],['Drama'],1990,1
113442,The Right Stuff,1983,['United States of America'],"['Period piece', 'Film adaptation', 'History', 'Docudrama', 'Adventure', 'Drama']",1980,3
27008655,The Unholy Garden,1931,['United States of America'],"['Romance Film', 'Drama']",1930,1
12624564,Goodbye Charlie,1964,['United States of America'],"['Comedy', 'Fantasy Comedy', 'Fantasy']",1960,4
570279,Godzilla Raids Again,1955,['Japan'],"['Black-and-white', 'Japanese Movies', 'Monster', 'World cinema', 'Science Fiction', 'Cult']",1950,5
346196,The Element of Crime,1984,['Denmark'],"['Surrealism', 'Detective fiction', 'Mystery', 'Indie', 'Thriller', 'World cinema', 'Crime Thriller', 'Suspense', 'Future noir', 'Detective', 'Experimental film', 'Science Fiction']",1980,4
9762916,Spiral,2007,['United States of America'],"['Psychological thriller', 'Indie', 'Thriller', 'Drama']",2000,7
5579274,Wanda Nevada,1979,['United States of America'],"['Western', 'Romance Film']",1970,9
11505804,Japan Sinks,1973,"['Japan', 'United States of America']","['Action', 'Japanese Movies', 'Thriller', 'Natural disaster', 'Doomsday film', 'Disaster', 'Science Fiction']",1970,3
12233331,High School Big Shot,1959,['United States of America'],"['Drama', 'Crime Fiction']",1950,9
9962209,A King and His Movie,1986,['Argentina'],"['Drama', 'Indie', 'Comedy', 'World cinema']",1980,6
11142653,Geraftaar,1985,['India'],"['Action', 'Drama', 'Adventure']",1980,5
19575016,Leningrad Cowboys Meet Moses,1994,"['France', 'Finland', 'Germany']","['Musical', 'Comedy', 'Adventure']",1990,4
14544959,Female Convict Scorpion: Grudge Song,1973,['Japan'],"['Crime Fiction', 'Action/Adventure', 'Thriller', 'World cinema', 'Martial Arts Film', 'Drama', 'Women in prison films', 'Japanese Movies', 'Erotica']",1970,3
4090453,Money Train,1995,['United States of America'],"['Action', 'Crime Fiction', 'Action/Adventure', 'Comedy', 'Thriller', 'Heist', 'Caper story', 'Comedy Thriller']",1990,5
10751918,Be Here to Love Me,2006,['United States of America'],"['Music', 'Musical', 'Biography', 'Documentary']",2000,6
876592,It Came from Beneath the Sea,1955,['United States of America'],"['Creature Film', 'Sci-Fi Horror', 'Monster', 'Horror', 'B-movie', 'Stop motion', 'Science Fiction']",1950,5
25436873,Paranormal Entity,2009,['United States of America'],"['Suspense', 'Horror']",2000,9
2812852,Love Jones,1997,['United States of America'],"['Drama', 'Indie', 'Romantic drama', 'Comedy', 'Romance Film', 'Romantic comedy', 'Comedy-drama']",1990,7
17777395,The Big Bird Cage,1972,"['Philippines', 'United States of America']","['Action', 'Filipino Movies', 'Exploitation', 'Prison', 'Crime Fiction', 'Indie', 'Women in prison films']",1970,2
26166969,V.I. Warshawski,1991,['United States of America'],"['Action', 'Film adaptation', 'Detective fiction', 'Crime Fiction', 'Mystery', 'Comedy', 'Thriller', 'Crime Thriller', 'Detective']",1990,1
13177414,Jargo,2004,"['Iceland', 'Germany']","['Coming of age', 'Romantic drama', 'World cinema', 'Crime Drama', 'Romance Film', 'Drama']",2000,4
24627900,Lucinda's Spell,1998,['United States of America'],"['Black comedy', 'Comedy-drama', 'Fantasy Comedy', 'Fantasy']",1990,8
20896389,Six Weeks,1982,['United States of America'],['Drama'],1980,2
30210289,The Woman Who Obeyed,1923,['United Kingdom'],['Silent film'],1920,3
2789767,"Atlantis, the Lost Continent",1961,['United States of America'],"['Fantasy Adventure', 'Mythological Fantasy', 'Costume Adventure', 'Adventure', 'Fantasy']",1960,1
2454007,Goldilocks and the Jivin' Bears,1944,['United States of America'],"['Animation', 'Short Film', 'Family Film']",1940,4
28673181,Be There or Be Square,1998,['China'],['Chinese Movies'],1990,8
26118204,Lady with Red Hair,1940,['United States of America'],"['Drama', 'Biographical film']",1940,0
1970527,Indiscreet,1958,"['United Kingdom', 'United States of America']","['Romance Film', 'Romantic comedy', 'Comedy']",1950,8
3018210,What Price Glory?,1926,['United States of America'],"['Silent film', 'Black-and-white', 'Indie']",1920,6
24616104,Is Raat Ki Subah Nahin,1996,['India'],"['Bollywood', 'Thriller']",1990,6
11976777,Yogi and the Invasion of the Space Bears,1988,['United States of America'],"['Comedy', 'Family Film']",1980,8
10640606,The Devil's Disciple,1959,"['United Kingdom', 'United States of America']","['Comedy', 'Black-and-white']",1950,9
13863939,Hantu Jeruk Purut,2006,['Indonesia'],['Horror'],2000,6
19164879,The Crimson Kimono,1959,['United States of America'],"['Crime Fiction', 'Mystery', 'Thriller', 'Film noir', 'Crime Thriller', 'Drama']",1950,9
3169388,Elephant Boy,1937,['United Kingdom'],"['Black-and-white', 'Adventure', 'Drama', 'Family Film']",1930,7
10387888,"Sleep, My Love",1948,['United States of America'],"['Psychological thriller', 'Black-and-white', 'Thriller', 'Film noir']",1940,8
11026100,Bratz Kidz: Sleep-Over Adventure,2007,['United States of America'],"['Comedy', 'Animation']",2000,7
6983478,On the Riviera,1951,['United States of America'],"['Musical', 'Comedy', 'Romance Film', 'Romantic comedy']",1950,1
33824540,Institute Benjamenta,1995,"['United Kingdom', 'Germany', 'Japan']","['Mystery', 'Japanese Movies', 'Thriller', 'World cinema', 'Fantasy']",1990,5
26599927,Utharaswayamvaram,2009,['India'],['Drama'],2000,9
4853040,Perazhagan,2004,['India'],"['Musical', 'Romantic drama', 'Comedy', 'Bollywood', 'World cinema', 'Romance Film', 'Drama', 'Romantic comedy']",2000,4
1766274,Superstar,1999,['United States of America'],"['Comedy', 'Teen']",1990,9
8929476,Stargate: Continuum,2008,"['Canada', 'United States of America']","['Science Fiction', 'Adventure', 'Sci-Fi Adventure']",2000,8
15383895,Baaz: A Bird in Danger,2003,['India'],"['Suspense', 'World cinema']",2000,3
30846200,The Brotherhood V: Alumni,2009,['United States of America'],"['Slasher', 'Teen', 'Horror']",2000,9
31735267,The Nevadan,1950,['United States of America'],"['Action', 'Western']",1950,0
5526366,The Witches of Eastwick,1987,['United States of America'],"['Film adaptation', 'Comedy', 'Thriller', 'Horror', 'Black comedy', 'Drama', 'Fantasy']",1980,7
18066576,The Last Station,2009,"['Russia', 'United Kingdom', 'Germany']","['Film adaptation', 'Biography', 'Romantic drama', 'World cinema', 'Romance Film', 'Drama', 'Period piece', 'History', 'Biopic [feature]']",2000,9
67422,Executive Decision,1996,['United States of America'],"['Action', 'Airplanes and airports', 'Action Thrillers', 'Action/Adventure', 'Thriller']",1990,6
2360178,Tumko Na Bhool Payenge,2002,['India'],"['Musical', 'Action/Adventure', 'Bollywood', 'World cinema', 'Drama']",2000,2
17066135,Courage of Lassie,1946,['United States of America'],"['Family Drama', 'Melodrama', 'War film', 'Adventure', 'Drama', 'Family Film']",1940,6
24731835,RoboGeisha,2009,['Japan'],"['Action', 'Action/Adventure', 'Comedy', 'World cinema', 'Japanese Movies', 'Horror', 'B-movie', 'Science Fiction']",2000,9
22545876,Look Up and Laugh,1935,['United Kingdom'],['Comedy film'],1930,5
13413539,If I Had Known I Was a Genius,2006,['United States of America'],"['Coming of age', 'Comedy', 'Teen', 'Drama']",2000,6
9309331,"Pizza, Beer, and Cigarettes",1998,['Argentina'],"['Drama', 'Crime Fiction', 'Indie', 'World cinema']",1990,8
9623638,The Other,2007,"['Argentina', 'France', 'Germany']","['Indie', 'Drama']",2000,7
5608911,Her Alibi,1989,['United States of America'],"['Action', 'Action/Adventure', 'Comedy', 'Romance Film', 'Romantic comedy', 'Comedy of Errors']",1980,9
2642413,Broken Wings,2002,['Israel'],"['Short Film', 'Drama', 'World cinema']",2000,2
11987078,Sir Henry at Rawlinson End,1980,['United Kingdom'],"['Comedy', 'Black-and-white']",1980,0
177736,The Trespasser,1929,['United States of America'],['Black-and-white'],1920,9
10986762,Urchagam,2007,['India'],['Romance Film'],2000,7
11253197,Suraj,1966,['India'],"['Action', 'Musical', 'Romance Film']",1960,6
10093225,Cassiopéia,1996,['Brazil'],"['Animation', 'Adventure', 'Science Fiction', 'Family Film', 'Computer Animation']",1990,6
17128512,The Gaiety Girl,1924,['United States of America'],"['Silent film', 'Black-and-white', 'Drama']",1920,4
29309335,Mr. X in Bombay,1964,['India'],"['Science Fiction', 'Adventure', 'Comedy film']",1960,4
21545226,Hit and Run,2008,['United States of America'],"['Psychological thriller', 'Suspense', 'Thriller', 'Horror', 'Crime Thriller']",2000,8
7903849,Stuck,2001,['United States of America'],"['Short Film', 'LGBT']",2000,1
25510322,Marmayogi,1951,['India'],['Adventure'],1950,1
32880599,Trooper O'Brien,1928,[],['Drama'],1920,8
8102720,The Time of Their Lives,1946,['United States of America'],"['Black-and-white', 'Comedy', 'Family Film']",1940,6
1510273,Be Cool,2005,['United States of America'],"['Crime Fiction', 'Comedy', 'Crime Comedy']",2000,5
2991530,Last Man Standing,1996,['United States of America'],"['Action', 'Crime Fiction', 'Gangster Film', 'Action/Adventure', 'Thriller', 'Crime Thriller', 'Drama', 'Period piece', 'Western']",1990,6
24584915,Random Hearts,1999,['United States of America'],"['Film adaptation', 'Mystery', 'Romantic drama', 'Romance Film', 'Drama']",1990,9
3510662,Far from the Madding Crowd,1967,['United Kingdom'],"['Film adaptation', 'Romantic drama', 'Romance Film', 'Drama']",1960,7
4318078,Invisible Waves,2006,"['Hong Kong', 'South Korea', 'China', 'Japan', 'Netherlands', 'Thailand']","['Japanese Movies', 'Thriller', 'Chinese Movies', 'Drama']",2000,6
337740,Bram Stoker's Dracula,1992,['United States of America'],"['Film adaptation', 'Gothic Film', 'Thriller', 'Romance Film', 'Costume Horror', 'Costume drama', 'Drama', 'Period piece', 'Horror', 'Cult', 'Fantasy']",1990,2
5645921,Le Couperet,2005,"['France', 'Spain', 'Belgium']","['Crime Fiction', 'Comedy', 'Thriller', 'World cinema', 'Drama']",2000,5
694541,The Star,2002,['Russia'],"['Action', 'War film', 'Adventure', 'Drama']",2000,2
16304395,Enemy Territory,1987,['United States of America'],"['Action', 'Drama', 'Crime Fiction', 'Crime Thriller']",1980,7
13722310,"Ganito Kami Noon, Paano Kayo Ngayon",1976,['Philippines'],"['Musical', 'Filipino Movies', 'War film', 'Drama']",1970,6
689611,What Dreams May Come,1998,"['New Zealand', 'United States of America']","['Romantic fantasy', 'Film adaptation', 'Romantic drama', 'Romance Film', 'Fantasy', 'Drama']",1990,8
3658781,The Lake,1998,['United States of America'],"['Science Fiction', 'Thriller', 'Horror']",1990,8
9170639,Everybody Sing,1938,['United States of America'],"['Musical', 'Comedy']",1930,8
32194593,One-Eyed Monster,2008,['United States of America'],"['Parody', 'Comedy', 'Horror', 'Black comedy']",2000,8
32910163,Bheeshmar,2003,[],['Crime Fiction'],2000,3
30542998,Ente Veedu Appuvinteyum,2003,[],['Drama'],2000,3
5260320,A Kid for Two Farthings,1955,['United Kingdom'],"[""Children's Fantasy"", ""Children's/Family"", 'Drama', 'Fantasy']",1950,5
11009343,Tattoo,2002,"['France', 'Germany']","['Crime Thriller', 'Thriller', 'World cinema']",2000,2
32642867,They Came to Rob Hong Kong,1989,[],"['Action', 'Comedy film']",1980,9
5923676,Veerabhadra,2006,['India'],['Action'],2000,6
18790154,The Adventures of Picasso,1978,['Sweden'],['Comedy'],1970,8
2543557,The Cranes are Flying,1957,"['Russia', 'Soviet Union']","['Art film', 'Romantic drama', 'World cinema', 'Romance Film', 'Melodrama', 'War film', 'Drama']",1950,7
20029902,Raining Cats and Frogs,2003,['France'],"['Family Film', 'Animation']",2000,3
31160411,The Mystic Warrior,1984,['United States of America'],['Drama'],1980,4
28117009,You Might as Well Live,2009,['Canada'],"['Indie', 'Comedy']",2000,9
1057671,Everyman's Feast,2002,['Austria'],['Drama'],2000,2
4301390,Ready to Run,2000,"['New Zealand', 'United States of America']","['Sports', 'Family Film']",2000,0
20904439,Tumhare Liye,1978,['India'],"['Romantic drama', 'Thriller', 'World cinema', 'Romance Film', 'Drama']",1970,8
32813277,The Ambassador's Daughter,1956,['United States of America'],"['Romance Film', 'Romantic comedy', 'Comedy']",1950,6
5978945,Beast Cops,1998,['Hong Kong'],"['Action', 'Crime Fiction', 'Action/Adventure', 'World cinema', 'Chinese Movies', 'Martial Arts Film', 'Drama', 'Crime Drama']",1990,8
5096064,Turistas,2006,['United States of America'],"['Mystery', 'Thriller', 'Horror']",2000,6
23555843,Thirty Three,1965,['Soviet Union'],['Comedy film'],1960,5
773327,The Wild One,1953,['United States of America'],"['Drama', 'Biker Film', 'Outlaw biker film']",1950,3
73494,Freaks,1932,['United States of America'],"['Psychological thriller', 'Black-and-white', 'Thriller', 'Pre-Code', 'Drama', 'Roadshow/Carny', 'Horror', 'Cult']",1930,2
4001378,The Tenants,2006,['United States of America'],"['Film adaptation', 'Drama']",2000,6
2867481,Johnny Tsunami,1999,['United States of America'],"['Comedy', ""Children's/Family"", 'Drama', 'Family Film']",1990,9
27902470,Unnatural History,1959,['United States of America'],"['Short Film', 'Animation']",1950,9
8056428,Emergency Act 19,2002,['South Korea'],['Satire'],2000,2
13023421,"Definitely, Maybe",2008,"['United Kingdom', 'France', 'United States of America']","['Comedy', 'Romance Film', 'Romantic comedy', 'Drama']",2000,8
9957228,Viva Erotica,1996,['Hong Kong'],"['Comedy', 'Erotica', 'Chinese Movies', 'Drama', 'Sex comedy']",1990,6
16725337,December Heat,2008,['Estonia'],"['Drama', 'Thriller', 'World cinema']",2000,8
10827382,A Good Day to Have an Affair,2007,['South Korea'],"['Romance Film', 'Comedy']",2000,7
20282112,Jack,2003,['United States of America'],"['LGBT', 'Coming of age', 'Teen', 'Television movie', 'Drama']",2000,3
5066214,The Last Metro,1980,['France'],"['Art film', 'World cinema', 'Romance Film', 'War film', 'Drama']",1980,0
5175724,Dallas: J.R. Returns,1996,['United States of America'],"['Family Drama', 'Drama']",1990,6
2413574,Ben,1972,['United States of America'],"['Thriller', 'Horror', 'Animal Picture', 'Natural horror films']",1970,2
7561586,The Reluctant Debutante,1958,['United States of America'],"['Romantic comedy', 'Comedy', 'Comedy of manners']",1950,8
1105284,Silsila,1981,['India'],"['Musical', 'Romantic drama', 'Bollywood', 'World cinema', 'Romance Film', 'Drama']",1980,1
16994806,Music Is Magic,1935,['United States of America'],"['Musical', 'Black-and-white']",1930,5
952902,Cheaters,2000,['United States of America'],"['Drama', 'Television movie']",2000,0
27733896,The Baby and the Battleship,1956,['United Kingdom'],['Comedy film'],1950,6
32293709,Buried Secrets,2009,"['France', 'Tunisia', 'Switzerland']","['Psychological thriller', 'Drama']",2000,9
925503,Thamizhan,2002,['India'],"['Drama', 'World cinema']",2000,2
835057,The In-Laws,1979,['United States of America'],"['Comedy', 'Crime Fiction']",1970,9
25553027,The Good Wife,1987,"['New Zealand', 'Australia']","['Period piece', 'Romantic drama', 'World cinema', 'Romance Film', 'Drama']",1980,7
27884720,Esther's Diary,2008,['United States of America'],['Drama'],2000,8
9078818,The Assignment,1997,['Canada'],"['Period piece', 'Thriller', 'Political drama', 'Drama', 'Political thriller']",1990,7
5008268,Qurbani,1980,"['United Kingdom', 'India']","['Musical', 'Action/Adventure', 'Thriller', 'Bollywood', 'World cinema']",1980,0
3210303,Mother Night,1996,['United States of America'],"['Anti-war', 'Spy', 'Anti-war film', 'Satire', 'War film', 'Drama']",1990,6
3750829,Asylum,2005,"['United Kingdom', 'Ireland', 'United States of America']","['Film adaptation', 'Romantic drama', 'Thriller', 'Romance Film', 'Drama']",2000,5
14726855,Resident Evil: Degeneration,2008,['Japan'],"['Creature Film', 'Computer Animation', 'Animation', 'Japanese Movies', 'World cinema', 'Horror', 'Zombie Film']",2000,8
23966679,Summer Wars,2009,['Japan'],"['Action', 'Animation', 'Comedy', 'Romance Film', 'Adventure', 'Japanese Movies', 'Anime', 'Science Fiction']",2000,9
25487856,Tyagayya,1946,['India'],"['Musical', 'Historical fiction', 'Family Film']",1940,6
3956399,Thambi,2006,['India'],"['Romantic drama', 'World cinema', 'Romance Film', 'Drama']",2000,6
14108821,Al otro lado,2005,['Mexico'],"['Documentary', 'Drama', 'World cinema']",2000,5
3869472,Ransom!,1956,['United States of America'],"['Drama', 'Crime Fiction']",1950,6
13659818,The Human Duplicators,1965,['United States of America'],"['Indie', 'Alien Film', 'Science Fiction']",1960,5
28141854,Billie,1965,['United States of America'],"['Musical', 'Coming of age', 'Comedy', 'Teen', 'Romantic comedy', 'Romance Film', 'Sports']",1960,5
28260594,At Home by Myself...With You,2009,['Canada'],['Comedy'],2000,9
2190310,It's All Gone Pete Tong,2005,"['Canada', 'United Kingdom']","['Parody', 'Indie', 'Satire', 'Comedy', 'Musical comedy', 'Comedy-drama', 'Mockumentary']",2000,5
33128846,The Axe of Wandsbek,1951,"['Germany', 'German Democratic Republic']","['Drama', 'World cinema']",1950,1
16930015,Bullet to Beijing,1995,"['Russia', 'United Kingdom', 'Canada']","['Spy', 'Action Thrillers', 'Thriller']",1990,5
4049715,Killer Condom,1996,"['Switzerland', 'Germany']","['Gross out', 'LGBT', 'Gross-out film', 'Comedy', 'Horror Comedy', 'World cinema', 'Parody', 'Horror', 'Sex comedy']",1990,6
16278262,Ooty Varai Uravu,1967,['India'],"['Drama', 'World cinema']",1960,7
11617679,Showdown,1998,['United States of America'],"['Crime Fiction', 'Short Film', 'Drama']",1990,8
13869704,Donga Sachinollu,2008,['India'],['Comedy'],2000,8
171066,What's Love Got to Do with It,1993,['United States of America'],"['Musical', 'Biography', 'Biographical film', 'Drama']",1990,3
6827148,Nuvvu Naaku Nachav,2001,['India'],"['Romantic drama', 'World cinema', 'Romance Film', 'Drama']",2000,1
24003402,The Unborn II,1994,['United States of America'],"['Monster movie', 'Science Fiction', 'Horror']",1990,4
2117473,The Country Bears,2002,['United States of America'],"['Music', 'Musical', 'Comedy', 'Musical comedy', ""Children's/Family"", ""Children's"", 'Family Film']",2000,2
26608236,Chuka,1967,['United States of America'],"['Western', 'Film adaptation', 'Action/Adventure']",1960,7
5970614,Three Little Pigskins,1934,['United States of America'],"['Black-and-white', 'Short Film', 'Comedy', 'Slapstick']",1930,4
2783102,Woman on the Run,1950,['United States of America'],"['Crime Fiction', 'Thriller', 'Film noir', 'Crime Thriller']",1950,0
15223564,The Barretts of Wimpole Street,1957,['United Kingdom'],['Drama'],1950,7
18188737,Desperate Teenage Lovedolls,2003,['United States of America'],"['Musical', 'Parody', 'Indie', 'Comedy', 'Punk rock', 'Cult']",2000,3
23146478,Skin Deep,1995,['Canada'],"['LGBT', 'Drama']",1990,5
924771,The Naked Gun 2½: The Smell of Fear,1991,['United States of America'],"['Parody', 'Comedy']",1990,1
4758386,My Blueberry Nights,2007,"['France', 'Hong Kong', 'China']","['Indie', 'Romantic drama', 'World cinema', 'Romance Film', 'Chinese Movies', 'Drama', 'Slice of life story', 'Road movie']",2000,7
149791,A Double Life,1947,['United States of America'],"['Black-and-white', 'Crime Fiction', 'Thriller', 'Film noir', 'Crime Thriller', 'Drama']",1940,7
13452919,Frontier,2007,"['Switzerland', 'France']","['Action', 'Slasher', 'Action/Adventure', 'Thriller', 'Horror', 'World cinema']",2000,7
6376026,Trader Hornee,1970,['United States of America'],"['Action', 'Adventure Comedy', 'Action/Adventure', 'Comedy', 'Adventure', 'Sexploitation', 'Parody', 'Jungle Film', 'Adult', 'Cult', 'Sex comedy']",1970,0
5676388,Unstoppable,2004,['United States of America'],"['Action', 'Psychological thriller', 'Action/Adventure', 'Comedy', 'Thriller']",2000,4
2154438,White Man's Burden,1995,['United States of America'],"['Crime Fiction', 'Thriller', 'Crime Drama', 'Americana', 'Political drama', 'Drama']",1990,5
18001712,Irupatham Noottandu,1987,['India'],"['Drama', 'Crime Fiction']",1980,7
9325204,The Man from the Diner's Club,1963,['United States of America'],"['Comedy', 'Black-and-white']",1960,3
1986380,Junior Bonner,1972,['United States of America'],"['Action/Adventure', 'Western', 'Sports', 'Drama']",1970,2
25185781,Merry Madagascar,2009,['United States of America'],"[""Children's/Family"", 'Short Film', 'Adventure']",2000,9
12695943,Bagets,1984,['Philippines'],"['Filipino Movies', 'Comedy', 'Teen', 'World cinema', 'Drama']",1980,4
16703150,Rough Night in Jericho,1967,['United States of America'],"['Revisionist Western', 'Western']",1960,7
30247229,The Animal,1977,['France'],"['Action', 'Romance Film', 'Comedy']",1970,7
22372814,Gopher Broke,1958,['United States of America'],"['Animation', 'Short Film', 'Family Film']",1950,8
518615,King Kong,1976,['United States of America'],"['Monster movie', 'Action/Adventure', 'Remake', 'Horror', 'Adventure']",1970,6
30897354,Mackintosh and T.J.,1975,['United States of America'],['Western'],1970,5
431562,Almost Famous,2000,['United States of America'],"['Musical', 'Musical Drama', 'Comedy', 'Drama', 'Period piece', 'Coming of age', 'Comedy-drama', 'Road movie']",2000,0
19985215,Arya 2,2009,['India'],"['Action', 'Drama', 'Mystery', 'Thriller']",2000,9
11440692,What Goes Up,2009,['United States of America'],"['Period piece', 'Indie', 'Comedy-drama', 'Drama']",2000,9
27258675,Surf Party,1964,['United States of America'],"['Musical', 'Comedy film']",1960,4
3652477,Raptor Island,2004,['United States of America'],"['Action', 'Action Thrillers', 'Action/Adventure', 'Thriller', 'Sci-Fi Adventure', 'Adventure', 'Horror', 'Science Fiction', 'Fantasy']",2000,4
12576807,Futurama: The Beast with a Billion Backs,2008,['United States of America'],"['Science Fiction', 'Comedy']",2000,8
10641005,Bewafai,1985,['India'],"['Crime Fiction', 'Drama', 'Family Film']",1980,5
4616725,Ernest Rides Again,1993,['United States of America'],"['Slapstick', 'Comedy']",1990,3
9736116,Dancing in September,2000,['United States of America'],"['Comedy', 'Media Satire', 'Romance Film', 'Drama', 'Parody', 'Romantic comedy', 'Television movie', 'Comedy-drama']",2000,0
10196402,Saat rang ke sapne,1998,['India'],"['Drama', 'World cinema']",1990,8
8401836,Stigma,1972,[],['Drama'],1970,2
21684384,ExTerminators,2009,['United States of America'],"['Drama', 'Crime Fiction', 'Indie', 'Comedy', 'Crime Comedy', 'Black comedy']",2000,9
3084841,The Quiet,2005,['United States of America'],"['Psychological thriller', 'Family Drama', 'Indie', 'Thriller', 'Drama']",2000,5
174251,The Lord of the Rings: The Return of the King,2003,"['New Zealand', 'United States of America']","['Fantasy Adventure', 'Film adaptation', 'Action/Adventure', 'Adventure', 'Drama', 'Sword and sorcery films', 'Epic', 'Fantasy']",2000,3
7286111,Ahimsa Stop To Run,2005,['Thailand'],"['Crime Fiction', 'Comedy', 'Thriller', 'Drama']",2000,5
5109756,Sweet Sixteen,1983,['United States of America'],"['Slasher', 'Teen', 'Horror', 'Cult']",1980,3
17286344,Page Miss Glory,1935,['United States of America'],"['Romantic comedy', 'Black-and-white']",1930,5
26026273,A Wicked Ghost III: The Possession,2002,['Hong Kong'],"['Chinese Movies', 'Horror']",2000,2
28842888,Bright Road,1953,['United States of America'],"['Music', 'Drama']",1950,3
22080792,One Woman Show,2007,['United Kingdom'],"['Crime Fiction', 'Mystery', 'Short Film', 'Thriller', 'Horror']",2000,7
682393,Menace II Society,1993,['United States of America'],"['Crime Fiction', 'Gangster Film', 'Drama']",1990,3
2752058,Straight-Jacket,2004,['United States of America'],"['Period piece', 'Gay Themed', 'LGBT', 'Gay', 'Gay Interest', 'Comedy', 'Romance Film']",2000,4
26096490,The Chalk Garden,1964,"['United Kingdom', 'United States of America']","['Mystery', 'Drama']",1960,4
3135608,Tales of Terror,1962,['United States of America'],"['Film adaptation', 'Gothic Film', 'Horror Comedy', 'Thriller', 'Zombie Film', 'Costume Horror', 'Drama', 'Horror']",1960,2
10131260,"Ready, Set, Zoom!",1955,['United States of America'],"['Animation', 'Short Film', 'Comedy', 'Family Film']",1950,5
20912988,Gunsmoke,1953,['United States of America'],"['Action', 'Western']",1950,3
9186122,Buenos Aires Plateada,2000,['Argentina'],"['Black-and-white', 'Indie', 'Drama']",2000,0
11226458,Make It Happen,2008,['United States of America'],"['Romantic drama', 'Dance', 'Romance Film', 'Drama']",2000,8
27728090,Devatha,1964,['India'],['Drama'],1960,4
25895961,"Tora-san, the Expert",1982,['Japan'],['Japanese Movies'],1980,2
33857221,"Mord ist mein Geschäft, Liebling",2009,['Germany'],['Comedy'],2000,9
7903143,Kadhalukku Mariyadhai,1997,['India'],['Romance Film'],1990,7
686006,The Wings of Eagles,1957,['United States of America'],"['Action', 'Action/Adventure', 'Biographical film', 'Biopic [feature]', 'War film', 'Drama']",1950,7
6882738,Tum Bin,2001,['India'],"['Romance Film', 'Drama']",2000,1
4441267,.45,2006,['United States of America'],"['Action', 'Psychological thriller', 'Crime Fiction', 'Indie', 'Thriller', 'Black comedy', 'Crime Thriller', 'Drama']",2000,6
308856,The Phantom of the Opera,2004,"['United Kingdom', 'United States of America']","['Musical', 'Period piece', 'Romantic drama', 'Horror', 'Romance Film', 'Drama']",2000,4
678599,Vision Quest,1985,['United States of America'],"['Coming of age', 'Romantic drama', 'Teen', 'Romance Film', 'Sports', 'Drama']",1980,5
6705113,Baba,2002,['India'],"['Musical', 'Bollywood', 'World cinema', 'Drama']",2000,2
8695709,Dracula,1973,['United States of America'],['Horror'],1970,3
12813350,Tobacco Road,1941,['United States of America'],"['Drama', 'Comedy']",1940,1
15187261,Saturday Morning,1922,['United States of America'],"['Black-and-white', 'Indie', 'Short Film', 'Comedy', 'Silent film']",1920,2
75263,A Night at the Opera,1935,['United States of America'],"['Musical', 'Black-and-white', 'Screwball comedy', 'Comedy', 'Slapstick']",1930,5
10418324,Michael Madhana Kamarajan,1991,['India'],['Comedy'],1990,1
4662218,Paramasivan,2006,['India'],"['Musical', 'Bollywood', 'World cinema', 'Drama']",2000,6
3941055,Personal Velocity: Three Portraits,2002,['United States of America'],"['Dogme 95', 'Indie', 'Romance Film', 'Drama', 'Feminist Film']",2000,2
29760708,Dark Mountain,1944,['United States of America'],"['Crime Fiction', 'Adventure', 'Drama']",1940,4
28531923,Swapna Lokathe Balabhaskaran,1996,['India'],"['Romantic drama', 'Comedy']",1990,6
30685077,Lonely Wives,1931,['United States of America'],"['Comedy', 'Comedy film']",1930,1
380517,Maverick,1994,['United States of America'],"['Action', 'Action/Adventure', 'Comedy', 'Thriller', 'Buddy film', 'Costume drama', 'Adventure', 'Drama', 'Comedy Western', 'Western']",1990,4
24228738,The Dragon from Russia,1990,['Hong Kong'],"['Crime Fiction', 'Superhero', 'Gangster Film', 'Action/Adventure', 'World cinema', 'Chinese Movies', 'Martial Arts Film', 'Drama', 'Superhero movie']",1990,0
32035678,Enamorada,1946,['Mexico'],"['Comedy film', 'Romance Film', 'War film', 'Drama']",1940,6
21334072,The Last Man on Planet Earth,1999,['United States of America'],"['Psychological thriller', 'Science Fiction', 'Thriller']",1990,9
21483521,Caroline at Midnight,1994,['United States of America'],"['Mystery', 'Thriller', 'Erotic thriller', 'Adult']",1990,4
22111726,Te Quiero,1978,['Mexico'],"['Romance Film', 'Drama']",1970,8
3654678,The Children Are Watching Us,1944,['Italy'],"['Black-and-white', 'Art film', 'World cinema', 'Drama']",1940,4
19398925,Mama's Little Pirate,1934,['United States of America'],"['Black-and-white', 'Short Film', 'Comedy', 'Family Film']",1930,4
3548116,Fast Getaway II,1994,['United States of America'],"['Action', 'Heist', 'Crime Fiction', 'Action/Adventure', 'Comedy', 'Thriller', 'Adventure']",1990,4
1608510,Behind the Sun,2001,"['Brazil', 'France', 'Switzerland']","['Crime Fiction', 'Family Drama', 'World cinema', 'Drama']",2000,1
2009947,Alice Sweet Alice,1976,['United States of America'],"['Psychological thriller', 'Crime Fiction', 'Mystery', 'Indie', 'Thriller', 'Slasher', 'Horror', 'B-movie']",1970,6
3178137,One from the Heart,1982,['United States of America'],"['Musical', 'Indie', 'Romantic drama', 'Comedy', 'Romance Film', 'Drama', 'New Hollywood', 'Romantic comedy']",1980,2
781201,The Emperor and the Assassin,1998,"['France', 'China', 'Japan']","['World cinema', 'Chinese Movies', 'Drama', 'Japanese Movies', 'Historical Epic', 'Historical fiction', 'Epic', 'War film']",1990,8
7734862,Sunday in New York,1963,['United States of America'],"['Romance Film', 'Romantic comedy', 'Comedy']",1960,3
24996543,Strayed,2003,"['United Kingdom', 'France']","['Period piece', 'Romantic drama', 'World cinema', 'Romance Film', 'War film', 'Drama']",2000,3
2640146,The Shiralee,1957,"['United Kingdom', 'Australia']",['Drama'],1950,7
539816,Silent Running,1972,['United States of America'],"['Dystopia', 'Adventure', 'Doomsday film', 'Science Fiction', 'Drama', 'Cult']",1970,2
9404717,The Lady Vanishes,1979,['United Kingdom'],"['Spy', 'Mystery', 'Action/Adventure']",1970,9
3679052,High Wall,1947,['United States of America'],"['Film noir', 'Black-and-white']",1940,7
4340438,Sátántangó,1994,"['Austria', 'Switzerland', 'Hungary', 'Germany']","['Comedy', 'Thriller', 'World cinema', 'Drama', 'Ensemble Film']",1990,4
5422011,H,2002,['South Korea'],"['Psychological thriller', 'Thriller', 'Detective', 'Horror', 'World cinema', 'Crime Thriller']",2000,2
18299903,Rock On!!,2008,['India'],"['Musical', 'Bollywood', 'World cinema']",2000,8
8346431,"Shake, Rattle & Roll IV",1992,['Philippines'],"['Filipino Movies', 'Comedy', 'Horror']",1990,2
23459968,The Case of the Stuttering Bishop,1937,['United States of America'],"['Detective fiction', 'Crime Fiction', 'Mystery', 'Detective']",1930,7
1343245,Fanny,1961,['United States of America'],"['Period piece', 'Romantic drama', 'Romance Film', 'Drama']",1960,1
27492676,La Otra,1946,['Mexico'],"['Crime Fiction', 'Mystery', 'Thriller', 'Drama']",1940,6
27170572,Daayraa,1997,['India'],"['Musical', 'Romance Film', 'Drama']",1990,7
4652449,Here Comes Peter Cottontail,1971,['United States of America'],"['Musical', 'Animation', 'Animated Musical', 'Stop motion', ""Children's/Family"", 'Holiday Film', 'Drama', 'Family Film']",1970,1
1528272,Murder in the First,1995,"['France', 'United States of America']","['Period piece', 'Prison', 'Crime Fiction', 'Drama', 'Courtroom Drama']",1990,5
25187705,Ho Ho Ho,2009,[],"['Family Film', 'Drama', 'Comedy film']",2000,9
11260752,Fit to Be Tied,1952,['United States of America'],"['Animation', 'Short Film', 'Comedy', 'Family Film']",1950,2
29854616,Changathipoocha,2007,[],['Romantic comedy'],2000,7
1954790,A Woman Rebels,1936,['United States of America'],"['Black-and-white', 'Costume drama', 'Drama', 'Feminist Film']",1930,6
9730374,Anumanaspadam,2007,['India'],"['Musical', 'Thriller', 'Bollywood', 'World cinema']",2000,7
244610,Wild Wild West,1999,['United States of America'],"['Adventure Comedy', 'Action', 'Buddy film', 'Comedy', 'Adventure', 'Comedy Western', 'Western', 'Science Fiction']",1990,9
1189721,They Live by Night,1948,['United States of America'],"['Film noir', 'Crime Drama', 'Melodrama', 'Drama']",1940,8
26878950,Ivide Thudangunnu,1984,[],"['Action', 'Romance Film', 'Drama']",1980,4
12537943,Tetro,2009,"['Spain', 'Argentina', 'Italy', 'United States of America']","['Mystery', 'Family Drama', 'Indie', 'Drama']",2000,9
1551200,Map of the Human Heart,1993,"['Australia', 'United Kingdom', 'France', 'New Zealand']","['Period piece', 'Romantic drama', 'World cinema', 'Romance Film', 'Drama']",1990,3
4564602,Yeh Dil Aap Ka Huwa,2002,['Pakistan'],"['Musical', 'Romance Film']",2000,2
3245477,The Merchant of Venice,2004,"['Luxembourg', 'United Kingdom', 'Italy', 'United States of America']","['Period piece', 'Film adaptation', 'Romance Film', 'Drama']",2000,4
29634383,Putnanja,1995,[],['Romance Film'],1990,5
32205817,Pretty Baby,1950,[],['Comedy film'],1950,0
26938419,Microwave Massacre,1983,['United States of America'],"['Slasher', 'B-movie', 'Horror']",1980,3
19571156,Iska's Journey,2007,['Hungary'],"['Social problem film', 'Drama', 'World cinema']",2000,7
29890747,Warpath,1951,['United States of America'],"['Action/Adventure', 'Western']",1950,1
10587298,We're No Angels,1989,['United States of America'],"['Action', 'Crime Fiction', 'Indie', 'Buddy film', 'Comedy', 'Religious Film']",1980,9
8273214,Trinetrudu,1988,['India'],['Action'],1980,8
2977550,Zeher,2005,['India'],"['Romantic drama', 'Action/Adventure', 'World cinema', 'Romance Film', 'Drama']",2000,5
23446234,Latino,1985,['United States of America'],"['War film', 'Drama']",1980,5
2947414,Dragons: Fire and Ice,2004,['United States of America'],"['Action', 'Fantasy Adventure', 'Animated cartoon', 'Animation', 'Adventure', 'Sword and sorcery films', ""Children's Fantasy"", 'Anime', 'Family Film', 'Fantasy']",2000,4
1413739,Kaho Naa... Pyaar Hai,2000,['India'],"['Action', 'Musical', 'Crime Fiction', 'Romantic drama', 'Bollywood', 'World cinema', 'Romance Film', 'Drama']",2000,0
28713211,To Face Her Past,1996,['United States of America'],['Drama'],1990,6
8919382,Veerapandiya Kattabomman,1959,['India'],['Historical drama'],1950,9
3009486,Tank,1984,['United States of America'],"['Action', 'Action Comedy', 'Action/Adventure', 'Comedy', 'Thriller', 'Drama']",1980,4
2467723,Monkey Business,2000,['India'],"['Musical', 'Comedy', 'Bollywood', 'World cinema']",2000,0
6498430,Twice Two,1932,['United States of America'],"['Short Film', 'Black-and-white', 'Comedy']",1930,2
15687214,A Business Affair,1994,"['Spain', 'United Kingdom', 'France', 'Germany']","['Romance Film', 'Romantic comedy', 'Comedy']",1990,4
20264949,Flamenco,1995,"['Spain', 'Portugal']","['Music', 'Musical', 'World cinema', 'Documentary', 'Dance']",1990,5
5041941,Read It and Weep,2006,['United States of America'],"['Coming of age', 'Comedy', 'Television movie', ""Children's"", 'Drama', 'Family Film']",2000,6
31163664,Forever Female,1954,['United States of America'],['Comedy'],1950,4
32907275,The Man from Kangaroo,1920,[],['Silent film'],1920,0
29407509,Boomer,2003,['Russia'],"['Crime Fiction', 'Gangster Film', 'Thriller', 'Drama']",2000,3
19401407,Dean Spanley,2008,"['New Zealand', 'United Kingdom']","['Period piece', 'Indie', 'Fantasy Drama', 'Comedy', 'Comedy-drama', 'Adventure', 'Fantasy']",2000,8
9957782,The Road to San Diego,2006,['Argentina'],"['Indie', 'Comedy', 'World cinema']",2000,6
4107170,Riding Giants,2004,"['United States of America', 'France']","['History', 'Biography', 'Documentary', 'Extreme Sports', 'Sports']",2000,4
14184381,First Love,2004,['Italy'],"['World cinema', 'Romance Film', 'Erotica', 'Drama']",2000,4
25648942,Strike Commando 2,1988,['Italy'],['Action'],1980,8
9090163,The Seduction of Joe Tynan,1979,['United States of America'],"['Comedy', 'Comedy-drama', 'Political drama', 'Drama']",1970,9
8991638,Week-End at the Waldorf,1945,['United States of America'],"['Black-and-white', 'Comedy', 'War film', 'Drama']",1940,5
6475757,Karz,1980,['India'],"['Drama', 'Thriller', 'World cinema']",1980,0
6492828,The Pit and the Pendulum,1991,['United States of America'],"['Costume drama', 'Cult', 'Horror']",1990,1
2736876,My Uncle Benjamin,1969,['France'],['Comedy'],1960,9
22734574,The Ten Commandments: The Musical,2006,['United States of America'],"['Music', 'Musical', 'Musical Drama']",2000,6
11455154,"4 Months, 3 Weeks and 2 Days",2007,['Romania'],"['Slice of life story', 'Drama', 'World cinema']",2000,7
4271752,Cybermutt,2003,"['United Kingdom', 'Germany', 'Canada']","['Comedy', 'Animal Picture', 'Television movie', 'Science Fiction', 'Family Film']",2000,3
3673758,Night Passage,1957,['United States of America'],"['Action/Adventure', 'Western']",1950,7
12643712,Haan Maine Bhi Pyaar Kiya,2002,['India'],"['Romantic drama', 'Bollywood', 'World cinema', 'Romance Film', 'Drama']",2000,2
1357923,Summer Holiday,1962,['United Kingdom'],"['Musical', 'Romance Film']",1960,2
469520,Avalon,1990,['United States of America'],"['Period piece', 'Drama']",1990,0
7170491,Sex and Breakfast,2006,['United States of America'],"['Erotic Drama', 'Indie', 'Romantic drama', 'Comedy', 'Romance Film', 'Drama', 'Comedy-drama', 'Sex comedy']",2000,6
10131206,Zipping Along,1953,['United States of America'],"['Animation', 'Short Film', 'Comedy', 'Family Film']",1950,3
17798387,The Guard Post,2008,['South Korea'],"['Mystery', 'Horror']",2000,8
1797645,Beverly of Graustark,1926,['United States of America'],"['Silent film', 'Drama']",1920,6
8235569,Rudraksh,2004,['India'],"['Drama', 'Thriller', 'World cinema']",2000,4
19908169,Marquis de Sade: Justine,1969,"['United Kingdom', 'Italy']","['Romance Film', 'Drama']",1960,9
10870536,Among the Living,1941,['United States of America'],"['Crime Fiction', 'Thriller', 'Horror', 'Film noir', 'Crime Thriller']",1940,1
17908468,I Love You Phillip Morris,2009,"['United States of America', 'France']","['Action', 'Prison', 'LGBT', 'Action/Adventure', 'Comedy', 'Romance Film', 'Black comedy', 'Drama', 'Gay Themed', 'Gay', 'Gay Interest', 'Romantic comedy']",2000,9
13396095,The Cat that Hated People,1948,['United States of America'],['Animation'],1940,8
8747363,Mush and Milk,1933,['United States of America'],"['Black-and-white', 'Short Film', 'Comedy', 'Family-Oriented Adventure', ""Children's/Family"", 'Family Film']",1930,3
183550,Pink Narcissus,1971,['United States of America'],"['LGBT', 'Romance Film', 'Drama', 'Gay Themed', 'Softcore Porn', 'Gay', 'Gay Interest', 'Adult']",1970,1
4703636,The Dark,2005,"['United Kingdom', 'Germany']","['Mystery', 'Thriller', 'Horror']",2000,5
20642521,White Light,2008,['Netherlands'],['Drama'],2000,8
15347769,Mr. Wu,1927,['United States of America'],"['Silent film', 'Black-and-white']",1920,7
1925048,Everything Is Illuminated,2005,['United States of America'],"['Film adaptation', 'Family Drama', 'Comedy', 'Comedy-drama', 'Road movie', 'Adventure', 'Drama']",2000,5
4451319,The Beating of the Butterfly's Wings,2000,['France'],"['Romantic drama', 'Comedy', 'World cinema', 'Romance Film', 'Romantic comedy', 'Drama']",2000,0
23724252,Villa Estrella,2009,['Philippines'],"['Filipino Movies', 'Horror', 'World cinema', 'Drama']",2000,9
3556758,Dang Bireley's and Young Gangsters,1997,['Thailand'],['Crime Fiction'],1990,7
13278422,Krishna,2008,['India'],"['Musical', 'Bollywood', 'World cinema', 'Drama']",2000,8
6537778,Color of the Cross,2006,['United States of America'],"['Christian film', 'Hagiography', 'Drama']",2000,6
31696903,Shanks,1974,['United States of America'],"['Horror', 'Fantasy']",1970,4
33724091,Reunion,1980,['United States of America'],['Drama'],1980,0
1507235,Song For a Raggy Boy,2003,"['Spain', 'Denmark', 'United Kingdom', 'Ireland']",['Drama'],2000,3
73401,City Lights,1931,['United States of America'],"['Black-and-white', 'Romantic drama', 'Comedy', 'Silent film', 'Romance Film', 'Romantic comedy', 'Drama']",1930,1
17049893,Rawhide,1938,['United States of America'],"['Action/Adventure', 'Western']",1930,8
20396414,Life Is Hot in Cracktown,2009,['United States of America'],"['Drama', 'Indie', 'Crime Drama', 'Ensemble Film']",2000,9
11271307,Sharpe's Waterloo,1997,['United Kingdom'],"['Period piece', 'Costume Adventure', 'Historical fiction', 'Adventure']",1990,7
9550478,Soldier Boyz,1995,['United States of America'],"['Action', 'Thriller', 'Drama']",1990,5
2486990,Scary Movie 4,2006,['United States of America'],"['Gross out', 'Gross-out film', 'Comedy', 'Teen', 'Horror Comedy', 'Absurdism', 'Parody', 'Horror']",2000,6
17754203,The Onion Movie,2008,['United States of America'],"['Parody', 'Comedy', 'Cult']",2000,8
32920652,Khamma Mara Veera / Rakshaa Bandhan,1980,['India'],[],1980,0
26306842,Tata Manavadu,1972,['India'],['Drama'],1970,2
3703551,Out on a Limb,1992,['United States of America'],['Comedy'],1990,2
24479951,Lost Song,2008,['Canada'],"['Indie', 'Drama', 'World cinema']",2000,8
15337014,The Whistle Blower,1987,['United Kingdom'],"['Action', 'Action/Adventure', 'Thriller', 'Crime Thriller', 'Political thriller']",1980,7
21874955,Leni Riefenstahl: Her Dream of Africa,2000,[],['Documentary'],2000,0
14199086,İş Bank commercial featuring Atatürk,2007,[],['Short Film'],2000,7
6165918,The Golf Specialist,1930,['United States of America'],"['Short Film', 'Comedy', 'Slapstick', 'Absurdism']",1930,0
14254136,1984,1984,['United Kingdom'],"['Thriller', 'Romance Film', 'Science Fiction', 'Drama']",1980,4
7165631,Pyaar Ke Side Effects,2006,['India'],"['Romantic drama', 'Comedy', 'World cinema', 'Romance Film', 'Romantic comedy', 'Drama']",2000,6
20156307,Stand by for Action,1942,['United States of America'],"['Combat Films', 'Black-and-white', 'Adventure', 'War film']",1940,2
2292079,Kill!,1968,['Japan'],"['Japanese Movies', 'Action/Adventure', 'Comedy', 'World cinema', 'Black comedy']",1960,8
34965228,Kentucky Woman,1983,['United States of America'],['Drama'],1980,3
54173,Pulp Fiction,1994,['United States of America'],"['Crime Fiction', 'Gangster Film', 'Indie', 'Thriller', 'Black comedy', 'Crime Thriller', 'Drama', 'Crime Comedy', 'Ensemble Film']",1990,4
9787696,The Bad Sister,1931,['United States of America'],"['Black-and-white', 'Drama']",1930,1
4350811,The Grapes of Wrath,1940,['United States of America'],"['Film adaptation', 'Black-and-white', 'Family Drama', 'Social problem film', 'Americana', 'Drama']",1940,0
25516274,If Someone Had Known,1995,['United States of America'],"['Marriage Drama', 'Social problem film', 'Television movie', 'Drama']",1990,5
698242,Red Dragon,2002,"['Germany', 'United States of America']","['Psychological thriller', 'Crime Fiction', 'Mystery', 'Thriller', 'Crime Thriller', 'Drama', 'Suspense', 'Slasher', 'Horror']",2000,2
20280702,The Nutty Professor,2008,['United States of America'],"['Animation', 'Comedy', 'Family Film']",2000,8
3555951,10th & Wolf,2006,['United States of America'],"['Crime Fiction', 'Gangster Film', 'Mystery', 'Thriller', 'Crime Thriller', 'Drama']",2000,6
5066460,Cheolindo,1930,"['Korea', 'South Korea']","['Action', 'Black-and-white', 'Drama', 'Indie', 'Silent film']",1930,0
7689323,Net Worth,2000,['United States of America'],"['Indie', 'Comedy']",2000,0
2205317,Arabian Nights,1974,"['France', 'Italy']","['Action', 'Comedy', 'World cinema', 'Adventure', 'Drama', 'Fantasy']",1970,4
10827350,Shoot,1976,['Canada'],"['Action', 'Thriller', 'Drama']",1970,6
15463889,El Cielo Rojo,2008,['Costa Rica'],"['Drama', 'Comedy']",2000,8
1112869,Godzilla vs. SpaceGodzilla,1994,['Japan'],"['Monster', 'Science Fiction', 'Japanese Movies']",1990,4
3668661,Talk to Me,1996,['United States of America'],"['Drama', 'Television movie']",1990,6
1637570,Fandango,1985,['United States of America'],"['Period piece', 'Indie', 'Comedy', 'Road movie']",1980,5
5881936,Kizhakku Kadalkarai Salai,2006,['India'],"['Action', 'Crime Fiction', 'Drama']",2000,6
14849115,Aa Gale Lag Jaa,1994,['India'],['Romance Film'],1990,4
20040056,Kaminey,2009,['India'],"['Action', 'Musical', 'Crime Fiction', 'Comedy', 'Bollywood', 'World cinema', 'Drama']",2000,9
23143530,Sandhesam,1991,['India'],"['Drama', 'Comedy']",1990,1
748616,"Spring, Summer, Fall, Winter... and Spring",2003,"['Germany', 'South Korea']","['Drama', 'World cinema']",2000,3
18506518,Curse of the Maya,2004,['United States of America'],"['B-movie', 'Zombie Film', 'Horror']",2000,4
1197917,633 Squadron,1964,"['United Kingdom', 'United States of America']","['Action', 'Combat Films', 'Film adaptation', 'Action/Adventure', 'War film', 'Drama']",1960,4
31148913,Sadaa Suhagan,1986,[],"['Romance Film', 'Drama', 'Family Film']",1980,6
7846363,Miss Firecracker,1989,['United States of America'],"['Indie', 'Comedy', 'Domestic Comedy', 'Comedy-drama', 'Americana']",1980,9
8268252,Boo!,1932,['United States of America'],"['Black-and-white', 'Short Film', 'Comedy', 'Horror']",1930,2
27697789,Revenge of the Zombies,1943,['United States of America'],"['Horror', 'Science Fiction']",1940,3
4550151,Katie Tippel,1975,['Netherlands'],"['Satire', 'World cinema', 'Romance Film', 'Comedy-drama', 'Drama']",1970,5
8658177,Wasp,2003,['United Kingdom'],"['Indie', 'Short Film', 'Drama']",2000,3
570269,Mothra vs. Godzilla,1964,['Japan'],"['Japanese Movies', 'Monster', 'World cinema', 'Science Fiction', 'Cult', 'Fantasy']",1960,4
4602699,Young and Dangerous 2,1996,['Hong Kong'],"['Action', 'Crime Fiction', 'Action/Adventure', 'World cinema', 'Crime Drama', 'Chinese Movies', 'Martial Arts Film']",1990,6
171522,Sling Blade,1996,['United States of America'],"['Melodrama', 'Indie', 'Drama']",1990,6
20700559,Miracle on 34th Street,1994,['United States of America'],"['Courtroom Drama', 'Family Drama', 'Drama', 'Family Film', 'Fantasy']",1990,4
32038301,V poiskakh kapitana Granta,1986,[],['Adventure'],1980,6
16362457,"Mahesh, Saranya Matrum Palar",2008,['India'],['Romance Film'],2000,8
19714149,Auto Antics,1939,['United States of America'],"['Black-and-white', 'Short Film', 'Comedy', 'Family Film']",1930,9
10485963,A Song Is Born,1948,['United States of America'],"['Musical', 'Backstage Musical', 'Comedy', 'Musical comedy']",1940,8
2483117,The Whip and the Body,1963,"['France', 'Italy']","['Costume Horror', 'Gothic Film', 'Horror']",1960,3
5374233,"Good Boy, Bad Boy",2007,['India'],"['Musical', 'Comedy', 'Bollywood', 'World cinema', 'Romance Film']",2000,7
2665467,Sex and Zen,1992,['Hong Kong'],"['Erotic Drama', 'Comedy', 'World cinema', 'Erotica', 'Chinese Movies']",1990,2
23015383,Metropia,2009,"['Denmark', 'Sweden', 'Finland', 'Norway']","['Computer Animation', 'Animation', 'Thriller', 'World cinema', 'Anime', 'Science Fiction']",2000,9
18162839,The Great Northfield Minnesota Raid,1972,['United States of America'],"['Action', 'Heist', 'Action/Adventure', 'Western']",1970,2
5578025,Kamen Rider 555: Paradise Lost,2003,[],"['Action', 'Science Fiction']",2000,3
8781770,Second Chance,1953,['United States of America'],"['Film noir', 'Drama', 'Thriller']",1950,3
26370924,Battle at Bloody Beach,1961,['United States of America'],"['Action', 'Combat Films', 'Adventure']",1960,1
3606845,Randy Rides Alone,1934,['United States of America'],"['Action', 'B-Western', 'Black-and-white', 'Action/Adventure', 'Western']",1930,4
616554,Mr. Blandings Builds His Dream House,1948,['United States of America'],"['Parody', 'Comedy', 'Romance Film', 'Domestic Comedy', 'Slapstick']",1940,8
26587817,Colors,2009,['India'],"['Drama', 'Comedy']",2000,9
6673089,Stage Door Cartoon,1944,['United States of America'],"['Animation', 'Short Film', 'Comedy', 'Family Film']",1940,4
454655,The Wedding Singer,1998,['United States of America'],"['Music', 'Period piece', 'Comedy', 'Romance Film', 'Romantic comedy']",1990,8
15438790,Arai Enn 305-il Kadavul,2008,['India'],['Fantasy'],2000,8
3861698,Marrying the Mafia II,2005,['South Korea'],"['Action', 'Crime Fiction', 'Comedy', 'Romance Film']",2000,5
1459045,The Finest Hour,1992,['United States of America'],"['Action', 'Action/Adventure', 'Thriller', 'Adventure', 'War film', 'Drama']",1990,2
7085998,Chhoti Si Baat,1975,['India'],"['Romantic drama', 'Comedy', 'Bollywood', 'World cinema', 'Romance Film', 'Romantic comedy', 'Drama']",1970,5
4343497,Stepfather II,1989,"['United Kingdom', 'United States of America']","['Slasher', 'Horror']",1980,9
9093781,Night of the Pencils,1986,['Argentina'],"['Indie', 'Drama']",1980,6
34115605,Disorderly Conduct,1932,[],['Comedy film'],1930,2
509662,Sinbad of the Seven Seas,1989,['Italy'],"['Fantasy Adventure', 'Mythological Fantasy', 'Action/Adventure', 'Adventure', 'Sword and sorcery films', 'Fantasy']",1980,9
7400687,I Love You Baby,2001,['Spain'],"['LGBT', 'Romantic drama', 'Comedy', 'World cinema', 'Romance Film', 'Drama', 'Gay Themed', 'Gay', 'Gay Interest', 'Romantic comedy']",2000,1
19168185,9 Dead Gay Guys,2003,['United Kingdom'],"['Gay Themed', 'LGBT', 'Gay', 'Gay Interest', 'Comedy', 'Black comedy']",2000,3
6206610,Felicity,1979,"['New Zealand', 'Australia']","['Romance Film', 'Romantic comedy', 'Comedy']",1970,9
18512327,A Hazard of Hearts,1987,['United Kingdom'],"['Romance Film', 'Drama']",1980,7
3300191,White Sands,1992,['United States of America'],"['Action', 'Suspense', 'Crime Fiction', 'Mystery', 'Action/Adventure', 'Thriller', 'Crime Thriller']",1990,2
6190944,Mamba,1930,['United States of America'],['Drama'],1930,0
18253063,Swing Ding Amigo,1966,['United States of America'],[],1960,6
28030302,Cry Terror!,1958,['United States of America'],"['Film noir', 'Thriller']",1950,8
21560958,Corrections,2008,['Australia'],"['Short Film', 'Horror']",2000,8
21260147,Redemption: Kickboxer 5,1995,['United States of America'],"['Action', 'Action Thrillers', 'Action/Adventure', 'Thriller', 'Martial Arts Film']",1990,5
5241472,Metallic Blues,2004,['Israel'],"['Buddy film', 'Comedy', 'World cinema', 'Road movie', 'Drama']",2000,4
33384836,Maanyanmar,1992,[],"['Drama', 'Comedy film']",1990,2
32241787,Raj Tilak,1984,['India'],"['Action', 'Drama']",1980,4
1040571,Bad Education,2004,['Spain'],"['Psychological thriller', 'LGBT', 'Crime Fiction', 'Mystery', 'Romantic drama', 'Thriller', 'World cinema', 'Film noir', 'Romance Film', 'Drama', 'Coming of age', 'Fantasy']",2000,4
5733558,Wild Hogs,2007,['United States of America'],"['Action', 'Biker Film', 'Action/Adventure', 'Buddy film', 'Comedy', 'Road movie', 'Adventure']",2000,7
28794470,Christina,1984,"['Spain', 'United States of America']",['Pornographic movie'],1980,4
7194265,Clubland,2007,"['New Zealand', 'Australia']","['Comedy', 'World cinema', 'Romance Film', 'Romantic comedy', 'Drama']",2000,7
8528824,Altered,2006,['United States of America'],"['Psychological thriller', 'Science Fiction', 'Horror', 'Sci-Fi Horror']",2000,6
1011167,Dragonheart,1996,"['United Kingdom', 'Slovakia', 'United States of America']","['Fantasy Adventure', 'Action/Adventure', 'Costume drama', 'Adventure', 'Drama', 'Sword and sorcery films', 'Science Fiction', 'Fantasy']",1990,6
27515247,Incense for the Damned,1972,['United Kingdom'],['Horror'],1970,2
2258469,Boomerang,1947,['United States of America'],"['Black-and-white', 'Crime Fiction', 'Film noir', 'Drama', 'Courtroom Drama']",1940,7
8893458,Almejas y Mejillones,2000,['Argentina'],['Comedy'],2000,0
577152,Pay It Forward,2000,['United States of America'],"['Film adaptation', 'Inspirational Drama', 'Romantic drama', 'Childhood Drama', 'Romance Film', 'Drama']",2000,0
77663,Madame Curie,1943,['United States of America'],"['Black-and-white', 'Biography', 'Biographical film', 'Biopic [feature]', 'Romance Film', 'Docudrama', 'Drama']",1940,3
24060860,Marked Men,1940,['United States of America'],"['Action', 'Crime Fiction', 'Mystery', 'Western', 'Romance Film']",1940,0
29054588,Aditya 369,1991,['India'],['Science Fiction'],1990,1
9985703,The Last Kiss,2001,['Italy'],"['Romantic drama', 'Comedy', 'World cinema', 'Romance Film', 'Romantic comedy', 'Drama']",2000,1
2237290,Our Dancing Daughters,1928,['United States of America'],"['Black-and-white', 'Silent film', 'Melodrama', 'Drama']",1920,8
27376208,Beauty's Exotic Dance: Torture!,1977,['Japan'],['Japanese Movies'],1970,7
15765481,The House of Usher,2006,['United States of America'],"['Thriller', 'Drama']",2000,6
24211707,Borderline,1980,['United States of America'],['Drama'],1980,0
596078,Good Boy!,2003,['United States of America'],"['Comedy', 'Animal Picture', ""Children's/Family"", 'Science Fiction', 'Family Film']",2000,3
22141846,Pontiac Moon,1994,['United States of America'],"['Period piece', 'Road movie', 'Drama']",1990,4
3356006,Unforgettable,1996,"['Canada', 'United States of America']","['Psychological thriller', 'Suspense', 'Mystery', 'Thriller', 'Crime Thriller', 'Science Fiction']",1990,6
3111296,The Meeting Place Cannot Be Changed,1979,['Soviet Union'],"['Action', 'Crime Fiction', 'Mystery', 'Adventure']",1970,9
2154704,Choke Canyon,1986,['United States of America'],"['Action Thrillers', 'Thriller', 'Adventure', 'Science Fiction']",1980,6
4679679,Una Breve Vacanza,1973,['Italy'],"['Romance Film', 'Drama', 'World cinema']",1970,3
29278064,Confidential Lady,1939,['United Kingdom'],"['Romance Film', 'Drama', 'Comedy film']",1930,9
44437,The Great Ziegfeld,1936,['United States of America'],"['Musical', 'Black-and-white', 'Backstage Musical', 'Biography', 'Musical Drama', 'Biographical film', 'Drama', 'Period piece', 'Biopic [feature]']",1930,6
5454803,The Lives of Others,2006,['Germany'],"['Period piece', 'Thriller', 'World cinema', 'Political drama', 'Drama', 'Political thriller']",2000,6
26612197,Mulla,2008,[],['Drama'],2000,8
1213939,Billboard Dad,1998,['United States of America'],"['Comedy', 'Romance Film', 'Romantic comedy', ""Children's/Family"", 'Family Film']",1990,8
748902,Getting Any?,1995,['Japan'],"['Japanese Movies', 'Parody', 'Comedy', 'World cinema', 'Slapstick', 'Sex comedy']",1990,5
24434156,Cigarette Girl,2009,['United States of America'],"['Indie', 'Fantasy']",2000,9
2114151,The St. Valentine's Day Massacre,1967,['United States of America'],"['Crime Fiction', 'Gangster Film', 'Crime Drama', 'Drama']",1960,7
10274511,Joseph's Gift,1998,['United States of America'],"['Christian film', 'Family Drama', 'Drama']",1990,8
6455349,Spring in a Small Town,1948,"['China', 'Republic of China']","['Black-and-white', 'Romantic drama', 'World cinema', 'Romance Film', 'Chinese Movies', 'Drama']",1940,8
18849330,Raja Mukthi,1948,['India'],"['Romance Film', 'Drama']",1940,8
13348400,Satisfaction,1988,['United States of America'],"['Drama', 'Comedy']",1980,8
24005728,Running Turtle,2009,['South Korea'],"['Action', 'Detective fiction', 'Action Thrillers', 'Action/Adventure', 'Comedy', 'Thriller', 'World cinema', 'Martial Arts Film', 'Action Comedy', 'Detective']",2000,9
30103174,Dobara,2004,['India'],"['Romantic drama', 'World cinema', 'Romance Film', 'Drama']",2000,4
27252164,The Impassive Footman,1932,['United Kingdom'],"['Drama', 'Crime Fiction']",1930,2
277160,Entrapment,1999,"['United Kingdom', 'Germany', 'United States of America']","['Action', 'Crime Fiction', 'Action/Adventure', 'Thriller', 'Crime Thriller']",1990,9
36057885,Uthama Purushan,1989,['India'],['Drama'],1980,9
12118772,Lucky Stars Go Places,1986,['Hong Kong'],"['Chinese Movies', 'Comedy']",1980,6
24327307,Sri Krishna Leelalu,1935,['India'],"['Musical', 'Drama', 'Family Film']",1930,5
17736697,Torch Song,1993,['United States of America'],['Drama'],1990,3
22762373,Unakkaga Ellam Unakkaga,1999,['India'],['Romantic comedy'],1990,9
29380772,The Ghost Goes Gear,1966,['United Kingdom'],"['Musical', 'World cinema']",1960,6
1585815,Yellow Hair 2,2001,['South Korea'],"['LGBT', 'Erotic Drama', 'Thriller', 'Erotica', 'Drama']",2000,1
677389,Dr. T & the Women,2000,"['Germany', 'United States of America']","['Comedy', 'Romance Film', 'Drama', 'Domestic Comedy', 'Romantic comedy', 'Comedy-drama', 'Workplace Comedy', 'Comedy of manners', 'Ensemble Film']",2000,0
8605430,Titli,2002,['India'],"['Drama', 'Art film']",2000,2
27978238,Westbound,1959,['United States of America'],['Western'],1950,9
21972773,Guiness Vision,2009,"['Canada', 'India']",['Action'],2000,9
25758881,"Little Tokyo, U.S.A.",1942,['United States of America'],"['Action', 'Drama']",1940,2
4913923,I Am Dina,2002,"['Denmark', 'Sweden', 'Norway', 'France', 'Germany']","['Period piece', 'Drama', 'Indie', 'World cinema']",2000,2
24318106,Drogi,2009,[],"['Action', 'Drama']",2000,9
11957333,Ninja Bachelor Party,1991,['United States of America'],"['Martial Arts Film', 'Parody', 'Indie', 'Action Comedy', 'Short Film', 'Comedy', 'Absurdism']",1990,1
26261438,Outlaw of Gor,1989,['United States of America'],"['Fantasy Adventure', 'Science Fiction', 'Adventure']",1980,9
871575,Avalon,2001,"['Japan', 'Poland']","['Dystopia', 'Japanese Movies', 'Action/Adventure', 'Thriller', 'World cinema', 'Science Fiction']",2000,1
17208834,Dance of the Dead,2008,['United States of America'],"['Indie', 'Comedy', 'Teen', 'Horror', 'Zombie Film']",2000,8
29046736,I Don't Want to Be Born,1975,['United Kingdom'],['Horror'],1970,5
30352708,Paju,2009,['South Korea'],"['Romantic drama', 'World cinema', 'Romance Film', 'Drama']",2000,9
2867597,Mr. Bill's Real Life Adventures,1986,['United States of America'],"['Slapstick', 'Comedy']",1980,6
1096473,The Last Command,1928,['United States of America'],"['Period piece', 'Black-and-white', 'Drama', 'Indie', 'Political drama', 'Silent film', 'War film']",1920,8
8628195,Kabuliwala,1961,['India'],['Drama'],1960,1
6040782,Dad's Army,1971,['United Kingdom'],['Comedy'],1970,1
